Episode,Average Reward,Average Lifespan,True Location Count,False Location Count,Explore Actions,Target Actions
1,-28.023249999998665,1974.75,18,6,34,24
2,-34.588249999999356,2106.684210526316,7,9,29,16
3,-39.05424999999969,1809.0,14,5,35,19
4,-46.79549999999937,2782.6666666666665,15,16,24,31
5,-37.31599999999983,2703.9473684210525,19,7,32,26
6,-50.63074999999991,1871.5,12,8,27,20
7,-53.76649999999963,1429.0,9,12,32,21
8,-18.196999999998813,3608.1666666666665,40,9,39,49
9,-39.654499999999544,3012.2105263157896,14,7,23,21
10,-19.03024999999876,2509.277777777778,20,4,27,24
11,-43.74049999999951,2005.1764705882354,9,10,37,19
12,-20.772499999999635,2274.777777777778,22,7,36,29
13,-51.20349999999961,2612.4,12,10,23,22
14,-53.291249999999806,3058.157894736842,20,17,24,37
15,-51.883499999999415,1429.0,5,10,23,15
16,-38.137000000000896,1634.375,27,4,41,31
17,-31.304499999999557,2994.277777777778,27,17,35,44
18,-36.895999999999255,3365.5789473684213,21,8,30,29
19,-35.101499999999284,2778.277777777778,16,8,30,24
20,-35.63749999999903,2320.764705882353,14,5,35,19
21,-33.681999999999135,2444.1111111111113,26,11,26,37
22,-27.014499999999508,3279.5263157894738,15,13,33,28
23,-44.83049999999898,3410.684210526316,23,4,46,27
24,-39.06649999999975,1629.2222222222222,4,12,22,16
25,-40.58624999999991,1603.625,18,8,25,26
26,-26.62124999999976,2815.5882352941176,22,20,24,42
27,-51.85624999999991,1666.1875,16,6,37,22
28,-33.559499999999474,2581.0526315789475,6,8,33,14
29,-31.40450000000007,1576.875,23,10,42,33
30,-46.007249999999274,2883.0,12,8,29,20
31,-34.71999999999929,1653.3125,12,0,34,12
32,-49.342000000000034,2266.8947368421054,4,5,35,9
33,-46.72274999999958,1820.2941176470588,8,13,23,21
34,-42.181249999998855,3351.35,16,5,36,21
35,-43.00399999999963,3335.4736842105262,13,8,30,21
36,-23.931749999999337,3185.157894736842,22,1,33,23
37,-37.329000000000086,2298.5555555555557,17,9,25,26
38,-42.31349999999945,1855.625,21,9,22,30
39,-38.35999999999931,1684.0,10,10,26,20
40,-38.090999999999184,2330.1666666666665,20,11,24,31
41,-42.98824999999974,2279.1666666666665,14,8,36,22
42,-51.06574999999947,1505.4375,6,8,35,14
43,-34.88774999999958,1621.5,22,3,33,25
44,-43.64199999999933,4284.6,18,14,31,32
45,-31.484999999999502,2533.4736842105262,12,6,27,18
46,-34.01299999999957,2609.8333333333335,11,14,23,25
47,-51.797000000000104,2008.8823529411766,13,12,31,25
48,-36.70649999999894,2694.15,18,2,31,20
49,-34.2539999999998,1755.4375,15,7,29,22
50,-40.05049999999981,1904.2941176470588,10,2,37,12
51,-56.352249999999216,2207.722222222222,10,11,37,21
52,-33.70224999999865,3744.2,19,15,33,34
53,-40.35299999999936,3510.1,20,7,33,27
54,-25.966249999997537,1706.875,25,5,37,30
55,-24.146749999999685,2733.157894736842,26,16,19,42
56,-40.78199999999837,2601.823529411765,24,10,43,34
57,-39.24899999999991,1518.3125,11,13,28,24
58,-27.068999999999612,1840.75,19,6,25,25
59,-23.722499999999084,1791.125,17,11,26,28
60,-42.90399999999867,3713.25,25,20,24,45
61,-54.66149999999983,2219.1666666666665,7,10,28,17
62,-34.75649999999903,3655.25,14,13,29,27
63,-42.28824999999785,2725.3333333333335,25,9,45,34
64,-22.080499999998327,3022.2631578947367,14,10,41,24
65,-37.61299999999853,2392.2631578947367,11,6,40,17
66,-11.567249999998754,2832.0555555555557,21,11,34,32
67,0.0887500000000534,2084.277777777778,23,13,30,36
68,-32.51799999999839,3956.85,30,9,26,39
69,-38.70099999999913,3933.0,21,16,34,37
70,-34.54724999999827,2610.777777777778,22,12,34,34
71,-24.509500000000493,1899.6470588235295,23,10,36,33
72,-55.38274999999989,2549.3684210526317,14,14,37,28
73,-38.63599999999779,4452.1,33,8,39,41
74,-36.11149999999846,4268.8,26,13,35,39
75,-31.175749999999578,2241.9473684210525,5,7,33,12
76,-23.601749999999583,2516.0,11,10,41,21
77,-47.574999999999136,2446.5789473684213,8,10,25,18
78,-10.222499999998977,2616.625,36,8,36,44
79,-37.2260000000003,2095.722222222222,21,9,24,30
80,-31.937999999998738,1626.4375,23,5,32,28
81,-44.443999999999676,1997.157894736842,6,15,19,21
82,-13.174499999999771,2106.0,25,8,26,33
83,-38.46149999999989,2121.3333333333335,11,11,29,22
84,-29.943999999998844,2670.5263157894738,20,4,28,24
85,-42.92374999999983,3258.684210526316,15,8,29,23
86,-51.94199999999883,2646.315789473684,6,6,47,12
87,-38.89849999999922,2517.95,7,6,31,13
88,-23.482499999998858,2652.1052631578946,19,9,31,28
89,-31.945750000000125,3082.5555555555557,18,9,35,27
90,-39.257749999999646,3313.0,28,12,39,40
91,-45.981000000000094,1655.7222222222222,8,6,32,14
92,-35.750999999998854,3159.3684210526317,16,12,31,28
93,-49.7507499999994,2145.842105263158,5,8,31,13
94,-45.460499999999755,2041.1875,32,13,31,45
95,-28.72674999999951,2341.6666666666665,18,8,26,26
96,-40.2857499999997,1608.625,9,5,25,14
97,-10.799749999999511,3282.529411764706,37,7,36,44
98,-28.007999999999377,2789.157894736842,16,17,23,33
99,-32.79000000000015,3627.9473684210525,24,17,23,41
100,-42.28124999999977,2937.8888888888887,36,14,43,50
101,-28.621249999998504,2057.4117647058824,33,10,38,43
102,-41.33049999999999,1901.6666666666667,14,12,32,26
103,-21.528499999998743,1662.1875,21,7,29,28
104,-42.45999999999968,2478.4210526315787,16,5,37,21
105,-39.39625000000064,2143.3888888888887,28,12,29,40
106,-35.056999999999036,4354.8421052631575,27,14,30,41
107,-25.154249999999607,2794.2105263157896,20,2,34,22
108,-22.75699999999889,3471.2,24,11,22,35
109,-22.597999999999214,2143.3125,20,11,31,31
110,-31.07400000000038,1769.8823529411766,19,6,35,25
111,-42.600500000000075,2500.5555555555557,21,10,28,31
112,-20.57449999999945,3246.157894736842,17,8,29,25
113,-41.916499999998344,3157.5263157894738,21,16,29,37
114,-43.986749999999944,1429.0,2,6,21,8
115,-25.960499999999417,2706.3529411764707,23,11,35,34
116,-14.487749999998945,2380.4375,38,11,27,49
117,-42.96299999999939,2428.1176470588234,19,15,32,34
118,-31.809999999999054,2298.6111111111113,19,11,30,30
119,-33.701499999999,1800.125,23,6,43,29
120,-37.88274999999951,3196.842105263158,19,11,24,30
121,-27.579999999999906,2352.277777777778,28,8,30,36
122,-17.656499999998566,3196.8947368421054,28,6,29,34
123,-31.618249999999854,1727.8235294117646,21,4,38,25
124,-28.983999999999888,2816.7368421052633,25,5,34,30
125,-52.71299999999978,2858.5263157894738,15,12,27,27
126,-35.47174999999967,1621.5,16,4,28,20
127,-40.17249999999928,2116.0555555555557,11,13,29,24
128,-31.452999999999044,2701.3684210526317,19,10,17,29
129,-23.112000000000155,3200.2105263157896,37,12,35,49
130,-47.383749999998884,1889.388888888889,9,4,39,13
131,-22.675999999997945,2171.1875,36,5,27,41
132,-37.03299999999843,3529.85,16,16,34,32
133,-31.502499999999692,2470.0526315789475,13,5,40,18
134,-32.21699999999869,2072.4117647058824,22,7,29,29
135,-30.537749999999885,2772.6470588235293,31,14,30,45
136,-44.630499999999984,2343.0,8,9,26,17
137,-28.14799999999921,4186.25,18,7,33,25
138,-44.97650000000057,2098.470588235294,21,12,25,33
139,-41.57499999999996,1830.3333333333333,5,12,29,17
140,-22.703749999999424,3713.2105263157896,40,16,24,56
141,-47.63549999999953,3221.1052631578946,24,4,38,28
142,-47.14299999999914,1982.5625,13,13,35,26
143,-32.973249999999204,3444.25,18,13,27,31
144,-31.61624999999944,3289.35,19,12,21,31
145,-27.763250000000124,2952.8333333333335,24,11,28,35
146,-37.94324999999866,4778.25,29,11,31,40
147,-26.70899999999923,1595.6875,11,4,31,15
148,-27.607249999998988,3444.15,18,13,25,31
149,-31.7035000000007,2748.4117647058824,43,18,39,61
150,-32.5762499999988,3076.75,15,13,22,28
151,-37.08024999999883,3495.277777777778,23,5,38,28
152,-40.89575000000093,1429.0,20,5,36,25
153,-32.67574999999871,2445.7894736842104,17,5,33,22
154,-47.27924999999991,3229.3684210526317,34,9,25,43
155,-37.25600000000081,2429.1111111111113,25,16,31,41
156,-32.57449999999919,3147.5789473684213,22,15,25,37
157,-30.796499999999334,2429.8333333333335,11,9,27,20
158,-44.397749999999455,2719.7894736842104,13,14,28,27
159,-36.98399999999838,1534.8666666666666,25,7,34,32
160,-44.43299999999911,1429.0,0,7,38,7
161,-31.634749999999492,2463.315789473684,15,8,26,23
162,-38.47399999999921,2906.0526315789475,21,8,40,29
163,-18.620999999998496,3933.15,32,8,31,40
164,-37.09774999999933,2491.6111111111113,14,12,25,26
165,-28.772999999999836,2353.1666666666665,16,9,30,25
166,-34.67150000000018,1863.1764705882354,21,7,37,28
167,-49.976499999999824,2877.7368421052633,11,3,38,14
168,-25.941000000000038,1736.235294117647,17,8,31,25
169,-28.038249999999113,3332.9444444444443,30,8,34,38
170,-42.74200000000037,1581.4,26,15,32,41
171,-27.00000000000021,3533.4736842105262,38,7,40,45
172,-46.43874999999995,2353.3529411764707,15,16,33,31
173,-28.87049999999885,1979.0,14,8,32,22
174,-52.642999999999596,2282.8333333333335,9,8,33,17
175,-49.077749999999966,1719.75,7,11,29,18
176,-43.69799999999978,2452.8888888888887,11,11,27,22
177,-35.30549999999904,2860.95,15,6,30,21
178,-31.087499999999732,1652.1666666666667,5,7,29,12
179,-46.56075000000027,2120.3888888888887,13,13,52,26
180,-2.0854999999977144,4084.0526315789475,39,12,35,51
181,-31.77699999999974,2713.8333333333335,15,9,26,24
182,-28.34424999999979,2255.277777777778,18,11,31,29
183,-27.287000000000013,2152.1875,40,16,29,56
184,-30.1372500000001,2471.0588235294117,29,18,45,47
185,-35.67049999999931,2499.157894736842,15,11,23,26
186,-44.648999999999845,2223.6470588235293,18,15,23,33
187,-25.834749999998415,2383.3529411764707,25,9,33,34
188,-52.571499999999546,2641.05,8,14,21,22
189,-40.16899999999973,2495.222222222222,11,18,28,29
190,-34.922749999999894,1694.1764705882354,19,13,36,32
191,-30.445499999997963,1992.5625,26,15,27,41
192,-14.285999999998396,2035.0588235294117,26,5,30,31
193,-29.838749999999003,3273.7368421052633,22,10,22,32
194,-33.805999999999926,1853.8823529411766,19,9,37,28
195,-37.51149999999924,2021.9411764705883,15,5,31,20
196,-36.132749999999795,2242.9444444444443,18,15,35,33
197,-40.7927499999988,3582.7368421052633,26,7,35,33
198,-41.015999999999494,2020.9411764705883,13,8,35,21
199,-46.34074999999951,1706.8125,12,8,27,20
200,-34.01124999999949,2928.684210526316,16,7,31,23
201,-43.86124999999975,2970.3684210526317,22,9,31,31
202,-57.33774999999913,2557.7894736842104,11,11,23,22
203,-42.879999999999924,2967.0526315789475,11,13,27,24
204,-50.171250000000086,3706.85,18,9,32,27
205,-33.228499999999784,2425.7894736842104,9,7,33,16
206,-31.536999999998926,2709.684210526316,19,9,30,28
207,-25.57199999999994,4040.5789473684213,38,13,31,51
208,-25.76799999999907,3354.5,25,6,28,31
209,-29.553749999999354,1660.5882352941176,18,11,32,29
210,-35.690999999999406,1739.5,8,9,28,17
211,-20.12524999999963,1548.6,46,11,27,57
212,-31.49924999999854,3484.6,29,5,40,34
213,-23.35949999999874,3032.1111111111113,28,10,30,38
214,-21.89949999999951,2487.9411764705883,20,14,34,34
215,-30.92174999999947,2232.1176470588234,24,11,32,35
216,-35.17924999999851,2027.25,42,10,43,52
217,-37.101499999999064,3120.45,14,10,27,24
218,-44.7579999999988,1908.9411764705883,12,4,39,16
219,-30.341999999998933,3731.5,26,8,35,34
220,-29.202000000000293,2168.8888888888887,24,9,29,33
221,-29.89924999999952,2938.7368421052633,23,15,16,38
222,-44.75574999999946,2017.375,26,8,39,34
223,-29.655999999999562,3245.2631578947367,18,11,26,29
224,-36.02249999999905,2120.3888888888887,12,4,31,16
225,-31.18924999999955,2474.0,23,8,30,31
226,-46.16549999999917,2092.9411764705883,11,22,26,33
227,-36.41874999999959,3184.6,13,13,29,26
228,-32.23224999999839,3957.65,19,10,36,29
229,-28.395000000000323,1857.625,33,13,30,46
230,-34.500249999999134,3235.1111111111113,21,3,46,24
231,-24.139499999999753,2991.6666666666665,29,10,25,39
232,-36.2602499999993,2732.3684210526317,16,10,23,26
233,-30.025249999998614,3742.6,21,6,33,27
234,-24.423249999999463,3245.7,23,9,26,32
235,-17.2022499999995,2160.1176470588234,34,17,28,51
236,-4.056249999998992,2997.0,29,7,34,36
237,-22.863249999999162,2413.1111111111113,10,8,39,18
238,-31.28449999999889,2820.842105263158,20,8,28,28
239,-52.29649999999916,3623.55,6,12,32,18
240,-30.633999999998792,1912.1875,18,7,31,25
241,-42.0944999999994,1572.8823529411766,6,3,29,9
242,-46.221750000000014,1541.125,4,9,32,13
243,-41.73774999999932,1898.375,17,9,37,26
244,-28.035999999999,1956.8125,19,7,35,26
245,-27.94900000000004,2754.3888888888887,18,9,29,27
246,-31.1329999999996,2172.7,9,10,22,19
247,-25.026499999999423,2237.625,22,10,33,32
248,-26.115499999998804,2554.0,35,15,33,50
249,-42.13649999999828,3658.5555555555557,26,11,41,37
250,-34.921499999999675,1946.4117647058824,17,8,31,25
251,-42.15474999999945,2049.0,6,7,28,13
252,-38.66874999999888,3756.05,19,17,28,36
253,-28.347750000000513,1613.8823529411766,23,10,37,33
254,-37.613000000000284,1571.875,6,8,36,14
255,-40.89474999999878,2386.1176470588234,16,17,26,33
256,-23.6602499999996,3497.5789473684213,32,9,36,41
257,-33.63149999999879,3932.8947368421054,24,6,31,30
258,-37.41200000000005,2119.5,11,8,29,19
259,-44.009749999999926,2131.8888888888887,8,10,30,18
260,-30.0979999999994,2400.7894736842104,11,11,24,22
261,-30.3097499999987,2060.4444444444443,15,6,36,21
262,-21.946499999999194,1621.5,18,7,41,25
263,-46.51499999999963,1628.388888888889,6,6,23,12
264,-41.10524999999887,1778.25,12,9,29,21
265,-33.9124999999973,3658.0526315789475,27,5,42,32
266,-30.03074999999908,2846.222222222222,18,11,24,29
267,-34.44549999999927,1675.0625,10,7,33,17
268,-37.261499999999764,2134.8823529411766,11,14,24,25
269,-46.14775000000001,2143.3888888888887,21,5,43,26
270,-39.74024999999985,2149.157894736842,6,6,27,12
271,-18.491000000000277,2770.3333333333335,36,8,29,44
272,-34.41499999999938,1550.0625,12,11,27,23
273,-40.96949999999961,2359.9411764705883,15,9,26,24
274,-14.66924999999829,3836.25,29,7,31,36
275,-27.388499999998963,1653.25,14,16,19,30
276,-21.417249999999335,2237.625,29,10,33,39
277,-36.88925000000047,2901.8333333333335,29,14,26,43
278,-31.79924999999937,1666.125,10,6,34,16
279,-30.268249999999306,2579.9,14,13,21,27
280,-25.39624999999854,1675.0625,34,7,33,41
281,-15.615999999999492,3122.8,15,9,30,24
282,-42.71899999999961,2083.85,7,12,21,19
283,-41.20649999999882,2237.625,26,14,28,40
284,-28.91199999999996,1920.1875,23,14,28,37
285,-42.96999999999911,2068.6470588235293,9,11,31,20
286,-45.62574999999964,2776.5263157894738,9,14,31,23
287,-24.38699999999867,3891.9473684210525,33,7,35,40
288,-41.922750000000036,2000.5294117647059,16,12,34,28
289,-24.191249999999233,3226.842105263158,18,13,30,31
290,-46.70599999999898,3140.6666666666665,26,11,36,37
291,-26.460249999999963,3517.95,16,13,26,29
292,-34.90749999999956,2539.315789473684,11,10,28,21
293,-35.0032499999985,1617.5625,16,11,36,27
294,-38.16399999999959,1639.375,29,14,35,43
295,-52.01775000000013,2223.5555555555557,4,10,38,14
296,-46.62499999999984,1429.0,12,9,42,21
297,-35.02874999999935,2571.8947368421054,16,7,31,23
298,-39.81099999999964,1528.25,5,11,23,16
299,-29.40449999999911,1916.125,19,9,40,28
300,-19.342749999998922,3365.6315789473683,33,10,26,43
301,-27.107249999999617,2381.4210526315787,11,7,27,18
302,-34.399749999999834,2328.176470588235,19,12,24,31
303,-26.060499999999468,2311.3529411764707,13,6,29,19
304,-24.85374999999932,2004.375,19,14,26,33
305,-30.764500000000147,4853.7,23,16,29,39
306,-35.93075000000091,1626.9411764705883,21,5,35,26
307,-26.747499999998798,2869.4210526315787,22,11,23,33
308,-18.204749999998043,2270.3529411764707,31,8,29,39
309,-36.10249999999938,3360.6315789473683,25,12,21,37
310,-33.738999999997446,2296.777777777778,24,11,35,35
311,-29.994250000000005,2786.222222222222,34,17,28,51
312,-51.5639999999991,1652.1666666666667,4,9,32,13
313,-25.56124999999998,3032.1666666666665,38,15,24,53
314,-24.57924999999902,2133.4375,28,11,33,39
315,-33.29049999999963,1429.0,20,15,34,35
316,-49.07150000000071,2403.2105263157896,21,5,45,26
317,-28.854499999997312,2572.8333333333335,30,11,36,41
318,-45.576249999999526,3052.3684210526317,29,16,26,45
319,-45.137499999999235,2523.4736842105262,11,17,24,28
320,-33.075499999999565,2885.9444444444443,23,12,21,35
321,-45.25149999999918,2251.35,10,9,29,19
322,-21.730999999998392,3425.7368421052633,27,10,28,37
323,-28.03224999999937,3298.95,15,10,28,25
324,-41.45799999999897,2971.9,17,6,30,23
325,-25.22349999999899,3538.4736842105262,32,17,24,49
326,-29.12349999999885,2992.9473684210525,21,12,23,33
327,-39.13775000000005,1790.3529411764705,24,20,32,44
328,-39.753999999998584,2993.8947368421054,20,18,16,38
329,0.3967500000007494,4940.2,39,13,24,52
330,-45.98549999999909,1766.1764705882354,10,5,30,15
331,-35.54449999999987,3176.0526315789475,24,10,29,34
332,-51.245250000000205,2302.0555555555557,20,14,25,34
333,-8.64274999999908,2857.6111111111113,27,12,22,39
334,-36.21574999999929,3189.45,14,17,26,31
335,-15.319749999999695,2206.823529411765,25,8,29,33
336,-27.09124999999845,2926.1052631578946,20,18,18,38
337,-34.62674999999949,2028.7777777777778,20,11,31,31
338,-22.319749999999075,3370.5789473684213,25,9,24,34
339,-54.66324999999913,2694.235294117647,23,11,32,34
340,-37.03474999999961,1429.0,18,12,27,30
341,-17.621499999998633,2628.3333333333335,24,1,33,25
342,-36.186249999998935,3707.777777777778,23,16,28,39
343,-36.66999999999916,2696.3684210526317,23,7,33,30
344,-25.946749999998225,3036.6666666666665,25,11,27,36
345,-38.38774999999923,2244.176470588235,16,8,29,24
346,-47.45100000000001,2607.0,23,6,38,29
347,-20.25099999999951,2239.5,15,8,25,23
348,-29.200749999999665,2283.5,13,14,29,27
349,-41.51324999999911,4598.05,21,14,26,35
350,-28.758249999999542,3973.684210526316,30,12,31,42
351,-46.455999999999776,2133.0588235294117,15,14,23,29
352,-31.919749999999357,2038.8235294117646,18,7,26,25
353,-43.12249999999957,2240.3333333333335,7,12,30,19
354,-39.92149999999886,3416.5263157894738,19,8,30,27
355,-48.64549999999868,2706.5263157894738,11,11,32,22
356,-50.62949999999911,2391.6470588235293,18,16,21,34
357,-37.30824999999669,2152.705882352941,31,5,47,36
358,-15.950749999999212,2398.235294117647,22,9,23,31
359,-21.822749999998862,2711.0588235294117,26,11,21,37
360,-34.99775000000015,2171.6111111111113,24,7,34,31
361,-33.88374999999843,2102.294117647059,13,12,35,25
362,-33.68849999999962,1429.0,11,8,32,19
363,-32.38449999999919,2005.1176470588234,15,10,28,25
364,-45.485499999999845,1429.0,2,13,24,15
365,-26.20100000000017,2801.6315789473683,36,12,19,48
366,-32.84774999999928,2214.777777777778,13,6,27,19
367,-30.8632499999988,4751.35,23,9,24,32
368,-39.90149999999934,1749.3529411764705,7,5,32,12
369,-44.30274999999856,5003.8,26,14,32,40
370,-35.365500000000424,1849.1764705882354,14,7,42,21
371,-25.580999999999094,2753.6111111111113,28,11,31,39
372,-46.677999999999415,3527.7368421052633,19,15,24,34
373,-40.07025000000023,1455.8125,11,11,25,22
374,-49.675499999999175,3182.3,17,19,24,36
375,-40.57424999999919,3303.65,15,14,29,29
376,-29.536999999999978,2496.235294117647,25,9,30,34
377,-31.98624999999898,2568.3888888888887,35,14,31,49
378,-15.569249999999744,2611.6666666666665,23,12,21,35
379,-34.147000000000034,2185.294117647059,17,6,35,23
380,-39.109750000000055,3779.1052631578946,30,6,37,36
381,-33.55649999999947,1614.8823529411766,9,13,22,22
382,-15.97574999999811,4133.368421052632,36,12,29,48
383,-38.316749999999544,2842.6111111111113,21,14,18,35
384,-29.093999999999482,2592.7894736842104,13,12,28,25
385,-15.498749999998854,4751.3,39,10,30,49
386,-30.19849999999864,3027.2631578947367,29,9,28,38
387,-33.46675000000033,1438.5333333333333,11,7,32,18
388,-24.136999999999084,3365.65,21,7,24,28
389,-38.184999999999164,2591.9473684210525,13,11,30,24
390,-23.83399999999581,2671.125,49,4,38,53
391,-14.557749999999235,3136.7894736842104,25,8,24,33
392,-33.957999999999984,1868.4375,20,9,24,29
393,-40.134249999998524,2809.0,37,16,33,53
394,-26.441749999998887,2539.294117647059,29,6,29,35
395,-34.59024999999978,2872.65,20,10,23,30
396,-33.770499999999124,1764.375,14,12,27,26
397,-33.841750000000246,1889.388888888889,21,15,27,36
398,-18.893249999999778,1429.0,31,17,26,48
399,-48.61749999999968,2595.315789473684,6,14,18,20
400,-42.383000000000116,1685.8235294117646,20,7,31,27
401,-35.25149999999865,1778.25,18,7,30,25
402,-29.77874999999919,1481.9333333333334,21,7,29,28
403,-36.191749999999914,2409.722222222222,25,5,34,30
404,-29.447999999999972,2019.1764705882354,27,14,23,41
405,-38.08150000000005,1429.0,7,8,29,15
406,-27.18825000000042,1429.0,10,10,28,20
407,-19.97175000000005,4377.55,22,11,27,33
408,-24.50199999999898,2322.6470588235293,22,12,24,34
409,-23.380249999999478,3306.5,30,14,24,44
410,-52.91574999999913,2906.1052631578946,12,10,30,22
411,-34.0237499999985,3948.3,24,20,27,44
412,-20.63824999999809,2354.4117647058824,30,15,21,45
413,-48.11424999999922,2790.7368421052633,13,19,24,32
414,-51.54499999999855,2134.5,7,15,37,22
415,-34.13024999999953,2458.5,9,11,24,20
416,-24.815499999999396,2466.5789473684213,20,7,22,27
417,-25.558999999998903,4576.210526315789,57,20,31,77
418,-24.291250000000375,2825.9444444444443,31,14,24,45
419,-35.954749999998775,3646.55,27,8,32,35
420,-25.465999999998825,2193.5263157894738,22,17,20,39
421,-25.42899999999911,3846.6,23,7,38,30
422,-29.50074999999897,3536.2,25,19,26,44
423,-23.20774999999947,2668.0588235294117,19,11,26,30
424,-19.537999999998824,2838.222222222222,32,13,20,45
425,-6.931499999996538,3595.3684210526317,44,11,29,55
426,-32.08424999999865,3275.9,16,16,27,32
427,-35.30349999999955,1733.625,14,13,21,27
428,-24.635999999998045,4518.8,30,8,32,38
429,-30.595249999999954,2912.7368421052633,18,15,24,33
430,-24.617249999998034,2787.1666666666665,24,13,31,37
431,-36.0602499999999,2198.9444444444443,18,17,18,35
432,-25.301249999998753,2846.222222222222,28,10,25,38
433,-28.28749999999904,3452.4736842105262,26,7,30,33
434,-37.023499999999416,2139.5882352941176,11,10,30,21
435,-35.87099999999922,3332.25,22,16,19,38
436,-22.898499999998226,3566.0526315789475,33,15,22,48
437,-39.753249999999255,1724.6875,8,8,31,16
438,-16.10324999999719,3557.0,46,2,29,48
439,-34.2254999999992,2576.5882352941176,31,16,26,47
440,-11.84299999999923,2112.625,29,17,20,46
441,-24.264500000000535,2960.777777777778,39,17,25,56
442,-44.37750000000004,1429.0,11,8,31,19
443,-20.958250000000195,1684.0,25,12,30,37
444,-30.491499999999434,1753.0588235294117,6,14,24,20
445,-38.67949999999883,2744.842105263158,15,17,18,32
446,-38.2009999999995,2269.3529411764707,22,16,26,38
447,1.4902500000024965,4301.4,41,8,27,49
448,-19.284249999999044,2814.4444444444443,33,6,27,39
449,-30.833249999998515,3367.315789473684,23,14,29,37
450,-40.72674999999985,1941.4444444444443,9,9,26,18
451,-51.445999999999785,1993.0588235294117,4,16,23,20
452,-27.821749999998747,3408.5,23,10,22,33
453,-31.6517500000001,1800.0625,8,13,22,21
454,-41.37974999999925,2206.764705882353,20,13,29,33
455,-31.292999999999836,2473.222222222222,21,9,29,30
456,-28.785499999998347,3765.842105263158,28,21,23,49
457,-29.752249999999954,2230.2631578947367,16,15,28,31
458,-33.679249999999605,1599.6875,13,18,14,31
459,-27.103499999999094,2618.6111111111113,21,13,25,34
460,-40.12625000000038,1630.4375,7,18,39,25
461,-33.878250000000136,1429.0,20,13,26,33
462,-17.466249999998823,3450.55,27,13,23,40
463,-40.280749999998235,2293.222222222222,23,3,37,26
464,-51.775499999999035,3140.15,12,11,31,23
465,-23.683499999999068,2735.1111111111113,30,18,21,48
466,-45.98449999999954,2346.222222222222,18,12,31,30
467,-20.15924999999952,3191.8888888888887,26,11,34,37
468,-22.962249999999084,4107.315789473684,33,20,22,53
469,-39.59999999999918,2583.684210526316,16,14,20,30
470,-29.761500000000087,1559.9375,20,6,30,26
471,-43.902499999999755,2752.1,7,14,22,21
472,-28.756249999998694,2432.125,41,14,39,55
473,-34.2182499999993,3799.7,23,8,32,31
474,-14.80649999999917,4071.9,31,13,19,44
475,-24.83899999999901,1731.5,19,19,16,38
476,-30.666999999998303,3175.85,17,11,29,28
477,-24.679499999999937,1727.8235294117646,25,13,26,38
478,-18.705249999998102,2623.294117647059,31,10,27,41
479,-15.539749999998858,3944.6315789473683,32,14,29,46
480,-28.16424999999876,1840.6875,24,4,29,28
481,-31.112999999998813,4334.55,28,21,26,49
482,-11.864499999999044,1760.4375,24,9,26,33
483,-35.04174999999991,2094.8947368421054,7,6,32,13
484,-8.206999999997475,2349.6875,47,9,23,56
485,-36.59799999999964,4484.65,23,18,14,41
486,-41.98524999999931,1810.888888888889,8,12,22,20
487,-32.87349999999882,3906.0,22,10,33,32
488,-29.521250000000045,3443.315789473684,46,12,32,58
489,-34.61099999999957,1662.4117647058824,7,15,20,22
490,-36.99524999999939,4975.15,35,17,22,52
491,-21.797249999999526,1866.9411764705883,19,8,21,27
492,-18.801500000000242,2666.222222222222,28,14,22,42
493,-29.484000000000226,2484.5555555555557,34,7,30,41
494,-16.81824999999909,3418.157894736842,20,11,29,31
495,-27.63124999999888,2568.5,29,11,19,40
496,-17.92299999999877,3109.2,26,13,23,39
497,-57.056499999999474,1550.0625,17,14,32,31
498,-30.816749999999843,2370.0,18,8,23,26
499,-28.62374999999874,1951.0588235294117,18,12,25,30
500,-27.35549999999938,2156.3125,16,15,17,31
501,-36.181,2906.8947368421054,15,5,33,20
502,-36.040249999998665,1966.9444444444443,15,8,33,23
503,-28.142249999999308,2695.4444444444443,20,14,16,34
504,-21.26424999999914,3194.2,24,7,25,31
505,-24.09600000000014,1660.125,31,9,29,40
506,-32.55399999999885,1671.125,20,8,24,28
507,-31.969999999998073,3185.0526315789475,30,15,29,45
508,-18.71624999999868,2761.529411764706,39,12,40,51
509,-31.696749999999287,2357.1176470588234,21,18,27,39
510,-37.07824999999953,3125.0,20,10,24,30
511,-37.618749999999565,2252.7894736842104,15,8,30,23
512,-23.352749999999727,3214.777777777778,41,21,24,62
513,-34.328249999998924,2327.6666666666665,20,11,21,31
514,-22.99199999999817,4714.85,31,5,35,36
515,-41.39474999999927,1631.7058823529412,5,11,23,16
516,-43.3382500000002,2310.0,25,13,37,38
517,-25.164749999998214,1597.6875,22,3,38,25
518,-30.308249999999845,2370.0,10,9,26,19
519,-12.33774999999985,3009.277777777778,31,12,24,43
520,-18.193999999999143,1898.3125,25,13,20,38
521,-34.79774999999993,2595.6666666666665,29,22,16,51
522,-38.35225000000142,1429.0,31,28,21,59
523,-25.92074999999948,2544.2,15,9,23,24
524,-29.60974999999994,2290.4736842105262,19,7,22,26
525,-36.685499999999465,2554.45,11,4,30,15
526,-6.398249999997568,4049.7894736842104,39,3,34,42
527,-17.197249999998913,1742.5625,25,16,15,41
528,-33.274999999999224,2337.85,12,3,30,15
529,-11.808249999998983,3430.0,27,8,24,35
530,-28.284499999998935,1833.3529411764705,23,2,32,25
531,-20.53599999999948,2689.5882352941176,19,10,33,29
532,-16.213749999998978,3314.4444444444443,41,11,29,52
533,-40.9469999999992,2560.4444444444443,14,13,36,27
534,-45.92649999999977,2922.7894736842104,21,17,19,38
535,-33.76249999999936,4079.1052631578946,29,13,27,42
536,-22.982749999999452,3276.315789473684,31,17,24,48
537,-30.656249999999705,2063.8823529411766,18,6,28,24
538,-22.679249999999026,2422.5263157894738,21,12,21,33
539,-39.628499999999406,2652.9473684210525,15,21,21,36
540,-18.28149999999951,3372.2631578947367,26,9,30,35
541,-36.51374999999898,2339.8125,26,16,23,42
542,-24.532749999998515,2408.470588235294,35,10,26,45
543,-35.107999999999876,2830.4444444444443,36,17,23,53
544,-35.30999999999947,3410.6315789473683,36,17,35,53
545,-19.93724999999898,3715.7,32,8,16,40
546,-24.1207499999983,2593.4117647058824,29,14,28,43
547,-24.12449999999982,2489.0,14,4,31,18
548,-17.489499999997633,2757.764705882353,41,7,26,48
549,-26.115249999998536,2111.5555555555557,13,7,35,20
550,-22.762499999997267,2162.9411764705883,32,17,25,49
551,-44.246749999999274,3618.5789473684213,18,20,22,38
552,-22.563999999999584,3207.7368421052633,27,11,30,38
553,-41.026249999999955,2663.6111111111113,17,14,26,31
554,-49.652499999999684,1429.0,0,6,31,6
555,-33.19699999999956,2109.764705882353,22,19,26,41
556,-32.6574999999989,3872.0,25,9,32,34
557,-23.561249999998896,4226.894736842105,33,15,26,48
558,-31.231249999999058,3203.4736842105262,29,16,30,45
559,-41.3617500000001,1731.4705882352941,12,8,31,20
560,-28.41599999999975,2319.8823529411766,33,12,29,45
561,-30.296499999999007,2063.9411764705883,20,7,30,27
562,-22.290749999998972,2269.3529411764707,27,11,21,38
563,-44.34574999999963,1429.0,0,16,17,16
564,-20.039249999999868,2639.5789473684213,24,19,23,43
565,-33.801499999999166,2602.8947368421054,15,10,23,25
566,-35.15924999999919,2065.8823529411766,12,18,23,30
567,-41.43625000000054,1429.0,8,11,32,19
568,-22.9157499999997,2719.470588235294,37,12,24,49
569,-42.81675000000037,1800.0625,10,19,17,29
570,-35.96174999999972,2430.9444444444443,14,10,27,24
571,-48.88949999999981,2273.0,14,8,28,22
572,-46.322249999999336,1850.611111111111,7,8,26,15
573,-49.69574999999889,1699.7777777777778,5,16,27,21
574,-25.440249999997626,2951.0588235294117,41,11,23,52
575,-41.68799999999874,2354.684210526316,11,13,27,24
576,-23.93099999999831,3565.315789473684,28,12,27,40
577,-25.406249999999783,2669.0,24,7,28,31
578,-27.301999999999964,1957.3333333333333,30,19,25,49
579,-12.490749999998899,4509.25,37,11,21,48
580,-34.17124999999918,2012.8333333333333,9,16,25,25
581,-27.12049999999839,3114.4117647058824,37,18,27,55
582,-19.280499999999144,3143.3888888888887,32,14,20,46
583,-41.82324999999954,3580.65,17,9,32,26
584,-35.06624999999933,2660.4736842105262,12,22,22,34
585,-30.17274999999974,1571.875,22,16,22,38
586,-36.48799999999849,1438.5333333333333,20,18,27,38
587,-34.420999999999225,1900.5882352941176,11,7,31,18
588,-33.725999999999,4329.9,25,22,22,47
589,-37.06324999999942,1635.375,10,27,13,37
590,-19.768499999998802,3918.5,36,17,16,53
591,-17.933749999997993,4254.4,39,12,23,51
592,-19.525249999999353,2277.3888888888887,15,20,15,35
593,-25.953499999999156,2326.8888888888887,18,10,18,28
594,-21.585999999999256,2669.0,32,10,28,42
595,-27.984249999998838,2223.6470588235293,33,11,23,44
596,-24.733749999998686,2505.0,29,6,39,35
597,-34.85024999999989,2227.3529411764707,26,19,29,45
598,-28.674500000000297,2466.1111111111113,22,11,27,33
599,-37.71999999999984,2260.8823529411766,32,11,29,43
600,-30.568499999999307,2653.65,18,9,21,27
601,-38.551999999999985,2901.777777777778,40,11,28,51
602,-8.867249999997592,2930.0,36,14,25,50
603,-35.54025000000011,1853.625,15,5,42,20
604,-35.991499999999846,1866.0588235294117,21,23,23,44
605,-21.161000000000094,3270.3888888888887,30,23,18,53
606,-32.7535000000005,1554.0625,27,27,23,54
607,-34.076999999999686,2387.2631578947367,7,11,23,18
608,-20.855499999998347,3279.5789473684213,37,6,18,43
609,-15.869749999998016,3215.6666666666665,31,17,22,48
610,-37.48974999999902,3144.3333333333335,21,11,22,32
611,-23.610249999998288,2866.0526315789475,32,7,19,39
612,-34.37874999999916,1952.8947368421052,16,14,18,30
613,-28.64424999999951,2194.764705882353,24,13,24,37
614,-42.42199999999935,2245.315789473684,14,14,24,28
615,-22.747249999999244,2931.2105263157896,22,17,18,39
616,-42.00874999999944,1667.1764705882354,6,8,29,14
617,-20.173749999999423,2457.277777777778,21,12,27,33
618,-52.16250000000051,2611.6111111111113,16,23,24,39
619,-41.465249999999855,2502.277777777778,19,15,18,34
620,-25.19199999999941,3309.9444444444443,31,27,20,58
621,-27.05124999999912,2809.277777777778,40,11,43,51
622,-17.811749999999325,3801.684210526316,25,15,28,40
623,-39.7567499999996,1501.0,15,21,15,36
624,-10.99924999999919,3606.157894736842,41,14,24,55
625,-12.66824999999913,2949.3333333333335,34,12,21,46
626,-28.189750000000167,2913.1111111111113,31,16,22,47
627,-19.6989999999993,2982.8333333333335,23,13,21,36
628,-8.708249999998367,4179.9,35,0,34,35
629,-45.58674999999958,2643.4,6,17,17,23
630,-27.93749999999911,2933.684210526316,34,10,29,44
631,-16.456999999999685,2299.294117647059,38,11,28,49
632,-15.766249999999406,4430.736842105263,37,18,16,55
633,-2.568499999999254,3219.4210526315787,24,20,13,44
634,-27.411249999999107,2256.375,34,12,27,46
635,-44.04799999999986,1429.0,0,10,26,10
636,-24.3092499999993,1964.0588235294117,15,16,21,31
637,-43.83149999999915,2208.6470588235293,21,13,16,34
638,-30.61699999999969,2993.842105263158,31,8,27,39
639,-40.33199999999967,1906.111111111111,5,18,20,23
640,-35.186749999998675,2408.529411764706,35,11,32,46
641,-37.375499999999946,2876.842105263158,26,12,30,38
642,-20.09599999999952,2223.6470588235293,36,15,25,51
643,-31.12424999999819,2210.8125,32,8,40,40
644,-6.822499999998863,4544.368421052632,40,9,30,49
645,-36.36174999999989,2317.157894736842,22,9,36,31
646,-33.515999999998904,2782.4736842105262,20,7,29,27
647,-21.793249999999517,2055.1666666666665,21,16,14,37
648,-2.778749999997897,4829.9,44,20,15,64
649,-33.318499999999396,3676.6,20,8,24,28
650,-33.412499999999895,3027.777777777778,32,17,35,49
651,-16.961999999999172,3846.7368421052633,39,9,22,48
652,-32.235999999999414,2927.277777777778,22,15,26,37
653,-25.83624999999906,2263.222222222222,23,12,19,35
654,-16.720249999999325,2181.705882352941,24,15,25,39
655,-39.35699999999921,1572.875,9,10,27,19
656,-29.261499999998705,2237.777777777778,22,14,19,36
657,-24.559749999999653,2566.6111111111113,21,11,23,32
658,-35.1464999999993,1934.0,23,11,28,34
659,-29.12449999999938,3244.95,18,8,25,26
660,-52.8799999999991,2160.9444444444443,12,14,24,26
661,-47.49674999999949,1895.9411764705883,14,12,31,26
662,-17.34249999999897,2198.4117647058824,28,14,24,42
663,-22.936749999997314,3231.9473684210525,40,5,32,45
664,-17.925499999997996,2352.75,38,9,27,47
665,-21.53374999999889,3046.45,25,14,16,39
666,-19.353249999997484,2421.705882352941,38,11,25,49
667,-38.8904999999978,4213.15,38,16,22,54
668,-27.767249999999507,2742.8888888888887,18,14,15,32
669,-38.60574999999951,1635.375,9,10,26,19
670,-36.181249999998485,2208.6470588235293,18,14,26,32
671,-36.68349999999853,2844.3888888888887,26,10,23,36
672,-21.845749999998134,2282.4117647058824,23,18,25,41
673,-29.585999999998563,3782.3,36,9,14,45
674,-29.656249999997367,2305.0625,36,6,35,42
675,-43.641999999999236,2195.5,18,12,25,30
676,-20.715999999999266,1942.6470588235295,22,10,23,32
677,-30.048749999997824,2168.0,20,13,32,33
678,-10.040499999999366,3230.157894736842,34,16,20,50
679,-39.53399999999847,1906.111111111111,18,13,22,31
680,-21.649999999999515,3125.0,39,18,22,57
681,-25.220500000000158,1795.0588235294117,19,15,29,34
682,-25.64049999999994,2038.8235294117646,35,7,29,42
683,-19.85400000000005,2425.3529411764707,29,11,31,40
684,-15.359749999997987,2919.3333333333335,37,3,24,40
685,-29.063000000000006,2240.277777777778,26,13,25,39
686,-29.216999999999253,2002.4117647058824,14,12,20,26
687,9.00400000000197,3576.3888888888887,53,7,14,60
688,-24.062749999999532,2631.8888888888887,33,9,28,42
689,-4.391249999997629,2241.294117647059,37,21,19,58
690,-38.43775000000015,2271.1666666666665,31,14,20,45
691,-27.3795000000001,2782.777777777778,22,20,19,42
692,-35.182249999999,2515.9473684210525,19,22,15,41
693,-23.91949999999872,4293.35,36,10,26,46
694,-22.088999999998784,3222.684210526316,22,9,31,31
695,-46.914749999999145,1710.8125,10,9,42,19
696,-16.606249999999655,2770.4444444444443,25,13,25,38
697,-57.203749999999765,1429.0,1,16,25,17
698,-24.747749999998813,5073.4,33,17,23,50
699,-30.306499999998408,2787.1111111111113,25,17,20,42
700,-34.09649999999912,2917.6111111111113,31,15,29,46
701,-23.016749999999053,1429.0,12,13,25,25
702,-34.66624999999988,2749.9473684210525,19,18,11,37
703,-26.287249999998807,2435.6315789473683,24,19,11,43
704,-17.838999999998414,2953.777777777778,37,7,21,44
705,-30.69475,2727.0555555555557,32,12,27,44
706,-23.322249999999766,2520.8333333333335,19,16,43,35
707,-16.001749999998935,2593.3529411764707,36,7,21,43
708,-9.321499999998245,3493.5263157894738,40,13,24,53
709,-27.53574999999902,2437.4210526315787,17,10,23,27
710,-34.307999999999346,2688.3333333333335,18,16,13,34
711,-3.4204999999976122,4894.15,45,4,31,49
712,-17.94549999999777,3421.1111111111113,42,12,23,54
713,-20.40824999999898,3807.6,26,23,16,49
714,-25.308999999998854,4558.5,28,12,25,40
715,-31.652499999999293,2884.315789473684,16,15,20,31
716,-45.83924999999864,2668.0555555555557,19,19,17,38
717,-12.25299999999832,4387.85,39,9,24,48
718,-19.229999999999627,4423.210526315789,37,19,16,56
719,-34.1287499999997,2038.764705882353,23,13,17,36
720,-27.09499999999855,2235.9411764705883,29,6,27,35
721,-25.8532499999997,2131.294117647059,22,7,29,29
722,-44.43725000000038,2395.4117647058824,25,19,32,44
723,-41.73949999999877,2876.1666666666665,28,16,21,44
724,-37.81949999999946,1429.0,0,19,21,19
725,-14.449249999998276,2267.722222222222,33,17,20,50
726,-11.808749999998922,3644.5789473684213,34,15,19,49
727,-10.911249999999505,3756.5789473684213,36,11,30,47
728,-16.899749999999077,3156.5555555555557,28,13,23,41
729,-31.39624999999925,1887.5294117647059,22,15,16,37
730,-6.065749999999572,3125.0,36,7,30,43
731,-21.18899999999924,2119.0588235294117,21,20,16,41
732,-17.887249999998836,3809.2,34,10,25,44
733,-41.69124999999946,2986.2631578947367,20,15,16,35
734,-26.215999999999333,3132.4736842105262,28,15,22,43
735,-38.762749999998434,2207.777777777778,24,16,18,40
736,-32.94549999999877,2226.8947368421054,14,18,18,32
737,-22.57499999999889,3817.95,28,20,21,48
738,-22.078499999998648,2400.176470588235,35,11,35,46
739,-28.110999999999244,2769.4444444444443,27,19,22,46
740,-64.68899999999937,1429.0,0,12,27,12
741,-43.1319999999998,1429.0,5,16,19,21
742,-11.085249999997755,4692.6,44,10,26,54
743,-43.49150000000019,3546.0526315789475,32,18,23,50
744,-16.02574999999886,3608.0,38,12,19,50
745,-43.12799999999976,1429.0,0,17,20,17
746,-22.81699999999869,2574.823529411765,34,12,16,46
747,-27.806249999998936,1769.8235294117646,17,15,33,32
748,-38.78899999999989,1648.25,13,16,22,29
749,-27.94699999999881,3551.3,24,4,30,28
750,-20.786499999998107,1900.5882352941176,27,13,21,40
751,-26.785749999999485,2335.4736842105262,24,6,23,30
752,-30.70449999999955,1946.3529411764705,20,17,25,37
753,-21.02549999999864,2455.235294117647,27,9,22,36
754,-18.743499999998896,4027.2631578947367,37,22,23,59
755,-36.97599999999896,3153.65,27,12,15,39
756,-28.47450000000009,1643.3125,20,14,26,34
757,-33.361999999999156,2236.0555555555557,20,16,16,36
758,-32.9132499999987,1429.0,21,6,34,27
759,-32.52249999999886,3112.4,21,3,30,24
760,-31.107749999999918,3619.6,18,20,21,38
761,-28.967749999999164,1719.4117647058824,17,18,21,35
762,-15.874999999999678,2152.3125,37,22,18,59
763,-29.15149999999996,2126.529411764706,26,20,17,46
764,-14.326499999999522,3623.7368421052633,39,12,26,51
765,-9.120249999999178,2154.8333333333335,28,13,15,41
766,-20.829499999999463,2416.9411764705883,39,12,17,51
767,-23.065999999999867,1505.4375,15,18,30,33
768,-27.763249999999296,2764.1052631578946,19,16,19,35
769,-34.76049999999988,1429.0,17,20,17,37
770,-25.42074999999952,1971.5294117647059,17,16,17,33
771,-39.55599999999931,2798.3684210526317,23,15,11,38
772,-22.40924999999833,2038.8947368421052,12,9,37,21
773,-17.32474999999948,1938.0,30,13,20,43
774,-26.084499999999018,2843.35,27,15,14,42
775,-19.385749999999252,3915.315789473684,36,17,22,53
776,-39.17024999999929,2643.7368421052633,23,19,9,42
777,-17.540499999997795,4728.0526315789475,52,15,17,67
778,-33.60074999999942,3530.6,17,21,13,38
779,-36.05699999999948,1528.25,10,20,13,30
780,-25.550999999998915,2277.3888888888887,26,15,19,41
781,-24.831249999998644,3388.1052631578946,42,7,30,49
782,-37.42449999999981,2361.764705882353,20,16,22,36
783,-18.20199999999918,3036.777777777778,36,9,20,45
784,-1.766999999999245,5179.95,44,20,10,64
785,-19.318749999998282,3916.0526315789475,43,13,13,56
786,-31.220999999999016,2660.05,19,18,19,37
787,-19.623749999999525,2258.8888888888887,28,9,21,37
788,-12.785249999999023,3012.2105263157896,25,16,18,41
789,-21.48724999999956,2481.1111111111113,23,18,18,41
790,-37.889499999999614,2147.8333333333335,16,3,30,19
791,-28.52174999999926,1534.8666666666666,15,13,20,28
792,-33.72049999999864,2908.1176470588234,31,24,18,55
793,-37.53649999999926,1429.0,13,12,22,25
794,-8.433749999998973,5970.3,47,15,24,62
795,-19.291999999998463,2672.2105263157896,24,18,19,42
796,-24.86674999999839,2459.823529411765,24,24,20,48
797,-35.47924999999936,1429.0,9,17,25,26
798,-34.179249999999364,2956.0,16,20,14,36
799,-7.709749999997989,3166.7894736842104,43,8,26,51
800,-27.093999999999056,3655.25,30,10,21,40
801,-39.166249999999444,2325.8888888888887,14,21,22,35
802,-27.68900000000005,2089.235294117647,21,20,21,41
803,-16.16974999999945,2608.0555555555557,36,12,30,48
804,-21.761499999999693,4156.789473684211,35,14,18,49
805,-30.23649999999995,2017.235294117647,23,6,37,29
806,-24.43174999999932,2902.9,20,14,17,34
807,-31.477499999998713,2963.176470588235,33,12,24,45
808,-4.151749999998282,3904.4,42,7,23,49
809,-28.980749999998977,2896.923076923077,26,18,16,44
810,-36.32424999999879,1710.8125,19,14,19,33
811,-17.718500000000358,2901.842105263158,32,17,25,49
812,-21.433249999999312,1816.5882352941176,15,12,22,27
813,-9.401249999998772,3377.2631578947367,40,11,14,51
814,-27.90099999999844,2616.0,35,18,26,53
815,-38.349999999999596,2806.1,18,14,18,32
816,-42.02499999999889,1623.235294117647,13,21,17,34
817,-17.605999999999586,4054.4,33,15,24,48
818,-33.93849999999923,2175.1052631578946,15,7,26,22
819,-29.48499999999931,1429.0,23,9,36,32
820,-11.464999999999526,3553.6315789473683,37,17,22,54
821,-30.881749999999226,3367.95,26,17,18,43
822,-25.006249999999387,3151.25,16,18,21,34
823,-10.624999999999918,3347.9444444444443,34,17,23,51
824,-19.74224999999908,3105.0,32,8,18,40
825,-27.15999999999924,2984.6315789473683,23,17,14,40
826,5.550000000000766,1947.875,36,11,19,47
827,-36.6635,1429.0,9,13,22,22
828,-36.40949999999967,2649.7,18,8,16,26
829,-20.209249999999752,2177.0588235294117,30,19,18,49
830,-26.631749999999585,2362.0555555555557,23,5,32,28
831,-28.214249999999673,2136.3333333333335,14,18,11,32
832,-19.150249999999893,2091.5263157894738,23,17,21,40
833,-33.70499999999983,2918.5,21,11,30,32
834,-18.365749999999075,2941.5,34,23,16,57
835,-25.45599999999897,3072.75,26,15,16,41
836,-28.435249999999275,3343.0,34,14,21,48
837,-27.716749999998893,2112.5,17,10,26,27
838,-26.723000000000305,1541.125,22,13,22,35
839,-22.529999999999667,1933.6315789473683,15,10,18,25
840,-38.57949999999961,2036.6666666666667,21,19,21,40
841,-19.339999999997694,2371.176470588235,24,13,32,37
842,-36.820000000000064,1429.0,12,11,35,23
843,-38.07674999999922,2948.7894736842104,17,18,14,35
844,5.248250000001475,3576.3333333333335,45,13,17,58
845,-37.547749999999894,2040.1666666666667,20,11,31,31
846,-26.63999999999905,2242.1111111111113,20,15,12,35
847,-29.451999999999703,2171.5555555555557,15,7,22,22
848,3.337000000001465,5202.9,49,5,28,54
849,-27.66999999999955,2258.8888888888887,16,12,19,28
850,-42.148499999999466,4186.25,30,12,25,42
851,-18.749749999999302,3175.1052631578946,25,14,17,39
852,-13.225249999999765,3675.5789473684213,42,24,21,66
853,-33.83774999999923,1710.75,13,11,23,24
854,-20.627249999998043,1824.9411764705883,30,16,17,46
855,-39.76974999999917,2928.2,18,17,23,35
856,14.268250000000766,4933.15,49,13,21,62
857,-18.714749999999224,2861.7368421052633,25,20,22,45
858,-30.21599999999814,3934.5263157894738,37,17,19,54
859,-24.475749999999255,1882.3333333333333,9,14,26,23
860,-22.954499999999086,2576.157894736842,31,13,19,44
861,-25.281499999999575,2520.35,19,7,18,26
862,-29.22150000000001,1925.125,28,7,26,35
863,-11.54774999999919,2380.6666666666665,26,13,18,39
864,-18.87474999999867,4207.736842105263,42,18,20,60
865,-31.12275000000046,2260.9411764705883,28,13,28,41
866,-9.745999999997808,4215.65,36,8,25,44
867,-32.86749999999954,1774.5882352941176,13,13,17,26
868,-6.462749999998638,3952.0,55,12,23,67
869,-10.33199999999618,2312.3529411764707,47,8,32,55
870,-19.79949999999965,2786.222222222222,33,20,20,53
871,-10.162749999997516,3020.8333333333335,41,17,24,58
872,-11.644999999998593,4614.0,42,17,13,59
873,-8.809499999998845,4379.9,44,16,16,60
874,-22.074249999998933,3726.4736842105262,28,13,20,41
875,-20.042749999999028,2809.2105263157896,29,18,16,47
876,-14.507249999998601,2181.6470588235293,30,10,24,40
877,-38.946749999999,2589.5263157894738,26,7,21,33
878,-25.110749999998834,1666.1875,15,12,26,27
879,-43.63599999999886,1932.2941176470588,18,14,27,32
880,-11.573499999998548,3210.2105263157896,36,18,15,54
881,-14.334249999998743,2699.7368421052633,23,23,14,46
882,-15.894749999999103,4109.894736842105,30,19,20,49
883,-28.0585000000001,1550.0625,37,9,31,46
884,-35.71424999999978,2470.7894736842104,19,13,26,32
885,-46.55524999999942,1429.0,13,5,46,18
886,-20.579499999998525,1569.875,21,13,25,34
887,-30.866249999999866,3272.0,31,12,25,43
888,-18.381749999998583,3988.7894736842104,41,17,19,58
889,-16.597250000000237,3468.722222222222,45,22,19,67
890,-17.37299999999888,2667.157894736842,26,12,14,38
891,-28.755749999999985,1938.0,33,16,15,49
892,-39.730500000000085,1657.1875,27,12,27,39
893,-14.366499999998833,3414.0,40,11,11,51
894,-33.87599999999925,2967.1052631578946,20,13,25,33
895,-37.49699999999782,4714.8,52,8,26,60
896,-30.357499999999146,2806.9,16,8,25,24
897,-15.890249999999451,2760.722222222222,42,12,17,54
898,-41.974499999999374,2312.9473684210525,12,17,16,29
899,-30.969749999999426,2120.7368421052633,11,10,24,21
900,-20.587999999998907,1844.75,42,16,26,58
901,-22.50274999999939,1622.4375,24,9,18,33
902,-39.5397500000005,1589.6875,12,13,27,25
903,-25.664499999998696,2663.2,20,12,22,32
904,-39.09624999999939,1429.0,0,24,19,24
905,-31.717249999998728,2500.0,26,15,20,41
906,-15.916499999999541,2663.722222222222,35,9,20,44
907,-52.31399999999893,2796.6,19,12,21,31
908,-7.7342499999977745,2153.25,41,10,22,51
909,-17.737749999999465,3972.9473684210525,32,19,16,51
910,-38.31024999999978,2076.277777777778,13,12,27,25
911,-11.591499999998897,2702.6470588235293,43,17,20,60
912,-21.704499999998884,3952.1052631578946,39,7,22,46
913,-27.351499999998957,2967.157894736842,26,15,12,41
914,-8.138749999998854,4472.8,43,5,25,48
915,-17.751249999998528,3195.157894736842,37,9,21,46
916,-8.246749999998443,2631.1666666666665,39,8,14,47
917,-29.52474999999933,2842.6,21,23,12,44
918,-18.846999999999383,2050.9411764705883,14,8,25,22
919,-5.049249999998319,3012.8333333333335,42,10,23,52
920,-31.852499999999544,2496.235294117647,23,23,16,46
921,-41.42299999999956,2410.7368421052633,12,11,19,23
922,-22.73624999999827,2026.7058823529412,26,4,29,30
923,-35.32799999999941,2308.4,10,15,21,25
924,-28.131000000000103,3157.5263157894738,38,6,35,44
925,-11.182499999999552,3794.1666666666665,50,13,18,63
926,-31.685249999999996,2714.777777777778,22,15,24,37
927,-27.45050000000031,3119.5555555555557,32,19,30,51
928,-1.5599999999981322,3001.3333333333335,41,15,18,56
929,-25.73724999999961,2944.4736842105262,20,14,22,34
930,0.25375000000211745,3413.1666666666665,49,9,17,58
931,-19.591749999999426,2758.8888888888887,27,16,24,43
932,-12.052749999998401,2512.5789473684213,24,13,25,37
933,2.9222500000015077,3599.3333333333335,45,10,23,55
934,-6.329749999998848,5833.8,58,13,25,71
935,-26.482749999999083,3142.65,34,11,11,45
936,-34.64124999999964,1652.1666666666667,5,22,9,27
937,-30.710499999999133,2546.0,16,16,29,32
938,-9.696499999998068,3029.842105263158,40,10,27,50
939,-2.2439999999983007,2532.277777777778,38,18,19,56
940,-24.189749999998476,2482.5263157894738,26,14,17,40
941,-44.60475000000023,1429.0,6,8,31,14
942,-1.0304999999985847,3734.157894736842,44,18,12,62
943,-10.550499999998356,2099.6875,32,12,19,44
944,-33.337999999998644,1635.375,20,10,22,30
945,0.4232500000013001,5495.0,42,25,21,67
946,-35.16999999999966,1621.5,21,15,15,36
947,-37.00199999999957,2160.85,10,14,18,24
948,-36.69275000000012,3254.5,43,16,22,59
949,-26.324749999999398,2005.5,27,14,17,41
950,-17.372249999998928,3274.35,32,13,21,45
951,-26.813249999999623,3106.3333333333335,44,12,20,56
952,-19.048249999999783,3183.0555555555557,32,10,38,42
953,-55.46674999999941,2628.7368421052633,18,15,20,33
954,-30.313249999999805,2068.3333333333335,19,8,29,27
955,-41.708499999999916,1559.0,13,13,25,26
956,-26.789250000000123,2317.9444444444443,39,24,19,63
957,-18.782499999998407,2648.375,47,21,17,68
958,-13.865499999998454,4495.75,39,7,23,46
959,-9.011749999999523,3270.3333333333335,33,8,31,41
960,-36.1039999999985,2157.294117647059,26,18,21,44
961,-24.83924999999873,3408.2105263157896,35,12,17,47
962,-20.3589999999998,2034.0,24,20,23,44
963,-46.31724999999888,1737.5625,9,12,30,21
964,-16.17574999999976,2369.9444444444443,36,19,10,55
965,-12.235499999999416,3370.0,42,15,21,57
966,-33.57624999999917,2393.722222222222,21,7,21,28
967,-38.77500000000018,1723.6875,21,20,21,41
968,-25.297749999998963,3817.6315789473683,34,17,21,51
969,-22.733499999999147,3390.684210526316,35,17,16,52
970,-3.0382499999984383,4094.15,41,10,19,51
971,-7.056499999998148,2862.3529411764707,44,16,26,60
972,-29.026749999999975,2973.7368421052633,27,18,20,45
973,-16.759749999999407,2549.0,33,12,21,45
974,-3.6347499999991717,3909.25,31,16,24,47
975,-25.725249999998518,3320.4210526315787,29,7,26,36
976,-33.11775000000015,2017.3529411764705,22,15,20,37
977,-31.960499999997165,2715.705882352941,37,10,31,47
978,4.776750000001523,4576.0,51,15,18,66
979,-14.945249999998017,4340.2,43,6,35,49
980,-36.79949999999999,2034.7894736842106,13,20,19,33
981,-21.952499999999244,2598.6315789473683,23,14,22,37
982,-25.96299999999914,2068.0,25,10,30,35
983,-31.193749999999604,2389.277777777778,18,9,25,27
984,-29.7199999999993,1715.75,18,4,44,22
985,-24.413249999999753,1946.2941176470588,15,15,23,30
986,-22.43299999999817,1961.8125,30,11,23,41
987,-11.1017499999994,3803.315789473684,42,13,25,55
988,-23.633749999999843,1639.375,20,21,18,41
989,-38.75374999999927,2166.3888888888887,19,6,33,25
990,-14.24075000000004,3191.8888888888887,44,14,23,58
991,-22.86424999999895,2155.6666666666665,12,12,38,24
992,-32.96724999999959,1620.4444444444443,8,21,14,29
993,-26.00849999999941,3459.25,30,15,19,45
994,2.203250000000967,2671.5,38,8,29,46
995,-22.046749999999477,2907.8333333333335,26,8,31,34
996,-41.785749999998885,3612.45,18,22,20,40
997,-17.302499999999124,3396.55,28,14,19,42
998,-19.731749999999483,3403.2105263157896,36,7,29,43
999,-36.54050000000032,1773.5882352941176,16,10,27,26
1000,-24.00749999999945,3666.315789473684,34,15,21,49
1001,-37.20399999999951,2112.4444444444443,12,13,22,25
1002,-0.6972499999974409,4086.25,48,11,23,59
1003,-28.727499999997956,1560.7058823529412,25,15,32,40
1004,-27.42499999999948,1576.875,25,17,24,42
1005,-16.03524999999805,4166.4,51,9,18,60
1006,-22.82574999999905,3242.9444444444443,36,13,23,49
1007,-18.01424999999963,3048.0555555555557,31,9,26,40
1008,-13.27824999999875,3714.8,36,4,25,40
1009,-6.521499999998532,2290.8823529411766,37,10,17,47
1010,-25.755749999999843,1514.7333333333333,25,18,19,43
1011,-18.156499999999387,1910.8823529411766,19,13,19,32
1012,-14.493249999999193,2799.157894736842,30,8,17,38
1013,-44.528749999999675,1567.9375,8,16,22,24
1014,-16.861999999998865,3138.6,23,16,23,39
1015,-10.495500000000161,1812.9375,28,10,35,38
1016,-9.06424999999909,4049.0,41,16,17,57
1017,-2.8659999999998194,4683.894736842105,61,12,25,73
1018,-18.301499999998672,2828.6470588235293,34,10,26,44
1019,-20.648749999999488,2231.5555555555557,32,13,22,45
1020,0.439500000001639,4100.6,49,15,12,64
1021,-17.192499999999107,2253.529411764706,27,12,16,39
1022,-21.754749999998577,3771.85,32,19,27,51
1023,-32.96824999999916,2537.5789473684213,19,9,28,28
1024,-34.275000000000325,2425.5,25,4,30,29
1025,-27.763999999998667,1963.1176470588234,23,16,23,39
1026,-14.052749999998639,2838.3888888888887,33,7,25,40
1027,-24.275499999998964,2504.8333333333335,19,19,23,38
1028,-26.756749999999727,1942.9375,31,11,34,42
1029,-16.691249999999478,3523.5263157894738,36,10,31,46
1030,-30.75499999999904,3180.8947368421054,25,25,14,50
1031,-27.795999999998617,4140.2,35,8,23,43
1032,-30.922499999999662,2481.1666666666665,25,13,26,38
1033,-7.6897499999996315,2897.3333333333335,32,34,16,66
1034,-26.24374999999833,2280.8888888888887,30,15,19,45
1035,-11.617249999999187,3077.3684210526317,26,5,25,31
1036,-7.499249999999128,3174.315789473684,40,7,26,47
1037,-30.306499999999357,2813.2,17,18,15,35
1038,-37.678500000000064,2225.470588235294,27,13,36,40
1039,-6.970749999998813,5291.0,46,17,13,63
1040,-27.79149999999931,2702.6470588235293,37,17,28,54
1041,-33.192749999999805,1744.6470588235295,13,9,31,22
1042,-33.767749999998735,1894.375,24,17,18,41
1043,-16.517249999998093,2630.5625,51,17,26,68
1044,3.086250000001522,4437.8,43,13,22,56
1045,-16.53574999999864,4455.3,37,21,15,58
1046,-0.19424999999890763,4804.894736842105,62,18,21,80
1047,-9.039999999997406,3825.0526315789475,59,3,20,62
1048,-20.107999999999087,3515.8947368421054,41,16,22,57
1049,-18.071999999998695,4072.3684210526317,39,12,27,51
1050,-32.86249999999955,2385.176470588235,22,13,17,35
1051,8.621500000001863,2555.176470588235,51,13,20,64
1052,-11.872999999998857,4895.0,42,17,13,59
1053,-12.287499999998673,3508.5,42,8,19,50
1054,-13.893249999999536,2655.6666666666665,34,15,22,49
1055,-38.280499999999414,1589.6470588235295,11,11,21,22
1056,-8.854249999999066,2196.3333333333335,45,1,33,46
1057,-24.01399999999908,3225.315789473684,36,14,22,50
1058,-34.331999999999425,1850.611111111111,8,18,17,26
1059,-39.68874999999951,1853.8823529411766,11,4,25,15
1060,-10.929249999998776,2926.1052631578946,22,13,26,35
1061,-27.177249999999514,2722.722222222222,30,15,27,45
1062,-16.016999999998315,2925.5555555555557,32,14,26,46
1063,-41.95224999999918,2658.4,17,12,20,29
1064,-18.892249999999855,3000.470588235294,56,16,30,72
1065,-12.040999999998876,1987.625,36,23,25,59
1066,-24.258499999999575,3279.5263157894738,47,15,29,62
1067,-27.379749999998893,2332.0555555555557,21,11,27,32
1068,3.928750000001891,5151.35,44,8,29,52
1069,-21.878749999998323,3095.75,34,12,21,46
1070,-21.349749999999784,2160.1176470588234,16,12,28,28
1071,-38.13774999999972,1438.5333333333333,19,21,18,40
1072,-18.182749999998556,3242.9444444444443,42,12,26,54
1073,-23.099249999998992,3271.9,27,14,15,41
1074,-5.698749999998323,3533.4736842105262,43,10,23,53
1075,-45.097750000000296,1429.0,8,6,49,14
1076,-26.21174999999845,3994.1,33,14,20,47
1077,-15.220249999999485,2576.222222222222,37,7,30,44
1078,-15.656999999999087,3190.2,27,10,17,37
1079,-9.417499999997274,2768.8823529411766,49,4,26,53
1080,-36.88924999999917,1429.0,11,11,25,22
1081,-11.459999999998633,3012.157894736842,34,16,25,50
1082,-21.27499999999934,3300.4210526315787,34,9,18,43
1083,-26.162750000000084,1899.6470588235295,23,12,29,35
1084,4.482000000002317,2489.5625,40,20,25,60
1085,-29.078249999999787,2746.5,21,16,32,37
1086,-19.368499999999365,2647.9473684210525,30,16,14,46
1087,-24.17999999999897,3078.2105263157896,23,18,27,41
1088,-25.20524999999891,2458.9411764705883,27,15,18,42
1089,-17.352999999997422,1766.3125,44,8,24,52
1090,-9.534999999999183,2290.6111111111113,36,5,27,41
1091,-7.618499999998953,3683.05,35,12,21,47
1092,-40.34999999999953,2508.3684210526317,15,10,20,25
1093,-27.055499999998954,3018.0,18,3,34,21
1094,-32.86524999999988,2319.8823529411766,24,11,22,35
1095,-30.93174999999991,2580.176470588235,35,16,33,51
1096,-20.780749999998676,2252.6666666666665,23,13,22,36
1097,-5.599749999998559,2525.222222222222,38,11,19,49
1098,-19.712249999998598,2958.7368421052633,28,15,19,43
1099,-39.775749999999796,2229.3684210526317,9,11,24,20
1100,-18.168749999997942,3017.222222222222,38,11,20,49
1101,-5.661999999998962,2998.8947368421054,33,20,13,53
1102,2.817000000001562,2559.8823529411766,47,19,22,66
1103,-2.1429999999980507,4914.7,51,17,14,68
1104,-18.846749999998934,3658.7894736842104,35,10,22,45
1105,-36.17449999999933,1429.0,10,20,9,30
1106,-16.294999999999636,3544.4210526315787,35,17,24,52
1107,-10.13399999999754,5556.8,57,13,28,70
1108,-11.496499999998989,2408.5882352941176,35,16,22,51
1109,-4.5137499999977,2547.0625,46,13,28,59
1110,-27.811499999999207,2849.7,23,13,19,36
1111,-15.614499999998865,2215.722222222222,27,7,18,34
1112,-23.085249999999473,2243.0,15,4,32,19
1113,-27.42424999999986,2597.176470588235,35,20,23,55
1114,-34.663499999999104,2100.1666666666665,13,18,23,31
1115,-25.95124999999905,2889.5,26,19,17,45
1116,-31.698749999998995,3203.3333333333335,41,5,28,46
1117,-23.10374999999944,3408.5,22,8,21,30
1118,0.47075000000193723,3743.9473684210525,48,19,12,67
1119,-18.18024999999996,2018.4375,31,12,20,43
1120,-27.3945,2556.0,27,15,21,42
1121,-10.804499999998072,2796.0,48,22,26,70
1122,-28.124749999999533,1689.0,13,19,15,32
1123,-12.323499999998365,3987.157894736842,45,15,15,60
1124,-33.05999999999905,2295.0,17,15,24,32
1125,-21.297499999997218,3235.0555555555557,55,18,22,73
1126,-45.450499999999366,1429.0,12,9,23,21
1127,-11.034749999998345,3694.25,40,9,24,49
1128,-23.514499999998385,2207.764705882353,23,18,33,41
1129,-27.76199999999895,2868.4736842105262,30,16,17,46
1130,-28.64074999999995,3008.3888888888887,39,17,22,56
1131,-19.464499999999372,3185.6666666666665,28,9,19,37
1132,-17.409499999999532,2575.315789473684,34,14,15,48
1133,-38.15524999999948,1429.0,18,10,32,28
1134,-24.532249999999568,2103.75,32,3,24,35
1135,-18.096749999999485,2798.5555555555557,44,15,26,59
1136,-18.00074999999928,3636.2631578947367,31,7,23,38
1137,-26.7007499999995,2421.1111111111113,22,16,15,38
1138,-16.878499999998688,2973.1666666666665,35,12,14,47
1139,-32.11224999999912,2983.6666666666665,26,10,20,36
1140,-5.0879999999977485,5029.8,48,7,22,55
1141,-38.42174999999846,2013.5294117647059,25,10,31,35
1142,-34.66099999999962,2639.8888888888887,30,19,20,49
1143,-23.517249999998647,4376.7,35,8,31,43
1144,-28.802249999999084,3563.9444444444443,35,15,21,50
1145,-16.64224999999905,2810.1176470588234,25,22,16,47
1146,-2.9397499999997434,2420.0625,45,20,28,65
1147,-1.605749999998205,2523.5,42,10,16,52
1148,-15.01924999999971,2437.4117647058824,45,16,20,61
1149,1.3852500000001207,3460.777777777778,53,13,18,66
1150,-23.49824999999896,2881.842105263158,26,13,13,39
1151,-9.599499999997807,3692.315789473684,43,19,13,62
1152,-29.09124999999991,3440.7894736842104,26,16,18,42
1153,-22.247500000000024,2143.3333333333335,26,17,21,43
1154,-16.762249999999504,3833.0,34,15,16,49
1155,-10.975499999998815,1528.25,25,12,21,37
1156,-34.98324999999984,1541.125,21,11,30,32
1157,-17.555499999998897,2581.157894736842,26,15,22,41
1158,-19.54274999999949,2064.0,14,15,20,29
1159,-12.492499999998257,3417.6666666666665,44,13,21,57
1160,-23.033499999999243,2523.4210526315787,19,5,32,24
1161,-51.49425000000042,1429.0,20,20,29,40
1162,-23.2522499999992,4064.842105263158,38,25,22,63
1163,-30.451499999999452,3042.470588235294,40,19,29,59
1164,-14.566499999998305,2580.777777777778,31,4,36,35
1165,-45.27900000000003,1429.0,5,10,27,15
1166,-11.102249999998751,2255.5,34,10,22,44
1167,-16.985749999999324,3191.8333333333335,31,16,19,47
1168,-16.956999999999308,2579.9,24,8,16,32
1169,8.16100000000137,4117.526315789473,54,8,23,62
1170,1.0810000000020412,2975.294117647059,55,4,25,59
1171,-24.49499999999965,2703.3333333333335,51,10,26,61
1172,-18.77725000000032,1924.8235294117646,25,17,22,42
1173,-47.40799999999961,1541.1875,8,8,26,16
1174,-3.1949999999981173,3231.5555555555557,37,9,26,46
1175,-35.639250000000054,2541.1052631578946,31,14,27,45
1176,-33.07449999999857,1653.3125,27,11,25,38
1177,-20.904000000000117,2185.4117647058824,31,17,22,48
1178,-33.578749999999,2727.5,14,14,22,28
1179,-16.249499999997653,2200.294117647059,37,17,19,54
1180,-13.941749999999411,1782.1875,30,18,17,48
1181,-33.29699999999896,2676.0,21,7,24,28
1182,-19.076249999999074,3509.3,29,6,21,35
1183,-39.29299999999811,3079.0526315789475,23,15,31,38
1184,-29.535749999999428,2393.777777777778,29,10,30,39
1185,-10.964750000000098,2965.277777777778,38,14,21,52
1186,-12.121499999999168,2686.5555555555557,35,11,17,46
1187,-16.778749999998922,2287.235294117647,23,18,16,41
1188,-14.576249999999112,3396.5,32,12,20,44
1189,-23.005499999998715,3499.7,24,19,16,43
1190,-27.543999999999023,2880.6,20,17,17,37
1191,6.765250000002519,5087.0,57,5,30,62
1192,-5.700999999998771,3521.1,37,9,24,46
1193,-24.63149999999948,2353.842105263158,15,15,22,30
1194,-14.149249999998286,3821.95,46,12,20,58
1195,-23.317999999998523,4503.65,38,15,21,53
1196,-12.1919999999994,2509.3529411764707,31,17,18,48
1197,-14.240249999998582,3987.8,43,13,17,56
1198,1.5320000000024063,2537.3125,48,12,25,60
1199,-17.498249999998713,3810.0714285714284,38,15,15,53
1200,-25.412999999998927,2030.3529411764705,24,11,29,35
1201,-24.884749999999134,2909.6111111111113,28,7,27,35
1202,-20.680999999998914,1822.875,31,10,16,41
1203,-25.14874999999868,4038.65,34,11,25,45
1204,-10.387249999998552,3074.5555555555557,36,16,19,52
1205,-5.28849999999939,3171.6111111111113,42,19,20,61
1206,-24.83574999999917,1920.125,41,15,20,56
1207,-29.763499999999908,1429.0,11,20,18,31
1208,-24.41149999999959,2672.764705882353,38,19,29,57
1209,10.234500000001232,3666.315789473684,55,15,13,70
1210,-15.036250000000706,2310.0,36,6,25,42
1211,-33.67274999999873,3834.6,29,10,24,39
1212,-38.47874999999919,2688.8947368421054,18,11,20,29
1213,-3.499499999997565,4553.7,53,16,14,69
1214,-12.780499999999535,2652.1666666666665,34,15,15,49
1215,-39.584999999998686,2982.2105263157896,20,11,29,31
1216,-5.361249999998629,3683.0555555555557,49,8,14,57
1217,-24.149249999999036,3610.05,25,22,17,47
1218,-20.99424999999824,2628.3888888888887,33,11,22,44
1219,-20.911749999997934,1760.4375,33,11,20,44
1220,-31.486499999999204,2647.3,20,19,12,39
1221,-17.956999999999883,2798.705882352941,36,9,20,45
1222,-8.03499999999946,2391.705882352941,35,8,30,43
1223,-21.855499999999683,2675.1111111111113,29,23,23,52
1224,-25.487749999998137,1965.8125,36,11,17,47
1225,-18.014749999999022,3457.277777777778,55,4,28,59
1226,-29.35149999999846,1528.25,19,14,22,33
1227,-24.279249999999386,2388.1052631578946,18,9,25,27
1228,-15.013249999998655,3135.842105263158,30,19,16,49
1229,-7.7439999999987466,4774.3,47,13,16,60
1230,-12.764999999999336,4468.65,33,16,14,49
1231,-18.91274999999884,3384.7368421052633,24,12,23,36
1232,-27.00524999999927,2735.0555555555557,28,12,31,40
1233,-16.874499999998392,3372.8,38,18,15,56
1234,-17.581499999999018,3426.7,24,7,25,31
1235,-8.834499999998789,4340.631578947368,52,13,21,65
1236,-36.042249999999555,1643.764705882353,10,20,14,30
1237,0.41175000000087714,2290.823529411765,30,15,25,45
1238,-20.952249999998315,2589.6470588235293,31,8,26,39
1239,-14.839749999998295,2028.375,42,16,12,58
1240,-19.779749999998195,1680.0625,31,12,19,43
1241,-38.447249999999364,1593.3529411764705,15,15,22,30
1242,1.7405000000001856,2299.235294117647,43,18,13,61
1243,-49.12824999999872,1556.0588235294117,9,16,30,25
1244,-12.338499999998948,3591.157894736842,38,15,13,53
1245,-31.498249999999636,2092.1666666666665,19,14,35,33
1246,-43.92974999999991,1652.1764705882354,9,9,51,18
1247,-28.632249999998862,2120.3333333333335,22,11,25,33
1248,-12.34699999999965,2211.277777777778,25,20,20,45
1249,-14.725499999999332,4695.473684210527,60,27,19,87
1250,-0.895749999998956,2663.6666666666665,39,20,18,59
1251,-21.40799999999971,2222.777777777778,21,13,19,34
1252,-0.9384999999996978,4294.578947368421,45,12,24,57
1253,-4.732749999999885,1429.0,43,12,28,55
1254,-22.507999999999438,2904.222222222222,34,14,26,48
1255,-47.213000000000356,1429.0,7,12,43,19
1256,-15.116999999998537,2543.0,38,12,18,50
1257,0.7112500000004183,3290.8823529411766,48,16,23,64
1258,-10.331999999998292,3313.8947368421054,36,11,23,47
1259,-21.595999999998185,3005.5263157894738,31,13,24,44
1260,-18.524999999999146,4669.45,38,11,27,49
1261,-27.969999999999022,2428.1666666666665,29,7,23,36
1262,-30.65550000000013,2004.888888888889,23,16,36,39
1263,-37.6544999999994,2576.157894736842,16,10,24,26
1264,-18.90824999999863,5017.25,37,20,25,57
1265,23.49825000000258,4920.35,61,4,24,65
1266,-24.763999999998774,3226.0526315789475,31,6,24,37
1267,-3.188999999998991,2085.875,40,9,23,49
1268,-4.36274999999795,4771.15,45,11,26,56
1269,-32.10299999999971,2643.7368421052633,25,16,23,41
1270,-23.721499999999654,2413.1111111111113,23,16,27,39
1271,-30.666749999998995,2884.1111111111113,33,7,31,40
1272,-19.35024999999944,2193.764705882353,29,21,16,50
1273,-6.9769999999982675,2822.3888888888887,48,13,20,61
1274,-12.123749999999923,3038.0526315789475,31,8,27,39
1275,-29.877749999999246,2121.5,25,8,27,33
1276,-9.546749999998745,4661.315789473684,56,17,16,73
1277,-51.61299999999959,2424.842105263158,7,15,25,22
1278,-5.710249999998335,2337.5882352941176,40,10,22,50
1279,-19.16149999999931,2759.8947368421054,28,11,19,39
1280,-22.122749999998966,3613.684210526316,42,16,23,58
1281,-36.038250000000204,3214.4210526315787,22,18,29,40
1282,14.202500000003614,2439.0,61,17,16,78
1283,-10.808999999998198,5051.3,42,11,22,53
1284,-5.891999999999622,3382.315789473684,51,13,19,64
1285,3.4240000000006865,4461.65,47,21,14,68
1286,-9.912499999999426,4552.05,45,9,19,54
1287,-45.774999999999295,2302.0526315789475,11,9,27,20
1288,-31.081249999999415,3222.6666666666665,45,14,23,59
1289,-7.628999999998632,3213.1111111111113,47,16,20,63
1290,-21.205499999999375,2151.764705882353,30,9,28,39
1291,-25.45949999999997,2329.235294117647,26,10,21,36
1292,-27.582749999999482,1648.4705882352941,14,9,21,23
1293,-20.88774999999953,1429.0,32,8,23,40
1294,-20.22824999999984,2473.2631578947367,24,18,15,42
1295,14.290000000001552,4324.736842105263,54,9,13,63
1296,-2.0057499999978945,4325.473684210527,54,15,22,69
1297,-29.31049999999877,3083.8,26,12,24,38
1298,-12.758749999998955,3254.4444444444443,41,19,19,60
1299,2.6047500000015558,4206.0,48,8,16,56
1300,-10.370249999997867,4194.1,42,9,30,51
1301,-11.592749999998496,2159.1666666666665,27,11,22,38
1302,-36.153749999999356,1559.0,13,16,14,29
1303,-37.64325000000006,3054.5,21,19,12,40
1304,-23.737999999999595,2683.0555555555557,30,14,19,44
1305,-37.66175000000025,1429.0,12,16,21,28
1306,-26.421999999999816,1692.9375,28,15,27,43
1307,-23.903249999999254,2238.6666666666665,22,14,25,36
1308,-24.504999999998823,2072.8888888888887,28,11,20,39
1309,-24.535999999999355,2920.3333333333335,27,12,24,39
1310,-4.588499999997914,4760.1,49,15,31,64
1311,10.016250000002298,4385.45,51,11,13,62
1312,-12.399249999999059,2560.4444444444443,31,11,24,42
1313,-18.146999999999387,1567.9375,28,16,29,44
1314,-15.5882499999994,2220.0,28,14,14,42
1315,-23.368749999999633,2445.8823529411766,35,12,25,47
1316,12.29700000000152,4768.263157894737,71,20,13,91
1317,-39.05350000000002,2350.5,29,15,26,44
1318,-18.417249999999214,2794.157894736842,24,16,15,40
1319,-10.415749999997626,2871.8333333333335,41,10,25,51
1320,-14.465749999998817,3920.3,34,12,24,46
1321,-37.20649999999863,1880.4375,23,11,25,34
1322,-4.861749999999283,3732.315789473684,51,7,35,58
1323,-14.7912499999994,2025.375,34,10,16,44
1324,-15.740249999998971,3653.0,49,16,21,65
1325,-32.818499999999695,2957.3333333333335,24,9,27,33
1326,-22.234499999999965,2429.0555555555557,28,10,21,38
1327,-37.18850000000038,1429.0,36,22,19,58
1328,-16.775499999998424,1951.875,35,12,23,47
1329,0.6015000000014066,4252.789473684211,60,13,17,73
1330,-28.06299999999976,1603.6875,15,11,24,26
1331,-13.889499999999192,3155.722222222222,38,18,13,56
1332,-18.823499999999406,1594.75,30,14,30,44
1333,-49.04799999999996,1429.0,0,14,20,14
1334,-17.13674999999882,4037.8,32,14,23,46
1335,-20.121999999999034,2631.9444444444443,22,10,19,32
1336,0.6322500000007653,2250.4375,54,16,21,70
1337,-30.186249999999017,2869.315789473684,19,4,37,23
1338,-30.94849999999912,2290.8823529411766,22,8,31,30
1339,-15.50399999999999,3111.7894736842104,41,11,39,52
1340,6.50425000000317,4944.15,61,12,21,73
1341,-15.497499999997839,2162.1875,40,12,18,52
1342,-11.481749999998511,2756.764705882353,37,13,14,50
1343,-23.538750000000228,2598.684210526316,22,5,29,27
1344,-12.384749999998357,2199.8333333333335,30,2,28,32
1345,-12.136499999998527,2449.5882352941176,38,10,19,48
1346,-37.81699999999923,1603.625,13,19,18,32
1347,-17.668749999999136,2348.8125,39,16,21,55
1348,-36.9987499999993,1429.0,12,9,20,21
1349,-35.52974999999857,2670.5263157894738,19,13,31,32
1350,-22.56324999999756,3029.470588235294,48,8,22,56
1351,-0.3907499999979933,4155.25,51,5,22,56
1352,-6.854999999998112,2497.5,50,12,24,62
1353,-19.420500000000214,1975.235294117647,41,17,19,58
1354,-11.581999999999931,2576.3333333333335,35,8,27,43
1355,-1.5324999999983184,2787.0,41,12,13,53
1356,-14.954749999999288,2475.764705882353,51,12,26,63
1357,-18.057249999999097,2509.4117647058824,28,12,35,40
1358,-17.71674999999899,2072.8888888888887,24,19,11,43
1359,-29.252999999999094,2050.777777777778,22,11,18,33
1360,-18.625249999999557,3309.5263157894738,34,19,20,53
1361,-41.7835000000006,2000.388888888889,21,26,13,47
1362,-18.26949999999809,3603.7368421052633,38,11,26,49
1363,-26.04650000000002,2538.4444444444443,45,12,17,57
1364,-26.744499999999487,2437.4117647058824,30,19,17,49
1365,-20.964999999999897,2282.9473684210525,16,9,31,25
1366,-24.514499999999238,2731.4736842105262,20,16,15,36
1367,-27.20624999999935,2678.0,15,10,25,25
1368,-19.741749999999193,2150.0,43,16,24,59
1369,-53.13974999999963,1429.0,1,20,14,21
1370,-19.36024999999848,1715.75,25,21,16,46
1371,-19.860749999999435,2441.5,26,11,24,37
1372,-28.18224999999945,2195.4444444444443,32,18,17,50
1373,-7.549499999998126,3464.315789473684,43,19,17,62
1374,-12.993749999998665,2215.235294117647,33,6,31,39
1375,-6.951499999999203,4579.0,35,10,22,45
1376,-10.958249999998957,2663.6111111111113,31,9,28,40
1377,-28.833750000000226,2117.5263157894738,29,12,21,41
1378,-11.462749999998648,2299.294117647059,28,21,23,49
1379,-3.890499999998154,2808.176470588235,61,17,17,78
1380,-28.85974999999914,3368.1052631578946,31,13,23,44
1381,-31.193499999999272,2295.5882352941176,19,15,16,34
1382,-15.24299999999773,4648.95,46,14,22,60
1383,8.026500000001414,4320.526315789473,62,15,18,77
1384,7.072250000000568,3727.3684210526317,52,15,18,67
1385,-17.461499999999766,2704.1666666666665,37,10,35,47
1386,-25.301250000000124,2017.235294117647,30,13,21,43
1387,-17.402249999998453,2723.722222222222,30,12,23,42
1388,-10.810999999998542,3844.1,37,8,28,45
1389,-29.213749999999273,2913.0555555555557,27,16,26,43
1390,-26.403249999999264,5116.35,48,9,26,57
1391,-16.54699999999937,3493.4736842105262,57,10,23,67
1392,-23.305249999998885,3052.1,33,8,14,41
1393,-24.71475000000009,2135.0,42,17,30,59
1394,-36.571499999999766,1467.1333333333334,20,6,28,26
1395,-31.589750000000027,2200.157894736842,20,14,23,34
1396,-21.664499999999265,1791.1875,39,10,20,49
1397,-30.552249999999184,1614.8823529411766,15,4,28,19
1398,-27.3262499999991,2611.6,25,6,19,31
1399,-26.552749999999225,1528.25,18,13,23,31
1400,-26.176749999999004,3008.45,26,11,18,37
1401,-37.107499999998915,2267.6666666666665,16,8,29,24
1402,-16.265749999999592,1929.5294117647059,34,20,19,54
1403,-32.23024999999981,2353.470588235294,25,21,26,46
1404,0.5755000000008866,2608.1111111111113,35,15,27,50
1405,-36.32300000000009,1429.0,17,29,22,46
1406,-16.688999999998437,3237.0526315789475,38,11,17,49
1407,-7.369999999998401,3101.3529411764707,44,12,16,56
1408,-8.703749999998417,3982.157894736842,44,14,18,58
1409,-3.3774999999988737,3583.6315789473683,40,11,20,51
1410,0.27100000000196556,2840.823529411765,50,21,21,71
1411,-12.344499999998893,2025.2222222222222,21,5,30,26
1412,-7.567749999999353,1567.6666666666667,34,14,17,48
1413,-17.415999999998878,3084.222222222222,38,15,27,53
1414,-15.65974999999906,2612.0526315789475,34,8,17,42
1415,-21.65624999999933,2144.2105263157896,20,12,19,32
1416,-25.992500000000007,3413.0555555555557,34,17,35,51
1417,-17.14499999999808,4044.2,43,7,23,50
1418,-23.31699999999916,2857.6666666666665,35,12,23,47
1419,-12.886999999998931,3033.1666666666665,29,7,29,36
1420,-48.38774999999904,1946.3529411764705,11,14,31,25
1421,-27.549999999999983,1938.0,46,28,29,74
1422,-0.4344999999992566,3034.7894736842104,47,15,13,62
1423,-32.868999999999374,2579.85,16,13,16,29
1424,11.973750000002688,4999.75,57,8,26,65
1425,-19.502499999999213,3218.3333333333335,39,13,22,52
1426,-26.774749999999564,3548.4736842105262,33,9,28,42
1427,-4.444749999998637,2541.1666666666665,33,6,22,39
1428,-9.245749999999413,4098.05,37,6,21,43
1429,-25.87024999999951,3331.2631578947367,32,13,21,45
1430,-34.80149999999903,2664.0,20,9,21,29
1431,-34.31924999999946,2103.2631578947367,6,18,26,24
1432,-35.67274999999957,2162.35,10,12,18,22
1433,-0.04799999999907332,4388.1578947368425,56,7,21,63
1434,-17.501499999998916,4210.1578947368425,56,19,19,75
1435,-5.335749999997784,4930.55,47,22,13,69
1436,0.48450000000150106,3804.5,44,18,13,62
1437,-24.45699999999954,1528.25,17,15,19,32
1438,-22.11225000000055,2024.1666666666667,30,18,20,48
1439,-9.759499999998326,3587.842105263158,36,11,22,47
1440,-37.67649999999914,1826.8125,20,23,20,43
1441,-48.014249999999976,1429.0,6,14,26,20
1442,3.038500000000462,2949.1176470588234,51,17,9,68
1443,-36.40374999999938,1715.611111111111,7,12,22,19
1444,7.84850000000152,2076.875,61,11,22,72
1445,2.8127500000004746,3967.9473684210525,56,10,21,66
1446,-31.380249999998718,2679.5,22,1,43,23
1447,-13.880499999999552,3846.45,30,17,15,47
1448,-27.797499999999207,3576.7,29,15,15,44
1449,6.98400000000216,2135.375,51,12,19,63
1450,-37.25049999999931,2655.6666666666665,22,10,16,32
1451,-27.092999999999165,3122.7,20,14,16,34
1452,16.945000000002427,4658.45,58,9,18,67
1453,-8.24749999999831,4059.3,41,2,23,43
1454,2.5827500000014476,2994.0588235294117,56,10,19,66
1455,-23.447749999999182,1429.0,24,7,29,31
1456,-41.01424999999981,2019.7368421052631,10,20,33,30
1457,-31.030499999999584,3124.35,21,13,18,34
1458,-11.776999999998896,2274.0588235294117,39,11,12,50
1459,-32.80749999999939,1728.625,18,8,27,26
1460,-31.639750000000266,1758.8333333333333,11,14,24,25
1461,-27.939499999999402,2197.35,14,3,29,17
1462,-24.587749999999254,3287.75,23,19,20,42
1463,6.072750000002064,3250.9444444444443,47,12,22,59
1464,-26.94049999999941,2306.4444444444443,28,5,26,33
1465,-2.2477499999977812,2936.0555555555557,41,8,25,49
1466,-31.585999999998954,2103.6875,35,23,15,58
1467,-28.14024999999877,2184.1875,31,10,24,41
1468,-40.11774999999869,3136.6315789473683,20,9,29,29
1469,-17.344749999999355,3455.7894736842104,45,16,26,61
1470,-36.51374999999891,2449.3333333333335,28,19,20,47
1471,-40.521999999999586,2793.4210526315787,27,15,25,42
1472,-28.513000000000126,3429.1666666666665,45,30,23,75
1473,-20.88724999999962,4402.0,32,9,19,41
1474,-14.993999999998925,3937.0,30,18,19,48
1475,-19.53474999999726,2888.6315789473683,47,9,20,56
1476,-8.520249999998049,2158.25,39,14,20,53
1477,-31.80824999999998,2806.5,31,12,29,43
1478,-12.494749999998685,4150.45,38,11,20,49
1479,-24.165249999999908,2621.315789473684,27,14,19,41
1480,-17.043499999998634,2537.25,33,19,25,52
1481,-44.833749999999746,2405.15,14,8,24,22
1482,-21.47699999999921,2494.315789473684,20,13,16,33
1483,-15.77499999999985,2810.1111111111113,40,9,13,49
1484,-28.104749999999406,3271.222222222222,40,11,25,51
1485,-33.50499999999944,2588.722222222222,26,14,15,40
1486,-26.90975000000021,2651.277777777778,35,16,33,51
1487,5.3505000000020635,4864.9,54,9,15,63
1488,-8.141499999999464,2304.1875,44,27,17,71
1489,-8.567999999999032,1604.625,21,12,23,33
1490,-21.477999999998563,2072.8333333333335,23,13,18,36
1491,-18.292249999998955,2893.777777777778,32,9,28,41
1492,-28.509499999998518,3522.8,31,4,22,35
1493,-17.405749999998825,3713.15,30,12,23,42
1494,-22.778999999998014,4429.85,40,16,26,56
1495,-23.922749999998434,3847.3,31,13,26,44
1496,-46.317499999999356,1746.5,26,25,15,51
1497,-10.44674999999927,2115.3529411764707,30,22,23,52
1498,-22.655249999999846,3290.4210526315787,35,3,40,38
1499,10.197250000001327,4410.8,44,20,14,64
1500,-29.984749999998492,2057.9375,35,7,25,42
1501,-29.733249999999323,2438.777777777778,27,12,25,39
1502,-27.879249999999548,3655.25,31,14,20,45
1503,-14.802999999999349,2316.0588235294117,27,13,17,40
1504,-11.415999999998602,2680.5,36,7,31,43
1505,-33.87474999999923,1596.5555555555557,12,17,19,29
1506,-6.960499999998061,3529.5555555555557,58,16,20,74
1507,-18.361249999998652,2798.85,28,17,15,45
1508,-34.893499999999726,2319.5789473684213,26,13,26,39
1509,-10.442499999997906,2715.722222222222,47,9,22,56
1510,-7.83574999999894,1903.3125,22,11,30,33
1511,-13.044999999998918,2241.3529411764707,27,15,15,42
1512,-29.703749999999225,2279.5789473684213,20,9,17,29
1513,-2.780249999999025,3297.9473684210525,49,6,24,55
1514,8.319250000002066,4017.8947368421054,55,11,19,66
1515,-0.7104999999988442,2839.1666666666665,42,10,12,52
1516,-37.378999999998676,2233.9411764705883,18,12,32,30
1517,-7.937249999998997,2525.1666666666665,21,12,25,33
1518,-21.116249999997525,2385.375,46,10,28,56
1519,-20.71724999999953,2814.3888888888887,29,12,19,41
1520,-5.227499999999059,4317.0526315789475,50,18,17,68
1521,-29.362749999999608,2754.4444444444443,27,21,25,48
1522,-4.889749999997848,2472.0,50,10,14,60
1523,-2.8667499999987447,2975.176470588235,53,16,28,69
1524,-24.3579999999987,2921.1111111111113,29,10,23,39
1525,-11.099499999998319,3018.842105263158,32,9,27,41
1526,-29.70499999999809,1773.3125,34,12,30,46
1527,-15.797499999998697,3964.75,33,16,22,49
1528,0.044250000001643565,4277.45,48,10,22,58
1529,-19.33199999999824,3100.1666666666665,40,18,14,58
1530,-2.856249999998284,6110.9,55,6,31,61
1531,-16.85774999999796,3751.3,38,10,23,48
1532,-26.156499999999944,1832.4117647058824,25,16,23,41
1533,-24.33774999999955,1715.75,14,19,13,33
1534,-26.260749999999415,2333.8333333333335,26,9,21,35
1535,-27.931500000000504,3546.7894736842104,47,22,15,69
1536,-6.08199999999743,4775.1,55,8,25,63
1537,-19.504499999998497,2245.777777777778,27,12,23,39
1538,-5.084999999998759,3869.4210526315787,51,4,27,55
1539,-30.044499999999978,2840.0526315789475,27,9,25,36
1540,-25.17024999999823,3480.0,41,9,22,50
1541,-36.32849999999852,2250.9444444444443,21,12,28,33
1542,-13.366249999999416,4340.526315789473,54,10,23,64
1543,-37.59150000000024,1781.9411764705883,22,9,42,31
1544,-17.794749999999276,1608.625,21,9,17,30
1545,-12.248249999999246,2164.764705882353,42,15,23,57
1546,-22.28474999999847,3514.05,29,11,22,40
1547,-25.133999999998487,2103.6875,24,14,26,38
1548,-12.047499999999541,3032.1666666666665,47,24,18,71
1549,-25.228749999999543,1429.0,12,17,18,29
1550,-9.848499999999524,2703.3888888888887,33,4,24,37
1551,1.1795000000017029,4214.473684210527,57,14,24,71
1552,-13.413749999997936,3129.2105263157896,37,8,23,45
1553,-14.609999999999573,2418.315789473684,26,10,24,36
1554,-35.91799999999916,2686.2,21,6,26,27
1555,-18.240749999998336,3505.842105263158,26,11,34,37
1556,-17.893249999998506,3071.4210526315787,32,18,19,50
1557,0.8972500000019767,5264.1,61,11,15,72
1558,-33.68075000000025,2179.5,18,15,26,33
1559,-34.34549999999991,1429.0,3,16,25,19
1560,-8.558499999999478,2643.7894736842104,33,8,26,41
1561,-0.8462499999987572,3552.15,37,8,25,45
1562,-0.79174999999963,2300.3888888888887,35,16,17,51
1563,-27.38074999999891,2309.6315789473683,15,19,22,34
1564,-26.635499999999418,2215.6111111111113,13,14,23,27
1565,-30.272749999999256,2091.277777777778,15,16,17,31
1566,9.04225000000107,5053.0,52,19,18,71
1567,-28.636999999999837,2072.315789473684,20,9,26,29
1568,-30.710749999999933,2207.7368421052633,17,17,24,34
1569,-9.61099999999889,3384.842105263158,44,18,24,62
1570,-24.36999999999935,1542.125,18,2,26,20
1571,-10.978999999999505,3112.5,36,11,24,47
1572,-5.225499999998811,3875.2631578947367,36,13,22,49
1573,14.102250000000467,3568.6315789473683,50,10,17,60
1574,-6.923999999997365,2556.0588235294117,51,9,25,60
1575,2.0560000000009166,2755.9411764705883,41,8,16,49
1576,-7.996999999998465,3695.0,42,6,20,48
1577,-35.22724999999873,2270.3529411764707,25,14,20,39
1578,-8.049249999999578,2554.1875,61,23,26,84
1579,9.771250000001782,4001.4444444444443,63,9,21,72
1580,-0.8469999999983209,3737.315789473684,45,9,24,54
1581,-20.0382499999989,2656.8,23,10,21,33
1582,-4.918249999999565,4754.105263157895,42,14,23,56
1583,-15.75174999999939,2910.75,32,6,16,38
1584,-41.3027499999995,2305.4210526315787,13,2,32,15
1585,-10.328749999998589,2325.8333333333335,28,14,21,42
1586,-14.204249999998178,3017.277777777778,37,6,32,43
1587,-40.613499999997345,2025.2222222222222,30,11,31,41
1588,13.937500000001723,5087.0,54,9,14,63
1589,-12.832249999997751,3892.55,45,15,24,60
1590,-19.488249999998345,3810.0555555555557,50,12,19,62
1591,-11.004999999999026,1773.25,39,10,24,49
1592,-8.76424999999845,2072.8333333333335,33,15,15,48
1593,-2.250499999999057,4886.2,48,23,11,71
1594,-29.59449999999938,1589.6470588235295,17,11,17,28
1595,8.349000000001649,5206.85,60,9,20,69
1596,-3.2862499999987547,3490.1052631578946,35,11,14,46
1597,6.928250000002114,3018.235294117647,52,1,24,53
1598,-48.970999999999414,2824.222222222222,24,19,24,43
1599,-34.6999999999998,1623.235294117647,12,7,19,19
1600,-15.629249999999107,3000.4736842105262,35,18,26,53
1601,6.508750000002003,6044.15,68,18,22,86
1602,-13.753749999998485,2577.0,40,9,19,49
1603,-38.92649999999924,2103.625,18,12,29,30
1604,-5.585749999998919,3425.6315789473683,59,2,28,61
1605,-21.30374999999912,3144.9,29,11,21,40
1606,6.560750000000977,2072.4117647058824,41,13,21,54
1607,-17.57449999999856,2984.6315789473683,30,8,26,38
1608,-40.14349999999984,1576.875,15,9,35,24
1609,-17.807999999999343,3576.277777777778,30,7,37,37
1610,-30.335249999999196,3603.6666666666665,41,20,22,61
1611,-24.895999999999667,2454.2631578947367,23,22,12,45
1612,-15.113249999998306,4515.7,55,9,14,64
1613,-33.46999999999937,1514.375,15,16,23,31
1614,-5.80774999999775,3648.0,50,14,15,64
1615,-22.57924999999903,3267.15,31,8,19,39
1616,-39.50599999999999,1652.25,13,13,20,26
1617,-7.427499999997896,2235.6875,43,13,25,56
1618,-0.19249999999867812,3222.7894736842104,47,3,26,50
1619,-47.840750000000085,1429.0,0,12,15,12
1620,12.29850000000078,3528.8888888888887,56,4,41,60
1621,-20.203999999999514,3050.5789473684213,25,17,19,42
1622,-19.423000000000293,1732.625,41,16,23,57
1623,0.31100000000153616,1737.5625,39,14,22,53
1624,-6.666499999998481,4046.5263157894738,37,8,21,45
1625,-14.81199999999931,4061.6,40,11,21,51
1626,-20.12874999999967,2089.294117647059,38,17,24,55
1627,-14.13199999999886,2699.777777777778,28,10,25,38
1628,-18.91449999999913,2255.5625,33,5,24,38
1629,-24.80499999999821,1534.8666666666666,33,10,23,43
1630,-20.280999999999015,3415.55,28,3,24,31
1631,-23.97175000000007,2460.777777777778,38,20,24,58
1632,-11.553999999999336,3700.5789473684213,50,21,19,71
1633,-27.58274999999997,2529.315789473684,25,10,25,35
1634,-20.27024999999905,3328.1052631578946,38,20,17,58
1635,-7.5082499999989265,4087.05,30,15,18,45
1636,-16.162249999998252,2831.1111111111113,27,22,25,49
1637,-26.537749999999317,1537.1875,18,7,19,25
1638,-10.540999999998327,3687.15,37,9,19,46
1639,-27.959999999999706,1937.9375,28,16,18,44
1640,-5.390249999998981,3518.9,33,8,25,41
1641,-16.751999999999416,2009.388888888889,20,8,20,28
1642,-15.508999999997929,4085.1666666666665,51,17,22,68
1643,-8.846249999998246,5114.0,52,12,20,64
1644,-32.23599999999894,2774.1052631578946,22,8,19,30
1645,-18.902499999999556,2004.888888888889,30,22,21,52
1646,-15.621249999999417,2520.0526315789475,26,11,22,37
1647,-19.392499999998545,4207.7,37,8,18,45
1648,-34.16574999999992,2465.1666666666665,23,17,24,40
1649,-32.02774999999955,1534.5294117647059,12,13,17,25
1650,-4.303999999998053,2523.375,47,5,29,52
1651,-18.99874999999887,2525.1666666666665,31,11,25,42
1652,-24.622249999998886,2103.722222222222,18,17,19,35
1653,-13.704499999998621,2754.6111111111113,40,15,22,55
1654,8.297500000002227,4709.8421052631575,55,16,26,71
1655,11.565250000000663,4354.736842105263,66,8,25,74
1656,-18.964499999998175,3671.2,44,3,29,47
1657,-24.940249999998937,2672.3333333333335,23,13,16,36
1658,-13.067999999999255,3680.5789473684213,44,3,32,47
1659,-32.41224999999944,2840.8947368421054,16,4,30,20
1660,3.8432500000016225,2173.1875,45,9,13,54
1661,-28.154499999999068,2888.7,27,12,23,39
1662,-12.359749999998686,3512.55,35,15,16,50
1663,-14.71849999999911,3303.0,56,15,19,71
1664,-2.1534999999981466,2694.4117647058824,42,7,23,49
1665,-28.345749999999413,1963.842105263158,8,13,23,21
1666,-3.920249999998952,3581.9473684210525,40,22,23,62
1667,-38.10449999999837,2625.4736842105262,24,16,17,40
1668,-25.42999999999943,1673.7058823529412,15,13,22,28
1669,-8.272749999999192,3119.5,43,18,27,61
1670,-18.222999999999235,3225.15,35,6,22,41
1671,-9.568749999998419,3621.157894736842,36,15,24,51
1672,-20.221499999999846,2730.6111111111113,32,9,38,41
1673,-20.068749999999405,1630.4375,28,5,26,33
1674,-5.889499999998696,2990.5263157894738,38,9,13,47
1675,-32.76949999999968,1496.5,14,9,18,23
1676,-11.733249999998893,2957.277777777778,45,8,16,53
1677,-21.15899999999853,2362.764705882353,25,4,34,29
1678,-7.845249999998883,2469.875,46,19,19,65
1679,5.850000000001837,2822.3888888888887,46,11,24,57
1680,-30.42124999999931,1429.0,10,15,23,25
1681,4.058500000001265,2727.1666666666665,39,10,14,49
1682,-22.28274999999911,2631.6470588235293,34,8,24,42
1683,-7.336249999999441,2801.684210526316,38,17,22,55
1684,-33.24750000000054,1429.0,6,22,33,28
1685,-29.874999999999215,3034.7894736842104,30,18,22,48
1686,-26.84274999999883,2651.3,20,7,25,27
1687,-6.056249999997556,2436.1666666666665,41,15,24,56
1688,-9.753999999998635,3398.9473684210525,48,10,21,58
1689,-19.5427499999991,3554.4210526315787,33,13,10,46
1690,-40.83000000000005,2302.8947368421054,11,14,38,25
1691,-6.273499999999478,2101.3529411764707,34,11,21,45
1692,-18.74424999999855,3283.5,42,25,20,67
1693,-38.63949999999921,3310.3684210526317,30,12,27,42
1694,-23.384250000000193,2651.315789473684,28,6,27,34
1695,-21.753749999999133,2112.5,16,14,25,30
1696,-16.176999999997413,2631.705882352941,45,12,21,57
1697,-28.619500000000336,2317.8888888888887,37,21,17,58
1698,-28.492750000000093,2028.8333333333333,19,12,28,31
1699,-10.594249999999374,3237.7368421052633,39,7,25,46
1700,4.268250000002176,4418.368421052632,63,13,23,76
1701,-7.689749999999111,3370.35,43,17,14,60
1702,-22.278999999999336,2705.5789473684213,28,9,14,37
1703,-9.887749999997961,2616.0,43,13,20,56
1704,-30.58049999999908,2099.3333333333335,18,16,18,34
1705,-21.554249999999428,2793.35,18,15,20,33
1706,-4.645249999998301,3691.8333333333335,39,14,20,53
1707,-19.434249999999903,2546.6470588235293,28,24,15,52
1708,-0.7302499999987144,2594.6875,63,7,22,70
1709,-13.803249999998368,2897.3333333333335,40,7,22,47
1710,-23.282749999998977,3241.8,32,11,19,43
1711,-8.281499999998713,2834.6666666666665,36,10,20,46
1712,-7.505999999998416,5401.4,43,12,18,55
1713,-15.292749999999728,1621.5,32,9,26,41
1714,-32.97774999999854,2824.4,30,17,13,47
1715,-3.4797500000000405,2429.0,46,12,14,58
1716,-19.113749999997303,3516.8947368421054,49,14,16,63
1717,-3.733749999999133,3195.5882352941176,76,12,25,88
1718,-16.833249999999502,2543.4736842105262,23,11,19,34
1719,8.290250000000682,3874.315789473684,50,15,19,65
1720,-17.826499999998592,2036.1875,35,5,31,40
1721,-42.664499999999734,2602.85,20,13,14,33
1722,-47.191749999999246,2293.6315789473683,13,21,18,34
1723,-1.5214999999983383,5360.8,57,5,16,62
1724,-17.185249999998984,2872.75,27,6,19,33
1725,-22.304749999998904,3787.1,36,6,22,42
1726,-16.542499999998938,3955.315789473684,50,8,28,58
1727,-16.608999999999035,2112.5,27,17,11,44
1728,-6.056249999997758,4709.789473684211,50,9,20,59
1729,-34.71649999999851,1429.0,10,10,30,20
1730,-1.10374999999841,4282.894736842105,59,9,22,68
1731,-34.2179999999987,1429.0,13,5,30,18
1732,-11.256749999999743,2824.2631578947367,35,14,22,49
1733,-0.10449999999897575,5075.2,46,11,20,57
1734,-27.37599999999936,3373.1052631578946,31,11,25,42
1735,-12.103749999999277,2312.470588235294,28,8,21,36
1736,-9.493249999998167,3148.3684210526317,48,11,16,59
1737,16.893500000001232,4818.0,57,11,21,68
1738,-8.295249999998203,2643.823529411765,41,14,16,55
1739,-17.40199999999889,2575.2105263157896,25,10,24,35
1740,-17.497999999998697,3419.842105263158,32,22,27,54
1741,-37.362000000000684,2095.722222222222,32,25,16,57
1742,-26.06174999999995,1476.6,26,8,15,34
1743,-13.80024999999821,2038.7058823529412,29,18,21,47
1744,-10.511999999997771,2756.222222222222,48,8,23,56
1745,-24.577249999999314,3170.0526315789475,28,18,18,46
1746,-9.593999999998292,3904.45,37,13,19,50
1747,-14.243999999999511,2483.1176470588234,34,16,16,50
1748,10.261500000003078,5809.2,62,18,13,80
1749,-27.318999999998784,2959.5789473684213,32,13,17,45
1750,-12.311249999999704,4020.5263157894738,48,12,23,60
1751,-12.01999999999949,2869.3684210526317,37,5,21,42
1752,-16.48299999999886,3316.35,38,7,20,45
1753,-20.34224999999997,2168.529411764706,35,15,25,50
1754,-4.408999999999344,3595.3684210526317,42,14,21,56
1755,-25.103749999999586,2375.222222222222,28,16,15,44
1756,-17.227999999999078,3073.6111111111113,31,7,31,38
1757,-20.02074999999877,3340.0,44,12,22,56
1758,-24.250999999999742,3276.9473684210525,48,19,25,67
1759,-42.66275000000048,2270.3888888888887,27,17,23,44
1760,4.841000000001448,2629.8823529411766,41,7,19,48
1761,-9.560749999998716,3623.55,43,8,18,51
1762,-4.427499999998867,3821.2,31,17,22,48
1763,-15.181249999998773,2429.0,31,4,27,35
1764,0.5745000000011424,4278.35,57,16,14,73
1765,-33.95974999999775,2261.9473684210525,21,15,32,36
1766,-20.331499999999984,2832.4736842105262,30,11,23,41
1767,-32.390499999998625,3094.9473684210525,32,12,27,44
1768,-28.160499999999377,2884.65,22,2,30,24
1769,-38.90899999999998,1481.9333333333334,13,20,24,33
1770,13.099000000001421,3709.0,57,15,23,72
1771,-23.44474999999912,2917.6111111111113,32,10,30,42
1772,-7.152999999999603,3097.4210526315787,41,9,18,50
1773,-5.744249999997363,2576.875,51,12,25,63
1774,-9.281749999998897,3171.6111111111113,38,12,18,50
1775,-32.14524999999941,2092.65,11,23,13,34
1776,14.22225000000184,4928.631578947368,57,17,11,74
1777,-27.59324999999917,4429.05,41,11,24,52
1778,-41.565249999999466,1639.375,10,10,29,20
1779,-8.434249999999508,2641.5555555555557,42,7,23,49
1780,-12.618499999999155,4897.35,47,17,13,64
1781,-46.02324999999893,1429.0,9,22,18,31
1782,-29.144750000000112,3003.842105263158,40,19,25,59
1783,-26.13299999999967,2765.176470588235,27,9,30,36
1784,5.278500000001559,3155.777777777778,61,9,25,70
1785,-26.894749999999483,2540.1666666666665,30,15,20,45
1786,3.5892500000007304,3812.5789473684213,48,7,34,55
1787,1.83325000000203,4514.8,55,5,22,60
1788,-9.87724999999874,2614.0,41,5,21,46
1789,-20.371499999998985,2779.85,25,6,19,31
1790,-33.047499999998706,2022.0,26,4,37,30
1791,-7.54174999999873,3116.0,33,13,25,46
1792,0.061250000001584134,4249.65,49,13,16,62
1793,10.628250000001833,5487.0,72,18,18,90
1794,-27.02174999999923,2195.4444444444443,17,11,27,28
1795,-12.363249999998882,4264.75,41,13,15,54
1796,-28.120000000000044,2087.777777777778,23,13,22,36
1797,-20.313749999998574,2628.3333333333335,32,7,24,39
1798,-31.1004999999998,2863.95,23,8,22,31
1799,-6.9102499999988725,4028.35,44,7,15,51
1800,-44.5032499999998,2379.05,8,7,26,15
1801,4.883249999999875,3563.9444444444443,49,22,14,71
1802,-28.68099999999963,1723.1764705882354,19,24,18,43
1803,-21.302999999998214,3144.277777777778,43,14,17,57
1804,-17.17574999999985,2257.235294117647,45,7,26,52
1805,-25.98224999999949,2429.8947368421054,27,10,14,37
1806,-20.28999999999793,3076.5263157894738,35,11,23,46
1807,-1.552999999998299,3508.6,35,10,24,45
1808,-19.993999999999012,1871.5,36,18,23,54
1809,7.305500000002745,2790.6111111111113,46,12,26,58
1810,-20.617999999998986,3214.777777777778,45,14,16,59
1811,-22.91974999999959,2251.0,15,15,32,30
1812,-29.578000000000237,2267.842105263158,29,5,20,34
1813,-13.915499999999493,3429.0,38,11,20,49
1814,-28.958749999998883,2287.1176470588234,28,13,21,41
1815,-10.00774999999853,4298.1,51,15,19,66
1816,-21.622999999999486,2663.35,23,9,25,32
1817,-41.94499999999959,2171.5,18,16,22,34
1818,-8.821249999999003,3694.15,38,2,21,40
1819,-21.05024999999946,2728.8888888888887,30,12,22,42
1820,-21.1714999999986,3607.75,38,21,9,59
1821,-30.12399999999905,2296.2105263157896,19,20,16,39
1822,-32.78674999999991,3459.8947368421054,26,11,39,37
1823,-28.38549999999828,1532.1875,35,23,20,58
1824,-19.772749999999085,2130.4375,38,9,26,47
1825,-4.255999999998546,2987.222222222222,39,9,23,48
1826,6.297000000001502,3045.4444444444443,47,3,22,50
1827,-15.614250000000435,2017.235294117647,39,21,24,60
1828,-30.391999999999705,2116.0,16,13,25,29
1829,-48.248499999999915,2042.3684210526317,10,22,12,32
1830,-9.461999999998868,3715.6,32,9,20,41
1831,-3.767249999998183,2245.1176470588234,37,8,19,45
1832,-25.250249999999436,1523.25,12,16,32,28
1833,-43.687749999999866,1429.0,8,12,42,20
1834,-31.99624999999985,2064.842105263158,19,13,16,32
1835,-22.93574999999896,3883.0,32,13,19,45
1836,-21.308999999998434,4054.0,39,14,13,53
1837,-18.974749999999027,2713.8888888888887,31,11,19,42
1838,-29.57624999999935,2559.3684210526317,20,19,22,39
1839,-15.528249999999392,3373.0526315789475,28,5,37,33
1840,-12.86324999999932,3575.157894736842,47,9,34,56
1841,-37.36649999999959,1870.7058823529412,12,13,20,25
1842,3.0122500000012815,3243.0555555555557,64,13,16,77
1843,-28.83824999999903,4048.842105263158,48,19,26,67
1844,-3.305999999999321,2727.222222222222,43,11,19,54
1845,5.151250000001758,3873.4444444444443,56,19,18,75
1846,-17.808249999998345,1976.235294117647,29,9,26,38
1847,-27.056999999998787,2784.6,26,11,26,37
1848,-9.36374999999848,3398.85,35,5,27,40
1849,-23.634249999999057,2450.222222222222,29,15,15,44
1850,-20.140999999998776,3986.3,35,3,26,38
1851,-9.885999999999651,2842.6315789473683,29,6,32,35
1852,-18.010249999999075,3651.3333333333335,51,21,16,72
1853,-8.183749999998717,3785.45,40,19,16,59
1854,0.6572500000024281,4076.5789473684213,56,7,21,63
1855,-21.530999999998908,2354.4117647058824,20,10,25,30
1856,-25.75674999999783,1481.9333333333334,33,10,21,43
1857,-16.88399999999956,1501.0,30,11,19,41
1858,-39.36199999999987,1429.0,3,11,19,14
1859,-12.695499999999052,2929.9444444444443,45,11,18,56
1860,-17.036749999999508,2775.7368421052633,24,15,22,39
1861,2.4390000000002168,2891.235294117647,48,15,19,63
1862,18.142750000002486,2699.0,56,4,24,60
1863,-28.449749999999945,2528.8333333333335,31,12,25,43
1864,-9.061249999999063,3708.0526315789475,61,11,19,72
1865,-9.701749999998668,3659.15,37,15,14,52
1866,-2.633999999998496,3512.9444444444443,52,10,23,62
1867,-24.859999999998273,4490.95,42,17,25,59
1868,-18.63399999999921,2676.0555555555557,23,10,23,33
1869,-2.9017499999986844,2543.8823529411766,41,16,19,57
1870,-27.783999999999555,2576.3888888888887,29,16,25,45
1871,-29.617999999998563,2364.6111111111113,22,10,28,32
1872,-27.689749999999975,1965.1666666666667,14,8,36,22
1873,-32.54974999999848,1429.0,24,7,18,31
1874,-31.199999999999484,2538.294117647059,35,15,14,50
1875,5.322250000000279,3756.6315789473683,46,7,21,53
1876,-40.97024999999905,1961.7222222222222,13,16,25,29
1877,-6.124499999999191,2663.6666666666665,31,12,26,43
1878,-26.523499999999007,2039.0526315789473,16,11,22,27
1879,-43.92799999999941,2104.6666666666665,10,4,26,14
1880,-10.368249999998309,2422.1111111111113,37,16,15,53
1881,-24.160749999999943,1811.8235294117646,21,9,35,30
1882,-21.841749999999532,3777.5789473684213,30,21,18,51
1883,-16.99474999999904,3785.0,58,15,26,73
1884,-8.670249999999664,3945.7,29,20,18,49
1885,-8.887499999998987,3258.9444444444443,39,14,27,53
1886,-22.37399999999888,3602.842105263158,39,11,26,50
1887,8.676250000001291,3076.3888888888887,46,10,25,56
1888,-21.106249999999715,2219.0,31,20,22,51
1889,-40.28525000000012,1622.3529411764705,21,16,31,37
1890,-20.867999999999135,2663.6666666666665,29,8,26,37
1891,-6.206499999998934,3206.8333333333335,45,29,14,74
1892,-14.212499999998112,2545.823529411765,45,8,21,53
1893,-15.510499999999041,2455.8125,38,12,25,50
1894,-29.811249999999394,2240.529411764706,16,16,15,32
1895,10.223250000000208,3448.315789473684,44,11,19,55
1896,-38.814999999999515,1429.0,11,8,29,19
1897,-32.294749999999894,2228.294117647059,36,10,22,46
1898,-22.242499999999566,1911.125,48,13,39,61
1899,-27.203999999999116,2241.8947368421054,13,13,25,26
1900,-17.740749999998563,3267.842105263158,35,5,25,40
1901,-11.449499999999041,3249.7,39,5,15,44
1902,-22.378749999999616,2440.684210526316,34,8,24,42
1903,-18.06099999999912,2643.7894736842104,30,9,22,39
1904,-25.629499999999258,1438.5333333333333,33,11,27,44
1905,-9.738499999997918,2163.0,40,8,29,48
1906,-24.61449999999936,2673.842105263158,26,8,20,34
1907,3.421750000000448,3303.0,47,17,18,64
1908,-16.73224999999903,3297.1052631578946,41,11,18,52
1909,-8.00899999999776,3230.6666666666665,50,9,21,59
1910,-41.9067499999992,2377.0555555555557,16,13,25,29
1911,-7.914999999998908,2509.277777777778,37,10,23,47
1912,-40.40899999999941,2206.0,8,15,22,23
1913,-11.156999999998002,1429.0,32,18,16,50
1914,-28.589999999999566,2512.8333333333335,33,11,20,44
1915,23.078250000002036,4606.210526315789,63,16,18,79
1916,-7.691999999999625,2587.777777777778,51,18,19,69
1917,-13.082249999999615,2634.4375,40,6,27,46
1918,-24.329999999999835,2063.9444444444443,24,22,17,46
1919,-34.23249999999959,1921.9473684210527,12,11,20,23
1920,-8.253999999999442,3372.315789473684,47,7,20,54
1921,-22.976500000000264,3011.315789473684,36,26,13,62
1922,-11.578749999999506,2663.6111111111113,34,14,13,48
1923,-19.776249999998562,3156.7894736842104,28,14,26,42
1924,-31.995999999998855,1630.4375,30,11,26,41
1925,-5.4077499999984795,2823.176470588235,44,10,7,54
1926,-37.18399999999948,2795.8333333333335,30,17,24,47
1927,-27.467249999999574,3004.5789473684213,29,14,26,43
1928,-15.874499999999347,2085.9375,37,13,12,50
1929,-37.591250000000144,1429.0,18,16,26,34
1930,2.9210000000008582,2240.470588235294,45,8,20,53
1931,-18.47499999999888,2721.294117647059,39,8,40,47
1932,-15.877000000000157,2252.529411764706,42,23,20,65
1933,-0.9534999999992901,3301.3,28,15,14,43
1934,-18.274999999999174,3716.45,32,16,17,48
1935,-1.9334999999991578,3425.5,51,7,22,58
1936,-14.97549999999901,2206.823529411765,27,11,27,38
1937,-24.32624999999863,1993.0588235294117,22,9,23,31
1938,-25.351499999998598,1692.9375,29,18,38,47
1939,-22.792249999998653,2316.0588235294117,34,14,15,48
1940,-10.443249999998807,4826.75,37,10,22,47
1941,-31.386999999998714,3919.4210526315787,36,18,15,54
1942,-43.0494999999995,2117.8333333333335,14,19,13,33
1943,-33.16200000000004,1429.0,19,13,22,32
1944,-10.680249999999043,2933.3888888888887,31,30,11,61
1945,1.5395000000014132,5005.35,51,5,22,56
1946,-11.932499999999166,1961.6666666666667,23,8,21,31
1947,-33.1242499999995,1679.0,31,11,19,42
1948,-7.065749999997919,2441.3888888888887,37,7,24,44
1949,-19.193499999998377,2616.6470588235293,34,9,23,43
1950,-25.031249999999353,2401.777777777778,31,9,40,40
1951,-8.384749999999812,3052.5,38,17,13,55
1952,13.271750000000026,3730.5555555555557,73,20,15,93
1953,-17.675499999998678,2362.764705882353,28,12,25,40
1954,-13.113249999998875,4325.85,41,13,16,54
1955,-32.371249999998724,2577.7894736842104,30,10,20,40
1956,6.267250000000059,3403.823529411765,64,13,13,77
1957,-24.44924999999845,2302.9444444444443,32,13,23,45
1958,-20.15674999999933,2181.5882352941176,29,10,17,39
1959,-21.43899999999861,1690.5294117647059,24,18,17,42
1960,-28.74074999999969,2274.722222222222,22,13,14,35
1961,-0.3592499999983553,4591.75,58,11,11,69
1962,-18.009749999999574,2118.1176470588234,29,25,10,54
1963,-27.764750000000184,2504.6470588235293,48,10,34,58
1964,-8.366999999999317,2047.1764705882354,34,20,14,54
1965,-13.422249999999243,4090.95,38,21,23,59
1966,4.075000000001533,2495.4117647058824,43,9,23,52
1967,-18.780499999998636,2144.3529411764707,30,10,16,40
1968,-2.6207499999987744,4892.6,56,8,17,64
1969,-25.577249999999758,2192.722222222222,20,15,12,35
1970,-1.0897499999986935,3736.4736842105262,50,19,16,69
1971,-22.18374999999909,2640.4210526315787,22,9,24,31
1972,-20.67849999999931,2461.6666666666665,25,7,17,32
1973,-20.36799999999855,3247.3888888888887,33,5,29,38
1974,-15.062999999998777,3196.0,36,12,19,48
1975,-16.46599999999933,3488.5,32,12,21,44
1976,-14.250249999998223,3515.8947368421054,42,11,15,53
1977,-2.68374999999928,2799.4444444444443,39,14,14,53
1978,-16.36524999999981,2140.0526315789475,31,11,11,42
1979,-26.87999999999884,1930.4117647058824,23,3,28,26
1980,-30.754999999999647,2136.277777777778,39,16,25,55
1981,-8.966499999998932,5149.7,56,12,27,68
1982,-35.45274999999929,1585.75,13,11,23,24
1983,-23.070499999998397,3734.6,41,9,18,50
1984,-22.869249999999113,2663.6666666666665,27,11,22,38
1985,-12.564999999998761,2880.6111111111113,37,10,17,47
1986,-24.11299999999799,1951.0,27,5,34,32
1987,-17.217999999999336,1576.875,25,17,19,42
1988,16.23050000000181,4921.15,58,5,18,63
1989,-30.871749999999583,2551.6111111111113,26,14,17,40
1990,-11.970499999998713,3135.3888888888887,41,13,21,54
1991,4.634750000003167,4813.421052631579,66,3,28,69
1992,-42.15574999999991,1429.0,0,10,26,10
1993,20.126000000003046,5220.4,70,0,26,70
1994,-27.539249999999885,1828.6470588235295,15,11,15,26
1995,-10.457249999999377,2839.315789473684,34,18,32,52
1996,-31.558499999999402,1862.2941176470588,23,8,26,31
1997,-9.602249999999,2244.5625,37,16,14,53
1998,-6.884999999998503,3633.9,41,7,19,48
1999,-26.996249999999975,2731.529411764706,32,18,19,50
2000,-2.4569999999985677,4178.3,43,7,23,50
2001,-9.30124999999708,2239.4444444444443,34,15,32,49
2002,-8.459249999999518,2773.470588235294,46,19,15,65
2003,-13.832249999999089,2933.294117647059,40,14,23,54
2004,-4.867499999998138,3228.0,37,9,31,46
2005,2.4670000000009624,4579.421052631579,60,14,20,74
2006,-31.663749999998892,1652.1764705882354,17,4,31,21
2007,-36.68724999999898,1684.0,17,17,19,34
2008,-15.404250000000221,2183.1111111111113,43,19,26,62
2009,-2.8197499999995523,2941.705882352941,53,17,25,70
2010,-0.21124999999772331,4465.55,54,6,15,60
2011,-34.59349999999996,1607.625,39,14,30,53
2012,28.359000000001167,3884.4210526315787,59,2,30,61
2013,-10.33199999999887,3822.4444444444443,61,18,19,79
2014,-2.0424999999977977,1481.9333333333334,49,18,12,67
2015,-4.1617499999987135,2302.9444444444443,28,13,17,41
2016,-33.06449999999934,2779.9,17,12,22,29
2017,-1.204499999998323,4729.85,44,2,27,46
2018,-21.299249999999713,2028.611111111111,27,13,20,40
2019,-9.560749999999405,2239.5,28,8,21,36
2020,-9.995249999998412,4376.8,50,11,11,61
2021,-13.968499999998802,2466.1111111111113,36,11,14,47
2022,-26.679999999999275,2760.05,27,17,15,44
2023,-5.403999999998936,3102.4210526315787,44,14,31,58
2024,-20.19574999999896,2049.1111111111113,23,14,18,37
2025,15.77350000000123,4839.368421052632,68,7,19,75
2026,-27.27049999999906,1844.6875,34,8,37,42
2027,-34.45049999999943,3056.8,24,8,27,32
2028,-5.041999999997872,4782.3,59,9,18,68
2029,-13.201999999999728,3175.1666666666665,29,10,27,39
2030,-12.190249999997196,3437.8888888888887,49,11,24,60
2031,-7.322999999998605,3115.1111111111113,48,10,24,58
2032,-12.110499999998465,3233.05,32,11,22,43
2033,-36.587749999999076,2044.842105263158,12,4,30,16
2034,-12.138000000000186,2941.2105263157896,39,14,20,53
2035,-24.10874999999855,2942.0,33,5,24,38
2036,2.020000000001626,4042.2105263157896,62,11,14,73
2037,-17.810749999999466,2891.8947368421054,31,19,26,50
2038,-17.055999999998647,2899.3684210526317,39,16,19,55
2039,2.666250000001058,4435.4,47,14,16,61
2040,3.866250000001267,3427.277777777778,61,17,13,78
2041,-26.583749999999334,2068.3888888888887,24,17,20,41
2042,-6.367999999998916,2849.6111111111113,40,15,19,55
2043,-35.214999999999456,2577.222222222222,19,13,26,32
2044,-13.628499999998684,5443.45,52,6,21,58
2045,-10.552249999998837,1862.5625,36,13,16,49
2046,3.027000000002194,2349.764705882353,50,8,23,58
2047,-3.8637499999995044,2014.4375,38,15,20,53
2048,-23.628999999998634,2906.9473684210525,30,9,32,39
2049,-27.611499999998976,2080.705882352941,37,13,21,50
2050,-19.485999999998604,4126.65,37,7,18,44
2051,-24.06324999999999,3067.315789473684,33,5,45,38
2052,3.9990000000007497,2423.0625,53,7,21,60
2053,-33.79449999999961,2023.8947368421052,11,13,16,24
2054,4.535000000001685,2711.0,54,6,14,60
2055,-9.167499999997585,3018.9444444444443,53,10,21,63
2056,-12.185249999998685,3195.8,38,14,17,52
2057,-15.288749999998757,3940.1,42,15,13,57
2058,0.7662500000011608,3691.315789473684,54,16,23,70
2059,-19.115249999998255,2871.9,31,11,22,42
2060,-17.97149999999983,2534.5882352941176,40,6,32,46
2061,-35.90025000000036,1429.0,22,21,19,43
2062,5.3902500000017834,3523.5789473684213,51,6,23,57
2063,-9.57274999999825,3322.157894736842,38,14,19,52
2064,3.1990000000028216,3458.1666666666665,55,6,25,61
2065,-13.982999999998938,2307.5882352941176,28,3,25,31
2066,-8.797999999999458,3079.8333333333335,46,28,15,74
2067,-39.697250000000125,1823.9411764705883,13,12,22,25
2068,-14.894249999998681,3088.157894736842,35,16,21,51
2069,-12.514249999998544,2694.3888888888887,32,10,19,42
2070,-0.10974999999867041,3854.45,48,8,19,56
2071,-20.71374999999945,2556.7894736842104,24,13,22,37
2072,-28.538249999999742,1873.5,14,16,13,30
2073,-23.67924999999906,3232.7894736842104,36,7,22,43
2074,-1.5179999999979663,4295.7,55,7,17,62
2075,-16.72799999999956,1895.8823529411766,33,13,14,46
2076,-22.453749999998912,2607.0526315789475,25,13,20,38
2077,-27.74199999999895,2549.0,20,9,24,29
2078,-40.958500000000285,1765.1176470588234,18,23,16,41
2079,-7.274249999999843,3415.684210526316,51,17,15,68
2080,1.982750000000454,2781.5789473684213,51,17,17,68
2081,-18.68824999999964,3302.1666666666665,42,15,19,57
2082,-18.74974999999902,2702.6470588235293,40,14,17,54
2083,-10.962249999998654,2560.3888888888887,33,11,31,44
2084,-1.4604999999987591,2323.875,55,16,20,71
2085,-6.513499999998791,4751.4,48,10,26,58
2086,-27.50974999999812,2038.764705882353,40,9,26,49
2087,-23.461999999999428,1877.9444444444443,10,11,26,21
2088,-16.51099999999862,3614.0,36,9,21,45
2089,-4.339749999998692,4479.263157894737,72,14,14,86
2090,2.1635000000019557,4586.15,43,17,18,60
2091,0.4415000000024808,2312.3529411764707,44,18,15,62
2092,-23.525999999998994,2552.5555555555557,35,15,21,50
2093,-7.81924999999926,2756.823529411765,60,18,21,78
2094,-0.09899999999858142,3599.5263157894738,41,9,21,50
2095,2.5010000000019095,3350.6666666666665,47,10,22,57
2096,-13.666000000000006,1518.3125,37,20,27,57
2097,-31.109999999999737,2156.4117647058824,21,8,15,29
2098,-27.546499999999686,1520.0666666666666,27,4,27,31
2099,-0.8084999999989442,3992.5555555555557,69,13,39,82
2100,5.921000000001169,2739.9411764705883,41,19,29,60
2101,-15.451749999998842,2803.529411764706,51,15,17,66
2102,-23.936499999999196,1908.0588235294117,25,11,31,36
2103,-9.751999999999324,3966.157894736842,62,20,15,82
2104,10.295750000000869,4658.8421052631575,53,5,26,58
2105,-5.947999999997945,4992.55,58,14,20,72
2106,-6.6134999999997035,2103.625,42,9,20,51
2107,-18.944249999999705,3318.0,35,15,24,50
2108,-15.965999999999047,4275.85,40,11,21,51
2109,-43.1614999999997,2185.1052631578946,9,10,27,19
2110,-15.53399999999873,3155.25,28,18,23,46
2111,-9.852249999998996,2536.6111111111113,37,16,17,53
2112,-31.577999999999395,3735.35,30,16,12,46
2113,-10.90799999999935,3536.842105263158,41,12,16,53
2114,-12.677499999998691,2576.6470588235293,44,13,27,57
2115,-4.522749999999412,2794.1111111111113,51,12,21,63
2116,-22.194749999999065,1581.235294117647,18,10,19,28
2117,4.294250000001557,3599.5789473684213,42,6,31,48
2118,-29.620749999999525,2115.1666666666665,19,15,18,34
2119,-28.44024999999932,2584.277777777778,35,6,21,41
2120,-8.950749999998258,3507.5789473684213,47,7,19,54
2121,-23.828749999998834,1528.25,25,12,17,37
2122,-16.66949999999934,2592.222222222222,38,6,24,44
2123,-24.958749999999,2190.8947368421054,19,10,26,29
2124,-5.5267499999998595,2989.9444444444443,52,21,17,73
2125,-24.511249999999002,2847.3,24,10,24,34
2126,-33.3649999999994,2579.8333333333335,21,13,25,34
2127,-20.589499999999727,1429.0,28,10,20,38
2128,-32.87999999999958,2322.3333333333335,21,11,30,32
2129,-3.734749999997939,1505.4375,41,12,29,53
2130,-11.403999999998796,2398.235294117647,36,13,20,49
2131,-5.522749999999654,4682.25,45,7,24,52
2132,-27.645249999999113,2626.2631578947367,26,3,24,29
2133,-4.267999999997537,5029.1,65,14,11,79
2134,4.517500000003185,2953.722222222222,63,6,23,69
2135,9.553500000001428,2139.375,55,12,15,67
2136,-15.119249999999687,3921.9473684210525,42,9,27,51
2137,-0.15274999999651814,2394.375,64,14,16,78
2138,-16.13399999999808,3779.9,40,12,16,52
2139,0.7360000000020801,2316.1111111111113,39,12,24,51
2140,-8.526749999998074,2215.294117647059,51,19,20,70
2141,-32.83149999999938,2194.3333333333335,18,13,17,31
2142,-18.500249999998452,3281.45,34,13,23,47
2143,-16.70499999999972,2345.0,36,10,27,46
2144,-31.421499999999572,2121.823529411765,30,11,24,41
2145,-28.782749999999965,1921.9473684210527,13,13,19,26
2146,-22.74674999999935,3811.7368421052633,50,8,22,58
2147,-11.153749999999167,2959.6315789473683,32,15,21,47
2148,-27.69924999999938,2150.45,15,15,15,30
2149,-6.758749999999165,3187.0,36,9,17,45
2150,-1.8397499999983005,4632.1578947368425,50,17,21,67
2151,1.3340000000008778,2963.176470588235,48,8,25,56
2152,-30.21299999999991,3457.3684210526317,36,3,44,39
2153,-27.924999999999688,2227.3529411764707,28,20,17,48
2154,-19.6437499999983,2407.470588235294,32,16,28,48
2155,-11.199999999998514,3731.5,42,10,21,52
2156,-7.828499999999181,2616.5625,52,13,16,65
2157,-4.020999999998378,3401.8333333333335,43,8,26,51
2158,-23.191499999998975,2952.842105263158,29,11,18,40
2159,-14.002749999997718,1577.2,49,19,12,68
2160,-12.650749999997194,1912.1875,51,13,19,64
2161,-30.34775000000019,1429.0,29,11,24,40
2162,-8.03949999999844,2403.25,44,20,18,64
2163,-23.084249999999322,2520.9444444444443,40,1,41,41
2164,-1.886499999999225,2846.1666666666665,49,13,17,62
2165,-7.906249999999142,2973.1666666666665,54,11,18,65
2166,-26.0617499999991,2690.95,28,15,16,43
2167,-21.544749999999105,1528.25,20,5,24,25
2168,-13.827249999999179,3664.684210526316,39,11,23,50
2169,-27.252499999999156,3529.95,35,7,20,42
2170,-8.943749999999751,2550.777777777778,29,10,26,39
2171,-11.381499999998598,4279.05,37,11,21,48
2172,5.410000000002635,3453.722222222222,49,5,27,54
2173,-25.267499999998524,3414.0,36,10,19,46
2174,-36.5859999999996,1514.375,10,21,12,31
2175,-8.604999999998658,1853.625,49,11,31,60
2176,-21.024249999999327,2449.3888888888887,26,8,29,34
2177,-6.3857499999994545,3211.3333333333335,40,21,24,61
2178,-0.17524999999828328,5227.45,58,15,16,73
2179,-25.356999999998777,2610.3529411764707,36,9,21,45
2180,-25.67674999999893,2738.157894736842,19,15,29,34
2181,-1.582999999999387,2295.0,25,10,20,35
2182,-29.2419999999997,2099.157894736842,11,17,15,28
2183,-30.045999999999633,1828.6470588235295,21,13,20,34
2184,-33.678999999998624,2017.1666666666667,20,6,31,26
2185,-21.63324999999882,3528.35,29,11,19,40
2186,5.626250000001631,5883.75,73,14,17,87
2187,-7.060249999998926,3424.9473684210525,45,20,19,65
2188,-37.31724999999979,1429.0,9,13,27,22
2189,-37.017499999999785,1692.9375,14,15,22,29
2190,-22.55299999999827,2655.5263157894738,20,7,33,27
2191,1.6730000000019132,2916.9473684210525,45,7,24,52
2192,-13.18774999999923,3067.4210526315787,29,18,19,47
2193,-17.38824999999914,2717.15,24,10,20,34
2194,-23.127249999998874,3064.85,23,16,18,39
2195,-1.0619999999993002,4521.05,46,13,15,59
2196,-37.300249999999934,1429.0,24,24,26,48
2197,4.353000000000399,3621.2105263157896,56,5,15,61
2198,-13.228749999998959,3095.7,41,11,14,52
2199,-9.852999999998747,4362.35,39,18,14,57
2200,-0.5227499999978031,3736.1,52,12,14,64
2201,11.92775000000091,3314.3888888888887,60,18,18,78
2202,-3.2477499999978967,1845.4705882352941,41,14,32,55
2203,0.20775000000093194,1457.6,50,7,29,57
2204,-14.634499999998619,3291.157894736842,37,11,18,48
2205,7.0937500000013385,4254.473684210527,65,9,15,74
2206,1.3265000000015856,3695.4444444444443,53,17,27,70
2207,-5.7869999999987325,2879.0588235294117,47,16,18,63
2208,-32.244249999999745,1429.0,7,19,16,26
2209,-8.818749999999069,2032.1875,51,11,18,62
2210,-32.876999999999306,1821.8125,30,19,22,49
2211,2.7227500000008957,2854.1666666666665,51,12,17,63
2212,-36.41049999999961,1429.0,6,18,15,24
2213,-13.769999999999277,2064.1176470588234,31,11,15,42
2214,-6.139999999997684,3076.277777777778,54,7,13,61
2215,-7.376749999999243,2708.5555555555557,30,2,26,32
2216,-26.17999999999983,2598.5789473684213,18,13,27,31
2217,9.385250000001287,2631.5882352941176,42,13,18,55
2218,-8.687999999999274,3094.0,36,12,18,48
2219,-25.813249999998426,3405.684210526316,33,7,24,40
2220,14.650000000000574,3206.8333333333335,56,13,21,69
2221,-14.910749999998979,3260.315789473684,27,10,33,37
2222,-5.373249999999649,2719.470588235294,41,9,25,50
2223,-5.639749999998396,3758.5,43,4,20,47
2224,-19.138999999999477,3296.5,25,16,17,41
2225,-14.657249999999499,3779.15,37,9,24,46
2226,-24.487749999998904,4006.05,34,15,17,49
2227,-14.360249999998548,2545.0,43,21,20,64
2228,-15.856249999998576,3260.3684210526317,44,10,23,54
2229,-23.695749999999297,3086.5263157894738,26,22,17,48
2230,-24.18649999999979,2162.5789473684213,23,7,24,30
2231,-6.5032499999988405,1996.5,57,7,24,64
2232,-14.746500000000244,2311.777777777778,28,8,20,36
2233,-1.7027499999994373,3173.4210526315787,47,15,22,62
2234,-15.587249999998445,2887.5555555555557,40,14,20,54
2235,-18.508249999999272,2693.5555555555557,36,5,20,41
2236,6.147000000002082,2559.823529411765,52,10,22,62
2237,-33.17974999999883,2310.8333333333335,20,11,24,31
2238,-9.883749999999047,3079.8947368421054,49,11,17,60
2239,-17.9589999999991,2513.0588235294117,44,14,23,58
2240,-24.64124999999953,1438.5333333333333,31,20,21,51
2241,13.27225000000164,3652.294117647059,62,6,21,68
2242,-26.41524999999974,2736.235294117647,54,18,19,72
2243,-0.07399999999928167,3052.5,41,11,20,52
2244,-21.04024999999905,2332.8823529411766,30,10,22,40
2245,-14.4429999999985,3424.8947368421054,36,13,21,49
2246,-10.431249999999263,3071.9444444444443,55,10,33,65
2247,-2.0087499999989933,1701.875,48,16,16,64
2248,2.318000000001389,4353.105263157895,50,6,25,56
2249,-37.92325000000012,2230.2105263157896,10,8,29,18
2250,9.303500000001211,2766.0588235294117,47,13,19,60
2251,-11.4864999999992,3212.0555555555557,42,13,28,55
2252,-1.8537499999984561,4267.894736842105,57,7,22,64
2253,-17.94149999999997,1954.764705882353,35,8,21,43
2254,3.6127500000015673,3034.8888888888887,49,10,13,59
2255,-15.449999999998477,3534.315789473684,46,9,22,55
2256,-11.318749999998573,3774.8947368421054,42,8,19,50
2257,-13.771749999999653,2989.8888888888887,45,15,21,60
2258,-28.75199999999797,3676.315789473684,39,12,29,51
2259,-20.16524999999918,2846.1666666666665,34,13,17,47
2260,3.1280000000008648,3533.1111111111113,41,5,27,46
2261,-3.10499999999898,2274.1176470588234,31,14,22,45
2262,-8.867499999998294,2404.764705882353,29,14,21,43
2263,-27.927499999999696,3975.4736842105262,41,14,21,55
2264,-3.595999999998484,2618.5,44,5,25,49
2265,-23.281499999999117,2103.6111111111113,25,10,17,35
2266,-48.61599999999933,1429.0,0,18,31,18
2267,-18.991999999999347,2068.4444444444443,23,19,30,42
2268,-20.12474999999928,3424.8947368421054,40,10,17,50
2269,-25.572749999998937,3625.05,34,16,18,50
2270,6.292500000001759,5027.5,59,17,10,76
2271,-32.10824999999959,1429.0,10,16,18,26
2272,-11.26049999999831,1900.5882352941176,34,8,23,42
2273,-4.20249999999825,3530.157894736842,45,11,20,56
2274,-0.6632499999993418,3572.842105263158,51,8,21,59
2275,-25.05949999999887,1537.1875,25,12,18,37
2276,-34.83174999999956,2066.823529411765,22,21,15,43
2277,-22.8250000000007,2286.157894736842,40,9,18,49
2278,-30.908499999999172,2429.9444444444443,18,9,21,27
2279,-13.648749999998063,4145.7,56,12,16,68
2280,-2.748000000000096,3202.1176470588234,62,15,20,77
2281,-38.56324999999985,1594.75,18,15,18,33
2282,-19.472249999999327,3120.0,25,11,23,36
2283,-9.235999999999148,4582.2,42,10,22,52
2284,-21.642499999999238,2234.9444444444443,21,18,18,39
2285,-21.941749999999068,3223.45,30,12,17,42
2286,-2.5982499999998283,2366.5625,48,15,16,63
2287,-15.323249999998854,3771.95,39,13,18,52
2288,-7.709249999998926,3493.3684210526317,46,8,23,54
2289,-10.957749999998752,2585.1176470588234,52,12,17,64
2290,-26.635999999999164,2568.5263157894738,25,11,17,36
2291,-10.328999999998754,3496.9444444444443,77,9,19,86
2292,2.484750000001453,2030.2941176470588,50,13,21,63
2293,-20.29074999999834,3087.3684210526317,45,16,22,61
2294,1.6345000000014238,4452.95,53,16,9,69
2295,-28.7075000000002,2004.6315789473683,25,15,26,40
2296,-7.594249999999329,4424.9473684210525,67,20,17,87
2297,-13.45149999999963,2158.1875,29,20,18,49
2298,-2.7129999999965912,1528.25,60,8,22,68
2299,2.9652500000019693,3925.1,49,21,11,70
2300,-24.443499999999723,1719.75,21,11,21,32
2301,2.081749999999711,2260.9411764705883,65,19,15,84
2302,-4.511749999998852,4596.1578947368425,63,20,13,83
2303,-13.13174999999823,3144.2105263157896,39,13,20,52
2304,-7.54299999999864,2365.5,27,11,25,38
2305,-20.878249999999063,2620.3888888888887,20,12,20,32
2306,-23.91499999999897,3350.45,27,4,32,31
2307,-17.805499999997657,2732.529411764706,45,11,18,56
2308,-8.59399999999904,2033.25,52,16,29,68
2309,-4.612499999998784,2892.176470588235,40,11,21,51
2310,-33.47374999999907,2475.0,19,15,18,34
2311,-40.11875000000011,1429.0,0,10,30,10
2312,8.37975000000191,4322.388888888889,74,10,28,84
2313,-11.759499999999809,2643.823529411765,53,15,25,68
2314,-13.89674999999992,2116.1111111111113,37,11,22,48
2315,-19.202749999998915,2166.1875,44,15,23,59
2316,-8.5487499999978,2171.6111111111113,39,14,16,53
2317,-18.509749999998213,2739.4444444444443,36,11,22,47
2318,-17.78049999999837,3842.55,36,16,22,52
2319,-28.279999999999923,2770.3333333333335,31,12,23,43
2320,-28.497249999999184,2694.7894736842104,24,6,26,30
2321,7.619750000001039,2921.176470588235,63,10,21,73
2322,5.010500000001747,2621.5625,47,13,26,60
2323,-13.904249999999791,1971.5882352941176,30,14,18,44
2324,-41.692999999997895,1564.0,15,13,37,28
2325,-24.352499999999985,1968.8333333333333,25,23,19,48
2326,-30.749749999998976,3581.45,27,15,24,42
2327,-5.3874999999991795,2729.764705882353,62,10,19,72
2328,-8.088999999999064,4335.473684210527,50,6,27,56
2329,-19.498999999998638,3094.0,32,9,27,41
2330,9.824000000002023,3506.842105263158,52,5,22,57
2331,-20.17024999999802,3368.9473684210525,41,13,19,54
2332,-12.84199999999941,2869.315789473684,30,5,22,35
2333,4.74825000000064,2487.823529411765,50,16,19,66
2334,1.1092500000028256,4046.4210526315787,59,8,22,67
2335,-26.064249999998953,2196.8947368421054,18,6,29,24
2336,-13.61724999999895,3626.157894736842,35,17,29,52
2337,-16.551499999999002,2080.8823529411766,29,18,15,47
2338,-18.811499999999747,2701.5555555555557,36,10,24,46
2339,-17.749499999999504,3421.1666666666665,57,26,23,83
2340,-6.590999999998745,2246.5625,48,10,25,58
2341,-15.302499999998528,3240.15,32,8,23,40
2342,-8.435000000000166,1929.0625,51,9,18,60
2343,-14.76824999999938,2563.9444444444443,38,10,20,48
2344,-5.831249999999615,2794.157894736842,50,8,22,58
2345,-39.42649999999956,1556.0588235294117,9,16,16,25
2346,-12.5424999999997,2770.3888888888887,35,10,25,45
2347,-21.16324999999934,1746.5,18,19,21,37
2348,-2.9767499999985914,4938.55,53,16,17,69
2349,-0.3732500000000941,2916.4117647058824,55,14,17,69
2350,-40.415249999998714,2613.6315789473683,22,6,30,28
2351,-3.3712499999999244,2265.6470588235293,45,15,16,60
2352,-31.544999999999646,2026.7058823529412,20,9,16,29
2353,-33.410500000000255,2968.6666666666665,42,14,18,56
2354,-28.877749999999292,2124.6470588235293,32,19,22,51
2355,-4.299749999999631,3319.6315789473683,46,17,18,63
2356,-10.725749999997765,2866.4444444444443,43,6,23,49
2357,-29.47649999999941,2282.6666666666665,22,8,22,30
2358,-27.749249999999215,2287.0,16,26,14,42
2359,-8.348499999998541,4797.35,50,14,17,64
2360,-22.665249999998785,2587.05,23,14,17,37
2361,-39.330999999999236,1481.9333333333334,22,10,24,32
2362,-9.39824999999859,2885.0,46,7,17,53
2363,-18.13624999999896,2013.5882352941176,45,14,17,59
2364,-23.703749999999335,2952.8333333333335,39,16,11,55
2365,-3.3419999999983916,1964.75,48,11,35,59
2366,-12.99724999999869,2769.4444444444443,41,11,26,52
2367,-35.00174999999933,3156.7368421052633,27,23,10,50
2368,-35.83424999999951,1697.9375,12,4,25,16
2369,-16.677499999999608,2277.823529411765,43,7,22,50
2370,8.55025000000143,2478.6875,61,7,25,68
2371,-21.21949999999935,2687.2631578947367,24,11,24,35
2372,1.6595000000011602,4345.7,52,9,18,61
2373,-6.149749999999006,4194.1578947368425,53,12,27,65
2374,1.090250000002597,5182.25,65,10,16,75
2375,-6.800999999998228,3189.1666666666665,39,11,24,50
2376,-29.453250000000327,1429.0,20,7,45,27
2377,-26.296499999998282,2228.294117647059,31,17,15,48
2378,-16.706249999999436,3307.0526315789475,33,11,22,44
2379,-27.753750000000366,1741.5,21,21,24,42
2380,-31.944499999999255,2622.85,22,1,28,23
2381,-13.653999999999916,2370.235294117647,39,12,16,51
2382,24.366250000001344,4459.9473684210525,72,11,14,83
2383,-10.151249999999195,4779.05,52,2,23,54
2384,-21.5934999999983,1542.125,30,9,27,39
2385,-29.295499999999937,2097.6470588235293,21,3,56,24
2386,-11.164499999998394,3205.9473684210525,34,10,23,44
2387,0.805250000001181,4552.0,53,14,27,67
2388,-15.927000000000126,2365.5555555555557,36,5,31,41
2389,-14.281749999998862,1862.5625,38,15,22,53
2390,-39.469499999999556,1523.25,8,11,23,19
2391,-6.693249999998881,2160.0555555555557,38,5,15,43
2392,-6.417249999998809,3172.75,32,6,21,38
2393,-8.257499999998213,2948.3888888888887,48,11,20,59
2394,-11.232999999997425,2066.8823529411766,50,12,20,62
2395,-6.415249999998906,4342.5,40,8,17,48
2396,-18.21499999999896,1749.3529411764705,19,16,17,35
2397,-9.939499999998494,2430.0625,36,14,18,50
2398,-37.62400000000012,3131.684210526316,22,9,42,31
2399,0.8697500000005685,2807.176470588235,38,12,18,50
2400,0.08300000000197745,2236.823529411765,37,15,25,52
2401,-3.2019999999983484,5909.3,60,8,26,68
2402,-10.183249999999555,3049.842105263158,42,12,19,54
2403,-27.489499999999623,1925.5,13,16,21,29
2404,-25.912499999999774,2811.777777777778,39,10,36,49
2405,-19.04249999999923,3277.0,30,8,26,38
2406,-41.70524999999908,2593.1111111111113,21,9,27,30
2407,-30.377249999998735,3109.2,21,17,20,38
2408,-24.327999999999285,2187.3888888888887,22,10,22,32
2409,-6.895749999997236,2469.235294117647,42,8,33,50
2410,-12.548500000000221,3049.7894736842104,46,8,23,54
2411,-11.292749999999174,2442.1176470588234,42,4,31,46
2412,-9.840499999999473,2576.3333333333335,32,8,29,40
2413,-31.730499999999644,2099.1052631578946,15,14,14,29
2414,-0.4914999999987101,2916.6666666666665,40,3,31,43
2415,-20.690749999999138,3541.8888888888887,44,9,21,53
2416,-8.1794999999989,4103.315789473684,55,15,24,70
2417,-8.961499999998747,3230.6,32,16,17,48
2418,8.077500000001141,4644.25,57,8,16,65
2419,-24.408499999998945,2495.9473684210525,27,13,18,40
2420,-39.73825000000009,1429.0,10,21,17,31
2421,-24.653999999999336,3111.6666666666665,43,20,28,63
2422,-17.461249999999133,3297.8947368421054,45,13,23,58
2423,-14.76224999999934,2611.7,28,10,17,38
2424,-37.694749999999175,2295.8,21,12,19,33
2425,-19.01874999999917,3273.45,29,6,22,35
2426,-31.83699999999947,2183.85,15,11,18,26
2427,-6.131249999997874,3379.529411764706,60,13,23,73
2428,-18.339499999998367,3195.3888888888887,44,10,24,54
2429,-21.426999999999563,2722.8333333333335,26,17,20,43
2430,-7.512249999999417,2623.9444444444443,45,17,23,62
2431,-28.95674999999975,2683.0555555555557,27,4,21,31
2432,-8.580249999998973,3973.7894736842104,55,11,23,66
2433,-27.907249999999387,2776.65,21,11,18,32
2434,-2.266999999998847,2818.8888888888887,39,12,18,51
2435,11.705250000001582,3862.7894736842104,55,9,13,64
2436,-28.042249999998624,2640.5263157894738,20,7,35,27
2437,-18.058249999998814,3926.7,41,6,20,47
2438,-8.20949999999957,2122.823529411765,55,18,16,73
2439,8.787250000001373,5482.25,50,6,18,56
2440,-14.950499999999275,3110.0,44,8,17,52
2441,-37.402749999999116,2745.7368421052633,23,11,19,34
2442,-13.646249999998835,2470.1052631578946,27,17,11,44
2443,-27.023499999998613,2738.2105263157896,28,13,23,41
2444,-10.095249999997945,4736.15,50,14,16,64
2445,-20.086499999999063,1510.5333333333333,45,15,24,60
2446,-32.020749999998884,2576.8947368421054,27,9,23,36
2447,-27.092000000000024,2889.277777777778,42,7,28,49
2448,27.523250000002434,4615.65,61,14,15,75
2449,-11.844499999998956,3143.4210526315787,31,10,28,41
2450,-14.358499999999225,2478.3684210526317,27,3,25,30
2451,-5.613999999998511,4147.631578947368,69,16,20,85
2452,-2.8197499999990208,2755.3333333333335,44,18,10,62
2453,-3.803749999998124,2950.277777777778,45,9,19,54
2454,0.012250000001654816,2810.9444444444443,36,9,22,45
2455,-16.62799999999918,2099.157894736842,24,10,18,34
2456,9.302000000001147,3543.4210526315787,62,20,18,82
2457,-19.44249999999979,3073.2105263157896,39,10,22,49
2458,7.820000000001412,5347.210526315789,60,16,11,76
2459,-27.373499999998522,2501.5,27,9,25,36
2460,-0.4392499999987134,4206.85,46,12,16,58
2461,-28.592749999999587,2158.3888888888887,12,16,15,28
2462,-4.8769999999984694,3893.777777777778,60,5,23,65
2463,9.441500000000397,2949.4444444444443,48,8,20,56
2464,-15.870749999998981,2322.9375,41,18,20,59
2465,-29.241499999999217,1438.5333333333333,10,19,16,29
2466,-2.5724999999981653,2291.823529411765,38,5,33,43
2467,-16.79699999999864,3569.4210526315787,40,10,24,50
2468,-5.682999999999936,2240.4117647058824,37,10,22,47
2469,6.4110000000005085,2726.0588235294117,46,14,16,60
2470,-11.824499999999123,2498.1176470588234,51,17,15,68
2471,22.570250000002353,4841.8,68,5,21,73
2472,-29.777749999999184,3075.4444444444443,45,14,32,59
2473,4.076000000002243,3605.3888888888887,66,14,19,80
2474,-10.251749999998927,3203.3888888888887,50,7,16,57
2475,-32.09174999999898,1949.2777777777778,24,14,32,38
2476,1.0745000000018234,2572.8888888888887,33,10,29,43
2477,-24.84399999999934,2341.235294117647,33,12,19,45
2478,-3.4369999999998258,2731.6470588235293,67,13,24,80
2479,-17.815749999998534,3742.45,35,5,28,40
2480,-45.20599999999844,2156.4117647058824,22,20,25,42
2481,-21.66174999999908,2637.1111111111113,28,11,21,39
2482,-22.990499999999095,2797.6666666666665,29,9,23,38
2483,-20.736249999999195,2255.5,35,17,14,52
2484,-29.180249999999496,2709.25,20,11,21,31
2485,-17.20224999999902,2528.777777777778,37,11,22,48
2486,-15.726499999997511,1528.25,40,10,22,50
2487,-21.79299999999936,3061.6,21,10,20,31
2488,-16.10549999999913,2150.823529411765,26,15,17,41
2489,-1.5732499999973037,4690.95,66,3,27,69
2490,-19.152499999999193,4302.85,49,12,20,61
2491,20.765750000001372,2447.0,63,18,19,81
2492,-15.009499999998274,3723.9473684210525,41,15,17,56
2493,-29.536999999999757,2571.8888888888887,29,20,26,49
2494,-33.68249999999914,2794.2,14,15,20,29
2495,-43.04824999999929,2020.0588235294117,11,15,22,26
2496,-36.565249999999985,2239.4444444444443,12,11,21,23
2497,-29.225999999999498,1429.0,28,6,29,34
2498,8.518250000001554,3487.4210526315787,50,11,20,61
2499,3.2460000000007456,2983.705882352941,63,23,12,86
2500,-20.0662499999993,2305.3684210526317,20,7,25,27
2501,-19.127249999998654,2497.5263157894738,30,10,21,40
2502,-10.587999999999493,3182.25,35,5,18,40
2503,-39.10199999999951,2192.7368421052633,27,6,29,33
2504,-15.671749999998895,2982.157894736842,33,6,22,39
2505,-7.627999999998093,4241.0,47,15,16,62
2506,-19.21049999999935,2874.4444444444443,33,15,19,48
2507,-11.841749999999521,3153.6,30,11,18,41
2508,12.954250000000908,2898.764705882353,61,18,14,79
2509,2.709500000001878,2398.375,50,22,13,72
2510,-23.621749999999565,1951.0,17,11,17,28
2511,-11.389749999998589,2559.0,49,8,28,57
2512,-20.129249999999338,4075.1,36,15,30,51
2513,-22.297499999998855,3160.9473684210525,31,8,27,39
2514,38.082500000004146,3533.222222222222,76,11,20,87
2515,2.7975000000017873,2425.1875,50,10,22,60
2516,-5.784749999998335,4937.0526315789475,67,13,18,80
2517,-0.5572499999969851,2329.176470588235,44,8,40,52
2518,-20.67374999999962,2708.5,20,2,22,22
2519,-14.536999999998963,2110.823529411765,30,13,18,43
2520,-15.418999999998576,2005.5625,38,19,11,57
2521,-21.37899999999848,2311.0555555555557,26,11,26,37
2522,-20.213499999999506,2755.3333333333335,35,13,15,48
2523,-16.492499999999165,1429.0,26,10,26,36
2524,-18.295999999999644,2457.3333333333335,28,16,22,44
2525,-10.225999999999635,2826.7894736842104,33,7,19,40
2526,-11.561749999998904,3091.85,34,10,20,44
2527,-13.121499999998559,2971.2631578947367,35,13,15,48
2528,-26.90724999999973,2034.1176470588234,25,9,21,34
2529,-8.012499999999097,2450.277777777778,31,13,20,44
2530,-26.48124999999853,2707.722222222222,26,7,31,33
2531,-5.411249999999096,2909.6666666666665,46,9,25,55
2532,5.359000000001505,3912.5,44,2,24,46
2533,-16.25399999999878,2694.9,28,9,24,37
2534,-15.405499999997787,2890.222222222222,41,7,29,48
2535,-11.936749999998906,2248.9411764705883,39,18,16,57
2536,-28.471749999998234,2231.6666666666665,27,14,19,41
2537,-17.272749999998332,3725.9,36,7,28,43
2538,-4.552249999995945,5201.35,68,0,28,68
2539,-6.500249999998371,2924.8823529411766,53,21,22,74
2540,-14.55749999999949,3541.842105263158,30,10,31,40
2541,-12.64499999999977,2018.235294117647,38,20,19,58
2542,-8.589999999997785,3474.0555555555557,50,6,26,56
2543,-6.097749999999069,2878.0,44,3,18,47
2544,-40.437249999999736,1949.3333333333333,10,14,28,24
2545,-13.350999999998928,2580.4210526315787,32,6,20,38
2546,-8.452999999997811,2541.0555555555557,38,7,24,45
2547,-31.06549999999938,3015.6,15,12,31,27
2548,-26.079499999998763,3609.95,38,8,19,46
2549,-2.8317499999982365,2933.4444444444443,53,7,21,60
2550,-37.587999999998985,1989.0555555555557,12,10,36,22
2551,-27.93899999999985,1711.0588235294117,18,11,27,29
2552,-9.289749999998069,2580.777777777778,34,9,24,43
2553,-23.07074999999829,2295.0555555555557,29,3,30,32
2554,-20.014249999999684,2049.0555555555557,10,4,36,14
2555,-19.331000000000138,1946.875,37,10,26,47
2556,-19.962999999999536,2695.4444444444443,25,6,21,31
2557,-30.432499999998168,3023.9473684210525,32,9,21,41
2558,1.4305000000021297,4957.6,50,13,19,63
2559,-10.231249999998745,2505.0,34,10,26,44
2560,-33.568249999999416,1429.0,16,9,22,25
2561,-18.20149999999837,2669.7368421052633,30,16,17,46
2562,-23.62699999999919,3494.1,28,14,18,42
2563,-17.92874999999989,1862.2941176470588,38,7,21,45
2564,4.066500000002094,3572.8333333333335,61,10,21,71
2565,-26.72499999999935,2094.777777777778,25,13,27,38
2566,-11.693249999998043,2473.8823529411766,38,8,22,46
2567,-23.47599999999935,3015.4736842105262,33,11,29,44
2568,-3.8689999999993225,3734.0526315789475,57,8,19,65
2569,-12.886499999999558,2601.823529411765,30,14,20,44
2570,-18.90299999999878,4654.45,44,15,26,59
2571,-4.159999999999313,2799.2105263157896,31,7,19,38
2572,-27.23899999999988,2101.3529411764707,23,11,18,34
2573,-16.427499999999036,3893.35,46,12,20,58
2574,-35.45949999999939,2698.95,14,6,28,20
2575,-23.616499999999363,3174.2105263157896,28,6,18,34
2576,-14.503749999999707,3179.2105263157896,36,17,25,53
2577,-13.561499999998693,2830.3888888888887,43,12,18,55
2578,-33.267499999999266,2199.777777777778,12,7,28,19
2579,7.607500000001542,5282.25,58,12,17,70
2580,-23.192249999998303,2303.9411764705883,40,13,15,53
2581,-37.48499999999904,1617.5625,10,12,24,22
2582,-2.2419999999989666,3866.0,56,12,12,68
2583,-16.067999999997532,3088.722222222222,34,7,40,41
2584,-31.376249999999544,2171.5555555555557,16,5,30,21
2585,-6.159499999999168,3458.3684210526317,41,4,20,45
2586,-29.125999999999703,2719.0,27,10,27,37
2587,-30.056499999999225,3246.1052631578946,37,17,12,54
2588,-7.048999999998506,3090.7368421052633,33,16,24,49
2589,-12.442999999999406,3760.75,39,8,20,47
2590,-25.22574999999987,1957.2222222222222,12,14,30,26
2591,-7.528749999999621,3183.0555555555557,46,10,21,56
2592,5.251500000002416,3110.6470588235293,60,9,19,69
2593,-9.324749999999927,1559.0,35,14,20,49
2594,-22.06949999999901,3319.55,35,17,16,52
2595,-7.476749999998565,3838.65,42,14,16,56
2596,-15.197249999999604,2695.1176470588234,44,18,11,62
2597,-21.40349999999865,3832.25,40,15,29,55
2598,-28.78049999999996,1551.3529411764705,21,4,37,25
2599,-21.103499999998387,2303.8333333333335,30,6,24,36
2600,13.07925000000177,5893.35,68,12,26,80
2601,-26.533499999999123,1534.8666666666666,15,17,21,32
2602,-20.272499999999475,3237.722222222222,30,8,25,38
2603,-31.253250000000026,2195.4444444444443,23,11,22,34
2604,-14.853999999999028,3125.0526315789475,44,7,26,51
2605,-9.24899999999862,2599.5263157894738,34,13,21,47
2606,-14.136499999998401,3471.95,41,7,20,48
2607,1.3040000000025986,3247.3888888888887,51,11,28,62
2608,-13.447249999998707,3894.1,38,3,29,41
2609,-20.724999999998854,1880.5,48,14,26,62
2610,-25.790499999999696,1933.1764705882354,23,15,38,38
2611,-15.789249999999466,3087.4210526315787,36,6,38,42
2612,1.8210000000016477,2389.375,51,14,29,65
2613,-23.056249999998553,2631.705882352941,40,12,19,52
2614,0.7622500000015183,3142.3529411764707,55,17,21,72
2615,-20.041249999999728,3180.1052631578946,37,15,19,52
2616,-27.028999999999144,1965.1666666666667,21,13,21,34
2617,-4.193749999997821,3049.0555555555557,46,7,25,53
2618,-32.27724999999853,3573.5789473684213,35,8,28,43
2619,-12.946499999999352,2723.1176470588234,55,20,21,75
2620,1.4502500000010035,3658.8947368421054,52,8,24,60
2621,-16.411499999999563,4640.95,48,16,23,64
2622,-19.835499999999367,2643.842105263158,26,13,14,39
2623,3.4512500000019286,2436.0625,57,13,7,70
2624,-21.756749999998497,2719.3529411764707,41,11,23,52
2625,-0.010249999998815085,2310.9444444444443,34,11,20,45
2626,-26.103749999998996,2648.529411764706,28,10,30,38
2627,-2.5627499999985597,2268.3125,51,17,18,68
2628,-8.286249999998258,3397.3684210526317,38,14,23,52
2629,-33.184999999999874,3488.6,26,10,19,36
2630,-11.268749999999333,2182.9444444444443,30,18,15,48
2631,-15.50824999999918,3002.9,19,12,26,31
2632,3.1430000000019134,5293.4,60,8,14,68
2633,-10.830749999999913,3374.842105263158,40,5,24,45
2634,-11.379249999998997,3112.4736842105262,34,23,19,57
2635,-7.293999999998208,5497.25,63,15,15,78
2636,-49.62749999999964,1572.7777777777778,1,13,26,14
2637,20.282750000001325,4304.631578947368,55,17,17,72
2638,-16.802249999998228,3290.3684210526317,38,15,21,53
2639,1.2635000000032037,2793.235294117647,56,7,26,63
2640,-13.7285,1955.75,32,13,29,45
2641,-7.4177499999989065,2094.75,49,12,23,61
2642,-15.222749999999209,2526.1176470588234,37,12,20,49
2643,-29.42774999999952,2023.9473684210527,13,10,19,23
2644,7.2072500000024196,2879.0588235294117,66,15,16,81
2645,3.8672500000020507,5198.9,58,20,24,78
2646,-20.587249999998896,2849.176470588235,35,15,32,50
2647,22.98100000000222,4889.4,63,12,28,75
2648,-5.752750000000196,2635.3888888888887,50,7,29,57
2649,6.439000000002126,2178.0625,45,15,16,60
2650,-19.856499999998807,1660.111111111111,21,11,20,32
2651,-31.458000000000716,1429.0,19,19,21,38
2652,3.725250000000442,4129.0526315789475,38,17,19,55
2653,-18.236499999998834,3636.1,32,9,23,41
2654,11.093250000001508,4821.95,58,13,19,71
2655,-29.262499999999797,2688.842105263158,31,10,23,41
2656,-20.905999999999423,2442.1176470588234,34,10,23,44
2657,-15.476749999999692,2064.8947368421054,24,8,31,32
2658,-0.42174999999854795,1976.235294117647,41,11,15,52
2659,-12.260499999999784,2873.5,40,17,18,57
2660,-12.38749999999877,2130.4375,33,8,25,41
2661,-8.611249999997543,2486.0,48,10,25,58
2662,-2.2642499999985963,5029.85,55,13,21,68
2663,-3.0904999999986393,3684.7,41,7,23,48
2664,-23.0464999999999,1657.1875,17,21,15,38
2665,-16.338750000000168,1448.0666666666666,36,5,23,41
2666,-32.454999999999174,2642.1052631578946,21,9,24,30
2667,-14.958499999998498,3758.55,33,7,26,40
2668,-10.123999999999901,2054.1875,45,3,31,48
2669,-5.740499999998782,4173.55,43,8,21,51
2670,-14.785749999998998,3140.0526315789475,31,5,29,36
2671,-33.359249999999975,2603.6666666666665,26,8,16,34
2672,-8.89599999999901,4425.85,38,7,24,45
2673,-26.285749999999375,2448.315789473684,22,4,27,26
2674,-3.284249999998134,2307.705882352941,54,18,17,72
2675,-20.81299999999901,2534.529411764706,41,10,16,51
2676,-39.605499999999765,2097.4210526315787,16,7,24,23
2677,-4.150499999998367,4436.95,48,7,23,55
2678,5.661750000001431,3084.277777777778,42,18,17,60
2679,-7.0424999999986255,3967.0526315789475,45,14,21,59
2680,-8.430499999998815,2672.8947368421054,28,8,28,36
2681,4.782250000000368,3382.9,38,11,20,49
2682,-39.19424999999933,1429.0,12,11,21,23
2683,-17.043749999999523,2265.705882352941,26,16,26,42
2684,-34.852999999999554,1429.0,10,8,27,18
2685,-7.570249999999004,3594.95,32,11,18,43
2686,0.6607500000015435,2729.0,47,7,20,54
2687,-25.56074999999982,2645.4736842105262,22,10,26,32
2688,-1.9909999999987058,2810.8888888888887,42,8,21,50
2689,-5.127249999998648,2511.1666666666665,41,14,12,55
2690,-15.022249999997793,3063.8888888888887,56,18,18,74
2691,-27.193999999997818,3396.4444444444443,46,16,21,62
2692,-22.92824999999924,3261.55,25,7,25,32
2693,-36.17774999999939,2343.0526315789475,13,12,23,25
2694,-18.74074999999868,2685.9411764705883,57,11,30,68
2695,-9.968749999998998,4493.35,35,8,28,43
2696,-23.538749999999304,3848.1,36,3,22,39
2697,-20.052749999998632,2156.6111111111113,32,9,22,41
2698,-36.05724999999914,2673.0526315789475,23,5,30,28
2699,-28.078250000000043,1795.0,22,14,24,36
2700,-21.95299999999731,2497.8333333333335,35,11,36,46
2701,-41.276999999999646,2290.95,11,10,21,21
2702,-11.266499999998826,2459.0,47,10,33,57
2703,-20.03699999999895,2805.0,29,6,27,35
2704,-0.9387499999987137,3536.9473684210525,49,5,24,54
2705,24.517250000001564,3877.9444444444443,63,3,18,66
2706,-17.47274999999932,1949.3333333333333,41,16,9,57
2707,-27.04499999999981,2096.5882352941176,22,7,26,29
2708,-22.351499999998502,2772.65,30,15,22,45
2709,-26.299499999998847,1634.3125,21,6,27,27
2710,-16.50024999999916,2126.470588235294,28,13,23,41
2711,6.878500000002015,2963.1176470588234,59,10,28,69
2712,4.813250000000946,3672.2105263157896,51,6,22,57
2713,-31.552499999999718,1997.2105263157894,13,11,21,24
2714,-14.872749999998991,3570.3684210526317,30,7,32,37
2715,-4.459999999998962,4313.736842105263,54,20,19,74
2716,0.4912500000014376,3984.65,51,19,12,70
2717,-11.230499999998894,3363.9,38,9,24,47
2718,-3.44899999999854,2463.6470588235293,44,10,18,54
2719,-21.35549999999756,4631.4,43,11,20,54
2720,-28.831749999999865,2164.2631578947367,13,12,24,25
2721,-5.923999999998585,4120.444444444444,60,12,18,72
2722,-14.917249999998575,4079.85,37,11,26,48
2723,-2.4047499999996615,3891.842105263158,58,5,24,63
2724,-29.12699999999989,2469.9473684210525,25,9,24,34
2725,-33.21124999999875,2675.5263157894738,26,11,23,37
2726,-14.259499999999496,2360.222222222222,28,9,18,37
2727,-6.779999999998795,4525.9473684210525,48,16,20,64
2728,10.082500000001037,4710.85,47,4,26,51
2729,-6.2459999999985865,3862.35,41,19,20,60
2730,-15.270499999998188,3538.8,39,10,23,49
2731,-18.012999999999945,2403.764705882353,62,16,23,78
2732,-27.59049999999946,1837.0588235294117,13,21,17,34
2733,-31.71274999999951,2409.95,14,14,22,28
2734,-7.815249999998279,4051.4210526315787,48,14,23,62
2735,22.656250000001727,4372.75,59,8,19,67
2736,10.052250000001582,2594.8125,65,2,29,67
2737,-12.937499999999156,3931.55,39,13,21,52
2738,9.767500000002123,3428.9375,74,9,18,83
2739,-10.559249999998539,1993.0588235294117,34,12,21,46
2740,-14.047749999999061,3975.1,41,4,20,45
2741,-28.528249999999172,1429.0,10,15,21,25
2742,-7.2932499999974825,2608.3529411764707,54,11,18,65
2743,-11.945499999999445,4317.15,37,11,14,48
2744,-5.850499999998731,3794.2,40,19,10,59
2745,2.119250000002042,5078.3,69,1,29,70
2746,-12.936749999998668,3856.85,38,7,25,45
2747,-7.211749999998962,2425.4117647058824,37,15,27,52
2748,-2.760499999998236,4618.05,56,20,14,76
2749,7.435750000000709,4390.631578947368,60,8,29,68
2750,-10.510749999998522,3021.3684210526317,27,9,31,36
2751,-10.037749999997935,4028.777777777778,61,9,15,70
2752,1.1675000000008262,4966.35,47,11,30,58
2753,-5.890999999999429,2739.842105263158,24,14,21,38
2754,-14.880999999998659,3162.5789473684213,42,9,24,51
2755,-35.62674999999882,1429.0,9,7,33,16
2756,-20.593750000000156,1622.2941176470588,33,10,31,43
2757,-19.838249999999203,2874.4736842105262,27,12,18,39
2758,-22.386249999998658,2143.277777777778,30,15,18,45
2759,-14.709999999999038,2064.0,41,2,27,43
2760,-17.63649999999984,1429.0,36,10,28,46
2761,-31.681499999998756,2404.9411764705883,22,16,23,38
2762,-17.01749999999949,3034.7368421052633,41,6,24,47
2763,9.330500000001322,4242.0,54,16,19,70
2764,-8.706999999998667,3377.8888888888887,47,10,23,57
2765,4.686750000001033,3167.222222222222,44,9,24,53
2766,-33.70699999999887,2969.5,21,6,27,27
2767,-29.755249999999272,2076.4736842105262,11,17,21,28
2768,-4.877999999999292,3773.2105263157896,44,12,15,56
2769,-1.7412499999981583,3028.8947368421054,48,6,19,54
2770,3.4575000000022884,5325.15,54,15,28,69
2771,0.05200000000170864,3957.842105263158,56,11,16,67
2772,-1.8557499999984348,1969.75,47,8,30,55
2773,-29.179499999999404,2764.2105263157896,37,10,24,47
2774,-40.21224999999856,1987.5625,27,30,17,57
2775,-25.10249999999936,2382.3333333333335,24,8,24,32
2776,-12.125249999998982,2818.8333333333335,31,8,25,39
2777,-12.412249999998227,4287.9,51,16,14,67
2778,-14.4597499999982,4154.45,43,8,20,51
2779,-19.185499999998918,2255.5,47,13,20,60
2780,-7.472499999998893,2113.5625,39,8,26,47
2781,-17.72949999999969,3621.2631578947367,41,11,20,52
2782,-20.53099999999806,3444.9473684210525,40,5,23,45
2783,-21.168500000000193,1605.4705882352941,29,17,26,46
2784,3.3185000000011824,2559.764705882353,42,7,24,49
2785,-23.75149999999926,2849.0,22,12,24,34
2786,-17.404499999998503,1528.25,30,9,18,39
2787,-18.756999999999472,4223.45,45,6,20,51
2788,-31.276250000000054,1719.4117647058824,9,10,34,19
2789,-1.44449999999873,2591.5882352941176,53,18,17,71
2790,2.6167500000011814,2937.0555555555557,40,20,16,60
2791,-8.725999999998473,2818.4117647058824,44,11,16,55
2792,-18.67949999999921,1954.7058823529412,19,2,33,21
2793,-12.201999999998403,3680.75,45,12,17,57
2794,-2.0974999999988415,3964.5789473684213,46,10,25,56
2795,-27.115749999999856,2756.0,17,9,22,26
2796,-13.38299999999727,2316.1176470588234,50,12,26,62
2797,-28.276999999998868,2866.0,18,12,26,30
2798,-19.550749999998928,1839.6875,30,9,21,39
2799,-25.17124999999938,3569.55,25,14,28,39
2800,-31.593499999999903,1429.0,14,15,21,29
2801,-9.338999999999206,3684.6315789473683,39,9,32,48
2802,-1.0412499999991818,2121.5625,43,11,24,54
2803,-9.182749999999132,2685.9411764705883,47,19,24,66
2804,5.034250000001805,2623.235294117647,44,2,25,46
2805,-10.947249999999139,3018.0526315789475,36,13,27,49
2806,-27.94149999999926,1528.25,19,13,16,32
2807,-9.515999999998568,2391.764705882353,41,6,22,47
2808,19.185500000001177,3177.0,77,11,27,88
2809,-1.2487499999994358,3552.5,48,14,14,62
2810,-1.1125000000001,2774.722222222222,34,15,19,49
2811,-26.111999999999433,3255.2105263157896,28,15,26,43
2812,3.9599999999997424,2555.1176470588234,70,33,20,103
2813,-2.842749999998225,3168.4736842105262,34,14,32,48
2814,-14.870999999998952,3688.8947368421054,48,5,27,53
2815,8.27975000000163,4410.85,56,9,20,65
2816,-41.19499999999982,1505.4375,5,14,20,19
2817,-22.21474999999974,2500.4444444444443,28,5,35,33
2818,-30.2847499999991,3552.05,39,11,21,50
2819,-3.907749999999575,3323.7368421052633,46,15,22,61
2820,-34.08874999999933,1429.0,21,13,20,34
2821,-16.729999999999308,2305.3684210526317,27,6,26,33
2822,-27.54449999999922,2885.9473684210525,22,7,41,29
2823,-11.328499999997689,4794.2,60,14,16,74
2824,-7.2797499999983515,1689.0,31,13,21,44
2825,-17.437249999998848,4971.9,52,13,21,65
2826,-16.987249999998916,2223.6470588235293,46,7,35,53
2827,-17.479249999998586,3429.0588235294117,45,17,26,62
2828,-12.438749999998159,4212.35,45,16,21,61
2829,-12.448999999999096,4594.9,46,10,22,56
2830,14.133500000001472,4506.85,43,18,16,61
2831,-13.692499999999303,2471.0588235294117,45,14,21,59
2832,-28.447749999999086,1954.7058823529412,12,6,31,18
2833,2.312000000000853,4245.263157894737,51,22,18,73
2834,12.511250000001102,2811.9411764705883,52,5,26,57
2835,-11.853249999999203,2776.5789473684213,24,10,25,34
2836,-8.694249999998766,3086.5263157894738,35,4,23,39
2837,-22.191499999999444,2243.0,23,13,29,36
2838,-5.444749999998937,3508.4210526315787,52,9,17,61
2839,-24.445749999998515,2774.0526315789475,32,7,25,39
2840,5.078000000000735,3531.0,39,11,23,50
2841,-15.34199999999969,2753.0588235294117,37,8,35,45
2842,-14.677499999998815,2783.5,34,9,21,43
2843,5.873000000001321,2988.1111111111113,43,5,21,48
2844,-12.338499999998344,4390.1,48,6,25,54
2845,8.701500000002266,4561.9473684210525,58,8,25,66
2846,-16.476499999999984,2447.0625,44,19,14,63
2847,4.410250000002007,3331.1666666666665,58,14,15,72
2848,-37.01450000000003,2186.7894736842104,10,10,31,20
2849,-7.44024999999864,2380.5625,69,9,20,78
2850,-24.422249999999444,1534.8666666666666,20,6,23,26
2851,-36.612249999999165,1429.0,6,14,24,20
2852,-34.03974999999923,1429.0,30,8,22,38
2853,0.2045000000020732,5026.7,61,4,26,65
2854,-15.356499999999823,2038.764705882353,25,9,26,34
2855,-5.889749999998599,2023.3125,46,11,23,57
2856,20.377750000001768,5234.7,77,9,18,86
2857,-15.477499999998074,1532.1875,29,13,25,42
2858,-36.51724999999982,2468.8888888888887,17,13,18,30
2859,-19.398749999999545,2185.3529411764707,25,21,19,46
2860,-3.7864999999985365,2943.1111111111113,39,11,23,50
2861,10.261750000001184,2937.9411764705883,63,10,9,73
2862,-11.584250000000019,2185.157894736842,23,6,29,29
2863,-8.929000000000027,2161.25,54,19,17,73
2864,-21.777249999999782,2465.1666666666665,26,14,19,40
2865,-3.408499999997967,4753.75,62,8,17,70
2866,-8.646499999998756,2518.1111111111113,50,10,16,60
2867,-35.041749999999254,2455.7368421052633,18,10,15,28
2868,-16.618749999999164,2166.1875,38,10,23,48
2869,-42.88199999999968,2116.0555555555557,17,6,49,23
2870,-35.511999999999844,1429.0,15,8,27,23
2871,-19.1122499999984,1993.1176470588234,30,14,17,44
2872,-27.900499999999532,2000.4375,27,18,16,45
2873,-20.924749999998916,3434.6,27,19,19,46
2874,-16.393999999998737,3825.85,46,7,20,53
2875,-30.23974999999954,2200.4,10,17,19,27
2876,-38.00699999999927,2491.7894736842104,14,15,25,29
2877,-10.280999999997855,2778.176470588235,52,16,14,68
2878,-19.686499999997466,1989.2941176470588,39,3,30,42
2879,-11.151999999997715,2983.842105263158,43,13,12,56
2880,-10.493249999999835,1429.0,30,18,15,48
2881,1.9892500000009612,2798.6111111111113,54,6,19,60
2882,-5.647999999998388,3632.9473684210525,43,11,18,54
2883,-31.118249999999755,2370.0555555555557,19,9,29,28
2884,-5.793249999998859,1528.25,33,18,12,51
2885,-16.885499999999578,2306.5,18,7,49,25
2886,-23.60724999999934,1429.0,14,15,20,29
2887,0.7115000000014793,3968.684210526316,52,5,23,57
2888,4.768499999999934,1955.8125,42,11,17,53
2889,-27.47724999999962,2258.6315789473683,7,16,23,23
2890,-16.195749999998526,2798.315789473684,26,10,25,36
2891,-4.0447499999986904,3007.5,38,2,30,40
2892,-23.16699999999962,3829.0,32,3,20,35
2893,-24.0892499999991,1715.764705882353,21,8,27,29
2894,-14.04799999999992,1877.9444444444443,26,21,14,47
2895,-16.391999999998752,4074.3,44,5,27,49
2896,-12.019749999999663,1594.75,34,17,22,51
2897,-8.438499999997541,1751.4375,39,26,13,65
2898,-16.22299999999869,3579.95,40,13,15,53
2899,-18.161999999998567,3306.2631578947367,36,11,20,47
2900,-19.503999999998573,2576.3888888888887,30,7,28,37
2901,-15.28399999999938,2459.0,38,10,22,48
2902,-0.9704999999983238,2626.625,46,4,22,50
2903,-7.246999999999524,2520.777777777778,48,9,20,57
2904,-31.15399999999962,3290.3684210526317,27,16,41,43
2905,-18.050249999999682,2478.3684210526317,17,13,20,30
2906,3.288500000001406,3920.3684210526317,46,11,21,57
2907,-32.65249999999916,2663.0,24,9,25,33
2908,7.72175000000252,2734.4117647058824,59,9,25,68
2909,-0.4867500000004842,3110.7368421052633,42,13,22,55
2910,-14.221499999998613,3149.6111111111113,44,14,21,58
2911,-15.603499999998984,4129.05,43,14,15,57
2912,-25.626999999998777,2255.3888888888887,21,12,20,33
2913,-33.88974999999918,1631.6470588235295,11,10,24,21
2914,-21.09324999999898,2572.75,26,9,22,35
2915,-26.966749999999386,1621.5,38,9,26,47
2916,-14.83249999999945,4183.526315789473,80,5,33,85
2917,-17.08224999999839,4245.75,41,16,15,57
2918,10.864500000001287,4081.5789473684213,49,13,27,62
2919,-22.750250000000122,2794.1666666666665,38,17,22,55
2920,-24.426999999999698,2580.294117647059,38,19,19,57
2921,-24.559499999999044,2377.0,36,9,23,45
2922,-25.779999999998104,2073.0,30,9,27,39
2923,-18.635749999998943,2779.1111111111113,35,4,25,39
2924,2.394250000001339,3653.65,43,14,16,57
2925,-14.690999999998109,2723.6111111111113,35,7,25,42
2926,-20.073749999998828,3166.7368421052633,34,9,21,43
2927,-26.028499999999344,2175.2631578947367,14,18,18,32
2928,-28.341749999999745,2127.4444444444443,24,15,17,39
2929,-20.073749999999496,2312.9473684210525,21,12,24,33
2930,-10.023749999998374,3988.6,36,15,25,51
2931,-17.517749999999218,2463.2631578947367,26,17,10,43
2932,-13.443749999998701,3031.55,35,15,17,50
2933,0.2930000000021208,4391.75,46,20,16,66
2934,-16.04450000000015,1768.3125,42,22,11,64
2935,-12.808499999998215,3662.9473684210525,45,11,22,56
2936,-41.84674999999943,1550.0625,27,14,16,41
2937,9.646250000002102,5729.05,69,12,16,81
2938,-21.582749999999763,2283.294117647059,25,6,26,31
2939,5.4842500000007215,3602.7894736842104,62,12,18,74
2940,-5.085499999998577,3267.157894736842,43,11,13,54
2941,6.394750000001807,2921.0588235294117,53,5,18,58
2942,0.9327500000002343,2504.764705882353,51,12,20,63
2943,-14.391749999999314,3517.15,28,18,25,46
2944,-11.201249999999826,2106.0,40,13,18,53
2945,-3.737499999998151,4931.5,57,9,19,66
2946,-2.6549999999973535,2623.294117647059,50,11,19,61
2947,9.080000000001089,3913.1666666666665,69,7,22,76
2948,-30.1417499999992,2726.4736842105262,31,15,15,46
2949,-2.5372499999978344,1481.9333333333334,41,13,21,54
2950,19.140000000000793,4019.7894736842104,52,14,16,66
2951,-34.702249999999296,3251.35,28,12,17,40
2952,-22.880249999999243,2103.8125,28,11,19,39
2953,3.920750000001039,3403.157894736842,50,25,11,75
2954,0.4955000000018531,2877.8888888888887,47,8,22,55
2955,-25.90624999999949,1692.875,15,5,27,20
2956,-4.493999999998579,2408.529411764706,47,15,19,62
2957,-43.60024999999934,2313.7368421052633,15,9,20,24
2958,22.65200000000107,4726.65,56,9,16,65
2959,-22.568249999999104,2969.6666666666665,25,16,15,41
2960,-1.9372499999988009,3064.176470588235,47,11,13,58
2961,-12.169999999999366,2486.0,47,12,25,59
2962,-25.873749999998786,2119.1176470588234,26,8,20,34
2963,-18.47999999999893,3061.4736842105262,28,18,18,46
2964,-25.931999999999352,2631.45,25,11,18,36
2965,-0.3349999999994447,3275.3684210526317,44,7,15,51
2966,-23.24199999999982,2060.4444444444443,30,7,24,37
2967,-9.47099999999802,3823.5,43,9,22,52
2968,-0.11124999999739113,4237.0,45,16,22,61
2969,-14.152999999998858,3299.5555555555557,43,4,18,47
2970,-10.416249999998811,3076.3888888888887,53,10,19,63
2971,16.79625000000113,2988.3529411764707,55,11,15,66
2972,-10.016499999998763,3016.3333333333335,33,14,20,47
2973,-29.294249999998726,3071.1,26,13,21,39
2974,-12.606499999999292,2584.222222222222,30,2,24,32
2975,-17.72274999999955,3519.2631578947367,57,21,17,78
2976,-23.42774999999923,2768.7,21,15,19,36
2977,-36.8357499999987,1623.2941176470588,20,8,22,28
2978,-38.02299999999962,1429.0,8,15,18,23
2979,-13.911749999999248,3087.3684210526317,32,10,22,42
2980,-11.542749999998962,2112.5,30,21,14,51
2981,-10.226249999999636,2078.0555555555557,45,11,17,56
2982,9.460000000000647,4425.736842105263,58,15,16,73
2983,-22.212749999999467,3163.25,33,9,20,42
2984,-2.679749999998576,2536.6666666666665,48,16,26,64
2985,-8.933999999998335,2414.0,37,17,14,54
2986,-23.791499999998983,3625.15,37,13,14,50
2987,-31.337249999999518,2324.470588235294,27,7,31,34
2988,17.182500000001987,1901.0,65,10,20,75
2989,-19.79749999999864,2202.4444444444443,28,18,17,46
2990,-26.873249999999143,2719.1666666666665,32,14,20,46
2991,1.8875000000023767,2521.722222222222,54,7,22,61
2992,-8.470749999999132,2660.1111111111113,24,8,28,32
2993,-28.60799999999835,3638.75,41,15,13,56
2994,-2.480499999998946,3273.9444444444443,39,8,18,47
2995,-20.950499999998907,3258.5,30,8,18,38
2996,2.9705000000015973,2505.777777777778,47,5,19,52
2997,-8.92024999999911,3284.65,43,8,13,51
2998,-8.470999999999405,2388.157894736842,30,6,18,36
2999,-6.4967499999984994,1598.0588235294117,32,14,12,46
3000,-15.065999999998311,3658.45,36,12,20,48
3001,-5.655999999998821,3226.8947368421054,45,13,21,58
3002,-20.19149999999932,2663.95,28,13,14,41
3003,-11.480999999998385,3455.842105263158,43,7,33,50
3004,-14.647249999998872,3932.842105263158,49,20,20,69
3005,-22.101999999999336,1960.8125,33,18,22,51
3006,-8.090999999998203,4254.421052631579,52,8,18,60
3007,-13.386999999998917,4754.4,43,11,23,54
3008,-21.71374999999904,2480.5882352941176,27,13,18,40
3009,-8.991999999997262,2310.9444444444443,48,11,18,59
3010,5.708250000001726,3046.3333333333335,45,13,20,58
3011,-36.11924999999967,2271.157894736842,13,9,25,22
3012,-36.88349999999973,1623.235294117647,11,2,24,13
3013,-6.703749999999175,2053.125,50,10,19,60
3014,8.648500000001018,2796.0588235294117,65,16,21,81
3015,-5.501249999998633,2593.5882352941176,45,13,21,58
3016,2.9627500000012517,2505.0,57,14,19,71
3017,-17.53024999999951,2914.4736842105262,43,6,19,49
3018,-30.478000000000065,2226.1666666666665,30,15,31,45
3019,-11.434249999999858,2651.2631578947367,36,11,18,47
3020,-14.544499999999136,2390.222222222222,31,15,9,46
3021,-13.68699999999831,3223.4736842105262,42,8,20,50
3022,-1.6984999999984969,4426.526315789473,56,12,21,68
3023,-12.555499999998442,4172.526315789473,47,16,24,63
3024,-16.48399999999904,2116.0555555555557,38,9,19,47
3025,-12.980499999999438,3478.4210526315787,41,2,26,43
3026,-11.571999999999779,2627.8947368421054,35,4,28,39
3027,-24.68324999999937,1969.75,29,13,28,42
3028,4.484750000001148,4325.85,47,9,15,56
3029,-5.162999999998343,3333.842105263158,42,14,22,56
3030,-9.342249999999057,1988.2941176470588,36,25,14,61
3031,-24.6492499999989,1900.5882352941176,21,13,17,34
3032,-11.652499999999362,3176.0,47,15,21,62
3033,0.19500000000078038,2505.0,49,13,15,62
3034,-17.934999999999484,1550.0625,22,11,17,33
3035,-26.94549999999948,2594.0,18,21,19,39
3036,-8.783999999999685,2377.8888888888887,43,3,24,46
3037,-2.9809999999991446,2854.1111111111113,38,22,13,60
3038,-6.913499999999199,2974.684210526316,50,10,20,60
3039,-10.353249999999068,2484.1176470588234,35,13,18,48
3040,-1.8762499999978104,3355.0,62,10,28,72
3041,-29.58974999999819,3006.315789473684,30,11,30,41
3042,-27.694750000000198,2778.277777777778,45,15,24,60
3043,-34.315250000000404,1429.0,15,11,20,26
3044,15.734750000001544,2809.0625,62,13,16,75
3045,-19.896499999999595,1429.0,17,22,11,39
3046,8.123500000000904,2669.9411764705883,48,19,24,67
3047,-23.175749999998793,2582.842105263158,31,6,22,37
3048,-0.9447499999988027,2996.9444444444443,60,20,20,80
3049,-16.69774999999873,3311.4117647058824,50,12,18,62
3050,-47.415250000000015,1429.0,0,12,19,12
3051,-10.012499999998553,2578.0555555555557,41,8,18,49
3052,-23.088499999999424,2589.4,22,10,14,32
3053,-1.212249999999019,3615.55,41,13,15,54
3054,-11.973249999999782,2723.176470588235,34,10,30,44
3055,-11.041749999998876,4743.3,45,13,22,58
3056,-49.78049999999983,1429.0,0,11,19,11
3057,-28.402249999998496,3683.8947368421054,38,7,21,45
3058,4.488250000000802,3815.55,50,9,12,59
3059,-16.503999999999653,2787.1111111111113,29,9,24,38
3060,-11.388499999998476,3455.3,39,8,22,47
3061,-6.59824999999928,3821.6315789473683,59,6,27,65
3062,-7.068499999999462,3366.4210526315787,48,11,18,59
3063,-20.05649999999881,2139.5882352941176,39,7,21,46
3064,-14.769749999998766,2311.4117647058824,42,19,12,61
3065,-9.702749999997522,2626.5625,59,6,17,65
3066,-23.633249999998323,3960.4736842105262,48,16,20,64
3067,-18.557999999998138,2426.4444444444443,29,17,24,46
3068,-2.619749999998983,2180.0,46,10,20,56
3069,-22.09400000000001,2261.176470588235,36,27,22,63
3070,-13.938499999999257,3086.9444444444443,45,21,16,66
3071,-12.902249999998606,3008.823529411765,40,26,15,66
3072,-13.155499999999126,1559.0,38,8,23,46
3073,-35.33249999999971,2234.55,14,9,20,23
3074,-20.31849999999977,2683.1111111111113,40,21,17,61
3075,-11.406749999999558,2901.0526315789475,27,16,15,43
3076,-11.40799999999907,3092.8823529411766,51,7,17,58
3077,-0.8064999999993043,4381.4,45,8,14,53
3078,9.504000000002526,4772.85,60,6,21,66
3079,-5.307249999998758,3628.7368421052633,49,11,24,60
3080,14.296000000001328,2611.133333333333,47,7,17,54
3081,-21.315249999999185,3923.45,39,11,25,50
3082,-3.1584999999975287,4673.55,65,14,13,79
3083,-23.61100000000011,3163.6111111111113,29,16,20,45
3084,-27.119499999998872,2206.8823529411766,23,13,33,36
3085,-30.207999999999277,2528.722222222222,22,16,16,38
3086,-16.795749999999764,2481.1666666666665,29,6,20,35
3087,0.5480000000012886,3231.4,42,12,15,54
3088,-24.985249999998995,2460.8947368421054,21,11,21,32
3089,-19.228499999998483,2387.9411764705883,30,12,19,42
3090,-18.233999999998847,1710.8125,29,14,17,43
3091,-9.887499999998397,1539.235294117647,21,15,22,36
3092,3.170000000002413,2928.5882352941176,59,11,23,70
3093,-15.256499999999175,3928.35,40,11,12,51
3094,6.466500000001257,2963.176470588235,45,18,20,63
3095,-28.251999999999338,2813.9,15,13,21,28
3096,-11.042499999999277,3309.3,26,21,16,47
3097,-8.423999999997726,3881.0,49,17,16,66
3098,-21.552999999999123,3552.9,30,6,15,36
3099,-10.87224999999947,2504.9444444444443,49,5,25,54
3100,22.084500000002844,1733.625,54,10,16,64
3101,-15.892249999999189,3230.2105263157896,48,12,20,60
3102,-7.500249999999378,2160.25,31,11,38,42
3103,-17.79274999999965,2544.6111111111113,35,10,23,45
3104,-8.616249999998228,2315.3333333333335,32,13,23,45
3105,3.170750000001565,2601.823529411765,48,11,16,59
3106,2.4655000000000893,3479.1052631578946,58,11,19,69
3107,-22.46274999999887,3254.4444444444443,42,18,25,60
3108,-22.97249999999955,2713.8947368421054,43,8,23,51
3109,0.9455000000029848,2814.3888888888887,51,8,28,59
3110,-5.879749999998705,4110.105263157895,63,12,20,75
3111,-16.993999999998405,2291.125,38,11,28,49
3112,-2.9659999999990765,3695.0,42,8,16,50
3113,-15.786749999999577,3064.8947368421054,31,16,18,47
3114,-35.127999999999474,2545.4444444444443,25,12,16,37
3115,-4.960749999998067,2242.5625,40,6,28,46
3116,-7.442499999998828,4769.9473684210525,62,16,19,78
3117,-13.000249999997504,2936.1666666666665,43,10,23,53
3118,-33.569999999999624,2382.2,10,12,17,22
3119,-19.64774999999769,1528.25,25,10,37,35
3120,-0.8357499999991314,3025.764705882353,68,12,18,80
3121,-5.133500000000062,2076.1176470588234,34,10,23,44
3122,-17.88774999999973,2735.235294117647,39,7,23,46
3123,-29.59099999999865,2631.777777777778,35,9,19,44
3124,8.136750000000971,4497.578947368421,55,7,17,62
3125,-21.08324999999872,2706.3684210526317,31,15,14,46
3126,-9.219999999998972,1724.6875,23,15,25,38
3127,-11.93299999999775,1894.3125,35,15,19,50
3128,8.91625000000219,2480.4117647058824,55,9,13,64
3129,-39.744499999999626,2267.7894736842104,10,15,21,25
3130,-12.968250000000097,2982.1052631578946,36,13,16,49
3131,-37.335749999999486,2144.1,10,8,25,18
3132,-25.545499999999002,2528.722222222222,30,18,15,48
3133,5.019000000001393,5202.95,56,5,21,61
3134,-7.9422499999985,3024.3333333333335,47,11,15,58
3135,-19.341749999998505,5137.85,40,11,22,51
3136,7.775000000000711,3084.6470588235293,56,17,19,73
3137,2.341750000001491,2456.875,38,10,22,48
3138,-13.7722499999998,2127.4444444444443,38,18,17,56
3139,-3.126249999997745,3475.9444444444443,57,11,15,68
3140,-7.177749999998957,3591.157894736842,45,10,23,55
3141,-1.9292499999994763,3087.777777777778,46,13,21,59
3142,-12.628249999998879,2576.5882352941176,35,15,18,50
3143,-32.42974999999939,2158.35,16,7,17,23
3144,-31.54649999999947,2392.315789473684,20,10,20,30
3145,-23.394499999999493,2538.4736842105262,25,11,22,36
3146,-28.538999999999078,2120.5,18,6,26,24
3147,-20.595499999998772,2586.0,30,16,16,46
3148,-3.2152499999984494,1974.6875,40,9,19,49
3149,-14.77224999999975,2323.222222222222,40,15,19,55
3150,-20.620249999999718,2054.125,20,11,26,31
3151,7.00825000000238,2639.1176470588234,54,11,18,65
3152,-1.0374999999992647,2756.5263157894738,45,10,19,55
3153,-0.7769999999984302,2349.705882352941,36,15,22,51
3154,-25.567749999999368,2333.9473684210525,24,10,21,34
3155,-5.381999999999808,2614.0588235294117,36,8,26,44
3156,-23.154249999998584,3743.157894736842,41,6,26,47
3157,-27.808749999999566,2871.9,19,12,22,31
3158,-14.470499999999328,3252.842105263158,43,8,20,51
3159,-34.686749999999165,1572.875,14,14,18,28
3160,-32.45474999999909,2923.5,24,8,25,32
3161,-34.82374999999931,1429.0,11,16,19,27
3162,-13.066999999999847,2775.8947368421054,23,7,31,30
3163,-10.456749999998948,2731.5555555555557,36,13,14,49
3164,-35.28925000000012,1612.5625,28,12,24,40
3165,-3.9387499999991915,2580.3529411764707,43,14,27,57
3166,-0.6272499999976662,2576.6470588235293,51,8,23,59
3167,-6.326749999998337,3687.3888888888887,56,9,25,65
3168,-25.875249999998836,2366.5882352941176,29,16,15,45
3169,-43.808000000000064,1429.0,6,15,17,21
3170,-16.712249999999532,2326.315789473684,18,16,14,34
3171,-24.59974999999836,3042.2631578947367,36,14,26,50
3172,-34.87224999999914,2104.6111111111113,14,17,21,31
3173,1.5365000000015965,2795.1176470588234,56,7,19,63
3174,-24.818749999998975,2584.9411764705883,36,18,20,54
3175,10.134500000001223,4429.95,53,11,17,64
3176,-19.697249999997958,2324.9375,50,7,23,57
3177,-10.234249999998852,3435.7368421052633,52,8,22,60
3178,-10.17349999999951,2584.4210526315787,41,9,23,50
3179,-8.416999999999774,2286.1875,55,21,18,76
3180,-5.202749999998954,3544.5555555555557,34,19,15,53
3181,-27.474999999998158,2580.315789473684,24,17,20,41
3182,-1.1764999999979047,2890.3333333333335,47,6,24,53
3183,8.501500000000293,2681.176470588235,74,12,23,86
3184,2.0455000000017334,3201.5555555555557,52,8,17,60
3185,-47.4987499999989,1548.6,22,14,22,36
3186,26.65975000000291,2374.9411764705883,67,13,28,80
3187,-1.6072499999988725,3833.4210526315787,56,11,13,67
3188,-7.500999999998141,1942.9375,44,2,28,46
3189,-8.720750000000198,1830.8125,38,11,24,49
3190,-14.513749999999002,4418.315789473684,60,10,28,70
3191,-15.451999999998131,1544.4,33,18,21,51
3192,-18.51324999999975,2706.3529411764707,47,18,16,65
3193,-19.368999999999478,1885.8333333333333,25,21,15,46
3194,8.166000000001363,3800.842105263158,51,3,20,54
3195,-7.21724999999886,3437.05,31,8,19,39
3196,-0.8759999999989606,3430.7368421052633,48,9,11,57
3197,-20.3104999999992,1845.4705882352941,27,20,20,47
3198,-5.1909999999992,3301.25,37,12,16,49
3199,-15.55349999999893,2866.0526315789475,25,14,25,39
3200,5.181750000000693,2635.4117647058824,44,10,18,54
3201,-49.245249999999906,1429.0,0,11,21,11
3202,-35.80724999999963,2170.0526315789475,19,11,29,30
3203,-29.022499999999887,1429.0,23,13,22,36
3204,-3.853749999999183,2621.6875,52,15,11,67
3205,-4.469249999998441,3870.35,52,8,21,60
3206,-29.732249999998963,2479.470588235294,35,10,23,45
3207,-11.37349999999935,3754.0526315789475,44,10,34,54
3208,-1.7767499999975516,3627.1052631578946,52,8,25,60
3209,-10.516499999998382,2644.705882352941,50,4,18,54
3210,-26.01574999999956,2683.8,22,13,15,35
3211,-26.655249999999533,3706.8,32,13,18,45
3212,-21.685499999999585,2271.1666666666665,24,7,32,31
3213,-8.302499999999274,3261.2105263157896,34,11,28,45
3214,-24.088750000000097,2151.3333333333335,24,6,43,30
3215,-10.863749999998129,3291.2631578947367,45,20,14,65
3216,-9.623249999998361,2176.1111111111113,33,16,19,49
3217,-8.765499999999598,4084.0,47,15,24,62
3218,-16.916249999998804,2814.5,35,16,23,51
3219,-9.519999999999031,4034.7368421052633,51,16,16,67
3220,-31.783999999999963,1429.0,26,16,31,42
3221,-21.806999999999146,1556.0588235294117,17,19,17,36
3222,-19.310999999998405,3123.1111111111113,36,18,22,54
3223,-5.080499999999192,2719.222222222222,33,13,14,46
3224,-22.000249999999404,3097.4736842105262,22,17,19,39
3225,-15.38974999999915,3807.7,39,12,17,51
3226,-1.4394999999991542,2231.6666666666665,38,9,13,47
3227,-19.103749999999586,2092.1666666666665,29,17,14,46
3228,-12.107999999998023,4927.5,47,18,17,65
3229,5.950750000001696,2685.823529411765,51,10,16,61
3230,-6.625749999998417,3292.8823529411766,65,12,14,77
3231,3.3770000000005718,3199.777777777778,38,8,14,46
3232,-5.1697499999975705,2412.294117647059,46,17,13,63
3233,-4.373749999998775,3964.75,36,14,14,50
3234,16.390500000001563,2405.3125,67,16,13,83
3235,-5.928249999999454,3774.35,39,14,12,53
3236,-33.2254999999994,2207.6,14,13,18,27
3237,-13.790249999999324,2662.777777777778,35,12,30,47
3238,-29.034499999999213,2672.6111111111113,26,13,15,39
3239,-14.143249999999401,3192.684210526316,29,2,41,31
3240,-15.86074999999901,4335.473684210527,47,8,22,55
3241,-7.715999999998763,3035.722222222222,38,17,13,55
3242,-7.204499999999712,2133.5625,48,14,18,62
3243,-6.4252499999987975,1514.375,38,18,31,56
3244,-18.863749999998532,3380.6,32,5,26,37
3245,-1.7529999999984152,4794.95,51,4,25,55
3246,-18.066249999999247,2842.6,19,9,26,28
3247,-15.681999999999466,2354.1111111111113,28,3,28,31
3248,3.578500000002954,3935.315789473684,62,8,17,70
3249,-12.073499999999004,2429.9444444444443,38,5,24,43
3250,-45.13550000000002,1429.0,0,11,17,11
3251,-16.893999999998623,2064.0,33,7,19,40
3252,-11.0222499999978,4134.6,55,9,21,64
3253,-39.607000000000184,2330.277777777778,11,8,51,19
3254,-35.479999999999755,2131.8333333333335,10,10,35,20
3255,-9.101249999999268,2139.3125,50,9,22,59
3256,-29.63799999999959,2486.3888888888887,24,5,25,29
3257,-19.80599999999934,3168.75,32,12,16,44
3258,-7.522749999999168,3811.6,36,3,22,39
3259,-21.759999999998826,2242.294117647059,29,9,23,38
3260,-31.260749999998986,2374.4444444444443,28,6,20,34
3261,-19.440749999999348,2678.8947368421054,24,14,22,38
3262,-8.90224999999934,3167.1666666666665,56,14,27,70
3263,-3.7107499999992277,3336.6470588235293,78,13,22,91
3264,-47.023999999998914,1429.0,12,3,35,15
3265,-3.6284999999980108,2926.9473684210525,43,13,23,56
3266,-36.75474999999937,1768.3125,24,20,12,44
3267,11.099000000002878,2886.777777777778,54,7,22,61
3268,0.9702500000005742,4714.789473684211,55,14,16,69
3269,8.55975000000281,3698.8888888888887,75,4,19,79
3270,-29.42099999999936,2861.842105263158,34,7,21,41
3271,-24.371499999999926,1634.375,27,11,24,38
3272,-11.972499999999076,2540.1111111111113,47,11,19,58
3273,-7.49999999999866,2576.5882352941176,48,16,20,64
3274,-27.21575000000042,2828.4210526315787,33,12,34,45
3275,-25.780499999999716,2623.9444444444443,23,9,27,32
3276,9.78125000000114,4647.35,58,9,15,67
3277,4.8270000000029025,4866.0,68,2,22,70
3278,-1.470749999999026,3927.45,40,18,16,58
3279,12.717750000002521,2727.8823529411766,66,7,34,73
3280,-10.87049999999821,2985.5,43,8,18,51
3281,-3.109249999999057,4313.0,41,14,19,55
3282,-22.2647499999986,2727.1111111111113,30,5,31,35
3283,-27.27275000000022,2152.25,48,18,30,66
3284,-21.743749999998947,3971.95,37,19,20,56
3285,14.156750000002706,5277.5,60,8,23,68
3286,-12.586499999999376,3131.6315789473683,47,10,15,57
3287,-18.21774999999877,5112.35,51,15,14,66
3288,-28.352499999999083,3255.3,30,13,22,43
3289,-25.674499999999313,2870.0,45,11,22,56
3290,-6.341499999999917,2473.75,55,26,14,81
3291,-18.407999999997852,3441.6315789473683,44,13,20,57
3292,-22.733749999999077,2865.9473684210525,30,15,18,45
3293,-3.2324999999977906,2975.777777777778,48,6,20,54
3294,-12.603999999997963,2670.823529411765,43,12,21,55
3295,23.14300000000353,3325.8333333333335,72,9,14,81
3296,-15.213249999999935,2595.8333333333335,38,14,19,52
3297,-13.93074999999931,3185.2105263157896,42,11,29,53
3298,-3.714499999999032,2881.0526315789475,28,13,19,41
3299,21.07775000000177,3012.6470588235293,64,16,13,80
3300,-17.195999999998897,4084.6,44,9,16,53
3301,-8.17724999999853,4228.944444444444,75,14,14,89
3302,-12.976999999999057,2266.705882352941,36,13,12,49
3303,-21.59599999999904,2667.2,28,6,25,34
3304,-30.21274999999884,1631.6470588235295,18,17,23,35
3305,-16.743749999998357,2282.4117647058824,36,9,25,45
3306,-24.970249999998813,3724.35,35,9,19,44
3307,-7.298749999999167,3108.9444444444443,43,16,15,59
3308,-7.733499999998304,3534.3684210526317,48,13,30,61
3309,-16.172749999999947,1761.4705882352941,26,20,16,46
3310,-12.07899999999963,2258.8333333333335,33,11,16,44
3311,-19.692499999999576,3288.55,32,8,16,40
3312,-7.526249999999128,1835.8125,33,16,28,49
3313,0.6720000000012021,2412.3125,36,15,16,51
3314,-30.947749999998955,2566.9473684210525,21,8,28,29
3315,-15.546749999998946,3390.2,34,7,22,41
3316,-8.431749999997919,2714.823529411765,45,5,29,50
3317,-14.206749999998575,3091.3333333333335,46,10,17,56
3318,-31.062749999999415,1724.1176470588234,15,10,26,25
3319,-17.44024999999955,3504.45,32,16,17,48
3320,-1.4304999999979586,2564.8888888888887,38,13,20,51
3321,1.450000000002058,4373.5,57,15,14,72
3322,-25.810499999998903,2508.5,21,13,20,34
3323,-15.945249999999339,3392.315789473684,43,7,9,50
3324,-18.332999999998968,3117.4736842105262,33,11,19,44
3325,-24.87349999999993,2156.842105263158,22,16,16,38
3326,0.5025000000016242,4886.2,55,7,27,62
3327,-9.053249999998497,2940.5,40,20,25,60
3328,-20.815249999999267,2929.05,21,6,24,27
3329,2.2730000000013737,2651.1111111111113,41,18,16,59
3330,15.302250000001825,5456.75,78,10,20,88
3331,-16.961999999999883,2274.722222222222,33,13,21,46
3332,-4.85924999999901,2148.0,37,2,29,39
3333,1.321500000001254,3657.65,40,17,18,57
3334,-2.1579999999997304,3485.9473684210525,57,6,30,63
3335,-22.351999999998718,2072.777777777778,21,12,19,33
3336,-23.60049999999878,2668.222222222222,25,4,32,29
3337,-22.343749999999247,2353.470588235294,36,12,12,48
3338,0.3500000000017735,2787.1666666666665,47,9,18,56
3339,-17.95724999999913,3075.15,26,15,17,41
3340,-11.208749999998343,3246.5,35,27,25,62
3341,-29.661750000000552,1429.0,32,15,21,47
3342,-20.96474999999916,2548.1,23,14,13,37
3343,-5.671499999998589,2130.1111111111113,28,16,21,44
3344,0.15550000000039405,2942.7368421052633,37,9,26,46
3345,-31.745749999998726,2879.95,32,7,18,39
3346,12.260000000001085,3341.722222222222,55,12,24,67
3347,-32.44149999999955,2195.3888888888887,23,4,38,27
3348,-13.879749999999149,3269.4117647058824,50,12,16,62
3349,-16.662499999999007,3079.9,27,10,20,37
3350,-2.5904999999988587,2941.5,65,10,21,75
3351,0.5977500000020084,3088.722222222222,42,4,31,46
3352,-4.254249999997746,2488.823529411765,49,7,21,56
3353,-3.474249999998372,2726.823529411765,40,15,15,55
3354,-21.52399999999906,2547.5882352941176,38,12,28,50
3355,-19.09124999999886,2758.8333333333335,26,9,31,35
3356,-6.518499999996941,3263.277777777778,56,16,22,72
3357,-31.136499999999465,2913.1666666666665,51,17,28,68
3358,-19.402249999998723,2064.0,36,8,24,44
3359,-30.033999999999327,2165.65,12,14,21,26
3360,-6.489999999999465,3681.2631578947367,51,8,22,59
3361,-10.331499999998119,4128.25,33,8,32,41
3362,-30.251249999999402,2713.2,22,10,28,32
3363,-10.125749999999044,4390.9,53,12,18,65
3364,-6.37224999999953,2248.8823529411766,35,16,12,51
3365,-6.010999999998372,2805.8947368421054,34,8,26,42
3366,-4.790999999998055,3023.8947368421054,38,7,26,45
3367,-33.7662499999988,2736.8333333333335,43,13,33,56
3368,-5.600999999998255,1528.25,36,16,14,52
3369,-5.295499999998229,5127.6,59,10,24,69
3370,-13.523249999999546,1769.3125,17,17,14,34
3371,-17.51399999999876,3772.0,45,11,18,56
3372,-5.382999999998757,4417.368421052632,75,2,26,77
3373,-25.929749999998755,3681.4,29,14,31,43
3374,-25.460749999999504,1481.9333333333334,32,12,20,44
3375,-12.020999999999301,2449.3888888888887,31,7,34,38
3376,-29.42149999999875,2512.6315789473683,22,6,27,28
3377,-3.703749999999245,2677.3529411764707,53,10,26,63
3378,-4.902999999998131,2325.875,61,11,19,72
3379,-14.18049999999829,3227.5,36,12,23,48
3380,-2.305999999997033,4072.3684210526317,61,8,21,69
3381,-19.268000000000157,3117.4736842105262,44,13,19,57
3382,-32.52599999999993,2072.3684210526317,16,12,30,28
3383,-49.44549999999951,2494.2105263157896,13,22,24,35
3384,-27.450249999998228,2511.176470588235,33,8,40,41
3385,-8.287249999998158,3901.0526315789475,49,10,20,59
3386,-0.6002499999978819,3458.277777777778,53,18,17,71
3387,-8.536499999998892,3831.7368421052633,39,12,28,51
3388,-4.312249999999058,2908.0,50,13,19,63
3389,-9.706999999998413,3221.8888888888887,47,9,15,56
3390,-1.577499999998699,2403.823529411765,37,3,20,40
3391,-3.2644999999987148,2517.823529411765,41,10,20,51
3392,-3.7264999999993877,2242.9444444444443,52,15,17,67
3393,7.548750000001303,3017.277777777778,45,7,16,52
3394,-23.767749999999452,2512.8333333333335,34,8,23,42
3395,-7.6914999999985225,3272.842105263158,38,17,13,55
3396,-26.140499999998458,2730.6315789473683,24,12,29,36
3397,-5.048999999997916,2110.6470588235293,39,9,24,48
3398,-18.64124999999895,3233.85,33,8,23,41
3399,-31.40824999999962,2206.0,13,8,21,21
3400,-33.77974999999929,2195.4444444444443,22,13,27,35
3401,-16.293249999998093,1969.6875,48,5,34,53
3402,-26.943749999997124,1892.1764705882354,32,9,44,41
3403,-12.078999999999159,2854.0555555555557,26,15,40,41
3404,4.397500000001341,2341.235294117647,59,13,22,72
3405,-23.795499999999326,1949.3333333333333,15,15,27,30
3406,-40.12224999999998,1901.7222222222222,10,8,29,18
3407,-36.09524999999951,2295.0,17,7,25,24
3408,-21.189999999998044,3433.2631578947367,47,9,21,56
3409,-14.598749999998628,3131.5,38,7,19,45
3410,-15.779499999999683,1621.5,31,13,24,44
3411,-12.632249999999175,2354.1666666666665,25,13,20,38
3412,-42.49974999999933,2263.5789473684213,17,12,28,29
3413,-4.52499999999923,2517.705882352941,32,12,17,44
3414,-33.52624999999914,2608.45,20,7,21,27
3415,-17.44649999999897,2414.8947368421054,22,6,27,28
3416,-18.052249999998782,3528.3684210526317,44,16,17,60
3417,24.67750000000308,3914.222222222222,65,0,27,65
3418,-16.75099999999905,2786.6470588235293,43,9,18,52
3419,-28.59074999999954,2636.315789473684,31,11,27,42
3420,-15.771249999998549,3058.5,31,16,13,47
3421,-4.579999999998387,2112.5,51,20,22,71
3422,-21.62824999999914,2052.5,35,11,20,46
3423,-25.85674999999897,2806.0,23,7,25,30
3424,-7.448499999998707,3321.2,41,5,25,46
3425,-9.24299999999779,2826.777777777778,49,14,16,63
3426,-17.99374999999947,2280.6470588235293,39,16,21,55
3427,-30.87824999999982,2373.9473684210525,11,20,20,31
3428,-7.829999999999103,4701.2,50,19,21,69
3429,-11.125249999999786,2282.470588235294,33,15,20,48
3430,-11.752249999998805,3022.8823529411766,46,12,17,58
3431,1.6212500000015388,2553.235294117647,41,8,22,49
3432,-35.20649999999895,3182.95,22,8,27,30
3433,-5.8294999999998405,2697.8823529411766,68,11,13,79
3434,-0.6164999999980292,2623.1666666666665,41,14,18,55
3435,-15.280249999999313,3008.5,27,3,20,30
3436,-19.244499999998986,2977.0526315789475,30,13,17,43
3437,-22.333999999999072,2731.4210526315787,27,7,26,34
3438,-12.535499999997153,4901.3,49,13,21,62
3439,-5.069249999998181,2659.705882352941,37,12,27,49
3440,-21.38749999999795,1849.6875,39,5,24,44
3441,-13.20424999999916,2064.0588235294117,47,7,25,54
3442,-11.169499999998317,3587.9,45,7,21,52
3443,6.66650000000201,4636.368421052632,73,2,27,75
3444,-2.272499999997863,2332.8823529411766,56,18,18,74
3445,11.127000000003196,2657.764705882353,66,17,13,83
3446,-10.175499999998411,4972.0,59,10,16,69
3447,13.31575000000169,4235.4,56,12,16,68
3448,-12.952249999999173,3275.4210526315787,41,7,24,48
3449,-37.94024999999933,1429.0,23,13,22,36
3450,-40.46224999999947,2102.777777777778,12,9,46,21
3451,-3.9219999999988104,2877.9444444444443,44,7,19,51
3452,12.065500000001116,3528.722222222222,83,4,21,87
3453,-9.670999999998909,2620.4210526315787,26,13,18,39
3454,-9.803749999999727,2116.5625,40,11,27,51
3455,-10.70599999999977,2716.4444444444443,46,12,15,58
3456,-41.904249999999955,1429.0,6,12,34,18
3457,14.322000000002067,4227.55,62,8,16,70
3458,-33.99874999999905,2564.3684210526317,21,12,26,33
3459,-29.239499999999175,2429.1666666666665,19,5,29,24
3460,18.32125000000077,3675.1111111111113,63,16,17,79
3461,-22.28774999999866,3106.85,26,15,21,41
3462,-16.122999999999006,2741.75,27,13,19,40
3463,-11.483749999998237,4431.45,43,13,16,56
3464,-5.371499999998247,3148.5555555555557,55,15,17,70
3465,-24.60849999999907,2845.7,22,5,27,27
3466,-22.018749999998768,2260.5,27,7,29,34
3467,-18.70624999999893,2719.470588235294,34,10,25,44
3468,-4.933249999998838,3363.1052631578946,35,6,27,41
3469,-17.49624999999869,1898.25,36,14,21,50
3470,-0.5269999999986295,2349.705882352941,48,15,19,63
3471,6.686000000001757,3189.3684210526317,43,10,19,53
3472,-6.781499999999919,2619.5,49,12,18,61
3473,-0.1849999999985837,3560.4444444444443,56,16,18,72
3474,-17.527749999999507,2636.2105263157896,23,10,23,33
3475,-10.127249999998483,4328.0,61,13,28,74
3476,6.350250000002033,2358.6875,52,4,22,56
3477,-10.424499999998597,3190.0526315789475,25,7,31,32
3478,-22.42499999999938,2528.6666666666665,34,21,17,55
3479,-13.247499999999528,2041.5294117647059,50,11,30,61
3480,-19.423499999999343,2576.3333333333335,42,4,20,46
3481,-21.20899999999945,2983.6470588235293,54,13,18,67
3482,-20.2027499999991,1996.4375,37,8,26,45
3483,-3.8787499999988833,2487.625,42,14,12,56
3484,-11.816249999999764,3034.7894736842104,31,4,23,35
3485,9.850000000002257,2296.125,51,9,23,60
3486,0.2372500000013611,4713.95,56,20,13,76
3487,-29.766249999999427,2451.7368421052633,22,12,15,34
3488,14.861500000002422,4087.8333333333335,66,12,15,78
3489,-13.745999999998949,3221.8947368421054,51,8,25,59
3490,7.266750000001162,3707.2105263157896,52,9,17,61
3491,-5.536499999999287,2663.4117647058824,58,11,21,69
3492,-4.34274999999873,4870.4,54,11,17,65
3493,-8.01799999999842,4226.0526315789475,61,16,18,77
3494,-18.21099999999912,3849.85,43,11,18,54
3495,-15.698749999999169,2743.0,29,12,24,41
3496,-25.07324999999947,2531.1052631578946,24,7,27,31
3497,-11.299499999998172,2702.6470588235293,45,14,25,59
3498,-32.26124999999962,2551.842105263158,19,15,17,34
3499,-8.812499999997696,1988.3529411764705,47,7,23,54
3500,-7.368249999999193,1925.0625,49,15,22,64
3501,-20.75999999999914,2247.3888888888887,25,10,22,35
3502,-21.729249999999247,2018.3529411764705,18,14,18,32
3503,-16.873749999997464,2620.5555555555557,41,4,30,45
3504,-18.67299999999904,2457.277777777778,32,12,18,44
3505,-2.605499999998441,3064.1176470588234,55,9,20,64
3506,-11.587749999998053,4421.1,54,6,22,60
3507,-39.259249999999454,2184.3684210526317,15,12,19,27
3508,-38.25674999999999,2028.7222222222222,24,7,30,31
3509,2.439250000001505,2398.3125,42,11,21,53
3510,-2.7507499999990404,3939.5263157894738,47,11,14,58
3511,-7.75099999999901,2880.5555555555557,49,11,18,60
3512,8.035750000002146,3694.235294117647,74,4,23,78
3513,5.240250000002021,4449.7,55,10,16,65
3514,-5.6482499999990186,4267.0,67,17,21,84
3515,-28.170999999998685,2661.3684210526317,23,14,24,37
3516,-6.6729999999976926,4321.315789473684,60,18,14,78
3517,6.676500000001471,4094.2,51,12,21,63
3518,-28.743249999999545,2401.8333333333335,26,5,24,31
3519,-15.699999999997582,4528.2,48,14,17,62
3520,-13.650249999998945,2698.9444444444443,45,12,18,57
3521,-10.314499999999791,3335.5263157894738,43,10,13,53
3522,-24.685749999999693,1997.2105263157894,13,9,30,22
3523,-27.0989999999989,3312.9473684210525,30,5,39,35
3524,1.9365000000018682,2732.470588235294,48,6,17,54
3525,-22.290249999999226,2975.5263157894738,24,20,15,44
3526,-0.10599999999925877,3404.0526315789475,42,8,17,50
3527,-29.364749999999,1614.8823529411766,13,8,29,21
3528,-24.85024999999984,2696.4210526315787,23,11,25,34
3529,-15.71799999999898,3712.45,40,9,13,49
3530,-10.246499999998298,2607.0526315789475,25,2,37,27
3531,-10.913749999999775,3100.684210526316,56,14,25,70
3532,-32.47325000000057,1429.0,26,10,20,36
3533,-29.04799999999947,2257.9444444444443,34,5,31,39
3534,-12.643249999999204,3300.55,32,4,23,36
3535,2.5675000000005204,4405.578947368421,73,5,27,78
3536,-17.311999999998825,2565.2105263157896,22,5,29,27
3537,-22.178249999998638,3178.3,29,12,20,41
3538,-9.936499999999524,1904.2941176470588,36,10,26,46
3539,-14.755249999999162,3914.05,33,8,21,41
3540,-30.457749999998946,3710.684210526316,43,5,23,48
3541,-10.507499999998831,2004.5,34,14,12,48
3542,-21.076999999998485,2255.3333333333335,25,9,28,34
3543,-13.681749999999408,2810.0555555555557,34,12,18,46
3544,-21.353749999999494,1635.4117647058824,26,5,36,31
3545,12.73975000000251,2212.8125,55,6,25,61
3546,-16.829749999999656,1992.0588235294117,27,11,30,38
3547,-26.27274999999917,2387.0588235294117,31,12,18,43
3548,-12.229499999997614,4350.45,64,7,17,71
3549,-9.981749999999842,2609.4736842105262,43,10,34,53
3550,-17.167249999999235,2622.842105263158,39,12,22,51
3551,16.380750000001676,2854.0555555555557,57,13,22,70
3552,-7.379249999997339,3347.2105263157896,50,10,21,60
3553,-21.615249999998756,3129.1052631578946,30,6,28,36
3554,-28.15674999999901,2163.6111111111113,20,11,22,31
3555,-22.82999999999838,2072.777777777778,30,7,23,37
3556,-20.0102499999993,2695.75,27,8,20,35
3557,-34.67874999999906,2913.6315789473683,21,7,30,28
3558,-17.235999999998576,4310.0,43,6,23,49
3559,-6.836249999998617,3512.8333333333335,37,14,31,51
3560,-15.025999999998541,3392.2631578947367,36,10,24,46
3561,-25.831499999999078,2134.6111111111113,20,7,25,27
3562,-23.09399999999935,3228.6315789473683,33,11,25,44
3563,2.790500000002475,3223.6111111111113,55,12,14,67
3564,-16.039000000000307,2119.1176470588234,24,16,25,40
3565,-19.78974999999895,2707.235294117647,53,4,35,57
3566,-29.835749999999972,1737.5625,27,9,23,36
3567,-29.55624999999954,2108.222222222222,27,8,36,35
3568,9.275250000002544,4925.1,52,11,22,63
3569,5.099250000001323,3473.222222222222,50,16,19,66
3570,-31.45424999999907,2718.0526315789475,20,9,27,29
3571,22.67600000000079,3294.1111111111113,65,20,15,85
3572,8.04625000000176,4410.736842105263,66,12,22,78
3573,-19.40899999999963,1481.9333333333334,25,10,23,35
3574,-25.458499999998658,3313.7368421052633,39,2,28,41
3575,-4.4284999999997225,3489.0555555555557,40,8,29,48
3576,-22.212499999999263,2532.6315789473683,22,17,20,39
3577,-31.224249999999273,2997.1052631578946,37,9,23,46
3578,-24.159499999999912,1429.0,8,13,20,21
3579,-18.871999999999645,2149.5,36,13,21,49
3580,6.776500000001808,3185.4117647058824,60,10,16,70
3581,-26.42374999999887,1534.8666666666666,35,6,26,41
3582,-27.735249999999525,2071.9375,31,13,42,44
3583,-32.12924999999901,2815.8947368421054,33,8,22,41
3584,-8.424749999999431,2947.8947368421054,39,10,19,49
3585,1.2922500000044423,1787.25,46,12,38,58
3586,9.739500000001083,3365.5555555555557,60,8,20,68
3587,-26.483249999999607,2219.277777777778,30,17,18,47
3588,-5.628249999998472,2783.5555555555557,41,11,20,52
3589,-12.471499999999487,2814.4444444444443,30,22,16,52
3590,-18.313499999999728,3495.0,33,12,26,45
3591,-10.60074999999823,3327.157894736842,45,9,23,54
3592,-8.46099999999922,3208.6111111111113,42,11,16,53
3593,-10.906999999998648,2594.3529411764707,34,10,22,44
3594,-19.56349999999826,2815.0526315789475,34,5,26,39
3595,-7.671999999999484,3555.1111111111113,39,3,30,42
3596,-7.876749999998944,3053.157894736842,36,9,17,45
3597,-43.357499999999796,1702.6470588235295,9,11,38,20
3598,-33.72124999999947,2552.1,19,9,20,28
3599,-2.541749999998308,5378.25,67,13,25,80
3600,-18.015249999999224,3890.2631578947367,49,10,16,59
3601,2.1820000000011626,3658.842105263158,55,8,19,63
3602,12.403500000002689,5254.5,78,8,16,86
3603,14.273750000001565,3643.764705882353,57,14,15,71
3604,-5.392249999998008,4021.95,51,10,24,61
3605,-15.749499999998472,1673.7058823529412,30,9,31,39
3606,1.0540000000012582,3352.3333333333335,57,6,33,63
3607,-4.33249999999928,2318.0,40,12,31,52
3608,-11.044749999999475,2492.5882352941176,38,4,22,42
3609,-19.1319999999992,2593.684210526316,24,12,22,36
3610,2.677500000000791,4281.45,50,7,19,57
3611,-20.41999999999977,2230.2631578947367,47,12,22,59
3612,-10.125999999999586,1963.1176470588234,32,10,28,42
3613,-18.284499999999575,1618.5882352941176,33,17,23,50
3614,-38.34674999999946,1576.875,8,6,28,14
3615,-3.664999999999446,2179.0,60,15,21,75
3616,-0.6399999999962459,2349.6875,65,6,27,71
3617,5.080250000001,3250.9444444444443,67,11,27,78
3618,-20.746999999999073,3263.15,25,6,28,31
3619,-11.915499999999044,3331.315789473684,39,20,22,59
3620,4.671500000001144,3702.9,36,5,25,41
3621,-9.716249999998393,2309.9375,42,13,20,55
3622,-35.51699999999953,1481.9333333333334,18,13,19,31
3623,-14.029749999997879,3324.684210526316,43,4,25,47
3624,-6.544249999999079,4698.85,41,15,25,56
3625,-2.4947499999997484,2720.235294117647,55,21,7,76
3626,-7.3909999999981535,2130.4375,50,13,24,63
3627,-3.53874999999774,4509.3,57,6,16,63
3628,-25.921249999998196,1787.25,28,5,32,33
3629,-11.575249999999007,1772.25,35,19,20,54
3630,-5.600249999998257,2612.0,46,15,19,61
3631,-31.16624999999945,1630.4375,19,7,25,26
3632,-5.860999999998418,4398.9,56,10,22,66
3633,-5.9804999999987345,2957.3888888888887,49,5,20,54
3634,-17.280999999999445,2282.470588235294,62,11,21,73
3635,-13.928249999998053,3733.9473684210525,56,10,33,66
3636,-36.61899999999934,1528.25,10,10,24,20
3637,-23.291749999998387,2341.294117647059,34,16,23,50
3638,-26.2344999999985,2670.5789473684213,23,3,31,26
3639,-16.46074999999859,2672.6666666666665,32,3,29,35
3640,-28.442749999999002,2708.45,19,10,22,29
3641,-6.722749999996106,1724.6875,56,14,22,70
3642,-40.00049999999941,2292.65,11,8,29,19
3643,-0.24549999999994396,2375.5625,62,12,20,74
3644,2.904250000001371,2744.5,61,17,15,78
3645,-39.51324999999952,1933.6315789473683,12,14,17,26
3646,-7.302749999999226,3538.5263157894738,47,19,16,66
3647,-7.9682499999976555,2529.8823529411766,46,13,20,59
3648,0.39175000000290056,3022.4444444444443,55,8,18,63
3649,-12.056249999998865,2385.294117647059,36,9,17,45
3650,8.111750000001239,2291.125,44,16,24,60
3651,-18.571249999999356,1660.5882352941176,24,12,22,36
3652,-11.634249999998012,3306.4444444444443,32,9,48,41
3653,-22.11799999999954,1973.6875,27,12,22,39
3654,-24.438749999999036,2505.0526315789475,23,10,21,33
3655,-12.260499999999329,2917.722222222222,45,8,16,53
3656,-25.03599999999988,2810.0,39,12,26,51
3657,-15.267999999999262,3292.9473684210525,57,4,27,61
3658,9.088750000000896,2987.222222222222,56,13,24,69
3659,-15.65299999999888,2760.684210526316,31,16,15,47
3660,-23.94599999999899,3146.0,39,10,29,49
3661,-0.23849999999940916,4875.1,45,6,26,51
3662,-38.96799999999942,2669.5789473684213,24,11,22,35
3663,-44.752749999999445,1628.388888888889,0,12,25,12
3664,12.599750000001183,2425.125,53,6,14,59
3665,-21.410999999999184,3883.5789473684213,41,9,23,50
3666,-21.15949999999922,3393.35,32,3,20,35
3667,-18.15499999999797,3545.2105263157896,39,13,27,52
3668,-21.236249999998986,3185.1052631578946,33,6,35,39
3669,11.876250000001901,3474.9444444444443,62,12,21,74
3670,-25.68174999999975,2115.1666666666665,20,9,35,29
3671,-12.803499999997651,2635.3529411764707,43,17,25,60
3672,-25.928249999998382,2908.777777777778,33,11,25,44
3673,-4.0292499999999825,2750.9444444444443,37,4,29,41
3674,-19.21799999999923,2786.1111111111113,31,6,24,37
3675,-24.960499999999605,1866.5625,26,6,33,32
3676,-35.52574999999983,2106.75,8,23,14,31
3677,-16.53599999999918,3203.277777777778,38,8,19,46
3678,-17.713999999999647,2695.4444444444443,30,8,35,38
3679,1.5842500000014845,2559.764705882353,57,16,36,73
3680,-18.983499999997967,2396.470588235294,25,9,32,34
3681,-16.16024999999931,2018.3125,38,6,30,44
3682,-31.43199999999926,2404.45,15,8,26,23
3683,7.209250000001862,2166.125,60,8,13,68
3684,17.0222500000011,2526.176470588235,71,4,18,75
3685,-2.9957499999992105,2417.823529411765,46,7,33,53
3686,2.337000000000347,3605.4210526315787,40,12,20,52
3687,-16.260499999998707,3094.25,34,4,23,38
3688,-23.77649999999939,3292.157894736842,35,10,36,45
3689,2.7247500000016673,3962.9473684210525,54,9,21,63
3690,-22.527999999998933,4007.65,40,6,20,46
3691,-2.49149999999864,3621.2631578947367,58,5,25,63
3692,-23.48824999999922,3299.684210526316,36,9,21,45
3693,5.0990000000011655,4281.263157894737,61,5,22,66
3694,-34.80174999999957,2105.3888888888887,25,16,31,41
3695,-4.783999999998693,2350.5,19,12,32,31
3696,-29.007499999999304,1481.9333333333334,22,14,20,36
3697,1.3392500000010794,2157.1875,50,14,23,64
3698,-18.791249999999174,2452.4736842105262,24,12,15,36
3699,-6.042999999998065,2022.8823529411766,46,17,24,63
3700,-35.509999999999636,2279.5263157894738,12,9,32,21
3701,-14.36724999999906,2921.8947368421054,28,6,29,34
3702,-26.2057499999999,1429.0,27,12,25,39
3703,-4.324999999998213,3714.75,49,12,14,61
3704,-26.85424999999865,3084.1666666666665,31,8,31,39
3705,11.955500000001232,3788.315789473684,46,8,25,54
3706,1.158250000000444,3663.15,35,16,13,51
3707,-16.304499999999084,2278.764705882353,32,9,17,41
3708,-21.317499999999797,2076.277777777778,23,15,17,38
3709,-24.54824999999881,1608.625,23,7,20,30
3710,-5.246499999998011,2850.9473684210525,44,1,27,45
3711,-24.645249999999475,2666.2631578947367,27,8,23,35
3712,-16.799749999998806,2586.25,27,16,17,43
3713,-11.957499999998934,3198.9444444444443,51,11,23,62
3714,-11.647249999999733,2244.5625,44,10,14,54
3715,-26.643499999999182,2155.1052631578946,17,10,24,27
3716,10.776500000001409,2416.125,61,0,24,61
3717,-31.765499999999793,2548.1111111111113,18,22,19,40
3718,4.9167500000011755,4155.105263157895,51,11,19,62
3719,12.351250000003278,3828.4210526315787,60,9,24,69
3720,-24.627999999999087,3759.95,27,11,27,38
3721,-35.72524999999983,1921.1176470588234,16,3,37,19
3722,-4.531999999998497,4579.05,56,18,25,74
3723,-19.884749999999077,2572.75,24,8,19,32
3724,-47.757499999998586,2009.388888888889,11,12,32,23
3725,-26.192499999999267,1501.0,33,10,19,43
3726,2.799000000001242,3598.5789473684213,47,24,15,71
3727,-20.26074999999967,2084.0526315789475,16,12,14,28
3728,13.560500000001841,3177.777777777778,49,11,19,60
3729,-9.568749999999266,3014.470588235294,45,10,19,55
3730,-22.652999999999615,2421.4736842105262,23,6,25,29
3731,7.084750000001385,4174.263157894737,48,5,18,53
3732,-23.000499999999874,1429.0,2,15,28,17
3733,-0.6752499999982777,4330.0,47,2,24,49
3734,6.364500000001804,3753.3684210526317,46,3,23,49
3735,-19.28474999999967,2793.2105263157896,26,8,20,34
3736,6.729000000000776,1889.375,47,17,20,64
3737,-9.986749999998812,2449.3888888888887,36,12,23,48
3738,-4.592999999998865,2576.3333333333335,46,9,19,55
3739,-33.915999999999535,2146.684210526316,16,18,19,34
3740,-13.037000000000083,2794.1666666666665,47,18,19,65
3741,-35.870249999998904,3306.85,20,4,29,24
3742,-13.968749999998192,3216.1052631578946,39,7,22,46
3743,-7.387999999999143,2548.470588235294,40,14,11,54
3744,-12.452749999998865,2357.777777777778,31,13,20,44
3745,11.070000000002107,4765.7,58,6,20,64
3746,13.958250000001211,4681.315789473684,58,9,22,67
3747,-26.786499999999773,2285.277777777778,18,12,20,30
3748,-26.012999999999693,1887.5294117647059,28,13,20,41
3749,-10.419999999997422,2564.8888888888887,48,6,22,54
3750,-24.596249999998797,2475.1052631578946,30,11,17,41
3751,-19.82599999999855,3112.4210526315787,31,9,29,40
3752,-5.02599999999942,2734.1052631578946,38,14,17,52
3753,10.84425000000315,3283.6111111111113,67,5,21,72
3754,-3.4269999999989684,2398.375,39,17,18,56
3755,-5.968749999997987,3049.0,46,8,21,54
3756,-15.707749999999507,2833.8333333333335,31,7,22,38
3757,-19.036249999999548,3012.2105263157896,55,7,18,62
3758,-25.07799999999968,2063.0555555555557,16,9,22,25
3759,-2.8669999999982507,2694.294117647059,51,13,30,64
3760,0.9777500000016233,2648.529411764706,41,8,23,49
3761,-23.839749999999405,2064.0,27,8,21,35
3762,9.045250000002957,1534.8666666666666,59,12,17,71
3763,-8.527749999997877,5124.25,61,25,23,86
3764,-12.674249999999665,2731.45,24,13,19,37
3765,-11.885499999998625,3100.7894736842104,38,10,20,48
3766,-40.035499999999736,2458.45,9,12,25,21
3767,-25.86899999999917,1710.75,23,8,28,31
3768,-0.13424999999986725,3124.0,51,4,22,55
3769,-6.066250000000246,2134.375,56,8,35,64
3770,-8.367249999999427,3728.3,31,17,13,48
3771,11.795500000001216,4108.055555555556,73,12,17,85
3772,-17.217749999998706,3052.05,29,12,18,41
3773,-2.112749999999005,2697.9411764705883,49,11,19,60
3774,-10.047999999999057,3131.8888888888887,43,16,29,59
3775,-22.391499999998693,2872.6666666666665,32,6,32,38
3776,-9.445999999998662,4045.65,42,12,28,54
3777,-6.0322499999992365,3034.7368421052633,48,11,23,59
3778,-3.710249999997658,2261.9411764705883,42,3,27,45
3779,-8.257999999998894,3238.5263157894738,41,10,18,51
3780,6.700750000002148,2628.3888888888887,53,6,16,59
3781,-0.8885000000004121,1902.25,48,30,11,78
3782,-27.164249999999118,2305.6111111111113,25,13,18,38
3783,-5.146999999999543,2917.722222222222,46,15,18,61
3784,-12.993999999998314,3857.7,42,8,25,50
3785,-8.332499999997223,2774.6470588235293,55,11,12,66
3786,-18.85099999999904,1971.4705882352941,24,10,22,34
3787,-9.904499999999654,1567.9375,34,12,19,46
3788,-41.68974999999921,2072.777777777778,14,9,24,23
3789,5.804000000000611,2790.6111111111113,40,5,37,45
3790,4.604250000001974,4516.5,56,4,20,60
3791,-33.561499999999796,2846.7894736842104,21,8,44,29
3792,4.703000000000882,2677.4117647058824,47,15,23,62
3793,-22.339499999998953,3000.4210526315787,28,17,22,45
3794,-10.981999999998308,1564.0,32,8,23,40
3795,-18.70224999999943,3005.5263157894738,31,10,19,41
3796,-7.307999999999541,3004.9444444444443,36,7,27,43
3797,-5.10774999999961,1429.0,31,11,24,42
3798,-21.103749999999767,1974.75,36,14,23,50
3799,-22.347749999999802,1974.578947368421,26,20,15,46
3800,-2.604249999998272,3337.157894736842,47,11,17,58
3801,-10.254499999999512,1875.3529411764705,22,13,14,35
3802,-23.8644999999992,1996.7058823529412,26,6,23,32
3803,-1.1879999999975457,4151.736842105263,57,2,25,59
3804,-12.101749999998631,1764.375,49,14,24,63
3805,-12.679499999999662,2552.294117647059,43,15,25,58
3806,-18.267749999999545,1520.0666666666666,41,7,25,48
3807,-15.13549999999854,1585.75,32,12,32,44
3808,-14.858999999999076,3143.35,35,6,22,41
3809,-13.864749999999276,2714.0,31,9,21,40
3810,-2.68274999999946,3632.0526315789475,50,12,12,62
3811,-26.530999999998688,3425.85,34,3,31,37
3812,-26.48324999999993,1476.6,33,8,21,41
3813,2.3895000000012905,3726.5789473684213,65,8,20,73
3814,21.617750000001713,3444.9444444444443,53,8,26,61
3815,3.8112500000027536,5369.6,65,10,16,75
3816,-11.750999999999573,2207.764705882353,31,12,20,43
3817,-1.6544999999986216,3538.5263157894738,54,5,20,59
3818,-29.448999999999927,2148.6111111111113,29,4,28,33
3819,-25.981749999999543,2425.5555555555557,26,8,24,34
3820,-12.461749999999558,2989.0,66,19,12,85
3821,-13.831249999999116,3747.3684210526317,46,6,27,52
3822,-27.802749999999435,1997.157894736842,14,21,25,35
3823,-7.6039999999993,2987.0,32,8,21,40
3824,-15.32399999999834,2435.6470588235293,36,6,26,42
3825,21.505500000001682,2869.5625,82,10,21,92
3826,-40.53049999999912,2147.8888888888887,30,9,34,39
3827,-10.891999999997427,4160.0526315789475,55,9,16,64
3828,5.49675000000151,2293.6470588235293,50,10,25,60
3829,-33.95175000000032,1429.0,29,8,24,37
3830,1.5532500000012663,4113.15,40,8,26,48
3831,-16.542499999998885,2723.6666666666665,29,14,19,43
3832,-14.776749999999065,4027.5,43,4,18,47
3833,-25.465999999999283,3094.85,25,19,15,44
3834,-10.74674999999778,2147.9411764705883,31,5,39,36
3835,-7.45749999999892,4410.8421052631575,54,10,29,64
3836,-17.957749999998363,3659.2,31,15,27,46
3837,-1.5239999999987182,3717.2631578947367,43,21,18,64
3838,-29.986999999999945,2192.684210526316,15,10,40,25
3839,-13.526999999998868,2881.0526315789475,29,10,26,39
3840,4.134250000002336,4721.2,59,13,18,72
3841,-6.558999999998657,3837.05,35,9,22,44
3842,-12.491499999999096,2285.294117647059,31,12,24,43
3843,-12.556249999999583,1991.4375,33,3,27,36
3844,-2.7427499999981038,4926.1578947368425,62,17,23,79
3845,-20.00049999999883,2467.5263157894738,21,17,17,38
3846,-23.441749999998684,2803.8333333333335,29,11,22,40
3847,-29.726999999999084,3311.315789473684,29,9,23,38
3848,6.1682500000018745,3726.4736842105262,83,18,16,101
3849,-15.029999999999413,2466.1111111111113,32,12,24,44
3850,-11.59924999999851,3902.684210526316,49,6,26,55
3851,-11.415999999998562,3820.9473684210525,38,4,27,42
3852,-1.8584999999995495,3339.5789473684213,33,17,19,50
3853,-16.689999999998932,3816.3,31,9,26,40
3854,-19.427999999999685,2608.1111111111113,45,5,28,50
3855,-7.457499999999238,3095.6666666666665,41,22,14,63
3856,3.0485000000017415,3773.8888888888887,54,2,21,56
3857,-9.532999999997264,4229.85,54,5,19,59
3858,-14.141499999998619,2295.5882352941176,30,9,29,39
3859,-22.09474999999903,2750.9444444444443,34,8,29,42
3860,-7.526749999998968,3658.0,42,9,20,51
3861,-0.46599999999822667,3098.470588235294,52,7,20,59
3862,-9.087249999998951,3425.7368421052633,42,11,30,53
3863,-18.289249999998237,2698.8823529411766,29,9,40,38
3864,1.5440000000009764,3647.8333333333335,45,4,27,49
3865,-18.41199999999882,3046.4736842105262,32,6,23,38
3866,-9.462499999997759,2611.294117647059,39,19,22,58
3867,12.618000000001402,3833.9444444444443,53,20,22,73
3868,-5.305499999999476,2920.277777777778,52,11,19,63
3869,-32.41525000000008,2862.684210526316,24,7,18,31
3870,-1.8897499999989062,4829.85,53,13,23,66
3871,-9.288999999998984,3486.7368421052633,44,10,22,54
3872,-7.247749999999715,2630.6470588235293,55,21,20,76
3873,-21.742499999998735,3713.25,46,6,22,52
3874,-11.352999999998449,2847.6315789473683,37,5,23,42
3875,-12.109749999998927,2335.8125,58,5,18,63
3876,-5.689499999998977,2433.705882352941,37,9,20,46
3877,-4.9877499999982335,2383.3529411764707,62,15,24,77
3878,-27.861499999999147,2806.684210526316,23,18,21,41
3879,-1.5707499999974703,4568.0,59,6,24,65
3880,-31.197499999999003,1539.0666666666666,22,7,35,29
3881,9.512000000001231,2791.1875,59,9,20,68
3882,-11.41274999999863,2621.2631578947367,29,7,22,36
3883,-9.303249999998242,4008.5,46,6,19,52
3884,-23.656749999999043,2584.277777777778,33,8,30,41
3885,-10.043499999998396,3108.315789473684,37,6,30,43
3886,-16.867749999998875,2267.722222222222,29,12,27,41
3887,-21.994499999998276,2966.9444444444443,40,9,23,49
3888,-3.007749999998725,5083.75,58,8,25,66
3889,-2.086249999999659,2815.5882352941176,55,16,18,71
3890,-24.514499999998407,3493.3,39,13,16,52
3891,-23.33349999999906,2112.5,22,8,20,30
3892,-7.686499999997548,2822.3333333333335,42,13,30,55
3893,-2.7424999999991533,3270.4,41,10,13,51
3894,-25.51199999999909,3251.3,26,5,20,31
3895,1.3515000000024315,3223.6666666666665,49,14,28,63
3896,8.712500000001375,2951.8125,50,9,23,59
3897,2.512750000001639,4333.75,58,11,18,69
3898,-15.176999999999461,3070.684210526316,53,9,20,62
3899,-7.607249999998807,3006.4736842105262,40,11,23,51
3900,-23.302999999998967,2841.8,30,7,22,37
3901,-34.27024999999925,1858.5294117647059,15,14,22,29
3902,-1.460999999997887,5660.75,70,6,27,76
3903,-31.71574999999906,4185.4,30,8,34,38
3904,-1.5464999999992364,4015.4210526315787,49,8,33,57
3905,0.6590000000009816,3859.95,49,2,18,51
3906,-2.7859999999979204,2541.1111111111113,32,15,23,47
3907,-22.176749999999547,2287.1176470588234,15,19,15,34
3908,-22.14099999999884,1947.1764705882354,32,16,15,48
3909,-38.42749999999934,2165.157894736842,19,14,15,33
3910,13.801750000002414,5008.45,63,9,20,72
3911,-30.306249999999853,2417.6111111111113,20,12,40,32
3912,-4.705249999997759,3243.9444444444443,50,3,19,53
3913,-17.280999999998134,3288.7368421052633,43,19,17,62
3914,-0.3289999999997226,2241.5,62,7,20,69
3915,-2.6977499999982832,3035.5263157894738,46,12,15,58
3916,-17.336999999998103,2824.0,40,12,35,52
3917,-5.065749999999084,4813.2,50,14,16,64
3918,-28.03249999999951,1880.4375,28,8,26,36
3919,-6.196999999998635,4351.25,51,9,17,60
3920,20.089000000001267,3735.0555555555557,66,14,17,80
3921,-2.6279999999990578,3058.722222222222,48,14,17,62
3922,-24.39099999999849,1946.875,46,15,35,61
3923,-14.902749999999404,3049.842105263158,28,11,12,39
3924,-17.04249999999877,2067.9375,31,13,28,44
3925,10.211750000002318,3176.0,57,16,18,73
3926,-18.434499999998827,3523.4736842105262,44,5,27,49
3927,-27.856500000000313,1429.0,23,9,34,32
3928,-18.36849999999952,2787.4736842105262,27,8,24,35
3929,-21.13949999999954,2328.176470588235,35,20,17,55
3930,5.685000000002075,3311.315789473684,50,3,24,53
3931,-9.22574999999981,4127.421052631579,50,10,23,60
3932,-27.293249999999773,2144.1052631578946,14,16,20,30
3933,-40.24549999999842,2530.4444444444443,23,10,26,33
3934,-13.723749999999274,2708.157894736842,23,9,20,32
3935,-30.520249999999475,2028.6666666666667,23,6,30,29
3936,-18.822999999998856,3035.9411764705883,43,12,24,55
3937,-16.649249999997945,2918.5,44,16,21,60
3938,2.9535000000011844,1978.625,40,7,21,47
3939,5.948250000002407,4149.263157894737,60,8,29,68
3940,-18.891249999997946,2862.9444444444443,35,7,24,42
3941,-7.393999999999008,2369.842105263158,25,11,20,36
3942,0.3767500000022911,3535.0555555555557,48,6,26,54
3943,-10.18699999999907,2380.5882352941176,28,13,15,41
3944,-23.660249999998772,2719.1666666666665,29,13,39,42
3945,-29.591249999999167,2635.4736842105262,24,9,24,33
3946,-5.269249999999326,2584.9411764705883,43,14,25,57
3947,0.7480000000019036,2672.705882352941,55,23,18,78
3948,-10.888249999998532,3821.7894736842104,42,22,17,64
3949,-33.90724999999966,2798.15,15,13,28,28
3950,-9.073499999998813,2914.8333333333335,45,10,23,55
3951,-21.768749999999443,2465.3333333333335,41,11,23,52
3952,-4.769499999998816,2900.0,37,14,12,51
3953,-3.1722499999979386,2198.529411764706,41,12,20,53
3954,-13.972499999999346,4311.65,43,4,23,47
3955,-26.095749999999725,2542.9411764705883,42,12,27,54
3956,-23.38099999999917,3004.7368421052633,28,13,41,41
3957,-16.362249999999918,2706.8333333333335,25,12,29,37
3958,-18.061999999999493,2834.6666666666665,39,11,21,50
3959,-12.95924999999769,2548.705882352941,36,16,26,52
3960,-10.97899999999811,2690.6470588235293,37,4,27,41
3961,-33.4337499999991,1692.9375,18,10,31,28
3962,-33.4514999999996,2510.3529411764707,27,4,22,31
3963,-7.08724999999807,3575.2105263157896,49,15,22,64
3964,-17.84299999999957,2158.1875,25,10,27,35
3965,-40.45324999999953,2970.4210526315787,20,5,33,25
3966,-19.82974999999901,2712.35,23,10,19,33
3967,-41.970999999999904,1925.5,9,8,23,17
3968,-7.6819999999989905,3772.4210526315787,45,13,26,58
3969,-1.1002499999982376,5784.65,68,16,24,84
3970,11.95325000000237,3679.5555555555557,52,18,27,70
3971,-16.633500000000137,2155.1052631578946,30,11,20,41
3972,-48.15324999999985,1429.0,0,10,29,10
3973,4.24375000000108,3982.2105263157896,56,6,15,62
3974,-24.000499999998883,2358.45,14,14,25,28
3975,-2.7247499999973295,3528.4736842105262,55,9,21,64
3976,-2.74174999999891,5042.263157894737,73,9,27,82
3977,-31.11774999999913,1528.25,11,22,15,33
3978,-19.493999999999083,3245.315789473684,49,9,21,58
3979,-2.805999999999071,2550.4117647058824,63,17,24,80
3980,0.39200000000132657,4272.6,47,22,18,69
3981,-24.120999999999228,3895.7,33,4,26,37
3982,-38.01724999999955,2167.1666666666665,22,11,32,33
3983,-16.98349999999899,2671.5555555555557,36,17,23,53
3984,15.869500000001196,2607.625,62,22,14,84
3985,7.793750000001227,4971.15,63,13,16,76
3986,-1.6067499999986055,3558.4,45,10,14,55
3987,-33.49599999999957,1905.1764705882354,21,6,31,27
3988,-31.272499999998907,2406.1666666666665,18,6,32,24
3989,-18.78424999999826,3011.1111111111113,42,8,31,50
3990,-17.31524999999791,3187.5,44,10,22,54
3991,-2.8604999999981073,2162.1875,36,12,24,48
3992,-17.87674999999896,2334.777777777778,23,12,22,35
3993,-13.71924999999932,2302.8888888888887,25,24,20,49
3994,-29.935499999999184,2012.5882352941176,19,7,25,26
3995,-17.285999999998534,2637.842105263158,32,10,21,42
3996,-21.34125000000008,1824.0,29,18,17,47
3997,-19.479999999998757,2732.5555555555557,24,17,18,41
3998,-28.9457499999995,3184.722222222222,30,8,27,38
3999,-10.891999999997731,2396.470588235294,28,11,35,39
4000,0.5947500000016083,2492.529411764706,64,11,22,75
4001,11.293000000000877,2697.9411764705883,56,14,18,70
4002,-13.639249999998338,1817.9375,42,20,11,62
4003,-13.009749999999354,2680.4736842105262,31,13,16,44
4004,-19.228999999998877,1429.0,21,11,29,32
4005,-15.410249999999715,2420.705882352941,49,9,14,58
4006,-16.77349999999894,2474.764705882353,41,15,20,56
4007,-2.9229999999999356,2975.294117647059,52,7,25,59
4008,-24.316499999999213,1930.0,15,11,22,26
4009,7.396750000001475,4651.35,43,5,27,48
4010,-37.00349999999977,2578.470588235294,25,8,23,33
4011,-33.56124999999922,2758.45,22,12,19,34
4012,-13.571499999999947,3016.3888888888887,44,29,14,73
4013,-22.51674999999924,3133.05,25,8,27,33
4014,-18.527749999998342,2085.8125,42,8,20,50
4015,-6.276499999998417,2798.4736842105262,39,9,21,48
4016,-16.394999999998973,3418.2631578947367,37,8,22,45
4017,-19.991999999998885,2401.4736842105262,24,14,19,38
4018,-34.522750000000045,1643.3125,24,7,31,31
4019,-17.82149999999941,4098.85,43,10,26,53
4020,-24.316499999999877,4072.3684210526317,46,14,18,60
4021,0.17100000000282983,5187.8,58,10,32,68
4022,-19.221499999999487,2311.470588235294,31,9,23,40
4023,-18.518999999998808,2459.0588235294117,36,13,18,49
4024,-32.92224999999927,2140.0,11,8,31,19
4025,-7.40775000000009,2159.294117647059,39,4,19,43
4026,-14.216749999999385,2324.5882352941176,38,2,28,40
4027,-15.509749999999276,2496.9444444444443,39,10,26,49
4028,-0.9237499999980521,5479.0,66,8,18,74
4029,-37.47174999999997,1429.0,16,17,22,33
4030,-29.382249999999466,2722.7,22,10,19,32
4031,-24.26374999999876,3205.2,27,9,24,36
4032,-26.94324999999916,2453.9375,40,8,22,48
4033,-19.335749999998722,2501.7368421052633,19,9,28,28
4034,-24.366249999998956,3782.25,32,9,29,41
4035,-6.193999999998351,4245.210526315789,63,17,19,80
4036,-2.5144999999983084,3682.1111111111113,51,13,20,64
4037,-22.674999999999354,2706.3684210526317,29,8,25,37
4038,-25.523749999999325,2729.8947368421054,30,7,35,37
4039,-28.388249999999335,3064.05,25,11,22,36
4040,-11.630749999998148,4553.65,43,11,27,54
4041,-18.492999999999785,2738.5555555555557,38,14,19,52
4042,-35.45849999999936,2681.315789473684,18,9,25,27
4043,-1.6374999999989626,2997.0,59,8,25,67
4044,-4.903999999998769,3536.6111111111113,66,17,19,83
4045,-11.713999999999713,1960.8125,47,9,30,56
4046,-16.643749999998647,1429.0,26,9,22,35
4047,-18.718499999999274,2013.5294117647059,26,22,14,48
4048,4.0630000000013125,2693.0,54,9,27,63
4049,-0.08624999999696055,3180.157894736842,55,11,22,66
4050,-8.616999999999262,2805.0,23,14,18,37
4051,11.416750000003452,2820.294117647059,69,10,21,79
4052,8.756500000003204,2698.8823529411766,58,6,18,64
4053,5.612750000002171,3841.7368421052633,50,9,26,59
4054,-23.27899999999916,1585.75,29,2,30,31
4055,-26.997999999999003,1429.0,25,14,20,39
4056,-7.579999999999002,2324.1111111111113,35,14,20,49
4057,-17.054249999998756,1824.9411764705883,30,15,18,45
4058,-9.297749999999548,3057.315789473684,49,11,23,60
4059,-15.827999999998331,2461.764705882353,27,13,29,40
4060,-33.271249999999384,1429.0,12,6,23,18
4061,-21.029499999998013,2168.9444444444443,30,12,26,42
4062,-21.040000000000337,2389.3333333333335,29,9,31,38
4063,-6.513249999999762,2976.6666666666665,42,13,23,55
4064,-34.8774999999993,1803.4705882352941,12,14,24,26
4065,-15.550500000000095,2753.9473684210525,40,6,20,46
4066,-32.492999999998666,2665.55,23,10,20,33
4067,-18.149499999998902,1813.0,27,11,22,38
4068,12.629750000002428,2564.470588235294,59,7,16,66
4069,-20.773999999999152,1541.125,18,9,40,27
4070,-40.95899999999908,2393.375,37,18,22,55
4071,-25.16049999999932,1840.75,27,5,18,32
4072,-44.86399999999927,2691.0555555555557,30,12,22,42
4073,-25.192999999998268,3391.8,37,7,24,44
4074,-32.9929999999993,2140.0526315789475,29,11,26,40
4075,-18.0214999999991,2409.6111111111113,27,10,21,37
4076,-22.064249999999202,3618.7368421052633,45,8,23,53
4077,-19.763249999998468,2157.4117647058824,36,14,13,50
4078,-19.691999999998963,2841.8333333333335,33,7,24,40
4079,-33.96399999999952,2161.1176470588234,30,12,34,42
4080,-27.97349999999929,2465.1666666666665,33,8,20,41
4081,-19.931499999999854,2017.3529411764705,28,11,22,39
4082,-21.055249999999287,3963.35,44,12,21,56
4083,-5.449499999998451,3504.705882352941,57,18,26,75
4084,-15.606499999999315,2576.529411764706,36,5,31,41
4085,-6.43074999999868,2114.3529411764707,54,8,24,62
4086,0.7652500000000984,4254.421052631579,51,16,15,67
4087,-19.121749999998578,2859.315789473684,28,13,22,41
4088,-16.22149999999877,2965.3684210526317,26,7,28,33
4089,-19.189999999999934,1941.5882352941176,31,9,20,40
4090,-7.129249999998848,2765.9444444444443,26,15,17,41
4091,-29.943499999999922,1758.8333333333333,18,18,18,36
4092,-9.064999999998602,2331.875,41,1,26,42
4093,-8.187499999999307,2454.235294117647,54,19,22,73
4094,-31.058499999999697,2764.157894736842,21,8,36,29
4095,-28.297999999999394,2807.65,17,8,27,25
4096,-14.250499999999457,2513.1176470588234,40,12,22,52
4097,8.343500000001104,4234.6,60,12,18,72
4098,-1.7042499999991496,3949.65,44,10,18,54
4099,-4.2449999999988135,3691.0,41,14,17,55
4100,4.7420000000012426,4206.105263157895,45,12,24,57
4101,-28.657749999999318,1653.25,6,20,23,26
4102,-6.738999999999092,3252.7894736842104,45,6,26,51
4103,-3.415749999998301,2428.222222222222,41,7,27,48
4104,-18.269249999997736,2572.8333333333335,34,11,28,45
4105,-2.017499999998212,2673.3333333333335,41,16,15,57
4106,-2.4422499999993237,4663.2,51,15,17,66
4107,-9.705749999998536,3116.0555555555557,41,8,30,49
4108,18.402500000000863,2727.823529411765,64,8,14,72
4109,5.609500000002611,2947.5555555555557,57,12,18,69
4110,4.125000000001381,3464.3333333333335,55,9,22,64
4111,6.427000000002269,4830.0,54,4,20,58
4112,-6.68474999999899,3681.315789473684,36,7,27,43
4113,-9.747249999998802,2399.842105263158,26,13,19,39
4114,3.81275000000145,3028.777777777778,57,6,24,63
4115,-21.299749999999513,2032.235294117647,24,19,17,43
4116,-1.0934999999988921,3402.85,38,15,22,53
4117,-15.105749999999952,1902.25,55,11,22,66
4118,-5.937749999999205,3478.3684210526317,44,11,18,55
4119,14.295250000001095,1576.875,51,10,21,61
4120,-28.20949999999994,2457.3333333333335,29,16,39,45
4121,-3.1954999999975393,5422.75,57,12,20,69
4122,-5.742749999997446,4339.45,53,12,29,65
4123,-16.151499999999213,2166.6470588235293,26,14,14,40
4124,-23.51549999999967,2741.5263157894738,32,9,23,41
4125,-7.500999999997347,3666.277777777778,65,3,21,68
4126,-28.702999999999168,3055.5789473684213,21,4,29,25
4127,-34.74224999999955,2523.4210526315787,17,10,26,27
4128,32.61850000000085,4270.333333333333,73,10,14,83
4129,-11.873749999999301,3087.722222222222,52,22,24,74
4130,-17.726749999998415,3210.15,36,8,20,44
4131,-10.47799999999875,2572.8823529411766,35,7,24,42
4132,-21.808249999999013,2949.3333333333335,31,7,25,38
4133,-1.3984999999985972,4593.631578947368,62,9,22,71
4134,-4.818749999997956,3592.1666666666665,57,1,30,58
4135,8.751500000001093,3012.8888888888887,66,12,10,78
4136,-29.192499999998784,3123.0555555555557,40,22,25,62
4137,12.889000000002998,3382.277777777778,60,13,19,73
4138,3.417250000000904,3257.235294117647,56,4,16,60
4139,-27.809000000000594,1429.0,24,18,20,42
4140,9.24700000000191,4256.9,49,9,21,58
4141,-20.320249999999028,2673.8947368421054,28,11,21,39
4142,-18.831249999999883,2489.2105263157896,23,9,28,32
4143,-16.693999999998972,3397.3,40,9,24,49
4144,-3.9134999999997175,2266.8888888888887,32,14,21,46
4145,-31.89974999999912,2232.7368421052633,12,13,27,25
4146,-8.752249999998556,3675.5263157894738,34,10,23,44
4147,-7.585249999999654,3021.6666666666665,46,10,24,56
4148,19.594000000001564,4779.1,60,4,22,64
4149,-29.78549999999887,2695.3888888888887,25,15,26,40
4150,-13.234999999998587,2475.0526315789475,26,3,29,29
4151,-14.683999999997837,1553.9333333333334,37,6,24,43
4152,2.1482500000015823,4229.368421052632,53,15,29,68
4153,-1.6277499999991214,2005.4375,45,6,18,51
4154,-16.892749999999033,2383.294117647059,37,12,24,49
4155,-15.08125000000022,2097.4444444444443,43,4,24,47
4156,-23.82399999999899,2139.5,30,6,22,36
4157,-25.89024999999914,2495.5625,25,8,32,33
4158,-2.2672499999985405,2397.3529411764707,43,14,17,57
4159,0.2185000000005047,3034.7368421052633,49,5,26,54
4160,1.1395000000023827,2072.9375,43,8,25,51
4161,-0.8182499999975349,3112.5555555555557,52,11,15,63
4162,-28.53900000000043,1429.0,18,17,25,35
4163,6.913000000001922,4072.7,53,14,16,67
4164,-19.738999999999635,2696.4736842105262,31,8,24,39
4165,-27.994749999998323,2155.6666666666665,27,24,12,51
4166,-27.684999999999185,2332.0555555555557,24,10,23,34
4167,-3.512499999999325,3084.3333333333335,58,7,13,65
4168,-35.07674999999987,2155.157894736842,15,18,21,33
4169,-23.709749999999808,2365.5789473684213,22,10,16,32
4170,-4.440499999998273,2072.777777777778,32,7,27,39
4171,-24.892749999999356,3445.7894736842104,44,12,28,56
4172,-24.0497499999993,2393.777777777778,27,5,22,32
4173,-9.144249999999506,4126.684210526316,47,15,22,62
4174,-10.587249999998653,3166.4,35,6,24,41
4175,0.798000000000593,2500.8823529411766,41,10,20,51
4176,3.385000000001239,1809.0,37,14,26,51
4177,2.166000000001405,2399.176470588235,44,6,23,50
4178,-14.933749999999957,2914.5263157894738,45,9,25,54
4179,-14.691499999999376,3147.5789473684213,43,10,24,53
4180,-23.319499999997245,1706.875,27,16,32,43
4181,-17.0559999999976,2360.5,40,10,23,50
4182,-2.421249999999051,2725.9411764705883,41,11,23,52
4183,-3.472999999998737,2766.8333333333335,58,12,26,70
4184,-27.637250000000183,2730.6666666666665,37,5,25,42
4185,-10.092499999999792,2497.0555555555557,31,12,25,43
4186,-8.425749999998263,3823.315789473684,47,10,20,57
4187,-5.117999999998051,2756.9411764705883,45,12,25,57
4188,-5.228499999998593,4019.55,37,6,27,43
4189,-23.560749999999423,2502.5789473684213,24,14,33,38
4190,-0.6617499999971747,4060.95,57,13,16,70
4191,-5.763749999999975,1848.6875,39,18,29,57
4192,-17.56699999999932,2231.5,18,6,28,24
4193,-5.404749999999243,2975.294117647059,68,11,17,79
4194,1.3665000000023644,2854.0,68,5,22,73
4195,-19.429499999998978,1925.8235294117646,24,3,30,27
4196,1.888500000001328,2144.3125,48,6,18,54
4197,9.228000000000012,2479.470588235294,47,10,15,57
4198,-21.81199999999889,2607.0,24,10,21,34
4199,-14.940499999998725,2971.5882352941176,42,10,16,52
4200,-28.390249999999575,3272.7894736842104,32,8,25,40
4201,1.1132500000015342,5125.1,52,7,20,59
4202,-20.550249999998677,3058.45,29,6,22,35
4203,-11.503249999997976,2669.1176470588234,54,9,20,63
4204,-40.62424999999968,2226.0,9,15,24,24
4205,-30.481249999999513,2108.0555555555557,18,4,29,22
4206,-26.21749999999948,2168.5882352941176,32,16,19,48
4207,-9.67874999999869,4387.05,44,6,23,50
4208,-25.176499999999205,2669.45,27,8,15,35
4209,12.521500000001364,3455.5555555555557,47,6,22,53
4210,-30.842749999998727,3328.9473684210525,30,7,25,37
4211,-30.734249999998617,2324.529411764706,23,9,32,32
4212,-9.00324999999827,2969.722222222222,38,9,23,47
4213,-32.89049999999976,2917.15,12,7,22,19
4214,10.527750000000866,3774.0,44,7,22,51
4215,-28.038999999999294,2395.4117647058824,29,16,26,45
4216,-8.206499999998552,3636.2105263157896,47,2,22,49
4217,-15.661249999999063,3069.0526315789475,31,9,19,40
4218,-13.211499999999294,2367.4117647058824,47,9,20,56
4219,-2.4484999999985106,3267.9,43,5,25,48
4220,-16.224249999999596,2350.6111111111113,21,18,22,39
4221,-32.59899999999997,2286.277777777778,24,15,32,39
4222,-12.46424999999896,3120.7368421052633,35,7,24,42
4223,-11.132249999999258,2207.0588235294117,27,8,28,35
4224,4.394250000000939,2908.0,55,17,16,72
4225,-6.325249999998159,4222.8,45,4,20,49
4226,-19.32774999999887,2790.6666666666665,37,6,32,43
4227,-6.076499999997039,3543.1176470588234,59,12,32,71
4228,-31.29874999999891,2598.684210526316,24,15,25,39
4229,-10.756749999999606,1750.4375,40,7,29,47
4230,-29.1097499999997,2067.315789473684,15,11,17,26
4231,-11.085499999999055,4470.3,37,15,21,52
4232,-19.703749999998553,3094.9,25,7,32,32
4233,-42.876749999999255,2381.3888888888887,21,11,26,32
4234,-10.311499999998423,2803.529411764706,47,12,21,59
4235,-3.584499999997169,5042.55,67,12,29,79
4236,-26.2764999999982,3285.45,29,14,28,43
4237,2.425000000002355,2715.8125,55,13,13,68
4238,-11.698249999998628,4179.263157894737,48,13,29,61
4239,-10.954249999999487,2197.470588235294,33,12,21,45
4240,-17.829749999999343,2097.5882352941176,28,13,18,41
4241,-3.739499999999468,3460.8333333333335,48,18,22,66
4242,-11.721999999999605,2957.3888888888887,57,9,21,66
4243,-7.677999999998017,4774.3,52,8,21,60
4244,12.655500000001814,2834.235294117647,62,6,24,68
4245,-12.825749999998212,3340.4736842105262,44,8,24,52
4246,-26.117999999998723,2681.3684210526317,25,10,26,35
4247,-4.753999999998842,2879.6666666666665,52,12,23,64
4248,-8.337249999997335,1910.1875,37,4,34,41
4249,-9.237249999998966,3915.55,39,12,19,51
4250,-20.855499999999992,2596.1052631578946,28,16,21,44
4251,8.639000000003099,5125.0526315789475,83,2,26,85
4252,-20.435499999999056,2812.5263157894738,24,12,21,36
4253,-28.199249999999342,1429.0,20,16,21,36
4254,-15.878749999997833,1528.25,37,7,23,44
4255,14.112250000001541,4017.3333333333335,63,13,24,76
4256,-30.14074999999937,3065.55,17,12,18,29
4257,-0.6619999999983289,3870.0555555555557,59,7,21,66
4258,-7.237499999999187,3686.3684210526317,39,19,18,58
4259,-23.593249999999347,2131.176470588235,26,0,35,26
4260,-6.062249999998938,4544.2,41,7,17,48
4261,-26.845999999999243,1710.75,20,8,27,28
4262,34.931250000002194,4328.894736842105,72,7,15,79
4263,-0.5589999999994508,3425.5,52,11,23,63
4264,1.5400000000012652,2223.625,47,13,18,60
4265,-6.024249999999201,2481.1111111111113,43,6,21,49
4266,-1.7904999999997746,2346.1666666666665,38,13,11,51
4267,-38.494249999999184,1429.0,14,15,25,29
4268,-12.806999999998675,4028.4,45,8,13,53
4269,-30.745999999998297,4271.2,45,4,23,49
4270,-6.8852499999992105,2965.55,31,13,14,44
4271,-1.299749999999274,3315.4736842105262,50,2,24,52
4272,-2.825499999997979,3450.8947368421054,45,21,13,66
4273,-28.765749999998526,2185.6666666666665,21,18,21,39
4274,-4.6207499999977575,2951.8823529411766,66,9,30,75
4275,-11.814249999997482,2874.4444444444443,53,6,22,59
4276,-0.7377499999990146,2352.8125,40,12,21,52
4277,-17.653749999999604,2492.684210526316,27,11,25,38
4278,-26.931749999998846,2156.4117647058824,22,4,30,26
4279,-12.199499999998539,1911.25,43,15,21,58
4280,-22.41599999999875,2947.0,33,12,23,45
4281,-12.212749999997971,2698.0555555555557,34,10,32,44
4282,-32.88499999999925,2631.8888888888887,37,9,27,46
4283,-22.971499999999374,2892.7894736842104,32,8,19,40
4284,-12.049749999999696,3002.1666666666665,50,10,26,60
4285,2.2552500000024387,3020.1176470588234,58,4,27,62
4286,-32.75974999999982,2172.3888888888887,19,11,20,30
4287,8.535250000002055,4772.7,48,13,16,61
4288,-27.636749999998834,2467.3529411764707,28,13,19,41
4289,-5.263499999998873,2763.277777777778,36,13,16,49
4290,-19.350999999999967,2968.722222222222,42,9,27,51
4291,-4.508499999999441,2840.0,46,18,17,64
4292,-36.571249999999466,2278.684210526316,8,11,29,19
4293,-29.463999999999128,2084.0526315789475,13,11,26,24
4294,-16.53949999999987,2901.722222222222,31,9,21,40
4295,-24.31349999999995,2118.722222222222,27,15,23,42
4296,-3.6132499999981045,2475.764705882353,53,10,30,63
4297,-21.48424999999967,2775.9,25,13,22,38
4298,-17.534999999998906,3064.842105263158,37,11,17,48
4299,-1.5529999999991526,2107.75,36,7,20,43
4300,-4.971749999999547,2080.764705882353,39,15,15,54
4301,-8.148499999999192,1553.9333333333334,26,8,22,34
4302,-29.545749999998918,2545.3888888888887,29,10,23,39
4303,-8.585749999999031,3357.722222222222,58,19,12,77
4304,-21.775249999999506,2846.7894736842104,22,18,16,40
4305,-6.487999999998347,2838.3333333333335,36,16,28,52
4306,-23.707999999998933,3401.35,32,15,18,47
4307,-31.78549999999832,1528.25,31,7,25,38
4308,-27.89474999999815,2192.9411764705883,36,13,24,49
4309,-30.608999999999703,3212.7368421052633,23,10,34,33
4310,-9.53174999999931,2864.315789473684,32,8,17,40
4311,-17.448999999998783,3322.3888888888887,47,17,17,64
4312,-14.230249999999467,4118.315789473684,50,18,20,68
4313,-27.093499999998876,2642.65,28,12,15,40
4314,-14.50724999999854,1429.0,45,17,16,62
4315,-20.035499999999665,2887.0,20,13,22,33
4316,-15.117249999999231,2431.722222222222,41,25,11,66
4317,-31.40274999999902,2787.05,23,11,23,34
4318,-7.1969999999985985,2715.764705882353,35,11,18,46
4319,-23.463499999997953,2946.722222222222,44,7,19,51
4320,-1.979249999998587,5073.5,56,10,18,66
4321,-6.0399999999991545,3818.3684210526317,49,12,24,61
4322,-16.26349999999956,2257.235294117647,42,12,16,54
4323,-9.562749999998346,4213.2,49,14,16,63
4324,-20.037999999998927,2948.684210526316,31,7,24,38
4325,6.203000000001214,2143.3125,49,6,26,55
4326,-18.069249999998647,4041.8,46,6,28,52
4327,-30.205499999998484,3630.3684210526317,41,13,23,54
4328,-13.80224999999819,2316.1666666666665,40,9,21,49
4329,-6.291999999998663,2534.705882352941,32,6,29,38
4330,-17.817999999999536,2575.85,22,7,18,29
4331,-29.645749999998987,2279.277777777778,23,19,13,42
4332,5.872250000001477,3839.3684210526317,49,11,26,60
4333,-7.679999999999902,3928.6315789473683,47,10,18,57
4334,-9.134249999997888,3159.1666666666665,45,4,25,49
4335,2.9665000000025277,2659.3333333333335,52,9,24,61
4336,-18.35224999999913,2757.65,25,10,20,35
4337,-13.88724999999874,3161.8888888888887,50,12,19,62
4338,-31.09824999999888,2436.1111111111113,26,16,21,42
4339,-15.237499999998636,2700.6315789473683,28,16,16,44
4340,9.306500000001236,4403.7,54,5,23,59
4341,-0.2757499999993779,2203.1176470588234,31,15,11,46
4342,-18.071999999998624,2316.1666666666665,28,13,18,41
4343,-39.45574999999877,2160.1666666666665,11,8,33,19
4344,-20.18149999999935,2492.470588235294,39,13,21,52
4345,-3.2354999999994343,4999.7,43,29,14,72
4346,-30.277499999999673,1581.8125,12,15,15,27
4347,-11.963249999998732,2812.764705882353,48,5,22,53
4348,-18.766749999998463,2014.375,43,7,23,50
4349,-30.21924999999937,2378.5882352941176,27,19,21,46
4350,-23.83149999999916,2587.1,20,10,20,30
4351,-22.598750000000138,2651.3333333333335,39,24,23,63
4352,-29.519249999998067,3211.7,33,5,26,38
4353,-7.1219999999997015,2568.294117647059,44,6,22,50
4354,-19.199749999999284,1964.6875,43,22,23,65
4355,4.225000000001488,4601.4,50,18,18,68
4356,-10.64999999999846,2716.4210526315787,28,12,26,40
4357,5.671750000002306,2360.277777777778,46,18,12,64
4358,-16.03774999999862,4535.45,45,8,24,53
4359,-24.301499999999077,2929.4736842105262,25,17,20,42
4360,-4.828749999998834,3830.842105263158,50,10,15,60
4361,-3.4622499999994227,3767.3684210526317,50,10,25,60
4362,-25.981249999999186,3000.6111111111113,33,13,26,46
4363,-10.18549999999854,2719.470588235294,41,16,21,57
4364,-17.45849999999895,2901.0,28,14,14,42
4365,7.76650000000178,4185.5,57,17,13,74
4366,-5.17049999999839,4330.6,46,2,33,48
4367,-3.6777499999978813,2808.1176470588234,56,11,30,67
4368,-1.6794999999980846,2944.529411764706,52,11,13,63
4369,-35.55024999999999,2320.4736842105262,12,2,33,14
4370,9.218500000001537,3318.0,47,9,33,56
4371,-15.27149999999827,3951.3,39,5,26,44
4372,-4.4224999999994985,2665.235294117647,56,9,28,65
4373,-13.660500000000031,1429.0,39,15,22,54
4374,-17.15074999999915,3592.0,60,9,17,69
4375,4.671249999999939,3227.470588235294,59,10,17,69
4376,-12.933499999998759,1719.6875,33,14,23,47
4377,-17.6099999999994,2139.8888888888887,49,17,16,66
4378,-16.10024999999944,2053.9375,39,14,21,53
4379,-1.544749999997696,3213.5263157894738,56,11,13,67
4380,-13.509749999999286,2328.1176470588234,39,11,18,50
4381,1.841500000001366,4308.4,46,11,22,57
4382,6.532000000001794,4235.45,53,11,15,64
4383,-7.296749999998897,2834.722222222222,36,13,15,49
4384,-15.736749999998816,3817.9,42,10,19,52
4385,-8.726499999998577,1481.9333333333334,41,6,25,47
4386,-4.6844999999981605,3014.6111111111113,41,7,25,48
4387,-15.93824999999934,2391.705882352941,35,6,24,41
4388,-17.44524999999909,2802.4736842105262,22,13,21,35
4389,-29.5362499999988,2552.5555555555557,33,7,24,40
4390,-25.67224999999825,3132.5789473684213,43,10,17,53
4391,32.63450000000153,3570.0588235294117,79,8,21,87
4392,9.434000000001692,3473.1111111111113,72,9,13,81
4393,7.887250000001879,5191.0,65,18,16,83
4394,-19.26224999999871,2658.842105263158,28,13,21,41
4395,-17.802249999999667,2077.0,27,0,50,27
4396,-5.373999999998654,1564.0,34,14,18,48
4397,9.421250000001224,2910.0,60,12,18,72
4398,-26.440249999998706,3524.3,30,14,23,44
4399,-3.1004999999985463,3506.6666666666665,71,14,12,85
4400,-23.238499999999632,2219.9444444444443,30,19,11,49
4401,-12.676749999998997,4873.55,44,17,18,61
4402,-2.5117499999987847,3544.6111111111113,52,10,15,62
4403,-3.4409999999989145,4547.25,40,7,23,47
4404,3.951000000002548,5400.5,58,7,20,65
4405,1.7625000000013489,4505.105263157895,51,16,26,67
4406,-33.69824999999948,2227.1111111111113,17,13,22,30
4407,-15.169999999999021,2685.823529411765,45,5,21,50
4408,-21.818999999999384,3673.8947368421054,36,7,24,43
4409,27.977500000001335,3887.529411764706,71,4,17,75
4410,-10.167249999999555,2804.4,24,10,24,34
4411,1.8385000000019804,2939.6111111111113,49,8,20,57
4412,-17.18224999999847,2173.25,33,10,22,43
4413,-14.117249999998773,2888.5789473684213,28,14,19,42
4414,-3.318749999999471,2311.4117647058824,54,13,26,67
4415,5.040500000001618,2793.277777777778,42,14,17,56
4416,-24.09474999999873,2873.4736842105262,30,16,21,46
4417,-18.722999999999324,2929.4736842105262,30,16,16,46
4418,-3.3607499999991743,2690.5263157894738,34,14,22,48
4419,-1.0299999999991152,2856.722222222222,43,9,19,52
4420,-0.9247499999985271,3613.842105263158,46,9,17,55
4421,-24.250499999999427,2109.705882352941,31,22,21,53
4422,-31.928499999999058,2085.470588235294,17,8,27,25
4423,-15.480999999999483,2391.764705882353,35,10,26,45
4424,-18.784749999998848,3302.8947368421054,34,15,20,49
4425,-19.111999999998204,3423.5,38,16,19,54
4426,-7.962750000000165,2370.235294117647,48,19,19,67
4427,-26.1367499999998,1862.2941176470588,25,12,32,37
4428,-14.888249999998305,2289.8333333333335,38,9,17,47
4429,-7.751249999999464,3644.5789473684213,35,9,23,44
4430,6.166750000001724,2853.8823529411766,58,11,31,69
4431,-28.19524999999922,3348.95,28,8,23,36
4432,-9.611249999998872,2143.3125,46,12,31,58
4433,-11.631249999999104,2775.95,27,13,19,40
4434,-13.893749999999343,3450.222222222222,38,11,23,49
4435,-7.071499999998741,3211.222222222222,40,9,23,49
4436,-24.069249999998462,1429.0,41,9,27,50
4437,-12.840499999998958,1617.5625,27,13,19,40
4438,-21.44774999999886,2501.9411764705883,44,13,20,57
4439,-6.2619999999986575,3971.95,40,7,24,47
4440,1.7955000000015702,3171.5555555555557,55,12,19,67
4441,-16.433499999998027,3249.4210526315787,28,9,29,37
4442,-17.175499999999303,2164.823529411765,33,8,25,41
4443,4.552000000001685,2661.3125,54,10,17,64
4444,0.7467500000031404,2001.4705882352941,48,13,24,61
4445,-32.72049999999992,1612.625,29,7,28,36
4446,-34.21349999999951,2148.1,13,5,25,18
4447,-13.107500000000286,2127.4444444444443,35,13,32,48
4448,-16.204999999997796,2759.777777777778,43,13,23,56
4449,-25.461499999999454,1841.7058823529412,17,8,26,25
4450,-6.422999999998081,4723.55,62,6,23,68
4451,-2.5759999999985603,4418.8,52,18,13,70
4452,-6.28374999999894,2622.0,32,12,10,44
4453,15.785500000003177,4379.736842105263,68,9,29,77
4454,-6.9359999999995114,4291.8,44,7,25,51
4455,-10.004749999998035,2682.0588235294117,53,14,15,67
4456,-9.885499999998975,3266.842105263158,44,13,15,57
4457,-9.997249999998619,4429.95,30,9,30,39
4458,-34.76324999999923,2118.6666666666665,19,14,18,33
4459,-14.409249999999039,3678.0526315789475,38,13,18,51
4460,-3.139999999999641,2758.8333333333335,49,11,15,60
4461,-5.200499999999249,3512.45,32,15,14,47
4462,2.512500000000871,1880.4375,41,19,13,60
4463,-15.430249999998932,2072.4117647058824,37,9,20,46
4464,-2.705999999997698,5567.15,56,8,21,64
4465,-27.707999999999107,1429.0,15,9,25,24
4466,-13.005499999998994,2079.9375,23,16,20,39
4467,-8.669749999998375,2416.8823529411766,61,10,26,71
4468,-36.320749999999926,1617.5625,7,10,18,17
4469,18.282250000002755,2653.3125,52,16,24,68
4470,-26.21499999999864,3346.1666666666665,42,3,32,45
4471,7.632000000000799,3205.1666666666665,70,8,20,78
4472,-3.039249999997989,3616.0,63,14,20,77
4473,-17.87124999999761,2601.0555555555557,42,11,28,53
4474,-33.215499999998414,2211.1666666666665,18,9,36,27
4475,-16.0684999999992,2269.3529411764707,30,10,17,40
4476,-13.16574999999915,3527.55,35,2,19,37
4477,-24.19924999999977,2656.5555555555557,36,11,33,47
4478,-30.043749999999477,2825.8888888888887,28,12,37,40
4479,-10.502999999998568,3160.85,42,4,18,46
4480,-40.13474999999997,1666.125,11,7,22,18
4481,-18.5132499999982,3612.0526315789475,47,12,19,59
4482,-26.836999999999108,2662.9473684210525,22,13,23,35
4483,-20.35074999999918,2500.8947368421054,31,14,8,45
4484,-0.9774999999981684,4564.05,50,8,26,58
4485,-2.614499999999399,3236.9473684210525,60,11,18,71
4486,-32.30875000000046,2436.9444444444443,33,11,34,44
4487,-34.471249999999436,1429.0,11,16,20,27
4488,-30.6422499999992,2861.6,16,10,27,26
4489,-34.60299999999917,1630.4375,20,9,24,29
4490,4.366500000001528,2054.125,47,20,14,67
4491,-8.588499999998735,3214.1,34,14,15,48
4492,-24.09149999999835,3186.7894736842104,37,12,21,49
4493,-11.25874999999891,2630.705882352941,33,9,29,42
4494,-21.583999999999584,4147.526315789473,42,12,21,54
4495,-11.270249999998004,3088.235294117647,46,10,23,56
4496,-21.321999999999182,3316.2105263157896,33,10,24,43
4497,-22.130749999999242,2759.842105263158,24,11,20,35
4498,4.4350000000020255,2578.875,51,9,12,60
4499,-32.54199999999916,2038.9473684210527,7,12,26,19
4500,-11.708500000000008,2711.4210526315787,45,7,16,52
4501,-25.975249999998777,3061.4736842105262,33,9,20,42
4502,-19.389999999998537,3792.55,42,7,20,49
4503,-35.290000000000326,2175.1111111111113,16,2,39,18
4504,-6.878500000000022,2248.8823529411766,51,8,29,59
4505,-5.723499999997969,2580.3529411764707,46,14,15,60
4506,-31.99249999999904,2243.8888888888887,22,8,19,30
4507,-24.42424999999843,3611.6,49,12,14,61
4508,-16.60849999999916,3129.2105263157896,45,5,20,50
4509,-3.727499999998783,4118.315789473684,54,26,18,80
4510,-21.389249999999297,1481.9333333333334,47,11,27,58
4511,-14.733249999999135,1887.5294117647059,33,14,23,47
4512,-34.004749999999305,1606.4705882352941,12,8,25,20
4513,-4.10599999999838,2599.0588235294117,39,17,19,56
4514,-22.717249999999357,2764.3529411764707,32,17,33,49
4515,-22.581499999999757,2920.55,18,11,18,29
4516,-20.932249999999257,1481.9333333333334,19,7,22,26
4517,-18.51649999999779,2319.705882352941,41,7,29,48
4518,-16.72699999999938,2290.823529411765,49,3,28,52
4519,-11.16249999999949,3260.2631578947367,44,10,28,54
4520,-33.014249999998775,2707.3529411764707,35,4,26,39
4521,-14.593749999999943,2193.764705882353,27,7,22,34
4522,-4.084749999997849,2779.277777777778,41,8,25,49
4523,7.325500000002037,5372.7,64,14,17,78
4524,-17.42024999999989,2525.9473684210525,21,20,18,41
4525,-13.611749999999128,3174.2631578947367,37,8,17,45
4526,14.073500000000186,3005.176470588235,66,16,16,82
4527,15.360000000002199,3047.235294117647,63,13,27,76
4528,-39.4014999999991,2072.2105263157896,13,4,35,17
4529,-33.21999999999974,2064.0,28,11,35,39
4530,-17.765749999999162,2493.4210526315787,27,4,31,31
4531,-28.596749999999155,2536.35,24,7,18,31
4532,0.008000000002533536,2866.5,52,8,24,60
4533,-22.827499999998444,2978.4444444444443,35,13,27,48
4534,-19.746749999999075,2168.5882352941176,27,10,21,37
4535,3.8807500000027644,3001.3888888888887,56,13,18,69
4536,-19.519249999998497,2498.722222222222,31,16,19,47
4537,-26.197499999999838,2643.3888888888887,21,19,26,40
4538,0.054250000000122964,3241.0526315789475,47,9,18,56
4539,-4.897249999999721,2651.2631578947367,36,13,19,49
4540,-13.991499999998473,2398.277777777778,29,11,22,40
4541,2.1827500000006266,4201.894736842105,60,11,25,71
4542,-16.565249999998507,2549.0555555555557,33,6,25,39
4543,5.628250000001723,2580.875,61,13,22,74
4544,-14.570249999999007,3493.4210526315787,47,25,16,72
4545,14.761250000001372,5134.9473684210525,57,11,21,68
4546,-2.07874999999928,3145.7894736842104,36,7,23,43
4547,-14.844749999999589,2667.1666666666665,38,17,17,55
4548,-11.129749999999138,4022.65,40,10,18,50
4549,11.974250000001586,1916.1875,58,12,20,70
4550,10.569250000001427,2809.9444444444443,43,9,21,52
4551,-40.941499999999245,2308.4,13,12,22,25
4552,-36.78949999999895,1576.875,21,11,22,32
4553,-15.96399999999893,2821.5555555555557,35,3,30,38
4554,-1.2559999999993916,2694.176470588235,48,5,20,53
4555,1.182250000000902,2516.3888888888887,43,13,15,56
4556,-29.508749999999196,1900.5882352941176,18,10,22,28
4557,-16.182749999998784,2572.8888888888887,31,8,18,39
4558,-17.65349999999966,3132.5789473684213,35,16,19,51
4559,-20.316999999999215,2387.0,31,11,16,42
4560,9.598500000000888,3873.5263157894738,56,7,26,63
4561,-12.747749999999701,2299.294117647059,50,9,21,59
4562,-18.223999999998902,2548.1111111111113,30,11,22,41
4563,-5.6454999999995845,3867.95,43,7,16,50
4564,-21.481499999999677,1955.8125,40,9,31,49
4565,21.505250000001475,4781.4,61,13,13,74
4566,-1.591999999999453,3210.3333333333335,39,16,25,55
4567,-3.088249999998685,4395.684210526316,54,11,19,65
4568,-20.632499999998625,3282.25,35,4,26,39
4569,-50.573249999999625,2133.315789473684,9,8,26,17
4570,-38.35825000000009,2314.4444444444443,16,12,33,28
4571,-21.98049999999974,1429.0,51,10,29,61
4572,-3.717249999999551,2748.3529411764707,51,8,14,59
4573,-30.125999999999244,2752.95,21,17,15,38
4574,-10.994749999998396,2476.6470588235293,47,3,22,50
4575,-26.726999999998508,3628.7368421052633,49,14,28,63
4576,-31.712749999999524,3166.7368421052633,35,11,25,46
4577,-29.17649999999959,2066.3,13,0,27,13
4578,-6.472999999999812,1692.9375,41,8,24,49
4579,-30.471750000000014,2618.7368421052633,35,9,24,44
4580,-15.955499999999432,2801.684210526316,42,11,26,53
4581,-34.10874999999923,1429.0,7,9,31,16
4582,13.914250000000607,2509.4375,70,6,11,76
4583,-6.955249999999623,2103.625,34,6,20,40
4584,-9.87449999999873,3583.5789473684213,47,14,19,61
4585,-16.828999999997855,3198.1111111111113,47,13,25,60
4586,-0.4059999999980766,5890.15,69,10,13,79
4587,-7.601999999998664,2524.3888888888887,31,20,15,51
4588,-16.059749999998406,1837.0588235294117,32,18,22,50
4589,0.011250000000370441,3437.0,79,8,21,87
4590,-25.867499999999602,2357.722222222222,24,13,28,37
4591,3.7475000000012395,3028.6111111111113,41,18,12,59
4592,-17.4579999999997,2155.777777777778,28,17,18,45
4593,-17.811999999999365,2520.1052631578946,28,14,15,42
4594,-22.080249999998586,3973.45,42,13,17,55
4595,-9.316249999999531,3620.3684210526317,45,9,16,54
4596,-1.2099999999991138,3801.7368421052633,43,13,14,56
4597,0.8895000000020705,4077.3684210526317,55,13,15,68
4598,-10.772249999999705,1971.5882352941176,40,12,15,52
4599,-15.664999999999813,2127.470588235294,24,6,23,30
4600,-17.239499999998756,2820.235294117647,38,12,16,50
4601,-13.151499999999043,2498.722222222222,28,13,22,41
4602,-15.07174999999952,2496.294117647059,44,15,24,59
4603,9.028500000000875,3854.3684210526317,59,14,20,73
4604,-0.5917499999984095,2714.777777777778,42,7,20,49
4605,-10.583749999998068,3081.5263157894738,38,15,20,53
4606,-21.4137499999997,2092.1666666666665,28,5,28,33
4607,4.916750000002326,3489.1111111111113,56,12,28,68
4608,-11.20149999999971,2185.3529411764707,54,14,20,68
4609,-34.80499999999897,2290.8823529411766,48,4,40,52
4610,-19.423999999999797,2005.1176470588234,35,12,17,47
4611,3.425500000001782,1800.0625,57,10,17,67
4612,-4.607249999999291,3019.7894736842104,45,4,22,49
4613,-16.82549999999957,2268.4375,36,8,22,44
4614,-29.740999999998813,2120.0588235294117,18,21,19,39
4615,-17.35224999999999,1429.0,37,9,19,46
4616,-31.84149999999918,3561.6,27,8,21,35
4617,-30.720999999998746,1567.9375,25,11,25,36
4618,-22.756999999999252,2512.5789473684213,21,11,20,32
4619,-23.828749999999264,2495.277777777778,27,18,11,45
4620,-18.27749999999962,2156.4117647058824,31,10,24,41
4621,-20.695499999998916,2703.3333333333335,33,12,17,45
4622,3.53850000000115,4170.0526315789475,54,7,23,61
4623,-12.094749999998893,3263.2,35,10,15,45
4624,-6.633749999998249,2676.8333333333335,36,7,34,43
4625,-0.8149999999989808,1769.375,36,5,17,41
4626,-22.079999999999224,1528.25,16,10,22,26
4627,8.834000000002181,3701.6111111111113,61,6,18,67
4628,0.6152500000028687,2749.529411764706,61,6,20,67
4629,-12.987749999999105,2552.5,20,12,29,32
4630,-20.831749999999317,2544.15,22,9,22,31
4631,-5.328749999998354,2103.625,38,4,22,42
4632,-31.445499999998912,2249.5263157894738,11,10,33,21
4633,23.429750000001814,3199.6666666666665,56,15,12,71
4634,-25.27074999999918,2711.4736842105262,30,7,29,37
4635,-6.4819999999993385,2624.0,36,9,25,45
4636,-14.457499999999168,3454.2631578947367,44,9,13,53
4637,-4.134499999998242,3059.0,49,8,18,57
4638,-22.29474999999937,2491.7368421052633,23,7,25,30
4639,8.555500000002882,4346.368421052632,67,8,25,75
4640,-20.612749999999423,1532.1875,36,23,18,59
4641,-2.314249999999558,2601.8823529411766,43,11,18,54
4642,-2.6222499999989304,2766.8888888888887,46,15,14,61
4643,-32.610249999999716,2321.315789473684,17,18,19,35
4644,-12.966999999998837,2474.0,36,10,24,46
4645,-13.624249999998252,3099.0526315789475,34,16,23,50
4646,16.704000000001322,1947.0,60,16,16,76
4647,-9.491749999998865,3376.75,40,9,15,49
4648,-22.727749999998974,2156.470588235294,24,9,25,33
4649,-5.625249999999341,3078.157894736842,34,19,10,53
4650,-12.09200000000005,1543.2666666666667,40,10,23,50
4651,-9.89024999999922,2469.722222222222,31,7,19,38
4652,-22.56674999999786,1689.0,28,20,17,48
4653,-39.42299999999959,2570.35,25,6,18,31
4654,-18.732749999999047,3104.842105263158,35,12,13,47
4655,-7.342999999997747,3093.8823529411766,54,1,22,55
4656,-12.25524999999865,3130.842105263158,33,19,21,52
4657,4.5677500000016265,3820.9473684210525,56,11,17,67
4658,-22.403999999998742,2592.842105263158,22,12,22,34
4659,-1.1084999999977863,3398.222222222222,49,3,19,52
4660,-30.922999999999394,2698.1,22,8,20,30
4661,-25.740999999998348,3315.6,41,10,18,51
4662,-13.907499999999624,2969.55,20,7,22,27
4663,-14.920999999999609,2687.2631578947367,27,10,27,37
4664,-30.947249999999734,3030.5789473684213,20,2,42,22
4665,-28.55774999999868,1429.0,21,18,14,39
4666,-13.890999999998721,3896.55,44,24,15,68
4667,-17.535249999998808,4666.35,52,12,21,64
4668,-13.780499999999057,3558.5789473684213,33,6,24,39
4669,-34.56224999999958,2038.9473684210527,11,9,23,20
4670,-11.721499999998795,2796.0,29,4,24,33
4671,-4.268499999998083,4193.4,46,11,22,57
4672,-27.68549999999933,2726.75,22,9,24,31
4673,-14.82149999999947,2927.222222222222,43,12,16,55
4674,9.866750000000236,2765.235294117647,57,17,10,74
4675,-8.471249999998744,3092.1111111111113,43,14,26,57
4676,14.793750000002088,6083.75,68,10,21,78
4677,-18.122749999999392,2683.0,27,6,23,33
4678,-0.42274999999855706,4918.75,48,5,25,53
4679,-29.07249999999906,2036.125,36,16,15,52
4680,-39.62674999999982,2862.684210526316,36,5,30,41
4681,-1.5319999999987413,3608.684210526316,50,10,18,60
4682,-19.70999999999935,1701.875,31,17,17,48
4683,-18.72124999999908,2690.1111111111113,48,9,34,57
4684,-10.49724999999858,2988.842105263158,31,20,19,51
4685,-26.691750000000024,3543.35,29,6,25,35
4686,-11.818999999999303,2232.0588235294117,39,10,24,49
4687,-2.0687499999988006,3287.1111111111113,44,14,19,58
4688,-14.217999999998877,2761.5,34,9,15,43
4689,-7.783750000000323,1741.5625,42,9,40,51
4690,-12.603749999999389,3028.722222222222,36,16,14,52
4691,-31.275250000000547,1429.0,29,27,23,56
4692,9.238000000001277,3914.4210526315787,62,4,12,66
4693,-31.918749999999584,2042.2105263157894,9,18,21,27
4694,-28.910999999999444,2500.1052631578946,29,16,21,45
4695,-33.066250000000004,2025.7058823529412,25,13,23,38
4696,5.4150000000011485,3516.3333333333335,78,6,27,84
4697,-5.383499999999873,2675.0555555555557,41,12,23,53
4698,17.823750000002374,4645.05,66,4,17,70
4699,-23.864749999999283,2079.8823529411766,27,14,28,41
4700,14.338250000001292,3455.5555555555557,66,10,17,76
4701,9.068000000000621,3564.0555555555557,69,13,17,82
4702,-13.168999999999622,3919.55,43,12,25,55
4703,17.270250000001813,2712.8823529411766,57,12,12,69
4704,-31.028999999999876,2190.9444444444443,22,10,29,32
4705,-43.904249999999124,2377.8888888888887,21,21,20,42
4706,-8.313249999999046,3213.8888888888887,44,2,21,46
4707,-12.211249999999387,3408.722222222222,48,16,32,64
4708,-15.16274999999951,2173.176470588235,31,23,19,54
4709,-19.850999999998162,1630.1333333333334,33,4,38,37
4710,-27.748000000000495,1429.0,22,7,36,29
4711,-8.766249999999202,5098.1,51,10,22,61
4712,-13.64799999999914,3223.55,31,14,19,45
4713,-1.6344999999990866,2925.6111111111113,50,5,23,55
4714,-25.807999999999417,2198.0555555555557,21,9,20,30
4715,-20.673999999998973,2156.4117647058824,37,7,32,44
4716,0.6487500000012876,3504.9444444444443,54,8,16,62
4717,-12.9614999999976,3258.6315789473683,47,14,15,61
4718,-11.294749999998952,3008.45,29,12,15,41
4719,-45.38949999999845,4604.4,25,14,34,39
4720,-10.702249999998179,2099.6875,48,16,20,64
4721,-6.905749999998408,2761.470588235294,54,10,23,64
4722,-19.3322499999983,3088.722222222222,46,17,19,63
4723,-15.513249999999099,4123.315789473684,56,9,15,65
4724,-18.918749999998848,1514.375,23,12,23,35
4725,-17.050999999999306,3229.777777777778,36,16,16,52
4726,-8.73324999999939,3236.1052631578946,52,15,17,67
4727,-21.973249999998206,1740.8823529411766,28,15,20,43
4728,3.0540000000016145,3542.777777777778,59,18,18,77
4729,-22.056749999999944,2516.3333333333335,34,10,26,44
4730,16.083000000002478,3023.3125,67,10,18,77
4731,-3.473249999998152,2256.4375,40,6,21,46
4732,-24.61799999999904,1706.875,22,16,15,38
4733,-25.93824999999986,2635.6666666666665,36,16,24,52
4734,7.099500000002254,2509.3333333333335,47,6,23,53
4735,7.183500000001857,4049.842105263158,53,6,20,59
4736,-11.253749999998321,3302.0526315789475,34,7,30,41
4737,-20.67099999999956,2185.294117647059,36,11,23,47
4738,-7.7642499999976575,3517.5789473684213,42,23,10,65
4739,11.311250000001051,3648.6666666666665,66,12,17,78
4740,-32.51424999999985,2338.222222222222,17,8,28,25
4741,-20.41399999999888,2670.4736842105262,26,1,29,27
4742,-39.53150000000022,2193.705882352941,25,25,18,50
4743,-1.7507499999980858,3374.5,45,5,24,50
4744,4.449000000002735,2825.0,48,5,31,53
4745,17.786750000002453,2973.470588235294,60,11,23,71
4746,1.5112500000013622,3891.842105263158,57,11,17,68
4747,-6.519999999998888,4740.15,44,13,19,57
4748,-6.823249999999288,2756.705882352941,53,18,23,71
4749,-0.36799999999826066,5099.65,48,15,22,63
4750,-2.7469999999985175,2592.222222222222,29,12,31,41
4751,-25.47649999999895,2497.5789473684213,21,11,21,32
4752,-43.588249999999576,1429.0,10,9,28,19
4753,-32.15424999999945,1988.3529411764705,17,12,24,29
4754,-12.933999999999306,2600.1111111111113,35,4,24,39
4755,1.244250000000325,2924.8823529411766,57,12,19,69
4756,-9.96549999999829,2679.5,49,11,22,60
4757,4.195000000000705,3523.5263157894738,48,13,25,61
4758,-3.879499999997568,2246.5,59,12,22,71
4759,2.3845000000007057,2464.8125,58,19,6,77
4760,-21.17999999999942,2994.277777777778,36,11,19,47
4761,-5.360750000000019,2219.1666666666665,35,17,25,52
4762,-12.600749999999817,2666.2631578947367,33,10,27,43
4763,-19.94599999999975,2619.5789473684213,31,10,21,41
4764,-18.073999999999437,2512.8888888888887,40,6,24,46
4765,-17.331999999998594,3849.7,48,17,19,65
4766,21.936500000002216,5278.35,69,8,20,77
4767,-18.836000000000332,2168.529411764706,42,16,18,58
4768,-7.296499999998849,5351.3,52,13,25,65
4769,-12.7584999999978,3536.7894736842104,44,13,20,57
4770,-15.19224999999948,2563.1111111111113,34,12,18,46
4771,-20.60874999999946,2544.2,25,5,19,30
4772,-9.882499999998503,3238.684210526316,38,7,19,45
4773,-20.09399999999922,3318.7894736842104,34,11,17,45
4774,-15.150249999998584,2988.684210526316,36,11,18,47
4775,0.4575000000016537,1742.5625,36,21,11,57
4776,-11.678249999999068,2110.6470588235293,62,13,23,75
4777,-11.34799999999866,2497.235294117647,34,9,25,43
4778,-1.8462499999985227,3927.45,40,5,26,45
4779,-32.14249999999938,2591.1052631578946,23,3,47,26
4780,3.7880000000014418,5262.35,57,6,16,63
4781,-25.707249999999128,2953.684210526316,31,8,26,39
4782,-20.079499999999538,3577.5,26,11,23,37
4783,-27.18674999999944,3084.3333333333335,33,5,26,38
4784,-29.36249999999917,2721.2,23,12,18,35
4785,-7.859499999997967,2751.8333333333335,43,15,17,58
4786,-5.253999999998786,3606.315789473684,47,5,29,52
4787,-35.60925000000053,1429.0,10,10,59,20
4788,-25.369499999999544,2490.95,10,9,23,19
4789,12.028250000001835,2520.266666666667,47,14,21,61
4790,-10.433249999998546,3324.5882352941176,55,11,21,66
4791,-6.830749999998602,1898.3125,43,22,18,65
4792,-39.59924999999918,1608.6875,12,12,20,24
4793,-6.812499999998633,1429.0,40,10,30,50
4794,-15.485499999999638,2115.294117647059,32,13,18,45
4795,3.7622500000029775,2991.777777777778,54,19,17,73
4796,-15.189000000000323,1933.235294117647,35,18,20,53
4797,0.4797500000011814,2735.0555555555557,39,15,20,54
4798,-26.152749999998207,1967.8823529411766,26,16,20,42
4799,-30.45424999999952,1643.3125,27,19,25,46
4800,-21.107999999999528,2407.8333333333335,25,13,15,38
4801,-33.53624999999804,2400.8888888888887,35,11,23,46
4802,-13.320499999998614,3776.65,33,12,31,45
4803,-10.28649999999945,2218.5263157894738,29,17,21,46
4804,-25.41249999999946,2227.1111111111113,31,11,27,42
4805,-1.8842499999990068,3818.7,39,13,19,52
4806,-38.21799999999976,1685.8235294117646,22,7,39,29
4807,13.876750000001639,3467.3529411764707,61,2,20,63
4808,-13.344499999999224,2701.3684210526317,31,8,21,39
4809,9.718250000001822,3449.277777777778,72,16,20,88
4810,3.5062500000020167,3987.2105263157896,56,9,14,65
4811,-40.985499999999504,2229.95,8,4,28,12
4812,1.0730000000005413,2282.529411764706,46,6,25,52
4813,-13.957499999998095,3191.9444444444443,47,7,24,54
4814,-20.713249999999583,2134.375,38,13,25,51
4815,-21.39224999999902,4337.05,43,8,21,51
4816,-23.697249999999695,2373.5,21,7,34,28
4817,-35.27849999999972,1727.8235294117646,9,20,13,29
4818,-11.118249999999176,2814.4444444444443,35,8,24,43
4819,-1.4372499999991777,3325.5263157894738,36,4,20,40
4820,-8.709999999999145,1481.9333333333334,42,13,25,55
4821,-40.078999999999056,2264.4736842105262,17,4,28,21
4822,8.787750000001399,3936.1111111111113,73,11,12,84
4823,13.600250000002717,2476.75,52,8,26,60
4824,-34.93424999999937,2210.6470588235293,26,8,27,34
4825,-37.00724999999944,1921.9473684210527,12,17,18,29
4826,-2.5594999999993795,2494.4117647058824,56,6,22,62
4827,-9.424999999998839,3170.777777777778,47,4,20,51
4828,-0.828749999999042,3181.7368421052633,47,8,16,55
4829,-3.0797499999993954,3335.4736842105262,43,3,26,46
4830,-1.0894999999988093,2041.1875,47,13,14,60
4831,-21.7347499999994,2360.8823529411766,28,11,18,39
4832,-26.08849999999968,2611.2105263157896,28,7,21,35
4833,3.329000000001828,4128.368421052632,53,3,23,56
4834,-14.956499999998865,2072.777777777778,28,8,20,36
4835,-20.36075000000003,2806.4444444444443,36,11,31,47
4836,-6.6172499999981635,2316.0588235294117,45,9,25,54
4837,4.75775000000125,3158.3529411764707,54,16,11,70
4838,-32.14374999999997,1973.1666666666667,28,9,39,37
4839,-24.680249999999113,2598.6315789473683,21,9,25,30
4840,-8.623249999999235,2983.6470588235293,43,21,20,64
4841,-25.2662499999983,3840.15,37,15,19,52
4842,0.9250000000014117,2916.722222222222,57,11,19,68
4843,-17.74899999999971,2561.157894736842,18,10,43,28
4844,-20.281249999999538,1536.1875,41,22,19,63
4845,-4.332749999999786,2041.125,27,4,25,31
4846,-10.14299999999942,2092.222222222222,30,14,22,44
4847,-26.01449999999941,2063.1666666666665,19,7,28,26
4848,-41.77324999999999,1429.0,7,9,49,16
4849,-21.005499999999223,2085.470588235294,22,8,27,30
4850,-31.944250000000316,1429.0,32,7,34,39
4851,-26.982249999999425,2261.0,31,17,22,48
4852,-22.28849999999881,2536.6666666666665,28,10,23,38
4853,-26.99574999999957,2644.15,18,6,25,24
4854,14.792000000001684,2652.176470588235,62,13,18,75
4855,-13.61349999999955,2188.0,32,14,25,46
4856,-6.749749999997573,4330.75,55,12,18,67
4857,21.33475000000195,5084.8421052631575,62,10,20,72
4858,6.859750000001616,4967.105263157895,70,3,22,73
4859,3.855500000002541,2676.8333333333335,56,8,17,64
4860,-25.905499999999613,2283.684210526316,17,13,24,30
4861,-18.54699999999776,4106.631578947368,45,8,31,53
4862,-2.3699999999993695,2600.222222222222,49,8,25,57
4863,-14.501499999999197,3189.3684210526317,30,12,23,42
4864,-0.07400000000031097,2067.764705882353,52,6,22,58
4865,-17.72049999999934,2929.4736842105262,30,12,24,42
4866,-20.45399999999886,2067.705882352941,48,11,28,59
4867,16.11125000000294,4652.9473684210525,67,13,32,80
4868,3.7630000000010027,4346.5,54,4,15,58
4869,8.140000000003386,2685.6666666666665,66,19,15,85
4870,-24.411249999998525,2545.5555555555557,23,13,30,36
4871,-31.49499999999926,2185.1052631578946,16,16,17,32
4872,-16.421999999998814,3701.35,43,9,21,52
4873,-19.418999999998753,3652.0526315789475,38,19,15,57
4874,-11.929499999998914,3842.55,41,17,22,58
4875,-4.490999999997659,3021.8823529411766,56,14,25,70
4876,-27.303999999997707,2390.277777777778,39,16,18,55
4877,-35.144249999999765,2052.5555555555557,24,16,23,40
4878,-26.473249999998284,1809.0,32,7,29,39
4879,-18.266249999999737,1857.625,38,13,27,51
4880,-19.78824999999944,2453.3529411764707,29,18,15,47
4881,-16.03974999999842,2327.294117647059,37,2,30,39
4882,-16.43799999999844,2609.777777777778,31,7,25,38
4883,-15.919249999998337,2346.9411764705883,38,5,21,43
4884,-10.24799999999901,2505.0,34,8,22,42
4885,-20.532749999999293,2807.235294117647,40,11,27,51
4886,3.403500000001587,3163.6111111111113,46,17,25,63
4887,-5.931749999999142,2727.1666666666665,42,5,25,47
4888,-11.021249999999275,3206.8888888888887,37,19,21,56
4889,-14.030999999998318,4117.15,41,11,13,52
4890,15.410500000002923,4982.105263157895,77,12,23,89
4891,-1.028499999999019,2450.529411764706,51,13,26,64
4892,-30.471249999998683,1589.6470588235295,10,11,31,21
4893,-31.513999999998752,2069.1052631578946,14,11,29,25
4894,-26.324249999999456,1476.6,27,14,27,41
4895,15.928250000000522,2152.3125,70,18,23,88
4896,-7.554749999997149,2362.823529411765,51,5,28,56
4897,-14.857499999997609,2057.4117647058824,37,10,27,47
4898,-25.55275000000026,2185.3529411764707,46,10,23,56
4899,12.710750000001832,2877.176470588235,56,18,17,74
4900,-15.853249999999576,1429.0,25,21,18,46
4901,-23.602499999998628,2638.1111111111113,29,10,21,39
4902,6.031750000001447,4672.0,51,10,28,61
4903,-37.50124999999847,2722.8,23,13,23,36
4904,43.493250000002156,3223.6470588235293,65,15,17,80
4905,-2.122749999999398,3723.55,43,14,14,57
4906,-21.019499999999198,1988.4117647058824,23,16,20,39
4907,-8.815249999999878,3292.842105263158,54,22,12,76
4908,-11.846499999999343,2801.3,19,18,16,37
4909,3.8232500000024965,2980.277777777778,45,12,30,57
4910,-19.08974999999841,2882.3333333333335,32,7,29,39
4911,-9.24549999999783,2651.3125,44,12,25,56
4912,-34.320250000000165,2104.842105263158,14,6,41,20
4913,-13.316999999998345,4685.4,43,14,24,57
4914,-1.3354999999993664,3659.7368421052633,64,11,23,75
4915,-4.4462499999982885,3018.1052631578946,44,6,22,50
4916,-37.78374999999929,2835.8947368421054,20,3,30,23
4917,2.112750000000232,3978.7368421052633,49,16,29,65
4918,17.21500000000232,3183.9444444444443,51,12,22,63
4919,-17.820999999998918,2130.5625,29,3,37,32
4920,-17.742749999998868,2616.0,48,13,24,61
4921,-1.5369999999977015,3023.375,70,4,15,74
4922,-20.702749999998236,2398.3125,41,16,24,57
4923,-15.01749999999908,2594.25,27,14,14,41
4924,-14.409999999999206,3505.8333333333335,46,14,36,60
4925,-32.28574999999883,2158.4444444444443,24,7,29,31
4926,5.335750000001996,4510.210526315789,68,10,16,78
4927,-38.54349999999899,2741.4736842105262,19,12,28,31
4928,-5.989249999997339,4809.25,61,6,27,67
4929,-12.216999999998611,2014.3125,36,9,19,45
4930,-31.627750000000354,2931.722222222222,38,11,38,49
4931,-23.65574999999972,1429.0,29,4,28,33
4932,-32.45649999999996,2452.777777777778,17,5,33,22
4933,-26.50574999999953,3661.6,23,16,17,39
4934,12.999750000000322,3754.3888888888887,75,23,19,98
4935,3.645250000000934,3746.5,47,19,13,66
4936,-3.8249999999993562,4097.421052631579,53,16,14,69
4937,-14.937999999999537,1505.2,23,17,22,40
4938,6.045000000001773,2601.625,56,6,21,62
4939,-19.65449999999895,2743.3,33,20,13,53
4940,-15.871249999999126,4063.15,38,9,21,47
4941,-5.539499999998185,3338.277777777778,61,8,34,69
4942,6.149250000001278,2514.9411764705883,47,5,25,52
4943,-18.619749999999406,4029.1,37,7,21,44
4944,-31.277249999999498,1954.764705882353,16,9,29,25
4945,-8.75949999999816,4147.473684210527,56,10,17,66
4946,-23.41449999999932,2587.75,23,2,28,25
4947,-33.38799999999899,2801.7368421052633,29,14,21,43
4948,19.34750000000196,4109.9473684210525,77,8,18,85
4949,-21.39174999999879,2597.0,33,12,17,45
4950,-16.10224999999918,2924.8823529411766,38,12,21,50
4951,2.9607500000017666,2245.1176470588234,41,8,22,49
4952,-24.310999999999,2865.65,26,7,20,33
4953,-3.08449999999875,4615.65,47,10,25,57
4954,-21.922499999999214,2955.4210526315787,32,9,20,41
4955,-12.783249999999178,2730.0,25,10,17,35
4956,-43.82374999999986,1429.0,0,9,23,9
4957,-23.58425000000017,2384.0,43,12,24,55
4958,-9.419999999999357,3661.4210526315787,60,13,18,73
4959,-29.30524999999893,2192.722222222222,26,12,25,38
4960,-23.19349999999985,2529.8823529411766,62,24,23,86
4961,-19.045749999999114,2143.235294117647,40,14,18,54
4962,-17.348249999998664,2383.4375,40,11,18,51
4963,-22.79649999999993,2696.3684210526317,32,8,22,40
4964,-8.725999999998482,3249.3684210526317,37,8,21,45
4965,-4.680499999998672,2592.1666666666665,45,13,15,58
4966,12.37950000000152,2064.0,47,5,23,52
4967,-0.3107499999993424,3522.6315789473683,37,8,28,45
4968,-17.061749999998458,3055.684210526316,33,10,26,43
4969,-7.581999999999381,4192.578947368421,63,10,19,73
4970,-34.32950000000005,1448.0666666666666,17,9,41,26
4971,-29.016249999998905,2532.3,20,10,23,30
4972,-18.31324999999962,2210.529411764706,33,11,21,44
4973,-6.594249999997849,1951.875,54,10,24,64
4974,-10.285749999997874,1581.8125,31,19,20,50
4975,-11.613499999999537,2794.9473684210525,34,9,22,43
4976,-22.512499999999232,2175.125,33,14,21,47
4977,-7.398749999998256,4193.473684210527,61,11,29,72
4978,-14.971249999998212,3619.65,39,10,21,49
4979,-12.41124999999899,3354.7368421052633,31,10,32,41
4980,-50.748750000000015,2658.7894736842104,12,10,54,22
4981,-29.646499999999357,2120.7368421052633,13,14,22,27
4982,-13.322749999999681,1782.1875,31,7,32,38
4983,-30.472249999999754,2250.4375,36,5,23,41
4984,-21.82499999999945,2823.4210526315787,34,14,21,48
4985,5.188250000001209,3847.0,57,19,13,76
4986,-4.299249999997926,3477.5555555555557,59,5,22,64
4987,-3.47424999999794,3719.277777777778,67,8,16,75
4988,-7.408999999999307,3094.0526315789475,27,10,22,37
4989,-4.958749999999606,3170.722222222222,43,13,25,56
4990,-14.080249999998793,3900.2105263157896,46,15,21,61
4991,-45.80424999999945,1719.6875,21,12,39,33
4992,-27.153999999999503,2809.2,20,10,25,30
4993,-16.699249999999175,2631.9444444444443,24,6,27,30
4994,-4.7004999999986605,4194.95,46,12,20,58
4995,-19.20899999999834,3763.15,42,4,23,46
4996,-24.220999999999034,3258.9444444444443,37,6,22,43
4997,-23.903749999999167,2441.4444444444443,29,8,27,37
4998,-3.735999999998851,2307.6470588235293,50,18,23,68
4999,-17.3422499999999,2275.5555555555557,39,17,19,56
5000,-11.763999999998617,2596.294117647059,43,8,28,51
5001,-2.3827499999989357,2548.1875,40,15,15,55
5002,-32.43824999999966,2111.5789473684213,12,12,22,24
5003,-19.07724999999983,2798.315789473684,30,5,21,35
5004,-5.737499999999004,4593.4,46,8,24,54
5005,-14.407499999998526,2032.3125,38,21,19,59
5006,-21.87449999999884,2554.222222222222,31,9,21,40
5007,5.592000000000915,4770.3,59,11,11,70
5008,-11.934250000000075,2697.9411764705883,54,9,25,63
5009,-24.594000000000175,2260.9411764705883,48,14,25,62
5010,-3.643249999999367,2250.8888888888887,41,14,28,55
5011,-26.444249999998675,3780.0526315789475,43,6,28,49
5012,1.7190000000009227,4024.277777777778,52,11,25,63
5013,-25.23274999999861,2638.0,33,10,26,43
5014,-33.10224999999933,2587.7894736842104,19,8,29,27
5015,1.7322500000003909,2612.4444444444443,44,8,23,52
5016,-21.37599999999957,2229.8333333333335,23,14,18,37
5017,-19.62424999999867,2277.3888888888887,29,10,23,39
5018,23.637000000003002,6315.6,91,11,16,102
5019,-15.281499999998337,2803.0,32,18,17,50
5020,0.7427500000003657,3579.8888888888887,61,5,25,66
5021,-9.971499999998946,2054.0,39,20,21,59
5022,2.3007500000014165,2735.1111111111113,45,5,17,50
5023,-10.9422499999999,1438.5333333333333,30,5,28,35
5024,-20.093999999999546,1429.0,26,7,26,33
5025,-7.466249999997894,4636.15,53,18,13,71
5026,-17.505999999998426,3269.65,35,10,21,45
5027,-32.6904999999986,1473.6875,17,18,19,35
5028,-27.151499999998784,2577.7368421052633,20,12,27,32
5029,18.570500000002987,3114.3888888888887,65,6,23,71
5030,4.434250000000839,3792.5263157894738,67,12,14,79
5031,10.09125000000154,4854.55,62,15,20,77
5032,6.845750000002039,4927.45,59,7,22,66
5033,2.4125000000010166,4369.5,47,14,20,61
5034,-35.86824999999955,2171.5,17,8,25,25
5035,-22.983250000000048,2822.5263157894738,34,2,27,36
5036,-12.324999999998301,3166.7368421052633,36,9,18,45
5037,-28.38174999999966,2471.3333333333335,33,6,21,39
5038,-39.87449999999994,1429.0,12,7,33,19
5039,-29.50824999999903,3209.25,34,6,22,40
5040,-23.094249999999555,2681.3684210526317,35,10,20,45
5041,7.937000000001822,3144.3333333333335,48,4,21,52
5042,-7.32424999999895,2855.9444444444443,37,10,19,47
5043,12.26199999999973,1429.0,56,22,23,78
5044,-26.104249999999467,2455.0,30,13,16,43
5045,-11.152499999998806,2803.0555555555557,38,2,23,40
5046,-7.889999999998554,2591.277777777778,31,9,27,40
5047,-14.190499999999071,4360.578947368421,46,10,23,56
5048,14.43125000000094,2635.4117647058824,74,10,17,84
5049,0.0687500000008873,2210.875,44,6,26,50
5050,-13.523749999998651,2646.315789473684,27,4,28,31
5051,-34.25299999999873,2694.05,22,16,21,38
5052,-9.689499999997212,3010.764705882353,69,14,18,83
5053,-16.712999999998672,2660.529411764706,36,7,23,43
5054,1.6232500000001622,3395.6315789473683,46,12,17,58
5055,-25.71724999999912,3288.5,29,10,20,39
5056,-2.7827499999983116,2685.6666666666665,40,8,26,48
5057,-27.222999999999267,3891.8947368421054,46,10,24,56
5058,-2.3919999999990345,2077.0,49,11,22,60
5059,-18.039249999999253,3331.2631578947367,32,10,25,42
5060,-3.29900000000018,3214.777777777778,60,18,19,78
5061,-33.229249999999396,2483.315789473684,14,13,24,27
5062,-28.579749999998405,2779.15,25,14,20,39
5063,-43.605500000000106,1870.7058823529412,8,6,62,14
5064,-27.773250000000253,1429.0,18,12,26,30
5065,2.4872500000024744,2572.777777777778,44,13,27,57
5066,-13.11249999999952,3500.8947368421054,33,3,31,36
5067,-4.253749999998581,3354.1666666666665,47,13,20,60
5068,-39.6529999999993,2586.2,14,19,25,33
5069,-2.928249999998043,2245.1176470588234,39,9,23,48
5070,-14.918749999998985,1571.8666666666666,36,7,34,43
5071,-4.853499999997998,3271.2105263157896,46,8,26,54
5072,-18.882249999997818,2834.6666666666665,34,2,37,36
5073,-27.952499999999027,2166.842105263158,13,11,26,24
5074,4.262500000001561,4049.8333333333335,63,10,23,73
5075,-11.433749999999003,3296.5,31,18,19,49
5076,-8.006499999998407,2661.3684210526317,29,7,26,36
5077,-12.22549999999956,2210.705882352941,39,14,18,53
5078,-7.992999999998612,3815.65,36,5,27,41
5079,-39.703000000000095,1786.6470588235295,19,10,35,29
5080,-12.10474999999911,2374.0,50,4,25,54
5081,-15.612499999997889,3148.315789473684,38,5,32,43
5082,-32.384250000000385,2357.6666666666665,23,10,41,33
5083,-23.09449999999906,2064.0588235294117,28,17,24,45
5084,-23.408749999998932,2160.1111111111113,18,14,24,32
5085,-40.381999999998776,1953.7777777777778,17,0,34,17
5086,-5.9809999999991685,2944.5789473684213,46,11,19,57
5087,-28.25974999999902,2320.5555555555557,27,9,24,36
5088,-15.626249999998468,2699.8888888888887,25,1,36,26
5089,-17.01324999999926,2803.3684210526317,28,17,15,45
5090,-26.292749999999376,2587.842105263158,22,8,20,30
5091,-16.766249999999715,2385.8333333333335,29,8,23,37
5092,-19.413249999998406,2792.3333333333335,40,10,19,50
5093,-28.21999999999877,2384.842105263158,9,5,46,14
5094,-21.975999999998926,2813.5,35,14,29,49
5095,-18.934249999998126,3467.95,34,12,24,46
5096,-24.241749999999396,2760.0,26,11,20,37
5097,-15.465999999998184,3908.45,38,10,26,48
5098,-22.546499999999327,2319.764705882353,43,10,29,53
5099,-12.388999999999099,3774.722222222222,53,4,23,57
5100,-5.655499999999409,3955.315789473684,58,7,25,65
5101,-15.263249999998504,3700.5,42,7,25,49
5102,-10.926749999997599,2326.777777777778,39,13,19,52
5103,-0.9789999999985343,3398.1052631578946,46,15,14,61
5104,-1.2474999999977299,2665.294117647059,45,13,22,58
5105,-4.790499999999435,2691.8333333333335,43,9,28,52
5106,-17.865249999999882,3003.1666666666665,43,14,19,57
5107,-18.43924999999863,3761.65,44,5,27,49
5108,4.144500000001539,3773.0,54,9,24,63
5109,-11.382749999999072,3067.4736842105262,39,14,20,53
5110,10.882000000000417,3270.277777777778,53,15,20,68
5111,-10.368999999999284,2917.6111111111113,59,4,21,63
5112,-15.576999999999193,2193.722222222222,27,17,14,44
5113,-2.190249999998655,4274.3,56,8,25,64
5114,-22.378999999999316,3971.85,35,5,31,40
5115,-13.927499999998807,3701.25,37,13,21,50
5116,3.8345000000019334,4236.0526315789475,63,12,23,75
5117,-26.59699999999956,2118.1176470588234,35,15,30,50
5118,-33.11299999999936,3010.5263157894738,21,12,30,33
5119,1.4147500000012931,2353.75,49,18,17,67
5120,7.309750000001817,4008.5,47,8,20,55
5121,-26.613499999999572,2114.529411764706,24,4,23,28
5122,-25.532999999999323,3799.7,31,9,28,40
5123,-24.709499999999643,2629.9,17,8,19,25
5124,-1.6732499999985062,3060.4444444444443,55,7,21,62
5125,-21.02749999999991,1952.0526315789473,31,3,24,34
5126,-30.77374999999875,1803.4117647058824,23,10,31,33
5127,-26.077750000000396,1429.0,33,15,26,48
5128,-21.107499999998126,2339.9444444444443,42,12,19,54
5129,-27.197999999999393,2572.7,18,9,24,27
5130,0.5520000000007783,4320.473684210527,46,6,26,52
5131,-4.710499999998891,4417.368421052632,59,9,21,68
5132,-34.0707499999985,2160.0555555555557,18,7,34,25
5133,1.8215000000016004,4243.35,56,11,16,67
5134,-4.366999999998999,3666.315789473684,45,14,14,59
5135,-22.899499999999556,1524.2666666666667,17,16,25,33
5136,-10.804749999998606,3211.222222222222,39,4,27,43
5137,-17.027499999998607,2322.3888888888887,28,19,16,47
5138,-12.365249999998424,4097.35,49,9,20,58
5139,-30.672499999998877,1429.0,37,10,25,47
5140,-15.450499999998865,2691.8333333333335,27,9,30,36
5141,-13.302499999999341,2685.45,22,10,16,32
5142,-5.569249999998528,3941.5,62,13,11,75
5143,-11.643249999998762,3966.315789473684,41,19,28,60
5144,-31.892999999998985,3305.315789473684,26,12,30,38
5145,-31.921499999999572,2051.823529411765,16,5,26,21
5146,-15.058749999998094,3745.7,36,9,25,45
5147,12.09225000000179,3446.722222222222,56,15,16,71
5148,-0.9217499999987124,3380.684210526316,64,9,26,73
5149,-1.4179999999992288,3033.8947368421054,38,14,13,52
5150,-13.972749999999309,4249.473684210527,45,9,26,54
5151,29.83025000000101,4188.421052631579,57,4,22,61
5152,-15.37324999999846,3079.9,31,9,26,40
5153,12.516000000000625,4000.5,68,3,18,71
5154,-34.689749999999634,1455.8125,11,5,34,16
5155,-0.6032499999984178,2647.6470588235293,56,13,21,69
5156,11.905500000002592,2961.722222222222,66,4,26,70
5157,-11.36224999999816,3024.7368421052633,42,4,28,46
5158,9.079000000003585,2261.9411764705883,57,7,30,64
5159,-5.162999999998651,3767.95,40,8,23,48
5160,1.2010000000011214,3653.0526315789475,58,13,21,71
5161,-23.482499999997348,2174.222222222222,40,11,21,51
5162,4.9162500000015275,4000.3684210526317,61,11,20,72
5163,-2.4097499999978296,3017.1052631578946,44,14,15,58
5164,-0.6527499999982074,4079.842105263158,67,7,19,74
5165,-32.52999999999899,3668.65,27,10,31,37
5166,-20.070999999998755,1606.4705882352941,21,21,22,42
5167,-9.102249999999623,2017.2941176470588,37,22,21,59
5168,-18.27399999999845,3774.35,39,5,18,44
5169,-14.14899999999852,3816.684210526316,61,7,19,68
5170,-18.13049999999817,5294.1,57,8,28,65
5171,-24.267999999998793,1787.1875,26,9,23,35
5172,-24.87749999999982,1714.75,32,15,20,47
5173,-19.36599999999847,1429.0,30,23,21,53
5174,19.09275000000034,2274.0,58,11,15,69
5175,28.57650000000087,3529.9411764705883,82,23,13,105
5176,-11.602999999998861,2178.0,33,6,21,39
5177,11.965750000001512,5467.15,60,10,19,70
5178,-9.64724999999947,1594.6875,41,15,18,56
5179,-16.869999999999475,2198.4117647058824,30,5,39,35
5180,2.520750000000983,3478.2631578947367,41,14,22,55
5181,-12.998999999998967,3009.0,34,6,22,40
5182,-21.748999999999292,2496.9444444444443,26,9,22,35
5183,-30.97249999999958,2034.6842105263158,14,6,25,20
5184,-38.615999999998955,2361.823529411765,24,12,30,36
5185,-25.557499999999138,3018.842105263158,28,3,21,31
5186,5.537500000003876,6065.65,73,7,23,80
5187,1.6852500000005093,2460.722222222222,46,11,17,57
5188,-12.490749999999007,2477.5555555555557,31,4,23,35
5189,-19.85124999999807,2775.7894736842104,34,4,25,38
5190,-27.36524999999825,4629.9,46,13,28,59
5191,-20.853499999999766,2512.8333333333335,40,10,29,50
5192,-34.25149999999918,2102.3684210526317,12,19,20,31
5193,-32.943499999998835,3573.133333333333,26,13,31,39
5194,-8.818249999997695,4123.368421052632,51,8,36,59
5195,-29.846999999998843,3153.6,32,15,16,47
5196,20.085000000002,3828.4210526315787,55,5,22,60
5197,8.159500000002128,4745.684210526316,53,7,21,60
5198,-1.354749999998455,3247.3333333333335,43,9,22,52
5199,-3.0084999999985564,4387.0,57,12,12,69
5200,-13.835000000000443,2205.875,66,12,27,78
5201,-6.883499999999147,3108.1111111111113,43,14,19,57
5202,29.191250000004327,2993.1176470588234,82,7,18,89
5203,4.333000000000713,2229.625,44,21,16,65
5204,-20.657499999999548,2786.6315789473683,29,14,17,43
5205,-4.083249999999192,3989.684210526316,53,14,16,67
5206,-33.6339999999994,1653.25,9,20,21,29
5207,-30.95674999999922,2229.85,9,14,25,23
5208,-6.345999999998697,2912.764705882353,47,8,25,55
5209,-16.25000000000037,1554.0625,36,18,21,54
5210,-26.751999999998937,3062.45,25,23,18,48
5211,-10.044999999998234,3297.0,48,14,21,62
5212,-35.30624999999876,2505.157894736842,19,15,19,34
5213,-11.317999999999179,4131.833333333333,50,10,20,60
5214,-18.387999999999145,3753.6,33,10,13,43
5215,-37.31874999999971,1528.25,8,13,16,21
5216,3.4327500000010085,3619.6111111111113,56,10,26,66
5217,-14.281249999999599,3512.5789473684213,45,8,30,53
5218,-28.137749999999187,2661.2631578947367,20,13,17,33
5219,-28.39749999999964,1912.764705882353,21,13,14,34
5220,-11.037999999999693,2471.0588235294117,41,21,21,62
5221,-8.801999999998852,2479.4117647058824,41,10,21,51
5222,-6.732999999999822,2177.0588235294117,47,11,20,58
5223,-32.27149999999907,2289.0,20,17,22,37
5224,-8.355749999999647,3105.684210526316,48,10,19,58
5225,-3.3692499999979146,3018.294117647059,50,17,13,67
5226,-18.779999999999543,1951.0,19,12,17,31
5227,-1.2417499999973902,3450.7368421052633,54,17,16,71
5228,-15.415749999998999,3671.25,41,4,25,45
5229,-8.33874999999866,2663.842105263158,34,11,19,45
5230,-2.9422499999986518,5021.1,48,14,22,62
5231,-0.40774999999810746,3772.8,41,13,23,54
5232,-24.61174999999924,2536.95,18,10,25,28
5233,-17.98299999999881,3072.05,34,10,21,44
5234,-9.331749999998097,4391.85,56,8,17,64
5235,-15.01774999999921,2647.529411764706,37,21,20,58
5236,-39.477249999999366,3136.15,25,15,24,40
5237,-31.80124999999942,4539.4,42,18,17,60
5238,5.266500000000745,4251.105263157895,61,10,11,71
5239,-10.795249999998441,2639.777777777778,34,5,29,39
5240,-4.564499999997951,3226.9473684210525,44,4,23,48
5241,-26.827249999999857,2603.6666666666665,42,15,24,57
5242,-15.336000000000022,1719.75,36,11,18,47
5243,-32.34399999999939,2669.5,17,6,26,23
5244,-31.18374999999934,2643.0526315789475,20,11,22,31
5245,-19.22499999999926,2756.5789473684213,35,6,16,41
5246,-9.92199999999925,1684.0,36,8,20,44
5247,0.33875000000209426,4946.4,65,7,15,72
5248,-40.768749999999805,1710.75,18,17,24,35
5249,-2.824999999997973,2825.8125,46,13,20,59
5250,10.164750000003083,3734.842105263158,61,5,26,66
5251,-20.72574999999952,1684.0,46,9,25,55
5252,-20.029999999998672,4159.25,43,10,19,53
5253,-25.777749999999077,2476.6111111111113,41,12,28,53
5254,-15.766499999998723,2232.0588235294117,36,29,8,65
5255,8.784750000001708,3679.5,59,14,13,73
5256,-13.546249999998816,3253.684210526316,35,17,18,52
5257,-12.709999999998747,2030.4117647058824,25,19,17,44
5258,2.181750000001261,2524.375,58,21,16,79
5259,4.362250000002165,3805.842105263158,43,12,23,55
5260,-8.770999999999097,2913.222222222222,39,12,16,51
5261,3.2282500000020056,3315.4615384615386,39,15,20,54
5262,14.281500000001364,3508.4736842105262,53,10,20,63
5263,-16.98499999999914,2716.3888888888887,43,9,30,52
5264,-8.498749999998314,2210.8125,51,7,26,58
5265,7.881500000000825,5062.35,61,10,21,71
5266,3.6980000000010245,2846.277777777778,48,10,13,58
5267,-28.595999999999272,2108.0,19,17,11,36
5268,5.183750000001082,4315.473684210527,67,29,16,96
5269,4.1665000000004895,3823.315789473684,52,8,11,60
5270,0.02375000000191383,2454.235294117647,46,18,9,64
5271,0.05425000000153304,2139.6470588235293,57,17,19,74
5272,8.87925000000285,3235.0555555555557,61,9,20,70
5273,2.1485000000006336,2832.8333333333335,63,6,20,69
5274,-18.05049999999872,2526.176470588235,39,10,28,49
5275,-8.483999999999149,4578.25,43,16,18,59
5276,-11.536499999999984,2090.4444444444443,26,14,14,40
5277,-21.55149999999884,2459.0,26,3,42,29
5278,-10.424499999999332,3236.8947368421054,30,15,21,45
5279,-24.60874999999988,2468.6666666666665,31,10,18,41
5280,-7.103749999998738,2412.294117647059,51,16,18,67
5281,8.416500000001623,2946.470588235294,54,8,21,62
5282,-19.743999999999748,1652.1764705882354,25,10,19,35
5283,-33.902999999999835,3079.8333333333335,29,24,23,53
5284,-6.329749999998022,2598.1176470588234,39,8,23,47
5285,-10.666999999999735,2504.6470588235293,41,9,26,50
5286,-16.36074999999946,2546.764705882353,51,12,18,63
5287,3.3795000000011557,3283.5555555555557,49,7,22,56
5288,-11.420499999999219,3271.222222222222,50,15,11,65
5289,-26.485999999999223,1429.0,20,20,19,40
5290,-3.5872499999991305,2228.6875,54,5,18,59
5291,9.890250000001732,5292.9473684210525,69,7,30,76
5292,-12.518749999998562,5206.15,50,21,17,71
5293,8.891500000002157,2492.6875,51,8,23,59
5294,-26.78174999999963,2197.1111111111113,16,12,20,28
5295,-7.856499999999687,2395.4117647058824,31,21,16,52
5296,-3.2782499999990273,3928.5,48,4,17,52
5297,0.2965000000021982,6235.45,72,11,16,83
5298,-19.58199999999922,1701.875,23,5,23,28
5299,-21.58124999999881,4088.2105263157896,54,9,21,63
5300,-2.090749999999818,4074.0,60,11,24,71
5301,-3.170999999999026,3840.2,40,9,19,49
5302,-22.491499999999306,4799.75,55,7,23,62
5303,2.008250000001978,2539.294117647059,47,11,21,58
5304,-11.967749999998833,2005.4375,36,5,26,41
5305,-5.752499999998504,2828.6470588235293,49,13,18,62
5306,-13.405999999998945,3448.2631578947367,44,15,22,59
5307,-2.763499999997479,3414.0555555555557,47,9,24,56
5308,-18.743999999999314,1680.0,20,14,18,34
5309,-21.727499999999235,3008.8947368421054,32,6,25,38
5310,-17.165499999998776,2495.0,29,9,21,38
5311,-24.114999999998837,4175.9,39,13,19,52
5312,-17.065500000000224,2496.294117647059,37,23,15,60
5313,-1.1069999999967406,2392.6470588235293,58,6,19,64
5314,-11.81800000000006,1532.1875,37,17,19,54
5315,-10.916749999999082,2663.6666666666665,35,11,19,46
5316,-0.5964999999981584,2269.3125,48,8,17,56
5317,-12.981249999997095,2791.5555555555557,48,7,23,55
5318,-32.6469999999994,1429.0,24,12,26,36
5319,-11.330749999998634,3194.95,35,9,24,44
5320,-16.37274999999944,2524.277777777778,58,7,21,65
5321,-11.266999999998998,2371.176470588235,31,7,23,38
5322,-27.174499999998847,2194.705882352941,20,13,22,33
5323,-20.7762499999985,2907.65,23,9,33,32
5324,-21.776249999999774,2527.6315789473683,47,6,23,53
5325,-2.522999999998126,2925.6666666666665,45,9,25,54
5326,-26.433249999999198,1697.9375,18,12,22,30
5327,3.8667500000015904,2585.0,67,11,12,78
5328,-5.007999999998889,2097.5882352941176,48,18,15,66
5329,-26.59974999999941,2922.7,18,6,27,24
5330,-21.024749999999177,2584.3333333333335,37,12,15,49
5331,-17.344249999999867,2989.6315789473683,35,13,19,48
5332,-31.665999999998398,2186.294117647059,25,12,24,37
5333,-17.993749999999437,3138.2631578947367,37,8,27,45
5334,-48.23749999999975,1429.0,0,11,25,11
5335,-18.678249999998776,4172.65,37,18,17,55
5336,-2.0492499999973965,3657.9473684210525,59,16,12,75
5337,-12.971499999999306,2188.176470588235,45,15,19,60
5338,-13.705249999999463,2405.222222222222,22,14,14,36
5339,0.0880000000007188,3060.5,41,20,23,61
5340,1.4960000000021758,3978.842105263158,55,11,16,66
5341,-13.519750000000155,1438.5333333333333,35,14,23,49
5342,10.814250000001616,4267.8421052631575,75,17,17,92
5343,-4.332999999997923,2831.875,51,9,11,60
5344,-6.905249999998665,3048.1052631578946,43,8,18,51
5345,-3.5297499999993085,2916.529411764706,39,11,22,50
5346,-6.827999999999018,3493.4210526315787,30,7,30,37
5347,-25.11424999999944,3474.157894736842,38,8,17,46
5348,3.9525000000008625,3643.7368421052633,53,7,17,60
5349,35.04525000000155,3401.8888888888887,80,10,25,90
5350,-9.200499999998264,2398.25,62,10,23,72
5351,-1.1534999999989652,2534.5882352941176,31,12,32,43
5352,-1.6357499999988305,4348.85,44,9,14,53
5353,-22.232249999999077,3341.722222222222,42,7,19,49
5354,-37.45950000000066,1429.0,17,16,29,33
5355,-7.854749999998279,3448.15,37,17,15,54
5356,-30.004999999999377,2092.0588235294117,38,10,29,48
5357,-24.842749999999754,2073.2105263157896,17,8,19,25
5358,19.643500000001698,2942.0,73,10,18,83
5359,-31.7292499999987,3043.722222222222,19,14,26,33
5360,-14.545499999998267,2063.1176470588234,38,13,20,51
5361,-10.20799999999896,2166.705882352941,34,10,24,44
5362,-15.015999999999355,2981.1666666666665,36,18,33,54
5363,-35.001749999999426,2787.8,25,10,19,35
5364,-22.014249999999546,2448.4444444444443,25,13,22,38
5365,-14.5457499999985,2986.2631578947367,36,6,19,42
5366,-8.22124999999838,5415.6,50,12,13,62
5367,8.29650000000092,3869.315789473684,54,16,16,70
5368,-24.790999999999045,2181.7368421052633,13,12,26,25
5369,-24.09099999999889,2136.375,34,25,16,59
5370,-10.910999999998745,2782.722222222222,49,9,26,58
5371,0.7785000000016481,2362.5625,53,5,17,58
5372,-5.800749999998474,4490.25,50,7,18,57
5373,-8.658749999999255,3267.9,39,10,15,49
5374,18.44750000000281,2873.4444444444443,64,14,17,78
5375,-2.0297499999976387,3072.777777777778,56,12,18,68
5376,-13.196499999998474,3597.25,36,9,17,45
5377,-22.42399999999977,1528.25,8,19,21,27
5378,-0.8929999999997487,2318.9375,49,12,15,61
5379,-11.43624999999849,3560.4444444444443,52,12,25,64
5380,-9.591249999998706,3216.7894736842104,45,10,14,55
5381,-20.65724999999943,2122.764705882353,24,7,25,31
5382,7.668000000001487,3695.4444444444443,60,9,23,69
5383,-24.59375000000037,3010.4736842105262,36,4,31,40
5384,-11.078749999999193,2997.705882352941,48,13,22,61
5385,-37.98649999999971,1429.0,5,13,19,18
5386,-15.089999999999003,2727.1111111111113,49,11,14,60
5387,-14.466249999999459,1514.375,23,13,18,36
5388,-15.694999999999848,2810.8,18,17,12,35
5389,-28.439999999998868,2952.1,23,16,17,39
5390,-11.214499999998537,3145.9473684210525,42,5,18,47
5391,-32.1594999999995,2632.0526315789475,32,13,18,45
5392,-17.220249999999567,3726.7,35,7,17,42
5393,-9.331749999999651,3072.315789473684,25,11,23,36
5394,-8.591250000000079,2639.1176470588234,55,8,21,63
5395,4.806000000000211,3905.2631578947367,53,16,22,69
5396,-25.340749999999623,1898.3125,29,3,31,32
5397,1.2002500000015157,4127.444444444444,80,18,25,98
5398,-5.440249999998837,3310.4210526315787,34,13,24,47
5399,9.775500000001324,3516.0526315789475,64,11,23,75
5400,-17.075499999999863,2063.8888888888887,33,13,19,46
5401,1.4732500000010929,3201.5555555555557,42,18,17,60
5402,-9.041499999998234,2763.277777777778,40,4,26,44
5403,-25.73849999999917,2466.1111111111113,22,11,34,33
5404,0.2725000000023794,2906.1111111111113,53,4,21,57
5405,-8.555749999998458,2223.5882352941176,45,7,23,52
5406,-27.621249999999538,2422.7,13,16,19,29
5407,-0.07724999999924922,4147.578947368421,50,3,19,53
5408,-3.4084999999990075,3208.35,34,11,17,45
5409,-21.563499999998648,1990.1764705882354,40,6,28,46
5410,-19.80049999999988,1481.9333333333334,28,5,24,33
5411,20.606500000000594,4129.1578947368425,57,14,25,71
5412,-11.993499999999589,3473.55,32,10,16,42
5413,-46.0909999999993,2584.222222222222,32,7,38,39
5414,-22.97674999999871,2393.777777777778,31,7,32,38
5415,-13.179999999998543,3566.5555555555557,55,7,19,62
5416,2.623000000001739,2425.125,61,7,18,68
5417,2.1334999999996564,2605.5882352941176,56,10,32,66
5418,-6.577999999998508,3235.1111111111113,45,16,19,61
5419,-23.96699999999941,2564.0,23,10,15,33
5420,-7.965499999999489,2034.0588235294117,31,14,18,45
5421,-13.327499999998969,3547.35,36,12,19,48
5422,-10.315749999999062,3151.7368421052633,36,4,20,40
5423,4.174000000000758,3616.1111111111113,49,6,23,55
5424,-19.31699999999858,2858.6111111111113,35,4,24,39
5425,-4.124999999998765,4451.35,53,8,21,61
5426,-11.815999999998969,2845.222222222222,46,13,14,59
5427,-9.151249999998697,3377.2105263157896,40,3,20,43
5428,-17.045999999998703,2566.35,31,11,14,42
5429,-4.382499999997644,3572.8947368421054,51,4,25,55
5430,-28.735250000000047,1950.0,21,12,30,33
5431,-26.41499999999948,2465.1666666666665,28,8,27,36
5432,-33.92174999999979,1924.9411764705883,14,4,41,18
5433,-48.261249999999464,1626.5,6,13,27,19
5434,-10.46224999999863,2865.1176470588234,45,12,24,57
5435,28.242750000002495,2496.5,71,17,15,88
5436,-18.04424999999945,2912.7894736842104,28,2,24,30
5437,-22.93025000000023,1438.5333333333333,26,12,17,38
5438,-17.164999999999544,2914.4210526315787,42,11,15,53
5439,-6.267999999998333,2255.4375,51,10,21,61
5440,-8.628249999998896,3203.4736842105262,35,11,25,46
5441,-10.020749999998777,3145.0,38,21,9,59
5442,5.927000000001509,3189.1666666666665,60,15,17,75
5443,0.6955000000006132,2887.5882352941176,57,4,19,61
5444,-16.250499999998944,2345.3333333333335,21,19,21,40
5445,-18.61049999999974,2493.4210526315787,38,8,20,46
5446,-7.347249999999072,2906.1111111111113,44,9,21,53
5447,-27.36374999999918,2619.55,20,13,21,33
5448,-25.58349999999927,1429.0,14,17,14,31
5449,-43.9872500000002,2068.3888888888887,21,11,30,32
5450,-37.02174999999986,2117.4736842105262,13,6,33,19
5451,-7.984249999999515,3354.1111111111113,51,7,33,58
5452,-0.5934999999983652,2388.8823529411766,43,6,25,49
5453,-8.445999999998751,2458.9411764705883,40,13,20,53
5454,-32.43399999999965,1917.6666666666667,25,12,21,37
5455,-8.3717499999989,3311.4117647058824,54,17,19,71
5456,-8.265999999998728,3041.9444444444443,37,16,12,53
5457,-12.074499999999043,1993.0,31,6,20,37
5458,18.126250000001185,2465.222222222222,49,20,17,69
5459,-29.044499999998912,1429.0,17,14,19,31
5460,-36.3792499999994,1929.5294117647059,16,19,20,35
5461,5.503250000002735,3470.7894736842104,61,9,16,70
5462,2.7807500000009013,2232.625,44,13,21,57
5463,-33.070749999999755,2325.8333333333335,27,9,28,36
5464,-0.14249999999928137,2425.3529411764707,50,8,15,58
5465,9.603250000001317,4854.315789473684,72,17,15,89
5466,-18.855749999998547,3833.4210526315787,53,10,27,63
5467,-7.653499999998504,2657.1052631578946,37,5,21,42
5468,-20.787999999998792,2685.0625,49,12,16,61
5469,-3.1705000000004313,1429.0,55,13,19,68
5470,-22.897249999998753,2492.6470588235293,45,16,16,61
5471,-43.83450000000006,1429.0,15,7,20,22
5472,-13.720999999999208,3241.0,23,6,25,29
5473,-37.62974999999942,2739.5,18,9,29,27
5474,-0.08874999999906459,4127.55,46,6,17,52
5475,-33.425749999998764,2457.3333333333335,24,17,22,41
5476,-20.88249999999982,2195.4444444444443,38,7,21,45
5477,-0.7022499999995582,2611.5,63,10,13,73
5478,-4.3464999999988425,3403.157894736842,43,11,19,54
5479,7.826250000002412,2383.294117647059,59,8,30,67
5480,-4.549999999998642,3020.4210526315787,41,7,18,48
5481,-2.744249999998739,4087.4210526315787,51,6,28,57
5482,-35.84924999999917,2175.0526315789475,12,9,33,21
5483,-9.712999999999486,2417.6666666666665,39,20,20,59
5484,-26.974999999998555,2703.277777777778,30,8,22,38
5485,1.4005000000015007,4947.25,61,9,20,70
5486,-32.62374999999874,2232.5625,38,8,37,46
5487,-16.885999999999058,4403.7,46,16,19,62
5488,-18.02474999999884,4001.3,39,15,16,54
5489,-7.513499999998851,4584.65,56,12,17,68
5490,-10.455749999999641,3035.777777777778,39,11,19,50
5491,-9.090499999997768,2620.3888888888887,36,11,23,47
5492,-22.960499999998834,3388.9473684210525,35,6,23,41
5493,-36.12149999999984,2245.315789473684,27,7,26,34
5494,17.250750000001673,5564.421052631579,72,8,11,80
5495,-26.562749999999056,2690.0555555555557,25,19,16,44
5496,-6.796499999997913,3537.5,47,11,32,58
5497,-21.567249999998555,1701.875,34,9,27,43
5498,-12.04249999999902,2546.3333333333335,28,6,26,34
5499,-27.121499999999315,2998.722222222222,27,12,43,39
5500,-2.526999999999715,2714.764705882353,65,10,17,75
5501,-18.624499999998626,2640.4210526315787,29,10,22,39
5502,-22.06899999999927,1496.5,23,11,23,34
5503,-1.2049999999985836,3617.9473684210525,44,5,24,49
5504,-6.838499999998874,4701.3,53,8,16,61
5505,12.899750000003593,4160.166666666667,70,9,22,79
5506,-16.239749999998303,3326.777777777778,59,5,34,64
5507,-33.20499999999971,2612.0526315789475,25,14,16,39
5508,-10.95974999999831,2080.823529411765,53,9,19,62
5509,-16.207249999998933,3276.2105263157896,32,12,17,44
5510,-35.75375000000039,2012.888888888889,11,9,55,20
5511,-26.008249999999283,3373.157894736842,44,16,23,60
5512,-18.268999999998016,4314.0,42,17,27,59
5513,-2.7147499999977556,2847.8888888888887,50,12,16,62
5514,1.8185000000006961,2029.1875,49,11,14,60
5515,-15.114499999998907,3203.3333333333335,47,12,25,59
5516,9.695250000001485,3113.3333333333335,42,13,24,55
5517,-31.14050000000011,2599.222222222222,27,11,30,38
5518,-14.418499999998854,2207.722222222222,28,12,22,40
5519,-5.664749999998269,4281.4,46,9,18,55
5520,19.1250000000015,4670.473684210527,67,8,23,75
5521,-12.422999999998355,2855.157894736842,40,11,14,51
5522,-35.63674999999954,1429.0,7,25,17,32
5523,-1.110249999997381,1429.0,46,12,18,58
5524,5.756000000001396,4076.3333333333335,60,12,18,72
5525,-15.92424999999981,2022.0,33,17,19,50
5526,8.464000000000192,2618.6666666666665,44,5,19,49
5527,-7.279249999998673,3638.5,38,13,23,51
5528,-32.11999999999949,2822.75,19,14,18,33
5529,8.98675000000133,3297.6111111111113,58,10,22,68
5530,-26.52324999999925,3214.777777777778,36,12,43,48
5531,-25.200999999998764,2777.45,24,10,21,34
5532,3.6997500000004186,2607.6875,57,14,15,71
5533,-1.668499999999257,2683.842105263158,28,11,17,39
5534,-28.829249999999853,2177.7368421052633,17,3,20,20
5535,-16.259749999999382,2365.5263157894738,18,14,18,32
5536,-16.681999999997707,3413.2631578947367,42,13,23,55
5537,-1.0637499999975453,3370.7368421052633,51,10,23,61
5538,-6.454499999998539,2615.3684210526317,35,14,15,49
5539,-24.390499999999747,1496.5,41,7,26,48
5540,19.174500000000293,3116.0,57,7,17,64
5541,-22.43274999999899,2175.0625,36,14,20,50
5542,-5.4877499999982575,3212.684210526316,49,7,16,56
5543,2.350250000000373,2683.0,37,11,21,48
5544,1.844750000002192,3587.842105263158,55,5,20,60
5545,-15.102749999999014,2443.1666666666665,27,4,28,31
5546,11.73375000000161,3750.9444444444443,68,10,20,78
5547,-7.208499999998985,5238.6,51,12,15,63
5548,-17.44299999999985,1567.9375,23,9,18,32
5549,-1.8384999999972393,2231.5555555555557,49,13,22,62
5550,-38.15649999999995,2125.7368421052633,9,1,36,10
5551,-18.08224999999839,2390.277777777778,28,15,19,43
5552,-10.44824999999964,3404.8947368421054,45,11,26,56
5553,-16.738999999999507,3718.8,26,8,20,34
5554,-8.828249999999377,2489.1666666666665,35,14,24,49
5555,-18.95974999999884,2647.722222222222,37,11,21,48
5556,-33.72699999999955,2097.4736842105262,9,23,13,32
5557,-27.41724999999912,1673.7058823529412,13,19,20,32
5558,-28.75724999999893,2252.722222222222,14,21,27,35
5559,5.985750000000081,1875.5,59,22,17,81
5560,-11.040999999998721,2989.1111111111113,39,6,18,45
5561,-4.907749999997762,2719.8125,56,8,19,64
5562,-9.860249999999285,2651.3333333333335,25,11,25,36
5563,-11.85149999999916,2604.6666666666665,27,7,20,34
5564,-8.164749999998985,3191.0,42,4,15,46
5565,1.5175000000021395,4052.5555555555557,66,15,20,81
5566,-39.92224999999932,1901.7222222222222,14,18,18,32
5567,-26.126249999999754,2030.3125,37,9,25,46
5568,-32.40599999999955,1941.388888888889,17,9,21,26
5569,-20.38349999999865,4102.85,36,15,17,51
5570,-25.48874999999903,3995.75,34,10,27,44
5571,19.541500000001204,3809.2105263157896,68,7,22,75
5572,-25.785249999998864,2491.7368421052633,23,9,25,32
5573,-11.11024999999878,2893.8888888888887,35,7,20,42
5574,13.831500000002839,5054.0,79,5,18,84
5575,-24.639249999999794,2286.1666666666665,17,15,24,32
5576,-41.295249999999555,1556.0588235294117,10,12,22,22
5577,-5.837249999999548,3311.2631578947367,37,6,33,43
5578,-18.196249999999498,2341.470588235294,25,14,27,39
5579,-28.870999999999345,1429.0,12,14,17,26
5580,-14.708249999998696,2081.705882352941,31,7,29,38
5581,-29.175249999999977,1429.0,14,7,40,21
5582,-35.22424999999954,2595.722222222222,15,9,47,24
5583,22.316000000000937,2416.25,62,13,16,75
5584,2.0445000000014386,5951.3,60,4,24,64
5585,-39.967999999999606,1429.0,12,13,22,25
5586,-24.492249999999135,2430.8888888888887,23,9,25,32
5587,13.252749999999626,2361.823529411765,45,14,26,59
5588,-15.28874999999941,3696.4210526315787,30,13,25,43
5589,-7.897249999999431,2883.1666666666665,35,11,22,46
5590,-9.416999999998815,3333.85,31,14,17,45
5591,-0.5104999999995379,3474.0526315789475,60,3,21,63
5592,-38.987749999998705,1429.0,8,12,32,20
5593,-13.96874999999945,2664.294117647059,44,16,24,60
5594,-18.864499999998863,2846.222222222222,35,15,17,50
5595,-24.540000000000283,1448.0666666666666,52,24,19,76
5596,-6.897000000000432,2210.529411764706,45,11,26,56
5597,12.334250000001367,3362.1111111111113,46,19,16,65
5598,-24.00849999999864,3160.8,40,8,15,48
5599,-27.94249999999863,2599.4736842105262,21,5,34,26
5600,-31.62349999999891,3296.2631578947367,34,14,24,48
5601,-11.337749999998803,3974.684210526316,44,9,26,53
5602,4.45750000000103,2504.5882352941176,51,19,17,70
5603,-29.561499999999494,2250.9444444444443,22,15,20,37
5604,-28.721500000000077,2134.8823529411766,23,15,22,38
5605,10.494500000001409,4365.578947368421,75,5,13,80
5606,5.716500000001365,3073.722222222222,42,12,15,54
5607,-40.91949999999971,1496.5,0,19,35,19
5608,-14.360999999999365,3064.1,35,3,16,38
5609,-20.89824999999965,2997.2105263157896,33,5,17,38
5610,-9.43224999999883,4292.55,53,7,15,60
5611,-9.902999999998466,4022.75,48,16,13,64
5612,-14.635249999999605,1429.0,27,22,15,49
5613,-14.357249999998677,2363.777777777778,36,11,16,47
5614,14.358500000001039,2702.5882352941176,66,13,17,79
5615,-10.619749999998664,2545.4444444444443,33,5,30,38
5616,-3.653999999999786,3177.6315789473683,33,9,22,42
5617,-7.952999999998302,2946.3529411764707,59,13,17,72
5618,9.866000000004174,2126.5625,64,11,22,75
5619,-9.627749999999118,3771.5789473684213,42,17,20,59
5620,-5.94799999999907,4049.7894736842104,59,7,30,66
5621,0.8660000000032951,2922.0555555555557,62,5,22,67
5622,12.004750000001039,4829.8,57,12,16,69
5623,-12.975749999999271,2954.764705882353,51,7,24,58
5624,-21.342499999998815,2861.0,26,11,26,37
5625,-46.405749999999514,1741.5625,11,13,26,24
5626,5.703250000001349,3884.4210526315787,53,5,24,58
5627,9.727250000001078,3943.4,51,11,18,62
5628,-10.139249999999267,2685.5789473684213,25,9,27,34
5629,-18.54024999999927,3770.25,36,10,23,46
5630,11.181000000002209,4744.15,56,22,14,78
5631,-4.345249999999047,2821.3888888888887,37,23,18,60
5632,-12.899499999999296,3216.842105263158,39,17,19,56
5633,-3.9987499999981653,5291.0,56,6,24,62
5634,-14.608999999999847,2155.5882352941176,42,9,23,51
5635,-3.484999999998474,4294.1,49,13,20,62
5636,-7.620249999999478,3130.1666666666665,46,15,18,61
5637,-8.809749999998976,2442.1176470588234,46,14,20,60
5638,-39.350999999999544,2452.5263157894738,15,8,23,23
5639,-18.765499999998855,2334.6666666666665,33,7,18,40
5640,-11.08974999999782,2465.8947368421054,30,10,25,40
5641,-26.413749999998977,1546.125,22,12,22,34
5642,-14.741999999999681,1481.9333333333334,40,14,17,54
5643,4.960500000000842,3810.8947368421054,37,14,28,51
5644,-17.42174999999921,2512.3,21,16,15,37
5645,3.9067500000018534,4042.3684210526317,58,14,13,72
5646,-25.557249999999165,2587.0,22,16,12,38
5647,-4.661499999998145,5206.05,45,11,29,56
5648,-3.9692499999985147,2862.9444444444443,47,12,14,59
5649,-16.778749999998336,1701.875,31,6,24,37
5650,6.748000000000802,3891.8947368421054,60,7,22,67
5651,-18.73150000000008,2216.4444444444443,15,18,25,33
5652,17.469250000001345,4410.736842105263,75,7,26,82
5653,14.596750000000906,4757.315789473684,68,4,23,72
5654,-20.91999999999835,2663.0,22,8,30,30
5655,42.45175000000143,2469.8125,74,14,17,88
5656,2.0432500000015836,2339.1111111111113,40,17,18,57
5657,0.015750000000612552,1996.5625,42,15,28,57
5658,-5.5414999999991315,2704.0,43,26,17,69
5659,-15.50049999999917,2896.0526315789475,35,5,23,40
5660,-6.970499999999293,2516.823529411765,32,8,24,40
5661,-44.48274999999938,2810.0,34,10,26,44
5662,-5.522749999999606,2596.176470588235,49,5,20,54
5663,-7.936499999999141,4170.35,44,13,18,57
5664,-11.998749999999864,2403.823529411765,33,13,20,46
5665,5.382750000001233,3158.3333333333335,56,21,14,77
5666,-33.590500000000155,1997.1052631578948,12,7,45,19
5667,8.691500000002417,4898.578947368421,75,9,20,84
5668,11.721250000001232,4694.15,57,9,21,66
5669,-6.823749999998995,4208.45,42,6,23,48
5670,23.048750000001597,5170.0526315789475,66,10,16,76
5671,-15.129499999999819,2028.7777777777778,36,14,18,50
5672,-3.0337499999984683,2173.176470588235,42,22,16,64
5673,-27.80749999999906,2694.25,23,11,17,34
5674,24.19075000000276,2501.5625,66,5,16,71
5675,-17.68799999999874,4150.0,33,9,29,42
5676,-18.01099999999931,4103.7,43,9,26,52
5677,-23.78199999999872,1467.1333333333334,25,16,15,41
5678,21.46425000000186,2317.9375,80,15,15,95
5679,-24.00849999999994,2502.6315789473683,26,15,18,41
5680,-4.630749999999075,3168.5882352941176,63,21,18,84
5681,-0.7819999999987374,4697.3,46,12,16,58
5682,-1.5877499999987612,4167.15,54,10,21,64
5683,-9.38799999999929,3206.842105263158,36,8,21,44
5684,23.390250000001238,5583.05,73,0,23,73
5685,-3.3987499999990183,4423.4,51,13,26,64
5686,-33.21674999999901,1429.0,15,6,31,21
5687,-35.16149999999918,2120.0526315789475,11,16,19,27
5688,-11.146749999998757,1599.6875,25,16,17,41
5689,5.953000000001365,4590.368421052632,59,12,18,71
5690,-9.597249999998652,3655.3,49,19,9,68
5691,-8.450749999999665,3460.777777777778,45,11,28,56
5692,-16.479999999999485,2235.0555555555557,34,14,26,48
5693,2.409500000002274,2885.8888888888887,55,7,24,62
5694,-9.758999999999112,4094.0526315789475,53,6,22,59
5695,-27.616499999999483,2298.5555555555557,19,10,28,29
5696,-25.53850000000004,2362.0,39,9,28,48
5697,-9.14174999999846,2834.722222222222,33,2,32,35
5698,-18.677749999999,3379.85,35,11,18,46
5699,-11.02449999999822,2627.1176470588234,50,9,23,59
5700,-30.48774999999943,2302.1052631578946,18,11,16,29
5701,-23.76525000000028,2071.8888888888887,27,20,20,47
5702,-15.05749999999929,1842.6666666666667,26,11,17,37
5703,-15.854499999999726,2749.1052631578946,28,13,18,41
5704,-19.294749999999752,2064.0,35,5,47,40
5705,-11.661999999998674,2628.3888888888887,27,10,29,37
5706,-5.057999999998565,2612.5625,48,5,18,53
5707,0.9767500000032632,3355.8333333333335,55,10,30,65
5708,6.954500000001542,3664.7368421052633,44,12,18,56
5709,-25.652749999999987,1429.0,22,11,22,33
5710,-4.097499999999395,3272.842105263158,52,8,22,60
5711,-8.10924999999895,5332.3,64,7,25,71
5712,-6.277499999999019,2845.470588235294,46,17,20,63
5713,-30.76924999999983,1429.0,7,6,34,13
5714,-20.819249999999656,3230.2631578947367,46,6,23,52
5715,0.21600000000136071,2525.176470588235,49,12,22,61
5716,-28.493999999999176,1942.5882352941176,17,19,24,36
5717,-9.632499999999293,2698.8888888888887,40,5,30,45
5718,-14.020499999999497,2698.8333333333335,33,11,29,44
5719,-13.065499999998565,3290.5555555555557,43,18,17,61
5720,-28.77899999999941,1528.25,13,11,24,24
5721,-4.116749999999268,2277.25,48,16,18,64
5722,-2.1239999999985093,3420.764705882353,51,8,17,59
5723,1.3037500000021442,2072.777777777778,41,4,25,45
5724,18.813000000000955,2103.75,62,18,9,80
5725,-21.783499999999147,2849.6666666666665,27,17,29,44
5726,-7.036499999998695,2330.3333333333335,41,12,20,53
5727,11.760000000001892,2916.1875,52,9,24,61
5728,-5.276749999999188,2028.7222222222222,48,11,20,59
5729,-27.100249999998187,3638.6,30,5,33,35
5730,-51.63125000000031,1966.9411764705883,11,6,34,17
5731,2.7947500000016126,2771.277777777778,31,8,26,39
5732,-18.87124999999842,3474.3,34,12,19,46
5733,-34.21924999999964,2540.222222222222,16,0,36,16
5734,-22.366499999999412,2398.1,15,11,19,26
5735,-14.222999999999212,2307.3888888888887,26,15,23,41
5736,-30.367749999998388,2814.3888888888887,29,9,30,38
5737,-17.78774999999836,2640.294117647059,44,1,30,45
5738,-11.560499999999065,3741.7,36,17,14,53
5739,-8.351499999999126,2846.842105263158,32,21,16,53
5740,-24.268249999998673,3845.75,42,7,23,49
5741,-28.66799999999959,2577.7368421052633,23,6,25,29
5742,-21.173999999999566,3361.6,30,11,21,41
5743,-24.91224999999892,2240.470588235294,33,9,28,42
5744,-23.20525000000007,1429.0,26,5,33,31
5745,-16.30274999999912,2421.5789473684213,26,5,21,31
5746,-27.75099999999936,2591.1052631578946,23,7,19,30
5747,-23.8324999999992,3628.25,33,11,23,44
5748,-52.77799999999945,1429.0,0,7,30,7
5749,-26.27299999999949,2644.1,20,7,29,27
5750,-10.95124999999905,2627.9473684210525,33,14,11,47
5751,-14.007999999999445,3201.3,34,8,21,42
5752,-25.286999999999207,2834.3684210526317,24,8,30,32
5753,-14.576249999998922,3857.6,35,12,19,47
5754,-20.722999999997295,1978.6875,50,13,39,63
5755,-7.573999999999565,1429.0,21,13,23,34
5756,-7.273749999998884,2559.764705882353,52,21,13,73
5757,-1.2072499999976418,2753.6111111111113,46,12,24,58
5758,-21.577249999999616,2944.4736842105262,19,12,30,31
5759,0.7720000000017112,3973.1666666666665,53,8,29,61
5760,-4.5142499999993415,4636.2,46,14,15,60
5761,-24.64524999999899,2836.7368421052633,30,13,19,43
5762,-21.520999999999727,1984.611111111111,26,13,19,39
5763,-9.901499999997997,3176.0,48,1,24,49
5764,-14.347749999998479,4085.45,41,8,27,49
5765,-20.195249999999408,2393.157894736842,20,11,23,31
5766,-10.630999999998073,5052.9,52,11,27,63
5767,2.8852500000004193,4373.45,56,10,13,66
5768,-33.17024999999953,2227.235294117647,23,12,25,35
5769,-2.9782499999981247,3457.222222222222,52,16,18,68
5770,-24.88149999999973,1870.7058823529412,28,10,22,38
5771,-23.272749999998815,2604.6111111111113,26,5,28,31
5772,-8.437499999998682,3325.5263157894738,45,9,25,54
5773,-18.34199999999884,3462.4444444444443,39,10,17,49
5774,5.886000000001253,4118.315789473684,63,14,14,77
5775,-11.915999999998043,2848.4736842105262,43,5,21,48
5776,-21.49749999999971,2487.8823529411766,42,12,16,54
5777,-15.867499999999003,3521.1,34,17,15,51
5778,-7.041999999998291,2398.4375,48,3,29,51
5779,-39.26749999999855,1528.25,12,12,29,24
5780,-0.7094999999984328,4264.526315789473,47,5,19,52
5781,-9.668999999998732,2602.842105263158,31,17,21,48
5782,-28.738999999999777,2500.9473684210525,23,9,28,32
5783,8.973500000001103,4057.2631578947367,51,10,18,61
5784,-21.262249999998954,2555.176470588235,37,12,17,49
5785,-5.256249999998042,2565.470588235294,49,7,23,56
5786,-2.0477499999979845,3311.777777777778,54,12,27,66
5787,-42.1092500000003,1429.0,0,9,38,9
5788,-19.26624999999866,2873.4736842105262,28,15,14,43
5789,4.9387500000008995,3463.5555555555557,47,7,18,54
5790,-7.725999999998345,4227.5,53,9,20,62
5791,-22.803749999998846,2239.4444444444443,18,9,31,27
5792,-16.721749999998156,2899.4210526315787,32,8,31,40
5793,-18.573249999999263,3373.0526315789475,39,9,26,48
5794,-5.860749999997642,4498.526315789473,58,11,22,69
5795,-16.432499999999486,3402.85,37,13,23,50
5796,-10.744499999998194,2749.3529411764707,41,12,20,53
5797,3.54750000000166,3987.1,51,10,13,61
5798,-26.016999999997562,2010.4375,42,12,24,54
5799,-8.21274999999886,3559.2,35,6,25,41
5800,-25.56599999999957,2780.65,23,13,16,36
5801,-34.374999999999154,2459.1052631578946,26,7,33,33
5802,-20.754749999999042,3305.4210526315787,30,26,12,56
5803,-10.69274999999823,1675.0625,40,13,20,53
5804,-14.208999999999136,2734.0526315789475,39,11,24,50
5805,-19.083749999999363,2130.5625,35,8,21,43
5806,-4.616749999998332,2400.1176470588234,51,13,20,64
5807,-7.793749999998066,2525.277777777778,39,5,27,44
5808,-13.645749999999524,2054.0625,49,12,35,61
5809,-9.705749999999158,2473.1666666666665,40,9,22,49
5810,-31.863749999999136,2030.4117647058824,21,0,31,21
5811,-22.88049999999994,3120.842105263158,21,5,46,26
5812,-21.231749999999586,2821.5,39,17,20,56
5813,-37.470750000000045,1429.0,11,9,31,20
5814,2.2460000000033347,3866.0526315789475,64,7,21,71
5815,5.96600000000206,5122.75,66,14,19,80
5816,0.6602500000013496,3062.157894736842,38,14,22,52
5817,-25.794999999998673,1429.0,22,8,19,30
5818,-44.65424999999904,2096.6666666666665,11,4,36,15
5819,-29.234499999999304,2996.5,21,6,25,27
5820,-10.339999999998465,2261.3125,38,6,29,44
5821,11.136500000001233,3316.1176470588234,54,8,19,62
5822,-29.014499999999288,3140.7894736842104,24,17,16,41
5823,-11.542499999999427,3349.722222222222,55,20,21,75
5824,-8.12049999999871,4255.263157894737,39,4,33,43
5825,-13.776999999998845,4279.8,38,9,19,47
5826,-13.511000000000418,2262.3333333333335,30,14,34,44
5827,-13.11849999999771,3309.684210526316,49,0,28,49
5828,-19.62024999999952,1874.3529411764705,26,14,30,40
5829,-29.52599999999931,2766.4,17,15,19,32
5830,-11.755749999999985,2328.294117647059,36,16,31,52
5831,-22.17524999999906,3159.25,33,4,21,37
5832,-23.465499999999373,2294.1111111111113,29,14,20,43
5833,-32.39424999999909,2033.9444444444443,23,4,25,27
5834,-3.1222499999989424,3008.9411764705883,51,8,27,59
5835,-27.721999999999092,2561.0,20,6,30,26
5836,-17.472749999998562,2919.4736842105262,34,9,22,43
5837,8.411750000000534,5111.65,58,9,16,67
5838,-3.352999999997916,2166.1875,59,9,19,68
5839,-1.1964999999982737,5067.15,62,10,19,72
5840,4.468750000002525,2950.222222222222,50,7,24,57
5841,-13.890499999998886,2210.3888888888887,33,9,20,42
5842,-1.468499999998653,2391.705882352941,56,6,24,62
5843,-1.2712499999970635,4601.3,52,6,30,58
5844,-1.7164999999993775,2863.294117647059,37,9,18,46
5845,10.495250000004084,5883.0,71,14,23,85
5846,-11.60749999999845,4132.473684210527,53,6,19,59
5847,-26.48499999999897,2512.8333333333335,28,6,37,34
5848,-2.041999999999726,2475.705882352941,40,11,28,51
5849,-2.8124999999993925,2125.5625,53,7,25,60
5850,-16.204249999998943,3298.9,29,9,23,38
5851,-0.530499999998623,4420.736842105263,58,12,28,70
5852,-16.767249999997652,2377.764705882353,42,9,26,51
5853,-11.0509999999978,2644.222222222222,37,4,27,41
5854,-20.323999999998883,1534.8666666666666,23,9,21,32
5855,1.2162500000024008,2115.222222222222,44,9,23,53
5856,-19.065249999998514,3151.35,34,10,19,44
5857,2.221250000001487,2467.4117647058824,48,12,24,60
5858,-8.707749999999134,3666.315789473684,47,8,22,55
5859,-16.61074999999965,2181.705882352941,33,7,47,40
5860,8.934499999999758,3368.222222222222,69,14,24,83
5861,-19.685499999999728,3222.7368421052633,39,6,23,45
5862,-11.867999999999112,2679.7894736842104,37,9,27,46
5863,-22.11649999999965,2517.823529411765,37,7,36,44
5864,-33.21724999999918,1585.8125,19,5,28,24
5865,-2.9847499999991576,2045.125,45,15,17,60
5866,-9.15049999999739,2610.1176470588234,50,6,23,56
5867,-1.4529999999990195,3155.0526315789475,55,11,27,66
5868,-28.010999999999207,3415.65,19,7,24,26
5869,-27.928999999999366,2017.2222222222222,17,14,16,31
5870,-16.69874999999949,2667.0,34,11,25,45
5871,5.7877500000016875,3596.6111111111113,64,14,18,78
5872,-2.5589999999991377,2493.4444444444443,29,14,14,43
5873,-30.610499999998932,2551.0,24,14,20,38
5874,-26.855999999999028,3797.3,34,11,16,45
5875,4.8140000000012275,3800.842105263158,48,11,21,59
5876,16.703250000001564,3655.722222222222,54,3,24,57
5877,-3.5994999999992716,1853.625,42,14,14,56
5878,-13.895749999999605,3142.5789473684213,41,13,20,54
5879,-36.82499999999987,1769.8823529411766,10,11,20,21
5880,-7.949749999998555,2572.777777777778,31,9,23,40
5881,4.667750000001288,4624.3,58,7,20,65
5882,-17.392249999999095,2809.2105263157896,28,5,28,33
5883,-25.336749999999462,3840.2,33,11,11,44
5884,-22.293999999999258,2253.470588235294,24,14,20,38
5885,-11.228499999999318,2400.1176470588234,28,12,31,40
5886,-38.644999999999236,1995.2777777777778,12,10,30,22
5887,-7.732249999998487,4226.65,45,16,18,61
5888,1.6765000000022159,2153.3125,49,4,25,53
5889,-10.923749999999998,1559.0,28,9,20,37
5890,-28.998249999999437,2181.764705882353,26,7,23,33
5891,-18.640999999998748,3414.75,35,18,20,53
5892,-2.870499999998895,3092.222222222222,60,8,21,68
5893,4.527500000000185,3800.7894736842104,68,8,20,76
5894,-2.267249999997531,4644.2,58,6,19,64
5895,-25.32449999999944,2762.3888888888887,35,12,27,47
5896,-40.933249999999894,1429.0,12,7,42,19
5897,-13.559749999998536,2893.777777777778,36,13,17,49
5898,-23.615749999999586,2564.3684210526317,23,12,20,35
5899,10.915750000000763,2536.722222222222,50,9,23,59
5900,1.3397500000011662,2536.25,57,10,18,67
5901,-20.874499999998786,2992.9473684210525,28,10,23,38
5902,-23.289999999999285,1657.1875,21,11,24,32
5903,0.4580000000007508,2492.5882352941176,43,5,22,48
5904,-32.68099999999914,2080.764705882353,24,4,49,28
5905,-29.96949999999839,2480.0,24,10,28,34
5906,-14.252749999997775,2776.5555555555557,47,10,21,57
5907,-36.46499999999918,3227.5,22,17,24,39
5908,-14.02524999999956,3867.277777777778,63,17,21,80
5909,-13.872749999999408,2571.1111111111113,21,3,29,24
5910,-15.582499999998657,2802.8888888888887,30,14,21,44
5911,-17.828999999997386,1909.0,28,17,29,45
5912,26.22675000000092,3783.315789473684,78,6,21,84
5913,-15.509499999998672,4022.75,36,16,20,52
5914,-13.075999999999862,3072.2631578947367,43,7,23,50
5915,-14.654499999999393,2555.2105263157896,19,21,16,40
5916,-23.048499999998292,2803.8888888888887,32,7,32,39
5917,-19.818999999999384,3478.315789473684,42,11,27,53
5918,-17.93074999999888,2149.0,29,15,19,44
5919,-12.831999999999272,2888.5263157894738,35,10,20,45
5920,6.764000000001246,2131.235294117647,41,19,16,60
5921,-32.736249999999345,2815.842105263158,26,11,34,37
5922,-9.883999999998418,2409.6111111111113,38,2,25,40
5923,-30.631249999999834,1429.0,28,13,24,41
5924,-7.217999999999644,2366.5,53,23,24,76
5925,-37.70800000000007,2313.5,25,8,24,33
5926,-16.808749999999048,2940.2631578947367,25,5,30,30
5927,-13.477749999998895,2496.8888888888887,43,5,24,48
5928,-7.430499999999209,2694.294117647059,57,12,19,69
5929,3.345250000002475,2763.277777777778,44,4,36,48
5930,-27.155999999999295,3181.5,31,9,20,40
5931,-30.474999999998612,2730.6,22,19,20,41
5932,1.5435000000018542,3185.9473684210525,42,8,20,50
5933,-24.68499999999903,2567.5,31,6,23,37
5934,-11.111499999998006,2608.625,40,1,33,41
5935,-10.433500000000512,1984.5555555555557,50,13,24,63
5936,-3.338749999997934,3808.45,48,4,24,52
5937,-25.885499999998324,2035.1176470588234,24,11,29,35
5938,12.00200000000086,1862.2941176470588,54,11,24,65
5939,-46.78274999999898,2976.2631578947367,19,11,29,30
5940,-13.43474999999801,3160.8947368421054,44,8,24,52
5941,-23.30174999999925,3043.25,21,11,24,32
5942,-33.32199999999882,1648.4705882352941,21,11,20,32
5943,-28.86824999999893,2809.1052631578946,24,16,19,40
5944,-17.834749999999328,1541.125,15,12,25,27
5945,8.301750000001274,3835.45,43,4,22,47
5946,-0.7227499999981994,2384.235294117647,39,10,20,49
5947,-7.193749999998927,2461.8333333333335,32,9,21,41
5948,-35.99849999999962,1989.6315789473683,12,11,24,23
5949,-20.685499999998424,3106.05,41,3,22,44
5950,-18.17924999999895,2806.5,27,18,24,45
5951,-14.43899999999959,2520.8888888888887,33,13,34,46
5952,21.82650000000381,2169.6470588235293,70,7,21,77
5953,3.9577500000020693,4937.05,64,22,18,86
5954,-31.04624999999914,3229.9,29,2,23,31
5955,5.184750000000948,4867.25,50,2,29,52
5956,-8.305499999998018,4809.25,46,11,26,57
5957,-1.7887499999980292,3947.5555555555557,53,9,22,62
5958,-10.036999999999143,3583.0,34,11,24,45
5959,-27.60749999999909,2798.95,23,14,21,37
5960,-17.60049999999934,2261.0588235294117,29,7,29,36
5961,-15.669499999999275,2923.9411764705883,51,13,20,64
5962,-5.379249999999362,2546.6470588235293,52,11,18,63
5963,-22.743749999998993,3436.2,33,7,23,40
5964,-22.365249999999175,2444.8823529411766,36,13,16,49
5965,-6.825249999999265,2101.294117647059,62,17,17,79
5966,-8.962999999998647,3191.8888888888887,46,11,14,57
5967,-29.18274999999897,1547.6470588235295,16,18,23,34
5968,-14.812999999998599,2967.0526315789475,42,5,44,47
5969,-12.999749999998532,4018.0,46,2,21,48
5970,3.7015000000022105,1617.5625,32,20,17,52
5971,-7.137999999998658,3662.35,39,5,22,44
5972,-13.709749999998568,2573.5789473684213,37,12,13,49
5973,-3.2667499999994356,2062.9375,58,15,23,73
5974,4.064000000000658,4742.368421052632,60,17,21,77
5975,-5.6630000000002125,2840.823529411765,52,20,22,72
5976,0.2782500000012485,3587.777777777778,75,16,20,91
5977,-21.175749999999205,2697.2631578947367,24,19,10,43
5978,-5.1227499999991295,2975.235294117647,55,12,13,67
5979,-3.2359999999989997,2332.8823529411766,62,4,31,66
5980,-27.25049999999888,3037.05,31,7,17,38
5981,3.9962500000013583,2389.5,56,12,21,68
5982,-17.18524999999967,2613.8823529411766,41,24,17,65
5983,4.971750000001829,4245.263157894737,63,11,27,74
5984,-1.510749999998253,3591.75,52,3,22,55
5985,6.295500000001992,4750.45,55,13,23,68
5986,-17.87724999999884,3072.2631578947367,35,12,19,47
5987,-12.080499999999965,3153.3684210526317,47,11,31,58
5988,-26.768999999999238,4161.65,43,10,24,53
5989,0.6212500000008129,3379.7894736842104,63,5,31,68
5990,-22.470499999999678,3051.4210526315787,30,4,25,34
5991,-20.90724999999903,1599.6875,22,6,26,28
5992,-14.007999999999772,2203.3333333333335,34,16,20,50
5993,17.590250000002797,5330.65,60,4,31,64
5994,-5.5802499999976956,3144.3888888888887,47,9,24,56
5995,-11.724499999999278,3072.315789473684,33,3,27,36
5996,-22.197249999999023,2489.157894736842,23,11,25,34
5997,-20.865499999998313,3073.9473684210525,23,16,38,39
5998,-23.458499999999113,2320.6666666666665,28,9,17,37
5999,-0.7559999999994474,2692.722222222222,44,13,20,57
6000,14.112000000003054,5087.05,64,8,26,72
6001,-14.587499999998746,1429.0,37,11,25,48
6002,-20.291249999998183,3264.4736842105262,33,18,27,51
6003,2.6490000000015526,4097.421052631579,55,13,17,68
6004,0.6007500000014512,3540.157894736842,57,8,20,65
6005,-13.021999999998673,2632.722222222222,37,8,33,45
6006,0.6032500000007737,2264.375,38,5,29,43
6007,-10.64649999999883,2737.294117647059,36,14,18,50
6008,8.188750000000756,3890.157894736842,70,4,24,74
6009,-15.613499999999437,1528.25,27,16,12,43
6010,-27.537249999999204,2252.6666666666665,22,8,20,30
6011,-15.22224999999934,2691.0,24,6,23,30
6012,-25.102999999999778,2481.1111111111113,27,10,28,37
6013,5.306750000000744,4430.736842105263,59,10,15,69
6014,-45.611750000000036,1589.75,14,20,32,34
6015,-13.46324999999895,3080.777777777778,41,8,18,49
6016,-22.091999999999096,3083.1052631578946,37,3,35,40
6017,-8.08699999999831,3655.35,41,14,19,55
6018,6.3965000000015895,3440.5555555555557,48,14,24,62
6019,-1.4019999999981152,4460.0,64,5,24,69
6020,0.9267500000007555,2866.0,52,11,19,63
6021,-2.034749999999181,3455.7368421052633,41,16,23,57
6022,-24.82849999999941,3213.777777777778,34,7,25,41
6023,-12.216249999999754,3064.8947368421054,31,5,25,36
6024,17.159500000001586,2491.5,75,10,18,85
6025,-12.455499999999315,3127.55,33,5,20,38
6026,-4.295999999999072,2290.6111111111113,35,18,16,53
6027,11.756750000001341,2719.529411764706,66,8,21,74
6028,7.805750000002375,3838.222222222222,77,11,20,88
6029,4.8400000000010035,3023.3333333333335,41,10,21,51
6030,-23.533999999998763,2861.842105263158,34,10,24,44
6031,-20.127499999998683,2345.9411764705883,29,7,25,36
6032,-10.2879999999999,3004.6315789473683,29,2,34,31
6033,-29.083499999999027,2299.235294117647,21,11,31,32
6034,-21.60449999999887,3186.0,30,3,38,33
6035,-14.379499999999535,2808.315789473684,29,7,20,36
6036,-33.0472499999995,1501.0,16,8,25,24
6037,-8.510249999998305,3441.3888888888887,52,9,23,61
6038,-7.021999999998755,4689.25,50,7,16,57
6039,-14.264249999998711,1429.0,28,9,23,37
6040,-2.2059999999985545,2429.25,57,24,21,81
6041,-6.331249999998052,3723.2631578947367,47,5,20,52
6042,17.344750000000776,2593.470588235294,55,13,12,68
6043,-19.31574999999925,2997.157894736842,31,4,35,35
6044,-20.2462499999994,2575.85,24,9,19,33
6045,-7.094749999999799,3703.9473684210525,45,15,20,60
6046,-5.937999999998125,1541.125,32,9,32,41
6047,-13.053999999999437,2714.8333333333335,35,13,21,48
6048,-14.185999999997966,2724.1176470588234,44,6,26,50
6049,-14.967999999998739,3279.8,40,5,17,45
6050,-29.292999999999516,2803.7,23,14,19,37
6051,-15.539749999999334,2484.5555555555557,43,9,31,52
6052,-20.901249999998626,2051.9411764705883,35,15,14,50
6053,-12.38474999999844,2780.0,27,13,25,40
6054,-27.85324999999957,2673.7894736842104,21,9,29,30
6055,8.829500000001932,4020.777777777778,68,13,17,81
6056,-6.077999999998131,4274.35,52,13,18,65
6057,2.420250000001933,4187.05,47,9,15,56
6058,-14.693999999998596,1481.9333333333334,44,9,17,53
6059,9.64075000000022,3718.0526315789475,77,10,17,87
6060,2.171500000001248,2444.0,46,16,24,62
6061,-23.837500000000098,1616.5625,24,12,23,36
6062,-18.195249999998474,3683.05,38,3,21,41
6063,-6.606749999999883,2120.625,43,12,20,55
6064,-15.684249999999182,2743.0,34,12,19,46
6065,-19.649749999999784,3902.7368421052633,58,5,41,63
6066,-4.3759999999985935,4180.7,55,2,20,57
6067,0.27625000000048816,3385.684210526316,53,7,19,60
6068,-20.530999999998887,4084.6,37,3,17,40
6069,-5.288999999998587,2779.1666666666665,37,11,20,48
6070,-33.77900000000003,2125.5625,24,17,16,41
6071,-3.665749999999117,2749.1111111111113,52,3,24,55
6072,0.21275000000107164,2454.235294117647,49,9,20,58
6073,-6.661249999997914,2843.4736842105262,37,11,22,48
6074,-12.537249999997835,3196.7894736842104,39,2,34,41
6075,-9.988249999998787,3145.1666666666665,49,12,17,61
6076,9.175000000001008,3143.3529411764707,69,7,14,76
6077,-37.89499999999932,2076.5263157894738,10,14,22,24
6078,-13.823999999999035,3091.0588235294117,41,1,28,42
6079,-5.556249999999335,3100.7368421052633,38,24,15,62
6080,4.992500000001717,2748.5625,50,2,28,52
6081,-17.042749999998936,2121.5,32,5,31,37
6082,-12.303249999997997,4806.8,64,7,19,71
6083,8.276750000001103,3102.9444444444443,52,12,13,64
6084,-10.29649999999909,3219.4210526315787,27,18,31,45
6085,-3.6619999999978967,3076.5789473684213,44,3,27,47
6086,-3.267999999998318,1951.0,34,10,19,44
6087,-19.96049999999878,3308.45,35,9,16,44
6088,-2.376249999998972,2992.6111111111113,47,15,19,62
6089,14.264500000002448,2841.764705882353,55,7,23,62
6090,-7.093499999998256,3683.75,38,10,22,48
6091,-2.201499999998979,3468.6666666666665,50,16,19,66
6092,-38.90399999999964,2158.45,11,19,15,30
6093,8.836250000002469,2220.0,48,10,26,58
6094,-16.76599999999959,1963.1764705882354,39,5,32,44
6095,-15.872249999999411,2706.4210526315787,33,16,24,49
6096,-23.800499999999406,1965.2777777777778,23,10,25,33
6097,-31.219499999999528,2489.0555555555557,19,23,27,42
6098,-14.947999999999656,2028.611111111111,36,2,30,38
6099,-25.023249999999138,2214.722222222222,20,4,27,24
6100,-15.712249999998377,2639.8333333333335,43,11,24,54
6101,-8.900999999998824,5466.35,53,10,20,63
6102,-21.14374999999931,2541.0555555555557,27,17,19,44
6103,-27.45199999999834,2152.6470588235293,37,3,27,40
6104,-12.785999999998108,2941.4444444444443,41,11,21,52
6105,-8.356499999999695,2748.3529411764707,50,24,30,74
6106,2.7702500000010843,3101.0,55,9,20,64
6107,-4.7424999999983255,2590.2631578947367,40,11,19,51
6108,-52.456249999999976,2615.3684210526317,12,12,31,24
6109,-10.19974999999819,5665.65,50,7,22,57
6110,-4.1447499999993,3421.1666666666665,61,18,26,79
6111,-1.489999999998902,3441.8,29,13,26,42
6112,-14.979499999999353,2827.6111111111113,45,4,18,49
6113,-10.697499999999156,3896.1052631578946,51,9,23,60
6114,-53.86674999999963,2071.9444444444443,7,15,27,22
6115,-44.913999999999604,1977.611111111111,10,16,15,26
6116,-26.964749999999412,3251.1052631578946,28,8,19,36
6117,-12.622999999999054,3021.315789473684,31,18,12,49
6118,8.081500000001421,4360.85,57,7,17,64
6119,13.176750000000956,2896.4444444444443,56,10,16,66
6120,-30.89399999999977,1997.0,20,13,19,33
6121,-23.622999999999344,2005.5,25,15,16,40
6122,-14.229749999999736,3106.5263157894738,31,15,21,46
6123,-22.39424999999867,2144.222222222222,27,13,17,40
6124,-17.085499999999158,1429.0,29,19,24,48
6125,-18.509749999999535,2097.6470588235293,35,4,31,39
6126,-4.191749999999148,3373.1052631578946,38,15,20,53
6127,-14.769749999998913,2539.4210526315787,35,13,15,48
6128,-28.11399999999897,2958.5,18,8,32,26
6129,-25.849749999999965,1594.6875,41,19,18,60
6130,-18.96674999999915,2669.6315789473683,16,17,20,33
6131,-27.210499999998955,3381.5,28,2,32,30
6132,-36.03375000000004,1621.5,10,14,35,24
6133,-6.763249999999114,3794.157894736842,55,9,17,64
6134,-0.8139999999981363,4069.55,43,8,17,51
6135,-7.244249999998617,2686.705882352941,58,15,17,73
6136,-31.674500000000393,2722.722222222222,40,4,44,44
6137,-23.246249999999023,3385.45,30,9,21,39
6138,-6.418499999999106,2536.722222222222,50,16,15,66
6139,-8.780249999999663,3270.4444444444443,59,16,25,75
6140,-28.220749999998702,2203.1176470588234,42,7,30,49
6141,-43.5257500000002,1937.0,12,11,35,23
6142,-3.690749999998053,3723.157894736842,41,13,17,54
6143,-8.278499999998715,3251.3,44,12,17,56
6144,8.921250000002654,2271.277777777778,46,9,19,55
6145,6.120250000000969,2257.235294117647,49,10,21,59
6146,-7.145499999998767,3219.1666666666665,49,7,30,56
6147,2.3112500000013205,2420.529411764706,47,14,14,61
6148,-17.588499999999307,3321.9,31,10,20,41
6149,-22.84699999999937,2573.5263157894738,18,6,31,24
6150,-1.1344999999968277,2707.470588235294,60,6,24,66
6151,-22.74049999999726,2183.470588235294,46,11,23,57
6152,-13.228999999998734,2253.5882352941176,27,11,20,38
6153,1.9835000000013139,4415.55,54,7,17,61
6154,-61.856749999999394,1429.0,0,4,32,4
6155,-11.87224999999911,2992.5,55,17,20,72
6156,-0.7094999999990318,2459.0,35,5,25,40
6157,9.393250000001979,2727.625,55,10,18,65
6158,-13.832999999998858,1760.375,26,17,15,43
6159,-22.129999999999427,3311.6,26,16,18,42
6160,-4.404999999998791,4639.4,48,9,22,57
6161,-24.65424999999916,2112.4444444444443,15,13,26,28
6162,-27.774749999999973,3674.3,29,10,18,39
6163,-13.903749999999615,2520.777777777778,25,16,27,41
6164,8.154750000000796,3469.2105263157896,41,8,25,49
6165,-18.295499999998547,2929.05,26,17,19,43
6166,-16.557749999999054,2156.4117647058824,35,8,18,43
6167,-9.222499999999581,3621.2105263157896,39,14,18,53
6168,-20.654249999999838,2937.842105263158,40,11,18,51
6169,3.1177500000008016,1916.1875,59,7,18,66
6170,-19.73924999999944,2298.5555555555557,23,13,18,36
6171,-17.16699999999964,3164.5,44,16,17,60
6172,-35.99100000000008,1429.0,9,17,22,26
6173,-2.0124999999990765,3539.222222222222,59,11,13,70
6174,-25.6624999999999,1429.0,21,15,23,36
6175,-10.379499999998565,1999.5882352941176,46,10,21,56
6176,-12.783749999999461,2771.6315789473683,29,15,18,44
6177,-10.534249999999206,2433.5,37,11,25,48
6178,-7.371249999998797,3016.3529411764707,43,12,19,55
6179,-13.57874999999911,2496.5,47,8,29,55
6180,-16.941249999998497,1547.6470588235295,9,13,35,22
6181,-5.41974999999681,4112.611111111111,61,8,20,69
6182,-13.65799999999933,2417.1176470588234,40,12,23,52
6183,10.653250000002481,3471.0,65,8,16,73
6184,-11.868499999998704,3092.222222222222,41,2,27,43
6185,-5.185999999998818,2813.4736842105262,39,12,13,51
6186,-10.46024999999906,2384.5625,39,8,23,47
6187,-17.81999999999935,2668.8947368421054,31,12,15,43
6188,-14.94774999999924,3314.8,34,14,17,48
6189,12.556000000000507,3627.7894736842104,53,9,17,62
6190,-25.837249999999464,2093.2105263157896,13,10,23,23
6191,-34.8129999999998,2312.9473684210525,24,2,26,26
6192,-28.86949999999939,2426.3888888888887,24,12,25,36
6193,-40.403999999999314,1755.4375,21,10,32,31
6194,10.359500000002248,2945.8333333333335,47,10,21,57
6195,-33.637999999999465,2206.0,20,8,22,28
6196,-20.943499999998817,2972.3333333333335,34,13,29,47
6197,-18.31949999999935,2219.4210526315787,17,11,23,28
6198,10.77725000000098,2626.9411764705883,58,10,21,68
6199,-17.833749999998847,3763.95,40,5,19,45
6200,-4.742999999998345,2526.1176470588234,47,6,21,53
6201,-7.814499999998693,2036.1875,50,15,19,65
6202,-22.890999999999103,2529.95,29,5,19,34
6203,-32.29649999999927,2151.7368421052633,15,16,16,31
6204,-31.26124999999933,1534.8666666666666,19,14,16,33
6205,-28.553250000000066,1429.0,32,12,24,44
6206,-14.865249999998245,3380.5263157894738,41,8,25,49
6207,-11.372749999999238,2449.3333333333335,48,9,22,57
6208,-6.764499999999289,3079.9,31,11,14,42
6209,8.808000000000249,3615.315789473684,53,8,18,61
6210,-18.502249999999204,3291.0,31,3,28,34
6211,-12.794249999998655,3795.0526315789475,46,9,28,55
6212,-7.849250000000282,2294.1111111111113,28,21,17,49
6213,-17.004249999999395,2125.0,27,14,20,41
6214,-1.4954999999997365,2553.176470588235,50,7,23,57
6215,-12.005999999999187,3950.3684210526317,47,10,18,57
6216,-4.181749999998006,3678.9473684210525,54,5,19,59
6217,-5.1559999999987856,4150.789473684211,42,15,21,57
6218,12.08900000000123,4159.210526315789,61,14,18,75
6219,-19.903249999998486,3108.45,31,5,26,36
6220,2.652500000001427,2201.9375,60,20,12,80
6221,-23.827249999999545,2341.315789473684,22,8,17,30
6222,-7.5117499999992905,3688.842105263158,44,12,14,56
6223,12.167500000000409,3154.157894736842,52,13,23,65
6224,-7.0217499999985264,3759.157894736842,48,16,15,64
6225,-12.835499999999204,2474.823529411765,54,16,14,70
6226,-11.177249999999365,2043.4705882352941,24,5,22,29
6227,-33.562499999999176,2106.5789473684213,14,8,29,22
6228,-35.2929999999994,2648.7894736842104,20,14,18,34
6229,-32.700499999998705,1820.235294117647,20,17,19,37
6230,-20.760249999999125,2929.4736842105262,31,7,27,38
6231,-10.384499999998932,2261.9411764705883,25,15,22,40
6232,3.4290000000012633,3414.0,47,14,9,61
6233,-14.852249999999424,1429.0,33,9,32,42
6234,-24.96749999999928,2378.777777777778,17,16,20,33
6235,0.25375000000058173,2694.235294117647,44,5,21,49
6236,-5.63199999999919,3460.8888888888887,64,10,16,74
6237,-22.176999999999783,2110.0,33,10,15,43
6238,-8.045999999999843,2489.0555555555557,42,10,12,52
6239,6.645500000003014,3604.6111111111113,61,5,27,66
6240,-27.901499999998485,2335.4736842105262,12,12,38,24
6241,-26.020499999999554,2171.6111111111113,26,13,20,39
6242,-19.814499999999747,2385.8888888888887,35,7,19,42
6243,-40.72049999999998,1532.1875,7,7,27,14
6244,-5.236749999998276,2060.294117647059,37,14,13,51
6245,4.168750000001031,4363.105263157895,66,15,14,81
6246,-9.71175000000012,3516.277777777778,51,11,19,62
6247,-25.67949999999875,3673.5,36,11,19,47
6248,5.6165000000008,4126.578947368421,65,10,26,75
6249,5.565750000002564,1976.235294117647,49,9,20,58
6250,0.06600000000223591,4069.0,58,7,24,65
6251,-4.3607499999999995,2580.3529411764707,64,7,24,71
6252,-47.859249999999705,2099.222222222222,13,12,34,25
6253,-36.94149999999887,2164.2631578947367,14,9,29,23
6254,-21.177749999998753,1937.9411764705883,24,19,27,43
6255,-17.849749999998814,2106.0588235294117,41,12,24,53
6256,-16.591999999998915,3502.9,31,12,25,43
6257,6.695750000000994,3907.7894736842104,83,8,22,91
6258,-24.25449999999872,2622.8,21,11,23,32
6259,-1.356749999998557,2177.9411764705883,34,17,16,51
6260,9.096500000000784,3921.9473684210525,60,6,21,66
6261,3.0175000000014904,2046.125,45,10,12,55
6262,-18.420249999999253,3651.2105263157896,34,11,22,45
6263,-3.8887499999969166,2064.9375,60,13,15,73
6264,20.523750000002394,4525.222222222223,69,10,19,79
6265,-1.4762499999987981,3821.684210526316,66,13,11,79
6266,-25.75274999999876,2630.2631578947367,26,8,31,34
6267,-0.11874999999823466,1903.25,46,4,25,50
6268,-16.4812499999991,3621.3684210526317,63,6,23,69
6269,-14.240999999999321,2206.8823529411766,35,18,19,53
6270,-17.07000000000013,2849.722222222222,53,4,33,57
6271,-24.636249999999304,2306.5,41,11,24,52
6272,-7.101749999999171,2664.235294117647,52,11,21,63
6273,-10.297999999998211,4154.4,54,15,14,69
6274,-10.931749999999187,3258.176470588235,51,8,15,59
6275,-10.36274999999734,4769.6,66,5,16,71
6276,-19.468749999999446,2500.5555555555557,25,15,24,40
6277,-10.472499999998405,3196.7894736842104,28,18,23,46
6278,-16.53199999999899,3944.15,48,14,22,62
6279,-8.915999999998753,2127.529411764706,28,13,15,41
6280,-6.094749999999133,4286.2,49,4,24,53
6281,-8.300499999999138,4175.055555555556,57,15,17,72
6282,-31.97224999999951,2290.3684210526317,19,6,25,25
6283,-35.68299999999939,2145.85,15,12,16,27
6284,-23.552749999998824,2536.2,27,13,18,40
6285,-9.296749999998886,4636.315789473684,42,13,18,55
6286,-30.941749999998553,2101.0,24,27,16,51
6287,-8.92074999999852,3893.8333333333335,61,4,24,65
6288,-5.171499999999606,4371.421052631579,51,19,15,70
6289,-18.09524999999754,1964.1176470588234,32,13,29,45
6290,-17.588999999997917,3318.8888888888887,39,5,32,44
6291,16.904250000001227,3774.9473684210525,56,9,13,65
6292,-12.455249999999019,3111.55,35,12,16,47
6293,-37.87449999999965,2128.3684210526317,17,13,17,30
6294,-5.154499999998853,4302.05,58,15,15,73
6295,-32.44925000000006,1429.0,20,11,21,31
6296,-1.201499999999561,2619.5555555555557,60,22,12,82
6297,-16.457249999999302,3198.5789473684213,35,7,19,42
6298,-13.104249999998752,4258.5,39,15,19,54
6299,-12.320249999998946,2482.625,48,16,26,64
6300,12.854500000002224,4285.368421052632,63,8,15,71
6301,-37.79649999999903,1795.0555555555557,11,13,21,24
6302,-24.040999999999805,1612.5625,20,5,29,25
6303,-33.31499999999936,2743.157894736842,16,12,17,28
6304,-9.247749999999183,3123.8888888888887,36,20,19,56
6305,-12.00149999999905,3124.0555555555557,41,17,17,58
6306,-20.514249999998363,2866.7894736842104,30,12,19,42
6307,-5.018499999999291,1835.75,42,12,16,54
6308,-32.03649999999882,2633.1052631578946,26,9,18,35
6309,-1.9322499999994018,3830.7,47,11,16,58
6310,-25.030999999998734,4219.55,49,10,14,59
6311,-7.3384999999991525,3057.2631578947367,32,10,31,42
6312,-6.093999999999217,4303.65,52,18,15,70
6313,-10.775999999999211,4397.277777777777,62,11,24,73
6314,-23.283749999998783,3101.35,29,8,18,37
6315,4.977750000002463,2818.9444444444443,54,11,16,65
6316,-14.682499999998907,2410.5555555555557,26,10,20,36
6317,-7.915749999998748,2584.222222222222,44,16,20,60
6318,9.231250000000717,3250.5,65,14,22,79
6319,-40.2699999999994,2103.6111111111113,15,9,23,24
6320,-7.724500000000016,3344.3888888888887,44,19,11,63
6321,-17.379249999999306,3876.65,40,9,23,49
6322,-20.541999999998954,3384.0,37,11,19,48
6323,-18.932749999998574,2623.9444444444443,43,14,22,57
6324,3.6632500000016193,3334.5263157894738,39,9,30,48
6325,6.349750000001895,3639.8333333333335,68,11,19,79
6326,-11.158499999998831,3163.6666666666665,52,13,26,65
6327,1.6417500000005147,2877.8888888888887,40,9,26,49
6328,3.9132500000022246,3648.0526315789475,49,16,14,65
6329,-15.11074999999912,3885.157894736842,51,10,28,61
6330,-12.6184999999983,3160.2105263157896,46,13,13,59
6331,-19.231999999999413,2738.6111111111113,49,9,28,58
6332,9.779000000000853,2446.875,59,13,27,72
6333,-8.957999999999053,2270.294117647059,23,7,26,30
6334,-27.2432499999998,3160.1052631578946,25,10,26,35
6335,-28.62049999999947,2583.6315789473683,22,14,29,36
6336,-7.239749999999124,2322.3333333333335,50,15,18,65
6337,-19.29624999999939,2908.722222222222,32,21,21,53
6338,-19.063999999999186,1996.5625,34,9,18,43
6339,-13.641999999999978,2063.9444444444443,39,17,8,56
6340,0.1427500000017158,3106.0588235294117,61,18,6,79
6341,-29.036749999999397,1429.0,14,16,17,30
6342,4.745250000002139,3040.5789473684213,43,18,16,61
6343,-7.547999999999099,3712.1111111111113,67,16,21,83
6344,-24.08925000000025,1429.0,18,10,31,28
6345,-19.868749999998574,2110.6470588235293,24,19,15,43
6346,-20.22499999999885,3256.8947368421054,21,15,23,36
6347,-12.988499999998965,2845.529411764706,38,10,18,48
6348,-21.545749999999618,2124.0,25,17,16,42
6349,-14.352499999999356,2264.4375,44,18,19,62
6350,-12.28399999999871,4215.210526315789,66,16,15,82
6351,-29.17549999999925,1614.8823529411766,20,14,15,34
6352,-9.479499999997817,2858.6470588235293,50,5,24,55
6353,-20.750249999999784,3748.3333333333335,41,22,19,63
6354,-18.164249999998756,4489.3,40,17,17,57
6355,-4.392499999997853,3233.3333333333335,50,5,20,55
6356,-6.860999999999207,3455.0,50,9,21,59
6357,4.56000000000132,3332.0555555555557,48,10,15,58
6358,11.508500000002,3255.3888888888887,46,5,24,51
6359,-9.639499999998694,2393.8333333333335,37,11,27,48
6360,3.545500000001644,2473.75,61,17,21,78
6361,9.697500000001286,2593.470588235294,58,14,19,72
6362,-18.640249999999288,3844.315789473684,51,11,34,62
6363,-46.279749999998614,2278.3333333333335,14,13,31,27
6364,-10.787999999998673,4315.6,38,7,24,45
6365,-15.72424999999889,1501.0,38,10,20,48
6366,-17.78574999999899,3776.6,45,7,15,52
6367,-21.805499999998904,2702.4444444444443,31,21,22,52
6368,-24.74424999999983,1901.7222222222222,32,15,21,47
6369,-10.77774999999983,2520.8333333333335,57,9,16,66
6370,-14.019249999999719,3338.8947368421054,44,7,18,51
6371,-18.10224999999883,2790.842105263158,33,11,19,44
6372,-0.5314999999990566,3669.55,40,8,15,48
6373,-12.816749999997601,4671.15,54,18,17,72
6374,-5.6492499999989825,2501.0,50,7,26,57
6375,-8.64999999999922,3057.315789473684,41,14,18,55
6376,0.5425000000016562,2278.764705882353,45,6,22,51
6377,-31.59324999999921,2219.9411764705883,24,11,19,35
6378,-7.885749999999582,3048.0526315789475,49,14,14,63
6379,5.132500000000721,2330.875,62,13,12,75
6380,-16.660999999999056,2526.1176470588234,46,8,30,54
6381,-34.75674999999901,1528.25,13,16,20,29
6382,-37.77399999999914,2649.5555555555557,27,16,22,43
6383,-1.6172499999982484,2214.75,58,12,17,70
6384,-0.7624999999981712,4687.1,47,13,20,60
6385,-8.0117499999988,4360.05,59,4,17,63
6386,-25.382999999999274,2051.25,18,12,18,30
6387,-37.97924999999955,1429.0,10,11,21,21
6388,-24.031000000000667,1536.125,26,11,35,37
6389,-15.264499999999728,2299.294117647059,33,9,20,42
6390,-13.955749999998833,2258.0555555555557,30,28,2,58
6391,-38.971749999999425,2315.7,11,7,25,18
6392,-22.623499999999375,2496.294117647059,51,19,17,70
6393,9.159500000001419,3389.5,48,9,21,57
6394,2.6527500000013946,4388.6,55,11,17,66
6395,-28.85299999999927,3245.2631578947367,33,21,17,54
6396,-2.416749999998985,3229.3684210526317,40,9,17,49
6397,-42.17249999999908,2337.0,14,23,11,37
6398,-18.99149999999925,1556.0588235294117,24,10,23,34
6399,3.308750000001202,2435.1666666666665,37,15,17,52
6400,-20.34925000000022,2225.3333333333335,16,3,48,19
6401,-25.372249999998523,4221.8,43,6,16,49
6402,-7.338499999999348,2328.5,29,8,19,37
6403,-9.292749999999875,1429.0,41,10,16,51
6404,-19.47999999999974,2208.5263157894738,16,12,22,28
6405,-49.05200000000066,1429.0,1,8,56,9
6406,-34.502499999999785,2104.9473684210525,21,12,19,33
6407,-19.734249999999466,2738.5555555555557,31,19,15,50
6408,2.1957500000019206,4102.473684210527,60,9,25,69
6409,-4.012749999999896,3003.1111111111113,49,12,21,61
6410,-26.76474999999951,1744.6470588235295,29,17,23,46
6411,-3.118499999998627,2546.705882352941,40,10,20,50
6412,-25.797749999998985,2484.6111111111113,22,14,26,36
6413,-28.97474999999998,2153.5882352941176,36,11,23,47
6414,-0.26899999999763313,2774.5882352941176,48,7,23,55
6415,-42.63049999999966,1429.0,11,6,34,17
6416,-15.897249999999474,2068.3333333333335,47,16,19,63
6417,-22.00149999999905,3234.4210526315787,34,8,23,42
6418,1.7947500000001178,3568.5789473684213,39,13,11,52
6419,1.059500000001246,3876.8947368421054,60,6,27,66
6420,-19.967749999998343,3622.75,41,10,20,51
6421,-19.30549999999921,2711.1176470588234,48,20,18,68
6422,-14.195499999998697,2014.375,51,8,27,59
6423,-10.940000000000316,3725.5789473684213,59,6,23,65
6424,-1.5817499999990903,3997.1052631578946,66,11,19,77
6425,-9.63174999999942,2226.470588235294,33,20,18,53
6426,-18.965999999998516,2698.0588235294117,41,12,18,53
6427,9.867750000001319,3727.1666666666665,62,4,35,66
6428,-8.309749999999733,3619.5,71,10,18,81
6429,-17.611499999999026,2440.294117647059,34,5,21,39
6430,0.9302500000020032,3023.8947368421054,49,11,15,60
6431,-5.072749999999149,3286.3529411764707,61,17,13,78
6432,-16.132499999999382,2405.684210526316,27,14,9,41
6433,-26.77049999999965,1429.0,30,9,32,39
6434,-23.42974999999902,2719.222222222222,32,17,18,49
6435,8.724250000001211,4170.105263157895,59,13,16,72
6436,-8.566749999998367,2438.470588235294,33,14,22,47
6437,-6.380749999999117,2105.9411764705883,33,5,26,38
6438,-14.908749999998728,2109.764705882353,43,17,22,60
6439,16.225500000001556,5198.1,61,11,25,72
6440,5.386750000000764,2652.4117647058824,58,8,16,66
6441,-33.88449999999936,3349.85,25,13,23,38
6442,-17.216999999999345,2508.4,18,20,9,38
6443,-21.22874999999933,3837.0,29,10,18,39
6444,-12.250499999999326,3726.5263157894738,47,8,20,55
6445,-18.322999999998736,3636.95,33,7,19,40
6446,10.817000000002057,4335.5,59,4,22,63
6447,-14.917999999998969,3417.95,34,7,23,41
6448,-5.059249999998616,3097.5555555555557,45,12,22,57
6449,-15.623749999999053,3304.5789473684213,54,8,26,62
6450,-31.749249999999524,2718.9473684210525,21,14,21,35
6451,-25.88449999999914,1701.8125,28,10,26,38
6452,-11.377249999999188,2631.9444444444443,37,16,22,53
6453,-38.8472500000001,1891.235294117647,22,6,32,28
6454,-16.469749999998392,2287.176470588235,33,16,20,49
6455,-18.18524999999881,2743.2631578947367,25,14,25,39
6456,-35.81699999999954,2230.65,14,13,18,27
6457,-18.731499999998633,3801.3,26,9,28,35
6458,-8.529249999999612,3000.4444444444443,54,8,18,62
6459,-14.786999999998596,3599.75,38,5,28,43
6460,-4.507499999998085,3844.15,39,7,23,46
6461,-6.02949999999874,3209.3684210526317,33,15,16,48
6462,-48.45124999999945,1671.125,9,15,21,24
6463,10.610000000002408,3957.3333333333335,60,15,22,75
6464,-3.719249999999184,2772.0555555555557,46,7,26,53
6465,-21.48799999999836,1606.4705882352941,24,16,24,40
6466,8.613500000003683,2818.4117647058824,81,6,17,87
6467,1.9532500000021131,5361.6,69,15,13,84
6468,0.6630000000010275,3937.05,39,6,24,45
6469,-16.74324999999938,2290.9411764705883,29,7,24,36
6470,-19.611999999999718,1921.1176470588234,42,7,26,49
6471,15.568750000000142,4246.555555555556,70,17,17,87
6472,-19.433499999998478,2492.5882352941176,39,11,27,50
6473,5.8265000000015394,5003.8421052631575,74,15,17,89
6474,-17.290249999999006,2512.8333333333335,29,13,22,42
6475,-3.5677499999991076,2760.6111111111113,48,10,10,58
6476,-19.3887499999991,2849.8333333333335,33,9,19,42
6477,14.386000000002397,2862.6875,71,9,22,80
6478,-4.889999999998433,3223.6470588235293,62,8,27,70
6479,-33.358249999999806,2234.222222222222,21,7,42,28
6480,-17.2012499999993,3144.2105263157896,38,11,20,49
6481,-14.931250000000011,2148.0588235294117,36,14,22,50
6482,-34.48299999999948,2618.7894736842104,24,12,21,36
6483,-41.31825000000002,1429.0,0,6,26,6
6484,10.56200000000137,2501.0588235294117,60,8,18,68
6485,-4.2412499999977475,2765.0555555555557,52,15,19,67
6486,-1.4702499999998242,2240.529411764706,40,14,22,54
6487,-31.941499999999326,2696.55,17,7,21,24
6488,-5.216249999998878,3282.842105263158,46,5,22,51
6489,-13.57674999999875,2987.277777777778,35,12,18,47
6490,-41.37149999999998,1429.0,0,12,21,12
6491,-13.69424999999735,2162.3125,51,11,22,62
6492,-11.225249999999281,2925.5555555555557,45,8,23,53
6493,-3.5124999999991133,2335.875,38,4,27,42
6494,-3.540499999997755,2159.222222222222,39,5,26,44
6495,-4.305999999999669,2274.777777777778,48,2,26,50
6496,-35.55599999999927,1782.8823529411766,11,15,17,26
6497,-16.28149999999815,2858.5,38,7,27,45
6498,-4.659749999999373,2536.4,32,12,15,44
6499,-30.47349999999929,2577.4117647058824,35,15,32,50
6500,1.594750000000647,3841.7368421052633,61,11,13,72
6501,-29.637749999999794,2084.222222222222,14,7,42,21
6502,-17.57125000000007,2336.6470588235293,39,27,14,66
6503,7.797500000000312,2609.9444444444443,67,17,12,84
6504,-14.00724999999891,2362.6875,39,12,17,51
6505,-27.616249999999344,2349.6470588235293,30,15,24,45
6506,29.814250000002733,4243.111111111111,78,7,21,85
6507,3.3242500000012205,3055.6470588235293,62,27,8,89
6508,-3.434999999998817,3316.315789473684,33,16,19,49
6509,4.714750000001483,2806.6111111111113,45,14,29,59
6510,12.133250000001315,4230.210526315789,62,6,25,68
6511,-11.166499999998386,2342.6666666666665,28,15,26,43
6512,9.875750000000739,2834.3529411764707,56,16,18,72
6513,-11.464499999999418,2186.5555555555557,25,9,18,34
6514,-10.671999999997558,3233.0588235294117,48,3,33,51
6515,16.35350000000139,5681.5,73,6,24,79
6516,-0.2727499999986206,1889.375,59,8,24,67
6517,-15.961999999998909,2963.0,31,9,18,40
6518,-10.93399999999907,2803.0,47,8,24,55
6519,-0.9219999999989431,4239.421052631579,64,10,16,74
6520,-17.246999999999222,2546.0,28,9,25,37
6521,-38.054749999999686,2020.7777777777778,12,14,33,26
6522,-20.95874999999928,2241.85,16,14,19,30
6523,-4.7887499999986165,2685.823529411765,51,12,17,63
6524,-10.960999999998826,2822.3333333333335,30,15,20,45
6525,-26.7867499999995,3171.15,22,3,34,25
6526,10.51925000000317,3049.0588235294117,71,8,26,79
6527,-2.820499999999615,3119.1052631578946,33,16,22,49
6528,-22.55724999999928,2476.684210526316,21,10,17,31
6529,-5.907999999999906,2173.235294117647,56,15,16,71
6530,-10.896499999998854,2084.0526315789475,23,17,16,40
6531,-28.415999999998984,3259.25,34,9,25,43
6532,-4.144749999998623,1481.9333333333334,51,11,23,62
6533,-40.69724999999902,2779.1052631578946,24,2,41,26
6534,-14.821999999999065,4040.95,32,14,24,46
6535,-11.350999999999486,3060.5263157894738,41,9,18,50
6536,-20.580249999999985,2644.6315789473683,41,18,23,59
6537,12.187000000002945,2737.625,68,14,25,82
6538,-12.797749999999866,2807.5789473684213,23,17,29,40
6539,-14.898499999998265,2064.0,31,7,29,38
6540,19.531500000002975,4072.2631578947367,71,6,18,77
6541,2.2047500000021762,2691.8888888888887,44,12,17,56
6542,-11.568499999998673,3211.9473684210525,35,15,15,50
6543,-3.5544999999961084,4129.1578947368425,69,3,28,72
6544,-2.7527499999986453,4003.0,46,9,17,55
6545,12.29350000000211,3163.6666666666665,66,13,19,79
6546,-11.147999999998266,2362.0555555555557,34,7,23,41
6547,3.1205000000019276,5183.1,65,4,18,69
6548,-32.78524999999904,3310.05,28,18,14,46
6549,-19.71825000000009,2230.2105263157896,21,18,15,39
6550,-17.2142499999984,2347.0555555555557,28,16,23,44
6551,-2.84199999999973,2332.8823529411766,57,12,12,69
6552,-36.67099999999972,1429.0,5,16,22,21
6553,-4.309749999998734,2886.6470588235293,49,10,24,59
6554,-22.284499999999355,2072.875,27,9,32,36
6555,3.469750000002,1630.1333333333334,44,21,13,65
6556,-29.07249999999957,2017.4117647058824,32,13,22,45
6557,-7.388999999998849,3156.529411764706,38,7,25,45
6558,-10.56649999999845,1942.9375,44,10,16,54
6559,-4.600499999998837,3835.45,44,15,17,59
6560,-38.0962499999993,2005.1764705882354,20,2,37,22
6561,-19.381749999998213,2509.3333333333335,34,15,24,49
6562,-16.068249999999267,2949.3333333333335,45,17,24,62
6563,-19.478249999998873,2584.222222222222,31,15,22,46
6564,-19.15675000000068,1429.0,48,29,23,77
6565,-16.04899999999906,3867.15,47,7,18,54
6566,-38.595499999998694,2882.25,30,11,27,41
6567,-8.20624999999864,2477.6111111111113,31,7,24,38
6568,-13.072249999997965,4848.9,35,12,27,47
6569,6.220750000000871,2803.529411764706,57,11,18,68
6570,-24.43849999999981,2568.5263157894738,18,7,19,25
6571,7.811250000000913,3500.9473684210525,54,12,14,66
6572,-12.21299999999806,2560.3888888888887,38,10,19,48
6573,1.162000000001504,2376.823529411765,67,11,23,78
6574,-9.690999999998061,3444.9473684210525,40,2,34,42
6575,-26.76574999999935,2282.15,18,7,26,25
6576,5.80000000000121,3583.5789473684213,54,11,20,65
6577,-20.62624999999864,2109.777777777778,23,6,28,29
6578,-18.614249999999302,2806.4444444444443,43,10,23,53
6579,-19.000999999999163,3444.0,50,9,19,59
6580,-27.804499999998665,2920.315789473684,27,11,24,38
6581,-19.079499999998717,5275.1,57,25,14,82
6582,-14.98324999999825,2905.2631578947367,38,20,15,58
6583,-29.697499999999593,2921.9473684210525,25,9,23,34
6584,-12.878749999999036,3890.9,36,12,20,48
6585,-0.7469999999984569,1902.25,62,15,17,77
6586,-21.485999999999496,1983.6470588235295,29,15,23,44
6587,19.418000000001296,3637.277777777778,70,4,13,74
6588,5.253750000001397,4770.3,57,17,16,74
6589,-41.48674999999971,2784.9473684210525,23,11,32,34
6590,-1.5404999999990274,1585.75,46,12,23,58
6591,-20.54624999999904,3110.7894736842104,45,5,14,50
6592,-17.787999999999528,2762.4210526315787,41,9,20,50
6593,3.5690000000006457,4237.0,76,8,18,84
6594,-26.037499999998346,1429.0,32,11,23,43
6595,-6.994749999999909,2319.823529411765,45,14,19,59
6596,-10.885499999998922,4486.2,47,18,14,65
6597,-2.4404999999995476,2179.0625,47,10,25,57
6598,0.4192500000011611,5238.578947368421,65,9,31,74
6599,-5.5049999999982555,2171.125,39,13,21,52
6600,12.560250000002217,3866.4444444444443,49,5,28,54
6601,-14.272999999999314,2857.6315789473683,42,9,28,51
6602,11.853750000001847,3101.8888888888887,46,11,21,57
6603,-7.282999999997882,3334.722222222222,45,10,18,55
6604,8.06975000000075,3978.4444444444443,63,14,28,77
6605,3.8300000000007786,2527.8888888888887,58,17,14,75
6606,-6.537249999998778,2685.764705882353,39,10,21,49
6607,-25.291499999998326,1960.8125,25,6,36,31
6608,-10.78149999999912,4279.85,44,10,18,54
6609,-9.362499999999127,2332.823529411765,50,18,16,68
6610,-16.87849999999933,2697.9411764705883,44,21,17,65
6611,-18.252999999998508,2310.8333333333335,34,8,19,42
6612,-2.1807499999991107,3643.3,41,7,19,48
6613,-24.181999999999462,3541.05,30,6,30,36
6614,-12.342999999999275,3167.1666666666665,44,19,22,63
6615,0.5945000000024898,4052.5,61,7,21,68
6616,-11.064749999999538,2711.4210526315787,40,10,21,50
6617,6.425500000001662,3181.0,49,24,8,73
6618,-13.98199999999938,2874.470588235294,46,14,21,60
6619,-1.8519999999984929,3202.684210526316,40,15,22,55
6620,-13.57124999999931,3895.75,49,5,18,54
6621,-1.5217499999981274,5298.1,64,15,11,79
6622,-6.301999999998069,4263.25,50,6,24,56
6623,-9.212499999999233,5271.85,52,14,19,66
6624,-20.581999999999347,2470.1176470588234,35,16,20,51
6625,-17.88949999999918,3502.85,28,7,21,35
6626,-34.56599999999924,2250.1111111111113,11,12,27,23
6627,-8.657249999998063,3017.277777777778,42,6,29,48
6628,-23.47349999999917,3275.85,22,11,25,33
6629,6.39375000000082,4923.631578947368,55,4,21,59
6630,-5.582999999998341,2568.176470588235,55,11,26,66
6631,-2.9774999999984617,3201.0526315789475,40,8,23,48
6632,-4.298749999998892,2072.3529411764707,40,8,17,48
6633,1.0970000000006945,3111.6,38,13,15,51
6634,-7.676249999998779,2354.1666666666665,39,12,38,51
6635,-33.89349999999926,2101.3529411764707,21,12,38,33
6636,-29.796499999999604,2807.5789473684213,18,5,28,23
6637,14.85375000000098,3884.4210526315787,56,13,21,69
6638,-37.64324999999923,2173.176470588235,28,16,29,44
6639,-3.845249999998127,2480.4117647058824,39,11,22,50
6640,-37.27849999999965,1662.1875,18,13,18,31
6641,7.106500000001897,2900.0,42,13,22,55
6642,-25.35825000000006,2992.9473684210525,26,8,25,34
6643,-26.192249999998666,2157.470588235294,29,9,22,38
6644,-3.7527499999994673,3837.75,39,8,16,47
6645,1.0242500000027686,3490.2631578947367,57,0,31,57
6646,-35.35249999999995,1429.0,24,10,26,34
6647,-6.86424999999805,3622.842105263158,51,9,16,60
6648,-4.988499999999319,3335.4736842105262,40,7,20,47
6649,8.553000000000491,2190.0588235294117,39,11,24,50
6650,-6.755749999999535,2950.1176470588234,59,14,19,73
6651,-43.961249999999936,1429.0,1,9,22,10
6652,19.827250000002913,4096.722222222223,57,14,24,71
6653,-22.831249999999436,1653.25,19,15,15,34
6654,4.328000000000436,3651.315789473684,36,9,26,45
6655,-32.88799999999975,2059.95,10,6,23,16
6656,-17.610749999999197,2526.0,61,11,19,72
6657,-32.55749999999941,2437.0555555555557,20,16,21,36
6658,-20.293499999998975,3271.9,33,12,20,45
6659,-7.7824999999979,4356.421052631579,60,4,32,64
6660,5.397250000002169,2950.0,53,8,21,61
6661,-8.364749999998006,4172.7,42,11,21,53
6662,-19.743499999999532,3453.65,34,11,18,45
6663,-49.89724999999986,2290.315789473684,9,6,35,15
6664,8.681250000000489,1971.4705882352941,37,13,23,50
6665,-12.4234999999991,2795.0555555555557,33,12,19,45
6666,-17.5817499999983,2518.0555555555557,35,7,23,42
6667,-13.112499999999557,4080.65,39,10,18,49
6668,-11.995749999999248,2764.1111111111113,38,17,17,55
6669,-18.190499999999986,1627.0,29,8,21,37
6670,-42.05149999999965,3178.35,17,10,23,27
6671,-6.208499999998757,4404.45,43,10,22,53
6672,-5.278499999998308,1943.0,44,6,24,50
6673,-9.455749999997433,2342.6666666666665,38,8,29,46
6674,-21.46599999999983,1848.6875,34,6,28,40
6675,-35.548749999999764,1429.0,10,14,35,24
6676,-15.897249999998582,1528.25,27,13,24,40
6677,-14.060999999998497,3441.85,40,8,16,48
6678,20.565250000002404,2559.0,70,5,21,75
6679,5.630500000002041,5895.0,68,15,15,83
6680,-1.460499999997686,4663.0526315789475,76,13,19,89
6681,-26.445499999999612,2314.3888888888887,21,6,24,27
6682,-5.975749999998694,3048.1,39,8,14,47
6683,-4.720499999998722,4242.65,51,18,15,69
6684,-8.762249999998327,2248.823529411765,36,12,18,48
6685,1.3497500000009004,4411.6,54,3,22,57
6686,-15.323249999999422,3911.5,39,9,18,48
6687,-2.8324999999977454,2323.277777777778,38,21,14,59
6688,-16.835999999999252,2600.1111111111113,45,6,27,51
6689,1.4615000000009837,4278.277777777777,62,6,22,68
6690,-14.80224999999876,2265.823529411765,41,10,26,51
6691,2.029500000001202,2268.25,44,12,21,56
6692,-9.387499999999553,1710.8125,34,11,26,45
6693,-11.361249999997975,2571.8823529411766,43,10,22,53
6694,-5.399499999999729,3063.9473684210525,45,11,20,56
6695,-28.965499999999434,3454.9473684210525,34,9,23,43
6696,-19.875999999998733,2255.3888888888887,24,3,30,27
6697,-26.91524999999884,2761.5,35,12,19,47
6698,-27.468499999999317,1429.0,19,7,20,26
6699,-14.382999999998813,1589.6470588235295,27,6,24,33
6700,-24.771249999998975,3342.6,24,14,23,38
6701,-20.498749999997653,2236.764705882353,43,4,26,47
6702,-7.023499999998455,3505.1052631578946,37,16,20,53
6703,-16.03599999999889,3680.3684210526317,35,10,16,45
6704,4.337000000001248,2650.294117647059,43,15,13,58
6705,-27.230999999998886,2296.2105263157896,11,14,33,25
6706,2.0445000000002547,2054.1875,52,6,16,58
6707,1.485000000001289,2115.5625,38,17,19,55
6708,-5.732749999998876,2602.705882352941,48,13,23,61
6709,-23.668249999999272,3285.45,28,2,24,30
6710,-10.904249999998743,2592.7894736842104,32,13,18,45
6711,-22.26224999999894,2685.823529411765,31,5,33,36
6712,-1.6174999999983632,2965.222222222222,44,12,16,56
6713,-8.940999999999567,1835.75,53,16,20,69
6714,-19.071749999999703,1481.9333333333334,39,10,26,49
6715,-21.392249999998548,3126.65,38,13,15,51
6716,-12.227249999998104,3223.5789473684213,40,10,22,50
6717,-23.42724999999912,2593.4117647058824,27,12,19,39
6718,-17.842999999998412,2461.6111111111113,24,17,20,41
6719,16.319750000000635,4047.1666666666665,62,23,15,85
6720,-9.66874999999977,2017.3529411764705,32,15,37,47
6721,-20.976499999998687,3417.4210526315787,29,21,25,50
6722,-33.504500000000014,2230.7,11,13,13,24
6723,1.2847500000001326,2926.3333333333335,49,12,19,61
6724,-23.733249999999394,4139.3,34,11,18,45
6725,-11.467499999999173,2949.3333333333335,33,22,12,55
6726,1.2187500000022875,2995.8823529411766,49,5,30,54
6727,-29.61999999999977,2626.65,15,9,23,24
6728,-16.886249999998473,4332.95,45,11,23,56
6729,-21.617749999999813,1911.125,37,12,20,49
6730,-17.750749999998725,3278.842105263158,36,0,35,36
6731,3.581000000001135,3470.842105263158,56,10,18,66
6732,-15.87524999999952,4301.25,43,12,21,55
6733,-8.541749999998723,2125.375,41,14,19,55
6734,-13.93049999999846,3079.95,41,4,24,45
6735,-17.97049999999937,3041.8333333333335,32,15,20,47
6736,-18.078249999997958,4286.2,48,11,24,59
6737,-24.426249999999428,3861.6,35,20,24,55
6738,5.3037500000021325,4929.95,59,6,17,65
6739,-29.571250000000088,2108.1111111111113,19,9,41,28
6740,-12.56474999999923,3227.45,31,14,15,45
6741,-3.8684999999983867,4230.315789473684,52,7,29,59
6742,-16.376249999999523,2194.705882352941,29,16,20,45
6743,14.318250000000138,3373.5555555555557,74,8,15,82
6744,-10.032249999998859,2461.6111111111113,34,15,20,49
6745,-8.167249999999417,2726.5263157894738,27,13,15,40
6746,11.69800000000173,3160.222222222222,40,11,26,51
6747,-4.552249999998798,2416.9411764705883,39,7,32,46
6748,-8.602999999999389,3591.0526315789475,37,9,20,46
6749,-21.045750000000034,2437.0,30,21,17,51
6750,-18.924500000000187,1429.0,41,15,22,56
6751,-30.677999999999578,2540.15,19,11,13,30
6752,-4.185999999998859,3876.842105263158,45,10,18,55
6753,0.3522500000013332,3884.3684210526317,64,13,22,77
6754,-3.6547499999981783,3525.157894736842,47,10,21,57
6755,14.000000000002098,3131.235294117647,60,10,17,70
6756,-14.499499999998596,2937.1052631578946,37,7,23,44
6757,3.703500000002556,3960.3684210526317,67,10,16,77
6758,-8.40374999999844,2654.777777777778,42,8,24,50
6759,-9.13249999999854,3459.9473684210525,45,10,25,55
6760,-8.704749999998603,2357.6875,51,13,24,64
6761,-20.009249999999227,2719.7894736842104,28,12,17,40
6762,-37.533249999999626,1949.4444444444443,8,8,30,16
6763,0.6642500000013156,2951.0555555555557,35,10,24,45
6764,-10.25724999999908,3045.5789473684213,34,4,24,38
6765,-29.893249999999625,1912.764705882353,28,12,24,40
6766,-19.51674999999907,2271.3888888888887,20,8,23,28
6767,23.589250000003094,5861.65,90,17,24,107
6768,13.117250000002155,2374.8823529411766,58,18,17,76
6769,-33.644250000000206,1429.0,25,25,23,50
6770,-5.34274999999852,3930.7,40,7,28,47
6771,-8.74324999999817,3831.7368421052633,47,8,32,55
6772,-10.778749999999022,3732.1,36,9,28,45
6773,6.959750000000758,3242.9444444444443,49,6,24,55
6774,-47.41275000000002,1429.0,0,9,24,9
6775,-21.768999999999437,2611.65,24,10,19,34
6776,8.188250000001883,3308.222222222222,63,14,26,77
6777,-17.84149999999928,2403.764705882353,30,14,32,44
6778,-0.23499999999709073,2158.375,54,7,22,61
6779,-4.968999999999247,4413.1,46,21,13,67
6780,-28.079499999998813,2239.6666666666665,25,11,23,36
6781,-7.534749999999167,2901.0,33,11,14,44
6782,-34.34774999999985,1984.7222222222222,13,16,28,29
6783,-31.396749999999354,2097.315789473684,16,9,22,25
6784,-7.5689999999982644,2685.823529411765,53,9,24,62
6785,1.1900000000004025,2005.0588235294117,38,5,31,43
6786,8.887750000001393,2445.8333333333335,44,9,20,53
6787,-29.0239999999993,2708.5,16,12,20,28
6788,-8.189999999997713,2469.6666666666665,42,9,27,51
6789,3.322000000003012,2590.5882352941176,48,9,26,57
6790,-22.991249999999255,3681.4210526315787,45,13,21,58
6791,3.750750000002337,4251.0,79,17,19,96
6792,14.521750000000775,4044.7368421052633,60,9,23,69
6793,-12.569999999998666,3354.45,35,15,15,50
6794,-28.435999999999247,2174.2631578947367,15,7,29,22
6795,-22.52024999999919,3252.8,35,7,18,42
6796,-43.18224999999849,1630.4375,24,23,26,47
6797,-17.779749999999513,2122.823529411765,36,18,21,54
6798,-16.917999999998635,2692.722222222222,26,14,24,40
6799,-12.932499999998488,2537.6111111111113,31,5,27,36
6800,-20.536249999998244,3159.3684210526317,32,10,32,42
6801,-50.65424999999992,2546.2631578947367,25,11,55,36
6802,-14.869749999999362,4169.55,42,11,28,53
6803,-19.081999999999905,2898.4736842105262,40,9,38,49
6804,-22.026249999999273,1429.0,18,14,17,32
6805,18.522500000001465,2803.529411764706,62,13,22,75
6806,5.12875000000119,3481.1111111111113,52,2,28,54
6807,-5.726999999998236,3601.4,43,4,23,47
6808,-31.35674999999994,2688.7894736842104,22,10,34,32
6809,-2.341499999997199,4143.222222222223,66,17,18,83
6810,-6.128749999998469,4352.210526315789,44,18,24,62
6811,-19.076249999998687,3072.315789473684,31,14,22,45
6812,-11.570749999998593,3125.0,40,10,17,50
6813,-6.699999999999332,3505.9473684210525,48,11,15,59
6814,-23.991749999998788,2909.6111111111113,36,8,20,44
6815,1.5912500000018959,2811.0555555555557,47,11,19,58
6816,10.764000000000266,3476.6666666666665,73,7,23,80
6817,-19.511499999999536,1429.0,20,14,29,34
6818,1.2542500000002472,3204.3684210526317,51,10,17,61
6819,-11.340499999999883,2540.1666666666665,33,10,30,43
6820,-15.784999999998908,3860.157894736842,46,22,21,68
6821,-3.6517499999992205,2835.5555555555557,46,9,23,55
6822,8.23850000000227,3136.222222222222,50,11,20,61
6823,-3.2479999999995144,2846.75,58,14,17,72
6824,-13.598249999999476,3153.4736842105262,28,11,26,39
6825,-8.195999999999012,2496.5625,50,6,19,56
6826,-1.00824999999822,4197.35,56,14,16,70
6827,-17.21224999999885,3840.2,35,11,24,46
6828,0.9245000000010208,4151.3,34,14,25,48
6829,-29.35449999999916,3100.7368421052633,37,4,23,41
6830,9.75175000000092,2492.5625,57,6,20,63
6831,-35.77524999999956,2377.8888888888887,21,7,43,28
6832,-3.7224999999982082,2711.222222222222,49,11,30,60
6833,-21.408999999997278,1528.25,42,13,24,55
6834,-3.509999999999093,2127.5,27,13,19,40
6835,-18.0599999999986,3334.6,34,14,19,48
6836,-8.019499999999383,3008.3888888888887,34,15,15,49
6837,-0.2572499999993564,2064.0588235294117,49,6,18,55
6838,-39.78324999999873,2701.4210526315787,16,8,42,24
6839,-20.191499999999987,3405.277777777778,48,27,23,75
6840,-24.608999999998698,2903.5789473684213,21,12,31,33
6841,-7.829749999998124,3457.3333333333335,48,16,21,64
6842,-12.080499999999045,3553.5789473684213,45,16,16,61
6843,-22.205999999999147,2544.35,25,1,19,26
6844,-32.28849999999952,2187.5,15,11,22,26
6845,8.611250000001094,4460.85,52,12,12,64
6846,-22.11599999999877,3460.7894736842104,35,4,18,39
6847,-14.369749999999517,2493.4444444444443,26,10,22,36
6848,-2.0142499999982055,2001.4117647058824,31,14,24,45
6849,-14.74024999999887,4285.45,33,18,11,51
6850,-16.275999999999993,2689.529411764706,36,19,14,55
6851,-19.87699999999931,2601.0,30,12,23,42
6852,-19.438249999999098,2198.470588235294,25,9,23,34
6853,-0.6327499999988134,2798.6111111111113,48,9,25,57
6854,-28.778749999999423,2852.05,22,10,21,32
6855,-31.345999999998508,3091.5789473684213,34,7,32,41
6856,-40.36450000000006,2018.25,33,14,30,47
6857,-24.119250000000182,2139.5882352941176,39,12,24,51
6858,-8.81499999999877,2839.2105263157896,25,16,30,41
6859,-13.678249999998508,2087.3529411764707,32,16,20,48
6860,1.490500000002235,1581.235294117647,35,12,26,47
6861,-34.22474999999897,1816.5882352941176,9,18,26,27
6862,9.592000000001645,4421.2,44,12,19,56
6863,-26.392499999997472,3510.8947368421054,48,2,27,50
6864,0.9660000000000801,2690.9444444444443,42,12,31,54
6865,-8.761999999999503,2395.4117647058824,45,14,26,59
6866,-5.141499999999388,3291.2631578947367,44,6,32,50
6867,-11.603999999998743,4349.65,37,17,22,54
6868,-26.600499999999368,2486.3888888888887,11,7,30,18
6869,0.6090000000018799,5358.45,57,3,23,60
6870,-11.968249999998386,3310.0,31,15,21,46
6871,-28.726499999999795,2175.9473684210525,11,12,18,23
6872,-2.9902499999986807,4015.55,40,12,23,52
6873,-16.866749999999143,2706.05,24,13,20,37
6874,-3.714749999998844,3393.8333333333335,59,4,28,63
6875,-17.342249999998902,2072.8333333333335,20,19,14,39
6876,-6.662499999999129,3693.35,40,19,15,59
6877,-16.415249999998345,3390.7368421052633,41,7,22,48
6878,-19.512249999998012,1978.5625,40,10,24,50
6879,-7.966999999998431,4078.2105263157896,52,14,22,66
6880,-4.890499999998402,2572.8333333333335,38,4,26,42
6881,-25.263499999998913,2766.8333333333335,39,8,29,47
6882,-21.594749999999287,2148.6666666666665,24,10,25,34
6883,-16.69575000000005,2084.529411764706,43,18,18,61
6884,-5.320749999999103,2546.705882352941,46,6,19,52
6885,-21.06724999999962,2190.0588235294117,36,19,16,55
6886,-6.536749999999745,2576.5882352941176,38,21,17,59
6887,-13.159500000000246,3532.1666666666665,71,17,28,88
6888,4.767500000001551,2411.1875,73,26,17,99
6889,-2.818249999998101,2955.5,52,6,19,58
6890,-16.962499999999324,2495.222222222222,23,9,23,32
6891,-33.60924999999844,2531.3333333333335,26,15,19,41
6892,-22.5282499999987,3257.65,37,9,25,46
6893,-19.411749999998765,2727.1111111111113,33,11,27,44
6894,-18.840749999999158,3894.95,36,6,23,42
6895,-25.121749999999523,3112.4736842105262,33,16,15,49
6896,-13.027499999998673,3179.85,31,9,21,40
6897,2.2065000000010264,2318.0,40,8,17,48
6898,-33.48074999999919,2424.842105263158,27,16,18,43
6899,-28.095999999999396,2152.1666666666665,20,13,16,33
6900,-6.290999999999019,4244.1,53,7,22,60
6901,-24.32324999999924,2493.5263157894738,28,14,14,42
6902,-29.438249999999336,1997.0,18,23,17,41
6903,-30.15249999999935,3091.7,24,14,23,38
6904,-11.344499999999224,2430.0,23,13,18,36
6905,-29.165749999998248,2855.1111111111113,34,12,23,46
6906,-16.75450000000016,1429.0,32,4,28,36
6907,7.0722500000015245,3092.4210526315787,40,12,19,52
6908,-11.557499999999482,2825.777777777778,39,11,19,50
6909,-22.18849999999949,3756.5263157894738,37,24,18,61
6910,-17.78574999999922,2854.2105263157896,25,15,23,40
6911,-9.776499999999817,1728.625,36,12,34,48
6912,13.491500000000329,3119.9473684210525,51,13,19,64
6913,-14.613999999998128,4467.2,51,10,26,61
6914,-8.111249999997383,4157.578947368421,53,9,24,62
6915,-16.66299999999862,2114.3529411764707,27,2,40,29
6916,-23.600249999998812,4130.0,56,12,24,68
6917,-23.809249999999402,2559.95,20,8,19,28
6918,-47.56974999999973,3117.9,20,10,27,30
6919,10.320500000001712,3165.3888888888887,64,17,18,81
6920,-23.423999999999204,2636.157894736842,25,7,22,32
6921,-34.238499999998716,1690.4705882352941,10,10,32,20
6922,-12.256499999999082,2080.8888888888887,25,19,8,44
6923,-0.039999999999259295,4250.315789473684,64,7,18,71
6924,-29.387999999999305,2143.470588235294,22,18,13,40
6925,-12.393999999998224,2826.777777777778,36,13,22,49
6926,-15.588749999999237,1656.8823529411766,26,14,17,40
6927,11.196500000001176,2043.4705882352941,38,12,18,50
6928,-16.51674999999985,2084.277777777778,28,14,23,42
6929,-18.50499999999852,2718.9473684210525,35,9,15,44
6930,-36.91324999999891,1564.0,17,9,26,26
6931,-15.129499999998805,2636.3333333333335,36,15,17,51
6932,-6.453249999999784,2383.3529411764707,38,19,19,57
6933,-11.022999999999126,2648.157894736842,29,14,17,43
6934,-19.02224999999911,3339.684210526316,33,12,18,45
6935,9.390250000001048,3080.8888888888887,44,1,22,45
6936,-14.31174999999829,2568.5,39,15,28,54
6937,-28.401749999999964,2568.3333333333335,30,14,25,44
6938,-12.42674999999896,2258.8333333333335,33,11,16,44
6939,-10.490999999998682,3874.35,38,16,19,54
6940,-24.265500000000127,2621.2105263157896,25,10,34,35
6941,16.731250000000205,2608.9444444444443,48,11,18,59
6942,14.094500000001839,2930.0625,50,9,22,59
6943,-32.676499999999194,2499.157894736842,25,12,17,37
6944,-8.925249999999384,2054.0,62,15,25,77
6945,1.3705000000022147,1528.25,41,16,17,57
6946,-2.7762499999991523,2538.294117647059,49,14,26,63
6947,-10.383249999998716,3606.2631578947367,52,7,22,59
6948,2.5705000000009877,2299.235294117647,59,10,15,69
6949,9.59875000000157,3317.8888888888887,58,23,19,81
6950,-16.037249999999872,2511.176470588235,33,8,27,41
6951,-21.736999999998922,3406.9,28,5,19,33
6952,-1.968999999998528,3800.0526315789475,47,21,11,68
6953,-18.185499999998733,2590.315789473684,26,8,24,34
6954,-22.591999999999768,2119.5,24,9,25,33
6955,-11.06624999999899,2407.3125,38,16,18,54
6956,-23.641999999998287,2144.294117647059,29,6,29,35
6957,-25.647999999999676,2591.1052631578946,21,8,22,29
6958,0.8272500000001551,2125.5,53,18,21,71
6959,14.359750000001473,4394.15,57,17,16,74
6960,-24.54549999999874,2913.6315789473683,35,17,15,52
6961,-18.864999999999025,2494.2105263157896,21,10,25,31
6962,-2.214500000000244,2354.3529411764707,46,6,20,52
6963,-21.53650000000036,2025.7058823529412,36,9,32,45
6964,-5.678499999999209,2912.823529411765,41,11,15,52
6965,-11.580999999999005,3532.222222222222,50,20,21,70
6966,14.833000000001501,2245.1176470588234,44,11,21,55
6967,-5.31149999999853,4771.85,50,13,22,63
6968,5.790749999999885,2261.0,68,11,24,79
6969,-12.236999999999052,2167.6470588235293,37,16,22,53
6970,13.207750000000734,1481.9333333333334,41,21,9,62
6971,-19.90049999999998,2256.222222222222,34,5,29,39
6972,-1.5487499999993144,5212.631578947368,75,5,24,80
6973,-29.69224999999911,2357.6111111111113,27,5,24,32
6974,19.999750000002006,5012.263157894737,72,10,18,82
6975,-19.207249999999455,2091.9411764705883,28,11,13,39
6976,-27.68225000000004,2668.8947368421054,22,11,47,33
6977,21.41575000000227,2955.5882352941176,67,11,21,78
6978,-19.01299999999906,2678.157894736842,24,5,29,29
6979,-16.623499999999332,3436.9444444444443,57,12,25,69
6980,-35.09174999999969,1429.0,10,11,24,21
6981,-24.515999999999742,2666.3684210526317,30,15,20,45
6982,-20.990499999998722,2064.0,27,6,30,33
6983,-6.259999999999086,2764.3529411764707,39,12,16,51
6984,-13.595999999998213,4106.684210526316,65,8,19,73
6985,-7.338749999999223,2411.3125,35,3,26,38
6986,-14.31974999999911,3009.0,31,8,19,39
6987,-7.342249999998669,3958.1666666666665,70,19,15,89
6988,16.924750000001637,4159.222222222223,67,14,19,81
6989,-12.97499999999946,2262.4444444444443,37,12,26,49
6990,-33.62424999999884,2279.1666666666665,19,9,24,28
6991,-19.467249999997907,2596.6666666666665,33,9,30,42
6992,9.915000000003534,5403.7,83,12,20,95
6993,-16.45124999999871,2231.5555555555557,29,9,25,38
6994,-16.33324999999875,3409.25,34,13,21,47
6995,1.4902500000001269,3449.3888888888887,48,10,22,58
6996,-31.78824999999901,1603.625,17,10,37,27
6997,-30.27749999999974,1567.9375,27,18,20,45
6998,6.798000000001386,3752.722222222222,61,12,26,73
6999,-37.18699999999943,1982.5625,17,10,33,27
7000,3.0272500000017013,4320.473684210527,64,3,25,67
7001,12.397500000001568,3384.294117647059,61,18,18,79
7002,-20.998249999998794,2072.9444444444443,25,3,27,28
7003,7.078000000001387,2889.4375,55,7,23,62
7004,-24.573749999999954,1997.2631578947369,13,15,27,28
7005,-4.430249999998685,4203.7,45,12,20,57
7006,5.167750000001648,4446.631578947368,57,8,19,65
7007,-9.774750000000022,2614.5263157894738,32,9,21,41
7008,-1.9569999999986294,5237.05,58,14,22,72
7009,-20.654249999999944,2611.5555555555557,35,17,22,52
7010,-27.249749999997572,1528.25,32,9,26,41
7011,-21.233250000000275,3434.0,41,13,30,54
7012,-18.496499999999603,2417.5555555555557,26,14,29,40
7013,-9.828499999998781,1539.0666666666666,36,17,22,53
7014,12.871750000001299,2719.4117647058824,54,8,23,62
7015,-19.115999999998927,1528.25,22,6,20,28
7016,-27.788749999999943,1481.9333333333334,17,18,15,35
7017,-2.9422499999975207,3326.8333333333335,53,12,24,65
7018,-12.624249999999318,3079.8947368421054,36,14,25,50
7019,-36.273499999998464,1668.0,19,13,26,32
7020,-24.580249999999264,2717.95,22,8,27,30
7021,-9.884499999998873,3452.05,39,12,17,51
7022,-9.990999999999358,2937.8888888888887,28,15,20,43
7023,-3.7412499999989945,3254.3684210526317,44,8,20,52
7024,-14.320249999999863,2252.5882352941176,39,20,16,59
7025,-23.513750000000247,2208.4736842105262,22,15,20,37
7026,-0.39024999999918764,3177.5789473684213,37,9,19,46
7027,-10.636249999998968,2304.0625,57,10,25,67
7028,0.8312500000006926,2769.823529411765,61,8,16,69
7029,-20.633500000000147,1761.4705882352941,18,8,43,26
7030,3.4665000000017443,3437.4736842105262,44,16,13,60
7031,19.51175000000202,2441.4444444444443,60,13,19,73
7032,-17.332749999998594,2632.8333333333335,38,5,27,43
7033,-4.495749999998936,3036.6666666666665,41,10,16,51
7034,-8.869499999999874,2244.176470588235,38,11,24,49
7035,-12.165499999998787,2191.8888888888887,22,19,17,41
7036,-12.06049999999678,3624.8888888888887,66,13,18,79
7037,-17.348999999999254,3165.55,25,13,17,38
7038,-2.979749999999035,3068.3888888888887,46,15,15,61
7039,-29.51274999999934,2600.315789473684,14,9,30,23
7040,-13.65049999999797,2398.222222222222,30,10,29,40
7041,-12.368249999998737,3786.95,36,7,23,43
7042,-2.7062499999986143,2635.470588235294,49,13,16,62
7043,-19.93699999999955,1778.235294117647,23,10,17,33
7044,0.20375000000173263,2492.5555555555557,40,4,20,44
7045,-8.601249999999812,3388.0526315789475,49,13,21,62
7046,-9.952249999999108,3170.9473684210525,39,8,18,47
7047,5.787750000002071,4508.45,51,9,18,60
7048,-14.403749999999132,3310.4210526315787,27,17,18,44
7049,-9.418499999999533,3013.0,45,12,18,57
7050,-8.143499999999204,2529.6111111111113,34,5,22,39
7051,-12.543749999999264,2447.5555555555557,51,9,23,60
7052,-30.3627499999994,2807.5789473684213,24,21,21,45
7053,-17.14049999999887,3265.2631578947367,36,5,27,41
7054,-13.58574999999956,2482.5263157894738,20,14,13,34
7055,-12.391499999998707,4664.9,49,10,16,59
7056,-18.656999999999062,2046.5263157894738,22,5,22,27
7057,-4.92774999999835,3409.6666666666665,59,22,17,81
7058,-35.334249999998804,2414.1111111111113,22,7,29,29
7059,-1.6592499999987063,2066.764705882353,54,13,22,67
7060,-26.66924999999882,3264.1,27,9,25,36
7061,-8.105000000000297,1991.625,44,22,17,66
7062,-28.76724999999912,2464.9473684210525,21,16,22,37
7063,-14.862999999998587,2579.0,34,17,22,51
7064,-6.270499999999584,3943.6315789473683,42,12,19,54
7065,13.855000000001445,3352.277777777778,77,12,23,89
7066,4.742250000001466,2237.5,40,12,21,52
7067,-16.9034999999989,1534.8666666666666,30,9,18,39
7068,-34.18299999999923,3194.4210526315787,34,11,22,45
7069,-11.913749999999961,2045.125,54,6,29,60
7070,-41.44574999999959,1528.25,8,6,26,14
7071,-29.65450000000027,2227.1111111111113,19,7,39,26
7072,-27.62299999999929,2664.5,24,15,22,39
7073,-4.262749999998265,2116.9444444444443,35,12,21,47
7074,-13.32999999999949,2370.0555555555557,35,11,21,46
7075,-16.97399999999903,2370.176470588235,33,7,21,40
7076,3.454500000000319,3381.3888888888887,54,19,10,73
7077,-26.808499999999725,2176.0588235294117,31,12,16,43
7078,-0.1512499999990556,2841.777777777778,41,13,23,54
7079,-21.314749999999474,2798.5555555555557,36,16,16,52
7080,10.332250000001602,5448.9,60,19,17,79
7081,-9.814249999999493,2714.823529411765,40,12,15,52
7082,-27.609750000000087,1429.0,31,9,27,40
7083,-18.368749999999313,3119.5,35,7,14,42
7084,-5.535999999999409,3135.3333333333335,46,27,15,73
7085,-27.854499999999103,3836.2,39,6,23,45
7086,-24.857999999998096,2253.5882352941176,34,7,28,41
7087,-9.67174999999782,2262.823529411765,44,9,21,53
7088,10.248500000001282,2573.764705882353,42,12,14,54
7089,-13.741749999999561,3117.4210526315787,39,6,26,45
7090,-39.28175000000034,1961.2105263157894,10,10,34,20
7091,1.3150000000005908,3529.315789473684,63,11,15,74
7092,-3.6519999999993744,2201.3529411764707,41,15,16,56
7093,-16.407499999999793,3282.8947368421054,45,7,28,52
7094,2.8875000000009052,3171.5555555555557,57,12,19,69
7095,12.15775000000163,4635.45,57,7,15,64
7096,-23.2732500000001,2471.0588235294117,46,10,26,56
7097,2.067000000002049,2358.625,47,7,21,54
7098,6.896000000003236,2197.529411764706,60,9,22,69
7099,-27.070749999999993,2623.684210526316,21,5,20,26
7100,-28.62699999999932,2844.1,19,8,25,27
7101,-20.055749999998966,2235.705882352941,48,21,31,69
7102,-5.564499999998876,4537.8,44,17,15,61
7103,-7.249499999997539,3198.5263157894738,50,12,18,62
7104,-10.547000000000008,2512.8888888888887,46,20,13,66
7105,11.225000000002614,5437.85,73,12,20,85
7106,-27.702499999998775,2825.0555555555557,36,8,21,44
7107,-37.87925000000012,1429.0,11,10,19,21
7108,-12.044499999999355,3425.9,31,10,19,41
7109,-39.43299999999887,2136.684210526316,14,11,27,25
7110,2.0065000000020463,2771.277777777778,40,8,26,48
7111,-6.917499999998855,2198.470588235294,46,13,22,59
7112,-20.28424999999886,3244.95,26,13,21,39
7113,-31.44524999999921,2171.5555555555557,20,12,37,32
7114,-13.3567499999983,2316.1176470588234,57,13,32,70
7115,-26.35474999999918,2853.7,28,10,18,38
7116,-14.37399999999926,2433.5,44,14,16,58
7117,-10.339999999998891,2660.1111111111113,31,8,22,39
7118,1.2995000000014119,3266.777777777778,57,8,18,65
7119,3.322250000000605,4691.0,43,19,15,62
7120,-0.7282499999991219,3645.4736842105262,52,6,20,58
7121,2.20450000000105,3143.277777777778,58,17,11,75
7122,-17.726249999997723,3957.0526315789475,49,4,26,53
7123,-12.567749999998956,2050.125,39,9,19,48
7124,7.778000000001482,2148.6666666666665,57,11,22,68
7125,-14.116749999998026,1974.6875,41,9,31,50
7126,9.622750000002357,3957.8947368421054,62,6,22,68
7127,-23.854749999999612,2538.4736842105262,35,10,21,45
7128,2.8617500000010754,3004.8888888888887,37,5,22,42
7129,-24.91724999999951,2627.45,25,5,20,30
7130,-26.760250000000248,2202.1176470588234,25,15,23,40
7131,-5.235999999999082,4084.842105263158,53,18,24,71
7132,-12.256999999998516,2172.294117647059,44,20,16,64
7133,-20.17749999999874,3275.3684210526317,33,8,29,41
7134,-10.42424999999879,2261.9411764705883,31,13,15,44
7135,-8.944499999998802,2800.3333333333335,40,8,18,48
7136,-30.3124999999995,1576.875,13,13,20,26
7137,4.029500000002182,2791.5,43,13,16,56
7138,-3.8297499999994384,4340.9,51,7,18,58
7139,-13.083999999999449,2954.6111111111113,29,10,17,39
7140,-5.611749999997513,3215.6666666666665,57,9,20,66
7141,-11.537750000000134,3389.3888888888887,55,9,14,64
7142,-40.732749999999456,2245.2105263157896,11,12,24,23
7143,-43.811499999999334,1429.0,8,9,21,17
7144,-19.108749999998867,2740.7894736842104,28,6,20,34
7145,-28.616749999998415,2414.8947368421054,19,11,35,30
7146,-18.32699999999921,2901.4,22,13,24,35
7147,-11.332999999999217,3701.5263157894738,38,9,16,47
7148,-6.628749999999552,2322.3888888888887,39,16,17,55
7149,-33.19624999999958,1983.6470588235295,23,19,31,42
7150,-6.982999999998389,2374.8823529411766,45,13,16,58
7151,5.154250000001636,4393.888888888889,75,5,24,80
7152,-39.31424999999943,2599.222222222222,21,11,23,32
7153,-19.429249999999467,2765.6,28,5,19,33
7154,-6.842999999999533,2601.823529411765,43,10,28,53
7155,8.36825000000172,2870.705882352941,47,11,13,58
7156,-23.06424999999899,2651.3,26,11,18,37
7157,-26.543999999999293,2369.842105263158,21,15,12,36
7158,-18.93525000000016,2168.529411764706,36,14,17,50
7159,3.62600000000083,4057.315789473684,64,12,16,76
7160,-25.96699999999928,2410.4444444444443,19,4,34,23
7161,1.8917500000008254,2909.6666666666665,50,4,21,54
7162,3.1587500000022812,2593.875,55,9,20,64
7163,-29.969749999999145,1429.0,16,8,26,24
7164,-13.416999999997675,4844.25,57,8,18,65
7165,0.44325000000152814,2464.3333333333335,45,11,14,56
7166,-0.35799999999783977,2988.294117647059,60,12,18,72
7167,13.476250000001627,4260.368421052632,52,20,20,72
7168,2.0117500000026194,3294.1666666666665,66,3,19,69
7169,-6.763249999998481,3508.4,37,9,19,46
7170,7.0795000000012624,2408.5882352941176,58,13,19,71
7171,-6.213499999998082,2594.777777777778,46,14,17,60
7172,-9.027499999998323,2572.8333333333335,39,5,20,44
7173,-28.074999999999182,2219.222222222222,32,11,23,43
7174,-12.689249999998685,2975.8888888888887,40,14,18,54
7175,-7.055999999999308,2241.5625,41,15,22,56
7176,-12.275749999999288,2976.6666666666665,42,10,24,52
7177,11.61475000000139,3997.1052631578946,65,6,19,71
7178,21.566250000001506,4167.222222222223,85,14,19,99
7179,-19.31074999999943,1481.9333333333334,20,12,22,32
7180,-35.87349999999947,2207.6,14,14,18,28
7181,-6.300999999998918,2366.470588235294,45,16,14,61
7182,17.421500000001128,5538.6,80,16,16,96
7183,-0.37324999999694325,2247.4444444444443,49,8,29,57
7184,-14.836249999998467,1710.75,39,15,17,54
7185,-16.475249999998596,2264.375,37,5,30,42
7186,-19.900499999998356,1528.25,29,10,24,39
7187,-11.711749999998233,2527.8333333333335,43,11,28,54
7188,6.755750000001072,4192.631578947368,53,11,17,64
7189,-20.96899999999887,3597.0526315789475,34,15,30,49
7190,-16.308249999999283,4216.35,41,9,18,50
7191,-25.03849999999823,4041.7,48,11,19,59
7192,-37.46200000000031,1925.4444444444443,14,6,43,20
7193,-28.679499999999564,2510.9473684210525,18,5,30,23
7194,-5.861499999999261,2045.125,56,17,18,73
7195,-36.18974999999982,1858.5555555555557,10,10,18,20
7196,-21.857749999999392,2166.1875,34,7,31,41
7197,-22.64949999999876,3329.9,23,6,29,29
7198,-18.115749999998766,3289.45,34,11,22,45
7199,-11.038249999999483,2929.1111111111113,38,18,19,56
7200,-8.959999999997331,3036.5555555555557,54,14,16,68
7201,-9.869249999997958,2850.8333333333335,40,13,23,53
7202,1.5242500000014971,1732.625,51,17,17,68
7203,-23.583749999998364,2723.157894736842,33,4,23,37
7204,-24.040250000000817,1429.0,33,17,25,50
7205,-18.749749999998876,1576.875,62,23,21,85
7206,-22.648249999999535,1696.875,33,14,24,47
7207,-5.765749999998467,2499.5555555555557,37,16,15,53
7208,0.1192500000006392,2517.823529411765,38,3,21,41
7209,0.3160000000003288,2274.0588235294117,43,7,20,50
7210,-18.80549999999953,2433.5555555555557,29,17,19,46
7211,-16.083749999998723,2601.0,30,19,17,49
7212,-17.992499999999204,2548.15,24,12,21,36
7213,-35.6304999999998,1603.625,17,18,23,35
7214,-7.695249999998305,4601.210526315789,53,11,24,64
7215,-11.76524999999842,2498.722222222222,28,10,25,38
7216,-36.05375000000008,1429.0,11,3,39,14
7217,-20.229749999999306,1572.875,25,6,18,31
7218,-25.514749999998962,1510.5333333333333,24,13,16,37
7219,-16.82999999999972,2651.315789473684,37,10,15,47
7220,-19.40424999999829,2442.4210526315787,35,8,23,43
7221,-20.371499999998694,2407.0,26,21,15,47
7222,-7.960749999999702,2643.3888888888887,40,7,34,47
7223,-8.227249999998723,3599.3333333333335,51,6,20,57
7224,-4.8552499999973,3307.3888888888887,54,11,24,65
7225,-15.450499999999527,2719.4117647058824,37,5,30,42
7226,-20.615249999999342,2544.9411764705883,38,9,20,47
7227,-10.22124999999917,3665.6,32,22,10,54
7228,-36.965499999999565,1429.0,26,9,28,35
7229,-14.31249999999989,2028.7222222222222,27,15,22,42
7230,-19.019749999998258,1528.25,30,11,19,41
7231,-41.56474999999931,2239.4444444444443,15,15,21,30
7232,-21.00549999999909,2156.4117647058824,38,11,24,49
7233,-21.6042499999985,3001.3684210526317,26,0,34,26
7234,4.844000000000883,3469.6111111111113,74,9,25,83
7235,-31.118499999998978,2107.5625,32,11,31,43
7236,-3.4867499999984006,2350.722222222222,33,12,20,45
7237,-17.51749999999895,2707.315789473684,25,8,23,33
7238,-21.860749999999065,2660.4736842105262,22,13,20,35
7239,6.132750000000793,2381.5882352941176,54,14,16,68
7240,-14.722250000000026,2317.9444444444443,34,13,20,47
7241,-38.28574999999987,1429.0,7,5,23,12
7242,-20.12274999999984,1764.3125,40,3,24,43
7243,-22.043749999999765,2738.6111111111113,33,21,25,54
7244,-30.59249999999931,2298.6111111111113,20,5,39,25
7245,3.379000000000816,4004.6315789473683,55,7,17,62
7246,-22.391499999998853,2715.6315789473683,26,1,28,27
7247,12.818750000001847,4705.4,58,10,19,68
7248,-12.114999999999506,2017.3529411764705,28,8,24,36
7249,-11.225249999998175,2030.4117647058824,52,9,27,61
7250,7.008500000001945,2037.25,45,9,27,54
7251,13.886250000000691,4621.95,59,11,26,70
7252,-6.703499999998762,2455.235294117647,31,4,27,35
7253,-7.992749999999077,3198.5263157894738,42,18,10,60
7254,-8.480999999999936,2163.125,40,5,19,45
7255,-17.686499999998734,4309.2,39,12,18,51
7256,-14.851499999999708,2130.375,46,4,23,50
7257,-10.389749999998866,2627.9473684210525,32,15,14,47
7258,6.812250000001558,2896.0,46,6,25,52
7259,2.591500000000789,3563.9444444444443,67,24,24,91
7260,0.2140000000008861,4106.684210526316,50,10,27,60
7261,-3.333249999998902,3944.5789473684213,50,10,25,60
7262,-8.192499999999315,2664.5,40,10,25,50
7263,9.077750000000847,4405.25,43,6,22,49
7264,-12.74149999999897,3153.0,35,7,21,42
7265,-11.74374999999828,2684.0,38,17,23,55
7266,-24.325999999998928,3652.95,29,12,26,41
7267,-14.48199999999903,3235.2105263157896,33,9,21,42
7268,-6.841249999999157,5019.5,53,5,17,58
7269,-7.19999999999889,2679.5,52,14,21,66
7270,-8.32399999999902,2996.764705882353,47,7,24,54
7271,-23.149249999998766,2648.7368421052633,27,21,20,48
7272,-15.912249999997949,4137.15,45,11,15,56
7273,-14.543249999998526,2494.3333333333335,35,7,24,42
7274,-14.338749999998223,3196.0,45,4,16,49
7275,-1.0852499999983518,3475.842105263158,46,13,24,59
7276,-12.316249999999318,3419.9473684210525,52,3,27,55
7277,15.173500000002264,3101.8333333333335,63,7,14,70
7278,-2.059249999997961,4190.1,46,19,18,65
7279,8.00775000000125,4910.0,66,4,21,70
7280,-21.035249999998957,3163.4736842105262,35,5,32,40
7281,-16.093749999999922,3067.315789473684,36,21,15,57
7282,0.3962500000014478,2264.375,52,11,19,63
7283,-12.446999999998646,2723.157894736842,35,7,21,42
7284,6.3697500000014085,2455.176470588235,57,9,33,66
7285,-24.337750000000106,2484.6111111111113,38,21,29,59
7286,11.457750000001662,3663.6666666666665,60,17,24,77
7287,-3.977499999998146,2345.0,44,17,10,61
7288,-7.577499999999267,3131.6315789473683,30,9,28,39
7289,0.7995000000022774,4889.5,63,13,18,76
7290,4.67725000000231,3128.5,54,7,25,61
7291,-14.39424999999899,2381.470588235294,38,10,22,48
7292,-7.487749999998779,3783.2105263157896,37,7,20,44
7293,-19.716999999999754,2670.6315789473683,30,14,26,44
7294,-2.840749999999144,3509.3888888888887,66,9,14,75
7295,-2.5832499999988716,3615.9444444444443,49,16,22,65
7296,-10.5799999999985,3494.277777777778,46,7,21,53
7297,1.574750000001663,5053.75,51,9,16,60
7298,-25.97974999999886,3627.1052631578946,29,11,24,40
7299,11.324000000000789,3163.6111111111113,75,6,19,81
7300,-19.02624999999919,2606.2105263157896,31,2,32,33
7301,7.499250000001223,2287.176470588235,43,12,12,55
7302,9.2527500000031,3663.6666666666665,70,4,20,74
7303,-20.759999999999224,3174.3,30,14,15,44
7304,4.6035000000016675,3526.0,41,10,25,51
7305,-19.865749999999213,3514.05,33,6,28,39
7306,-17.806249999998904,4815.55,44,4,27,48
7307,-2.783749999997622,1742.5625,46,11,20,57
7308,5.626000000002273,4109.894736842105,64,8,14,72
7309,-17.88949999999863,2433.823529411765,34,8,33,42
7310,-1.6417499999984286,2108.625,49,4,16,53
7311,6.591000000003423,2774.529411764706,66,7,21,73
7312,-48.03124999999952,1429.0,8,2,36,10
7313,-21.80799999999868,1534.8666666666666,28,8,21,36
7314,-41.33499999999893,2684.7894736842104,20,7,30,27
7315,-26.14724999999921,2608.0,26,14,20,40
7316,-1.342249999998632,3988.7894736842104,53,10,16,63
7317,-15.061749999999552,2764.8,31,15,12,46
7318,-19.883499999999263,2583.05,23,9,18,32
7319,-38.21949999999889,2072.8333333333335,8,16,29,24
7320,20.141000000003494,1626.5,64,15,19,79
7321,6.0417500000023185,4599.65,60,11,18,71
7322,-18.927249999999795,2108.1666666666665,19,10,20,29
7323,-24.412999999999847,2933.5,29,10,20,39
7324,13.596500000001495,2847.8888888888887,50,11,18,61
7325,-10.41099999999884,3327.0,36,14,29,50
7326,7.605750000001711,4155.0526315789475,65,12,15,77
7327,-20.14199999999943,2591.157894736842,36,8,23,44
7328,-2.5739999999979206,3512.8888888888887,65,7,26,72
7329,-12.169499999999825,2298.5555555555557,37,6,27,43
7330,6.511500000001535,4817.95,50,8,18,58
7331,-19.847250000000134,1429.0,20,0,37,20
7332,-23.60449999999969,2497.0555555555557,19,8,31,27
7333,6.940000000000223,2358.1176470588234,53,3,26,56
7334,-16.945499999998567,3915.6,41,6,20,47
7335,-31.236499999998976,3044.15,24,4,27,28
7336,-20.998749999999184,3500.8947368421054,31,14,36,45
7337,-1.4244999999990868,2192.9375,42,5,24,47
7338,5.411750000001862,2108.6875,48,5,25,53
7339,-3.333499999999998,3225.2105263157896,51,2,24,53
7340,-21.524499999999353,4200.1578947368425,51,3,25,54
7341,-26.878749999999023,2734.0,36,10,21,46
7342,-13.184749999998456,4813.15,53,8,25,61
7343,-7.402999999998839,3143.3529411764707,64,12,20,76
7344,-17.280249999998937,2484.235294117647,31,4,23,35
7345,-36.60674999999897,2587.85,23,9,23,32
7346,12.462750000001318,5361.65,61,13,15,74
7347,-12.262749999998732,3875.2631578947367,43,7,32,50
7348,-19.738999999999372,1481.9333333333334,31,7,26,38
7349,-14.415749999998255,2946.6666666666665,40,9,21,49
7350,-23.803999999999768,3322.1052631578946,31,5,23,36
7351,-2.332249999997223,2041.111111111111,44,15,18,59
7352,-24.84299999999906,1948.0,31,7,14,38
7353,-3.6149999999982527,4421.1,52,13,18,65
7354,-11.695250000000073,2508.5,35,8,27,43
7355,-9.491499999999958,2579.8888888888887,39,5,32,44
7356,8.469000000001916,3049.8888888888887,53,4,22,57
7357,-24.72049999999883,2959.25,23,8,27,31
7358,-24.096999999999746,1576.875,13,15,31,28
7359,-21.583249999999442,2688.8947368421054,23,7,33,30
7360,-11.03374999999965,1879.0588235294117,27,10,21,37
7361,5.387250000001388,2430.0,43,4,17,47
7362,-50.96649999999988,1429.0,13,15,30,28
7363,0.535500000001176,4402.05,53,10,15,63
7364,-15.455999999999088,3322.3888888888887,54,4,26,58
7365,-16.23449999999867,2610.4117647058824,37,14,17,51
7366,16.134000000001397,3020.176470588235,78,6,19,84
7367,-6.632999999999031,2953.777777777778,37,4,19,41
7368,-16.528499999999294,4321.9,38,18,23,56
7369,-32.89874999999959,2793.315789473684,23,11,29,34
7370,-3.4249999999980725,3227.1111111111113,57,8,18,65
7371,1.8692500000012469,3095.8,42,15,15,57
7372,-28.66774999999874,1989.888888888889,21,21,19,42
7373,-1.3547499999986985,3809.157894736842,43,6,34,49
7374,-0.6917499999998677,1991.625,57,11,24,68
7375,-23.817999999999124,3333.05,30,4,22,34
7376,9.541750000001771,2996.705882352941,57,8,31,65
7377,-21.667249999997956,2143.4117647058824,29,20,27,49
7378,-1.3392499999991032,2282.4117647058824,34,7,28,41
7379,-12.646249999999597,3027.315789473684,39,9,19,48
7380,-18.300499999999023,2698.1052631578946,33,11,21,44
7381,-26.24724999999943,3196.5,23,7,23,30
7382,-22.270999999999045,3133.4210526315787,28,12,23,40
7383,-34.873749999999816,1429.0,8,11,23,19
7384,-14.408249999999507,2773.2631578947367,27,1,26,28
7385,-5.1342499999989055,3020.5789473684213,41,6,17,47
7386,3.7700000000022604,4155.0526315789475,69,5,30,74
7387,15.219250000003035,4108.263157894737,68,12,27,80
7388,-19.40749999999939,2059.3529411764707,30,15,23,45
7389,-16.494249999998157,4911.55,54,6,33,60
7390,-29.04974999999859,1922.111111111111,21,12,21,33
7391,-5.763999999997418,4285.421052631579,51,11,29,62
7392,4.763500000000966,3165.157894736842,53,14,16,67
7393,-11.994749999999925,2423.470588235294,45,12,24,57
7394,6.886000000001549,4317.95,58,5,24,63
7395,-0.8989999999988483,3272.0,39,7,14,46
7396,4.265250000000824,3516.4444444444443,57,13,14,70
7397,-24.622249999999166,2833.9,27,11,20,38
7398,-8.231249999998159,1930.0,28,11,30,39
7399,-16.930500000000244,2343.4444444444443,27,8,24,35
7400,-12.665749999999125,4364.789473684211,44,16,13,60
7401,-14.288749999998183,2941.3888888888887,48,12,33,60
7402,-15.64849999999866,3632.9473684210525,31,6,33,37
7403,-8.044749999999521,3861.8947368421054,54,13,17,67
7404,-25.304999999999744,2798.1,17,19,16,36
7405,-34.536249999999775,2159.222222222222,16,14,27,30
7406,-15.476499999998481,3941.7,39,6,22,45
7407,2.07650000000154,3064.8333333333335,43,2,24,45
7408,-31.41224999999968,1514.375,12,3,41,15
7409,-6.506999999998905,3172.7,30,10,19,40
7410,-9.310749999998725,4901.3,55,12,17,67
7411,-14.573749999999297,2859.4444444444443,33,4,19,37
7412,6.518000000001734,4267.894736842105,70,4,25,74
7413,-22.08649999999915,3275.0,30,11,23,41
7414,-1.693499999998842,2561.3333333333335,34,4,21,38
7415,-32.97024999999831,3178.777777777778,34,11,24,45
7416,-16.78549999999949,2025.7058823529412,36,5,34,41
7417,-18.061999999999067,3130.6,32,5,22,37
7418,0.4467500000016374,3595.75,47,10,16,57
7419,-30.834499999999007,2439.9473684210525,23,8,20,31
7420,-9.626749999999063,2850.6111111111113,64,10,25,74
7421,1.8855000000011812,4042.315789473684,65,12,12,77
7422,-10.36474999999825,3415.55,41,4,20,45
7423,-26.931999999999636,2234.8823529411766,24,4,27,28
7424,-20.49749999999873,2475.1052631578946,27,9,20,36
7425,-22.643999999999057,3361.55,32,15,21,47
7426,-14.66749999999871,2496.3529411764707,45,20,25,65
7427,-14.700499999999398,2733.8947368421054,29,9,17,38
7428,-11.071749999998882,3467.4736842105262,34,22,16,56
7429,-15.646499999998477,2331.9411764705883,35,5,23,40
7430,-6.535499999999172,4006.4210526315787,50,17,19,67
7431,-4.248999999998491,2559.6470588235293,42,9,21,51
7432,-24.720499999999284,2758.0,36,15,23,51
7433,-22.924749999998713,3117.4210526315787,30,10,19,40
7434,-23.36224999999977,1429.0,19,19,19,38
7435,-29.642249999999176,1842.611111111111,16,12,16,28
7436,-14.116249999999402,2950.277777777778,34,8,26,42
7437,-15.715749999999051,2874.3888888888887,34,14,17,48
7438,-10.037249999997773,5121.95,63,12,17,75
7439,-30.21824999999897,2508.4736842105262,22,11,28,33
7440,4.139750000001356,3734.842105263158,51,11,12,62
7441,-1.8704999999985632,2989.0555555555557,48,12,23,60
7442,9.960500000002058,3165.3888888888887,53,7,18,60
7443,-9.577749999997973,3891.8947368421054,46,14,29,60
7444,3.492500000000875,2567.4444444444443,67,13,16,80
7445,-14.511249999998622,3094.8333333333335,33,7,32,40
7446,-11.598249999999743,2876.7894736842104,47,9,20,56
7447,-19.889499999998314,2634.722222222222,35,15,17,50
7448,-27.691749999999892,3004.8888888888887,39,9,18,48
7449,-26.255999999998643,3887.05,35,5,25,40
7450,-13.932999999999106,2102.294117647059,29,0,24,29
7451,-19.447999999999936,1429.0,32,12,22,44
7452,-0.03924999999663381,2833.470588235294,64,16,21,80
7453,5.520250000000776,5356.315789473684,81,10,23,91
7454,-13.221499999998198,2046.1764705882354,41,15,29,56
7455,-11.290499999999422,3812.5789473684213,51,11,16,62
7456,4.888250000000726,3166.3333333333335,44,7,19,51
7457,-15.113249999998747,4027.45,45,2,23,47
7458,-42.819499999999984,2129.157894736842,11,12,22,23
7459,-13.498499999998817,2501.0588235294117,28,8,27,36
7460,-13.239749999997816,2095.6666666666665,62,12,29,74
7461,-24.073749999998885,2219.1666666666665,33,14,27,47
7462,2.1140000000018597,3731.6111111111113,55,7,16,62
7463,-17.634749999999947,2235.9444444444443,30,5,24,35
7464,-18.419249999999103,2401.6666666666665,27,15,25,42
7465,-4.555999999999159,3520.1052631578946,33,7,21,40
7466,-19.61974999999873,5254.45,58,13,16,71
7467,-3.177499999999361,3439.842105263158,62,6,24,68
7468,-9.096499999998747,2899.6470588235293,51,6,25,57
7469,-3.821249999998578,2383.3529411764707,34,9,22,43
7470,-12.653749999999368,3120.3888888888887,33,9,19,42
7471,-34.07299999999952,1429.0,9,10,22,19
7472,-27.28349999999985,2319.764705882353,33,8,32,41
7473,-2.0857499999986677,4257.65,58,3,15,61
7474,-14.818249999998566,4143.35,41,18,24,59
7475,-21.67174999999994,2606.2631578947367,28,20,27,48
7476,-26.74224999999966,2369.9444444444443,17,18,17,35
7477,7.474750000002144,2940.823529411765,62,15,18,77
7478,-5.908249999999151,2912.764705882353,43,6,19,49
7479,9.510000000000769,2643.823529411765,56,13,18,69
7480,-25.962249999998726,3189.45,33,8,17,41
7481,-20.23799999999971,3040.5789473684213,36,7,26,43
7482,-9.204249999999927,2468.722222222222,36,18,18,54
7483,-19.430999999998882,3915.55,38,6,24,44
7484,-13.01599999999963,1964.75,43,14,24,57
7485,-8.882999999998406,3334.7,38,17,14,55
7486,-28.863499999998776,3682.2105263157896,40,10,19,50
7487,-13.536000000000465,3198.9444444444443,45,13,20,58
7488,-29.082749999998935,2699.7368421052633,27,5,24,32
7489,-1.6154999999996549,3630.823529411765,62,9,18,71
7490,-10.33349999999841,3031.3684210526317,44,7,18,51
7491,-8.699749999999668,2671.6111111111113,52,4,22,56
7492,-19.472999999999534,2487.0,39,11,24,50
7493,9.62975000000019,3333.8888888888887,61,13,16,74
7494,-25.270499999998773,1429.0,21,15,16,36
7495,-5.0194999999989705,3267.842105263158,35,11,20,46
7496,4.6437500000015675,4868.8,65,11,11,76
7497,-34.70149999999954,2783.8,21,5,26,26
7498,-11.505999999998867,2538.3888888888887,30,12,20,42
7499,1.573000000000396,3151.3333333333335,44,11,23,55
7500,-19.512499999998944,2777.3333333333335,34,8,23,42
7501,-0.46049999999862656,2694.235294117647,52,11,14,63
7502,-17.167749999997902,3490.9473684210525,47,9,21,56
7503,-19.75949999999931,2557.777777777778,28,14,21,42
7504,-14.202499999998551,2251.5,32,13,18,45
7505,13.617750000001468,3579.4210526315787,46,19,10,65
7506,-6.328749999998639,3155.722222222222,52,11,20,63
7507,-28.927499999998304,3106.1,30,3,27,33
7508,-2.1565000000000074,2643.3333333333335,42,9,21,51
7509,-24.435749999999384,2551.9473684210525,26,14,20,40
7510,2.3280000000005048,2804.0625,77,15,13,92
7511,-12.462999999999074,2683.9,28,8,24,36
7512,-0.4342499999981969,6152.85,75,7,17,82
7513,-2.074999999999586,2694.176470588235,34,6,20,40
7514,-8.62224999999886,2396.3529411764707,39,11,13,50
7515,-20.856749999999064,3328.0,49,5,25,54
7516,-2.10475000000013,2532.222222222222,53,9,41,62
7517,-11.513999999999301,3019.6,27,13,12,40
7518,-29.95649999999918,1796.125,15,15,20,30
7519,-17.814499999999292,4918.578947368421,72,23,20,95
7520,-22.87724999999883,3485.842105263158,35,16,17,51
7521,2.1797500000018704,3146.8888888888887,59,6,22,65
7522,-24.56999999999946,2257.3529411764707,42,11,26,53
7523,-11.792249999998946,2911.3888888888887,33,5,21,38
7524,12.42275000000081,2416.9411764705883,59,10,18,69
7525,-5.023999999999652,4314.85,46,6,20,52
7526,-4.222749999998937,2946.4117647058824,43,6,20,49
7527,-11.656249999999318,2807.294117647059,52,14,23,66
7528,-6.403999999997754,2485.6111111111113,40,14,18,54
7529,2.4132500000017587,2627.0588235294117,48,16,27,64
7530,-1.8857499999988216,4438.263157894737,51,7,22,58
7531,-21.10774999999925,2393.722222222222,32,9,21,41
7532,-35.875999999998676,1537.1875,17,8,31,25
7533,-8.701499999998713,2345.9411764705883,47,6,17,53
7534,-0.22524999999973475,3056.0,49,16,14,65
7535,-23.569499999999145,4309.684210526316,40,4,28,44
7536,-21.890499999999445,3297.8947368421054,36,14,23,50
7537,-2.109749999998304,3334.684210526316,42,11,18,53
7538,-2.8652499999986714,3851.7368421052633,72,7,26,79
7539,-15.944999999999771,2873.5555555555557,33,5,26,38
7540,-15.41224999999902,2475.764705882353,40,5,20,45
7541,-20.85199999999937,2816.7368421052633,30,9,22,39
7542,-28.087499999998936,3335.5263157894738,34,5,36,39
7543,-21.768000000000022,2529.8823529411766,37,17,21,54
7544,-35.87324999999904,2449.3888888888887,29,7,32,36
7545,-24.864749999999955,1429.0,18,7,35,25
7546,-26.226749999998475,4222.7,36,9,22,45
7547,26.8785000000004,5387.263157894737,84,5,23,89
7548,13.430750000000966,2648.529411764706,62,15,17,77
7549,-17.37674999999892,2729.7894736842104,27,4,29,31
7550,-9.42749999999806,4208.4,43,3,32,46
7551,-21.378500000000216,1429.0,35,14,27,49
7552,-38.19424999999861,1961.7777777777778,16,7,28,23
7553,-11.658499999999979,1924.8235294117646,39,10,21,49
7554,-14.870499999998916,2368.0526315789475,29,2,24,31
7555,3.2597500000015573,3412.277777777778,60,10,27,70
7556,9.844000000000417,3101.3529411764707,61,9,18,70
7557,-10.136249999998983,1760.375,26,9,22,35
7558,-19.21074999999987,2548.470588235294,45,13,30,58
7559,-20.10649999999831,4139.35,48,8,20,56
7560,-23.818749999999117,2131.8333333333335,26,20,34,46
7561,-7.046249999999697,2157.1875,48,10,20,58
7562,-6.666499999998152,2567.6666666666665,42,10,20,52
7563,-14.582999999999359,3079.9,30,16,13,46
7564,7.0312500000010685,4162.631578947368,56,15,19,71
7565,-33.091249999999604,2480.1666666666665,22,7,37,29
7566,-8.421499999999412,3636.315789473684,50,5,25,55
7567,-23.071249999998905,3021.3684210526317,28,8,30,36
7568,-26.5244999999998,2468.722222222222,24,24,26,48
7569,-7.853749999998786,3522.6315789473683,54,14,28,68
7570,-7.601499999998664,4042.55,39,11,23,50
7571,-33.944999999999936,2079.9444444444443,14,14,35,28
7572,-5.41074999999877,4327.5,53,7,16,60
7573,-28.502999999999496,2751.5263157894738,21,17,19,38
7574,-9.662249999999307,4281.5,50,13,18,63
7575,-4.853499999999292,3425.5555555555557,44,7,21,51
7576,-15.573999999999222,3418.2105263157896,50,8,19,58
7577,-12.097249999999757,2005.1176470588234,39,9,23,48
7578,-11.029749999999035,3072.3684210526317,50,5,31,55
7579,20.239250000002972,4558.5,71,10,14,81
7580,-7.942749999998779,4106.85,47,10,17,57
7581,-17.73399999999878,3031.4736842105262,30,17,20,47
7582,-31.74749999999981,2036.25,12,19,9,31
7583,-15.879249999998724,3135.0,37,16,16,53
7584,-8.632249999999743,2583.684210526316,43,8,24,51
7585,-18.945499999998564,3776.0,42,12,20,54
7586,-6.536500000000082,2101.294117647059,33,23,21,56
7587,-23.656499999999767,2139.8333333333335,28,15,20,43
7588,-33.54224999999953,1791.3529411764705,10,8,31,18
7589,-11.704499999998747,2358.0588235294117,37,7,22,44
7590,-5.42774999999947,2415.8823529411766,57,7,20,64
7591,-23.148499999998826,4358.45,36,14,22,50
7592,-34.55974999999756,1510.5333333333333,38,0,40,38
7593,12.157499999999434,2738.5,67,16,17,83
7594,16.02325000000189,4613.736842105263,67,2,22,69
7595,-14.20374999999911,1429.0,35,9,29,44
7596,-20.90624999999907,1429.0,26,22,21,48
7597,-24.175249999999522,1979.9411764705883,32,15,22,47
7598,-12.558999999998862,3305.4210526315787,44,6,19,50
7599,4.051750000000581,3470.7894736842104,48,4,21,52
7600,-13.238499999998439,4681.368421052632,54,1,35,55
7601,-33.27299999999939,2706.85,20,12,21,32
7602,0.7622500000013657,2425.294117647059,60,13,22,73
7603,15.396250000002869,5718.85,64,17,19,81
7604,-24.68224999999891,3124.157894736842,36,9,27,45
7605,-19.260999999999424,2623.7894736842104,32,12,13,44
7606,-15.243499999999333,2637.05,20,10,19,30
7607,-18.386499999999455,2413.1111111111113,40,12,22,52
7608,-35.189999999999415,2421.0555555555557,15,9,29,24
7609,-25.108749999998988,2758.8333333333335,34,12,22,46
7610,-0.6364999999981996,4960.9,61,13,16,74
7611,-15.354249999999976,2622.294117647059,42,10,40,52
7612,-10.036499999998878,2478.6470588235293,37,11,17,48
7613,-15.131749999999183,2256.176470588235,30,13,17,43
7614,-11.492749999998995,3693.842105263158,50,8,27,58
7615,-16.32424999999916,2588.705882352941,38,10,27,48
7616,-22.08924999999857,1963.1176470588234,37,9,30,46
7617,-18.827749999999273,3137.0,29,9,20,38
7618,-23.58649999999986,2633.75,24,6,20,30
7619,-41.462749999999815,1576.875,15,10,24,25
7620,-10.330999999998735,4303.736842105263,50,11,23,61
7621,-5.320499999996227,2401.9411764705883,76,10,22,86
7622,19.600250000001232,3148.0588235294117,67,6,16,73
7623,-34.647499999999454,1997.157894736842,15,3,29,18
7624,-30.35299999999925,1523.25,18,2,32,20
7625,-30.858999999999185,2455.842105263158,26,9,29,35
7626,-0.5559999999996623,2610.176470588235,51,13,19,64
7627,-3.4287499999997904,3568.5263157894738,43,11,24,54
7628,-16.472499999998256,2561.3333333333335,32,17,26,49
7629,8.058750000000984,2847.294117647059,49,26,15,75
7630,-0.7764999999992146,2214.294117647059,33,3,24,36
7631,-31.5647499999995,2131.8888888888887,22,4,22,26
7632,-2.0879999999985883,2576.3333333333335,46,13,21,59
7633,-4.31799999999895,3168.3684210526317,33,15,12,48
7634,-11.125749999998176,2077.0588235294117,33,10,24,43
7635,-11.327999999999452,2341.294117647059,30,8,23,38
7636,13.983000000002084,4864.8,64,18,16,82
7637,-8.182999999999533,2482.5625,46,9,22,55
7638,-15.18674999999995,2118.1176470588234,42,8,24,50
7639,-15.293249999999095,3557.8,36,5,21,41
7640,-20.587499999998993,2779.157894736842,44,7,29,51
7641,14.426500000001562,3005.8333333333335,61,13,16,74
7642,-19.952749999998126,4296.5,48,12,18,60
7643,-8.313249999999002,2910.5555555555557,28,10,22,38
7644,-18.41224999999924,2465.222222222222,33,18,19,51
7645,-7.911999999996601,2479.277777777778,55,3,29,58
7646,-6.423749999998402,2939.705882352941,46,11,21,57
7647,-7.999500000000313,2538.235294117647,64,18,22,82
7648,-5.841250000000047,2032.2941176470588,41,8,17,49
7649,-37.500249999999575,1695.3333333333333,13,7,29,20
7650,-5.870249999998325,3675.5263157894738,51,8,18,59
7651,-19.952249999998525,3816.4,41,13,22,54
7652,-10.776499999998705,3108.1111111111113,47,20,18,67
7653,6.288000000002784,2628.3888888888887,61,1,22,62
7654,4.933750000002126,1724.6875,41,5,24,46
7655,4.430750000001327,2460.8125,71,6,22,77
7656,-28.395249999999315,1828.6470588235295,12,7,29,19
7657,-11.362249999999484,2702.2631578947367,43,10,15,53
7658,-10.764749999999292,2138.5,37,10,20,47
7659,-3.918249999999498,4538.578947368421,58,11,15,69
7660,-6.21424999999817,2937.9375,47,10,28,57
7661,-20.323999999999458,1929.5294117647059,30,1,31,31
7662,11.838750000003198,2827.9375,60,5,23,65
7663,-15.30774999999882,1929.4705882352941,62,12,24,74
7664,-19.72024999999961,2403.2631578947367,21,8,32,29
7665,-13.727999999999009,2504.9444444444443,37,18,16,55
7666,18.02375000000151,4436.578947368421,56,7,19,63
7667,-15.533999999998727,1429.0,38,12,21,50
7668,-11.913499999998425,2106.8823529411766,39,11,25,50
7669,-9.347249999998496,4041.0,43,2,27,45
7670,-2.6557499999977856,4694.9,50,11,16,61
7671,-18.972000000000026,1429.0,25,8,23,33
7672,-22.45474999999968,2576.157894736842,20,13,26,33
7673,-31.3882499999986,2774.1052631578946,22,11,29,33
7674,-12.052749999996891,3088.6666666666665,50,3,27,53
7675,-14.852499999996516,2811.0,46,4,45,50
7676,-13.267999999999867,2206.8823529411766,33,12,23,45
7677,-30.312749999999404,3230.65,30,4,23,34
7678,-6.820999999998463,4108.5,43,5,16,48
7679,19.998250000002123,3759.777777777778,76,14,14,90
7680,-6.180749999998917,3049.842105263158,42,11,20,53
7681,-8.588249999999686,2982.0526315789475,35,8,24,43
7682,-26.69950000000008,2544.6111111111113,36,23,30,59
7683,-0.689749999998581,2307.764705882353,60,5,25,65
7684,-27.678499999999577,2255.3333333333335,19,7,21,26
7685,-19.459999999998793,2514.0,36,5,23,41
7686,-22.121249999999232,3183.1111111111113,43,15,20,58
7687,-6.825999999999143,2934.176470588235,42,11,21,53
7688,-31.298249999999648,2915.2631578947367,32,9,22,41
7689,10.51200000000159,2753.1176470588234,55,6,19,61
7690,-13.754499999998894,2787.1111111111113,30,11,18,41
7691,2.1365000000009835,2685.823529411765,57,16,23,73
7692,-21.234999999999253,3107.222222222222,38,20,20,58
7693,-11.98799999999809,1751.5,34,24,14,58
7694,-19.155249999996975,2152.222222222222,34,13,37,47
7695,-16.707000000000132,2171.5555555555557,38,18,22,56
7696,-16.11099999999968,3130.842105263158,36,12,26,48
7697,0.9070000000013951,3186.5555555555557,56,8,20,64
7698,-11.23124999999921,3173.4444444444443,33,12,30,45
7699,-4.570999999998491,4034.6,32,7,31,39
7700,-25.87374999999917,3132.4210526315787,27,8,35,35
7701,-33.394999999999705,2736.95,23,8,21,31
7702,6.431250000001745,4538.526315789473,69,14,25,83
7703,-2.9342499999988974,2848.777777777778,38,10,16,48
7704,-11.658249999999523,2646.8333333333335,33,9,19,42
7705,-10.555999999999246,3777.4210526315787,46,12,25,58
7706,-19.83674999999924,1618.5882352941176,27,27,17,54
7707,-11.296249999998995,3994.95,49,2,22,51
7708,5.282500000001311,4755.25,46,11,21,57
7709,6.02450000000104,4305.25,51,7,13,58
7710,12.001250000002473,5302.15,71,13,15,84
7711,-28.034500000000435,1534.5294117647059,12,12,40,24
7712,-6.3524999999991305,3497.0,46,19,16,65
7713,-6.600249999999309,4102.85,43,10,20,53
7714,-20.676749999997853,3369.842105263158,38,15,24,53
7715,-18.124749999998237,3564.7,43,16,16,59
7716,6.205500000002351,1572.875,30,11,32,41
7717,-41.18574999999985,1429.0,5,20,21,25
7718,-19.60224999999924,4409.2,42,24,15,66
7719,-3.654249999998856,2801.7894736842104,26,8,31,34
7720,-31.011499999999472,2370.294117647059,39,17,30,56
7721,-11.281249999998197,2745.6666666666665,36,16,19,52
7722,-2.9329999999982066,3558.45,38,2,28,40
7723,-3.914249999999817,2112.625,36,18,16,54
7724,-1.716749999999355,3250.9444444444443,44,5,23,49
7725,-7.742999999999209,3272.8,33,7,18,40
7726,-25.488249999999482,1684.0,21,17,20,38
7727,-12.601499999998747,3881.0526315789475,45,21,18,66
7728,-30.669499999999328,2064.0588235294117,31,9,25,40
7729,-15.434499999999407,2494.1666666666665,24,13,20,37
7730,-2.5907499999977466,3797.4736842105262,60,10,15,70
7731,-10.826999999997888,1680.0625,35,20,17,55
7732,24.508250000001905,3566.3529411764707,85,15,18,100
7733,0.6542500000010216,3601.0,44,19,15,63
7734,-26.0972499999994,1925.0625,18,13,20,31
7735,-25.98975000000023,1429.0,28,18,22,46
7736,-3.7959999999985983,3310.0,55,12,18,67
7737,-20.545749999997867,2043.4705882352941,25,13,35,38
7738,12.548000000002133,2472.0,50,9,17,59
7739,1.8497500000017972,3417.6111111111113,57,15,29,72
7740,13.501250000001829,4579.05,60,9,18,69
7741,-32.48349999999965,2299.6315789473683,14,9,25,23
7742,-18.311249999999518,2916.1052631578946,36,12,26,48
7743,-20.30649999999892,3083.8,34,6,17,40
7744,25.502000000003623,3335.9375,85,13,26,98
7745,-16.054749999998172,4211.65,45,7,25,52
7746,5.526500000000495,4158.315789473684,53,6,30,59
7747,-7.0662499999983535,2143.4117647058824,42,12,15,54
7748,-4.041249999998909,3568.3888888888887,50,11,23,61
7749,-4.413499999999547,3108.0,56,1,17,57
7750,-15.453499999998886,3383.1,36,7,25,43
7751,-19.806249999999565,3200.157894736842,37,6,24,43
7752,-5.368499999998892,2661.315789473684,29,17,13,46
7753,3.140500000000853,2476.6111111111113,35,10,17,45
7754,-30.121249999999414,2084.3333333333335,33,8,33,41
7755,16.14775000000094,3409.7894736842104,57,2,26,59
7756,-14.95549999999885,1737.5625,29,6,19,35
7757,-9.599999999997705,2169.529411764706,34,9,29,43
7758,-5.152749999998255,4571.1,53,8,21,61
7759,-17.319749999999686,2109.705882352941,37,13,23,50
7760,-22.089499999999244,3147.5789473684213,22,14,25,36
7761,-17.20974999999874,3638.65,40,15,12,55
7762,-7.870999999998546,2273.3125,45,13,23,58
7763,-20.755999999998195,3186.3,39,5,26,44
7764,-21.35674999999886,2893.8333333333335,39,15,16,54
7765,-20.885499999998746,2370.0555555555557,30,12,21,42
7766,-26.590499999998592,3910.8,38,18,21,56
7767,-11.874250000000139,2196.9375,38,3,31,41
7768,-9.648499999999583,2134.4375,55,8,21,63
7769,-3.9652499999989517,4134.1578947368425,60,4,30,64
7770,-22.276999999998875,3336.3684210526317,31,12,23,43
7771,-19.79324999999951,2547.7368421052633,22,5,22,27
7772,-2.458499999998936,4822.0,57,1,24,58
7773,-27.61774999999949,2120.0,16,5,31,21
7774,-14.529749999998154,3061.5263157894738,33,6,26,39
7775,-21.712999999999003,3562.35,37,7,23,44
7776,-10.925999999999034,2349.705882352941,27,2,30,29
7777,-19.593499999998986,3525.1052631578946,29,1,33,30
7778,-19.837249999999365,2772.75,20,5,29,25
7779,-41.26425000000009,1979.2777777777778,18,18,29,36
7780,-0.27774999999873556,4102.368421052632,42,3,27,45
7781,-8.366499999998702,2264.4375,35,14,32,49
7782,-6.575249999997912,2487.5625,53,7,21,60
7783,-13.674249999998953,2433.705882352941,40,13,29,53
7784,-7.3992499999986,2441.5555555555557,45,5,22,50
7785,-10.843499999998974,3087.4736842105262,33,6,24,39
7786,-11.137999999998645,3470.842105263158,41,11,25,52
7787,0.12200000000144637,4726.75,51,7,25,58
7788,-15.07274999999892,2628.3888888888887,34,10,21,44
7789,-26.97374999999966,2200.2105263157896,11,10,26,21
7790,-7.6424999999978755,3597.7368421052633,48,8,25,56
7791,-33.53924999999937,3676.75,24,11,29,35
7792,-10.505749999998455,2808.222222222222,43,12,20,55
7793,-19.512999999998726,1598.0588235294117,26,15,16,41
7794,-8.9192499999983,2989.1111111111113,46,8,24,54
7795,4.235000000002434,3271.1666666666665,57,4,22,61
7796,-8.690749999999118,2602.8333333333335,28,9,21,37
7797,-12.25249999999863,4892.65,42,10,31,52
7798,-15.722999999998745,3140.722222222222,55,7,22,62
7799,-8.186249999999228,2982.1052631578946,39,14,20,53
7800,7.135250000001927,3580.315789473684,53,7,17,60
7801,-16.393249999998044,3159.2105263157896,42,19,15,61
7802,-18.728749999999287,2600.222222222222,42,9,17,51
7803,-12.427999999997695,2726.277777777778,41,14,18,55
7804,-30.75374999999919,2974.6315789473683,27,9,27,36
7805,-22.92449999999807,3139.8333333333335,48,9,27,57
7806,-11.819999999998107,3418.2105263157896,43,6,29,49
7807,-0.7309999999984965,2826.722222222222,43,5,20,48
7808,-14.420250000000241,3135.3333333333335,42,6,21,48
7809,-4.587000000000179,2645.1111111111113,51,8,17,59
7810,-1.502999999998472,1939.0,37,14,15,51
7811,-20.952999999999424,2749.222222222222,29,5,27,34
7812,-25.626249999998908,2475.0526315789475,21,7,21,28
7813,-5.195749999998439,5194.95,56,6,18,62
7814,-4.652499999999333,3429.1176470588234,69,12,23,81
7815,-26.01124999999817,2081.6666666666665,34,5,21,39
7816,6.196000000001909,2228.625,56,5,27,61
7817,-12.98599999999928,3937.0,35,7,27,42
7818,-28.455249999999285,2463.2631578947367,17,9,27,26
7819,-18.919999999999803,2679.6111111111113,69,8,14,77
7820,-7.337499999998842,3056.1,37,5,22,42
7821,-14.881999999999149,2150.5,26,8,21,34
7822,0.8017500000009751,6094.2,69,14,21,83
7823,3.820250000002555,3588.722222222222,53,8,22,61
7824,-7.847999999999184,3050.5263157894738,29,10,21,39
7825,-11.401249999999633,2576.3333333333335,38,18,19,56
7826,-18.438249999998572,3988.55,44,8,27,52
7827,-26.02774999999886,2691.8888888888887,31,13,15,44
7828,-32.374249999999805,2516.3333333333335,34,12,29,46
7829,-28.730749999998984,2645.75,19,10,23,29
7830,17.307750000002198,3610.4210526315787,53,2,22,55
7831,-14.913249999999497,2645.1111111111113,35,8,15,43
7832,-19.319499999999067,2369.1666666666665,27,10,20,37
7833,-2.4074999999999362,2319.764705882353,55,10,19,65
7834,6.328750000000143,3259.4210526315787,49,4,18,53
7835,-4.733749999999153,2563.529411764706,26,17,29,43
7836,-18.513499999999734,2336.5882352941176,39,24,11,63
7837,1.6490000000013225,4190.95,57,8,14,65
7838,-22.627249999998316,3754.0526315789475,37,3,28,40
7839,-12.505249999999071,4445.8,52,13,21,65
7840,-4.378249999998487,2834.722222222222,42,8,22,50
7841,-3.534249999999126,2395.3529411764707,45,15,16,60
7842,-16.522499999998708,3573.6315789473683,44,8,13,52
7843,-6.848999999997524,2808.176470588235,43,4,30,47
7844,10.809250000001741,4732.315789473684,48,13,28,61
7845,-0.6982499999976236,3149.9411764705883,59,6,21,65
7846,2.468999999999976,4967.95,49,23,22,72
7847,-8.90574999999858,3184.0,39,9,21,48
7848,-27.95724999999991,2505.0526315789475,24,7,33,31
7849,-15.650999999998131,4168.75,47,12,16,59
7850,-17.940499999999545,2237.625,33,13,22,46
7851,-21.817749999999897,2111.5,30,12,20,42
7852,-14.354749999997697,2589.6470588235293,36,8,29,44
7853,-15.275499999999653,2520.8888888888887,38,9,22,47
7854,-5.066999999997297,4738.65,57,11,22,68
7855,5.113250000001521,4294.1,42,12,19,54
7856,-9.74399999999931,3267.15,32,21,14,53
7857,-19.001749999999753,2743.157894736842,24,12,25,36
7858,-12.966999999998976,2655.777777777778,44,9,20,53
7859,-7.877999999998356,2657.1875,58,2,30,60
7860,-2.1202499999989826,2529.8823529411766,51,11,22,62
7861,-33.3130000000002,1429.0,16,17,26,33
7862,-28.32399999999936,1890.2222222222222,17,9,20,26
7863,-11.169999999998758,2578.1666666666665,42,19,18,61
7864,-12.108749999998574,3726.4736842105262,46,14,31,60
7865,-41.4387499999995,1438.5333333333333,8,14,25,22
7866,-11.094749999998745,2316.0588235294117,42,5,27,47
7867,-3.102499999998858,3370.0555555555557,52,14,14,66
7868,-14.426999999998861,2022.0,30,7,27,37
7869,-32.32474999999947,2704.45,19,14,22,33
7870,-8.172249999999448,2190.0588235294117,47,13,15,60
7871,-9.187249999999144,2915.8333333333335,58,11,22,69
7872,-2.1942499999972056,2784.5,56,15,16,71
7873,-20.33374999999945,2232.0,26,13,18,39
7874,-4.904749999998677,3415.8888888888887,45,12,19,57
7875,-11.538999999999755,2305.3684210526317,28,9,22,37
7876,-2.9832499999978133,2262.4375,45,8,20,53
7877,9.28575000000122,2514.0588235294117,39,11,16,50
7878,-9.13899999999731,4944.1,56,3,21,59
7879,-40.78700000000056,1429.0,34,23,32,57
7880,-13.811249999998134,4417.1,37,13,26,50
7881,-12.902999999998467,3143.4210526315787,43,11,25,54
7882,6.640750000002586,2517.764705882353,63,10,17,73
7883,4.627500000000898,5039.45,67,6,23,73
7884,-37.32799999999959,1429.0,9,12,22,21
7885,-8.529499999999187,2723.157894736842,25,15,20,40
7886,-12.407499999999596,2403.823529411765,35,14,22,49
7887,-13.001999999997542,3075.4444444444443,47,4,30,51
7888,-19.099999999999593,3810.842105263158,38,2,26,40
7889,-22.580249999998742,1875.4117647058824,25,9,25,34
7890,-1.851999999999612,3468.6666666666665,62,14,23,76
7891,-39.31574999999965,2216.157894736842,15,5,26,20
7892,-25.958749999999146,2496.8888888888887,29,10,18,39
7893,-25.44499999999901,1429.0,16,12,26,28
7894,5.8417500000009195,2751.0,49,8,21,57
7895,-25.194499999999074,2552.5555555555557,26,5,28,31
7896,-6.1899999999990385,4394.1,44,3,27,47
7897,-15.08974999999863,2223.5882352941176,40,7,27,47
7898,2.6760000000014323,4637.15,46,16,12,62
7899,-28.02274999999853,1564.0,20,8,30,28
7900,10.666750000001008,3735.8888888888887,49,18,19,67
7901,-11.652250000000091,2076.0588235294117,36,17,14,53
7902,4.74525000000133,5079.85,51,9,18,60
7903,-13.252999999997991,1724.6875,31,6,29,37
7904,-13.894249999999175,2575.9,30,12,11,42
7905,-13.737249999998976,3658.7894736842104,40,15,23,55
7906,-23.34274999999918,2628.0,27,10,39,37
7907,-26.06749999999904,3385.5,29,14,19,43
7908,2.9762500000016345,3681.315789473684,59,7,21,66
7909,-29.783749999999486,2071.8,11,13,22,24
7910,-16.660749999999215,3236.9473684210525,26,9,25,35
7911,-9.561000000000353,2304.125,62,7,22,69
7912,-19.868249999999144,4018.0555555555557,64,8,21,72
7913,-12.70149999999877,3155.722222222222,49,5,20,54
7914,-27.92749999999959,2921.1666666666665,33,14,27,47
7915,-36.77549999999966,2125.85,10,13,17,23
7916,-15.403499999999658,2747.4210526315787,19,11,26,30
7917,-24.34674999999839,2870.2105263157896,30,10,23,40
7918,-29.37524999999917,2687.8,28,8,18,36
7919,13.963000000002168,4508.5,57,1,24,58
7920,-19.56974999999899,1946.2941176470588,43,20,28,63
7921,-27.642249999999642,2369.9444444444443,24,7,32,31
7922,-3.3612499999992096,2535.470588235294,48,12,17,60
7923,-32.966749999999315,2014.5555555555557,14,9,32,23
7924,-31.350749999999845,2481.1666666666665,16,5,43,21
7925,-17.265749999998427,2175.125,44,18,15,62
7926,-5.138749999998967,3299.4444444444443,48,13,21,61
7927,11.902750000000808,3402.315789473684,51,22,15,73
7928,-16.766249999998887,2922.0,35,11,16,46
7929,-10.402499999998145,2743.0,49,9,19,58
7930,-17.889749999998884,3743.35,38,11,12,49
7931,-16.881249999999557,2014.3125,32,10,21,42
7932,1.3287500000011767,3279.05,28,7,28,35
7933,-1.5309999999971569,2734.9444444444443,47,12,23,59
7934,-29.541999999999053,2055.470588235294,21,17,13,38
7935,4.735000000001079,4043.0526315789475,63,12,18,75
7936,-17.569499999999373,2008.5,18,12,21,30
7937,-17.603249999998344,3048.1111111111113,41,9,19,50
7938,-3.9387499999989535,2853.9411764705883,45,12,20,57
7939,-19.045499999999794,3317.9444444444443,49,21,25,70
7940,-37.01474999999925,1909.6666666666667,10,2,40,12
7941,-8.563749999998922,2375.823529411765,35,6,20,41
7942,-8.494999999998894,2517.764705882353,40,7,22,47
7943,-25.68924999999827,5022.75,49,7,24,56
7944,-23.834500000000197,1429.0,25,19,16,44
7945,-33.25799999999953,1523.25,13,15,19,28
7946,-6.72999999999752,5216.35,55,5,24,60
7947,-39.55074999999893,1496.5,14,10,26,24
7948,-6.205749999998197,2761.470588235294,53,15,18,68
7949,23.156500000000538,4642.894736842105,62,20,16,82
7950,10.873750000002357,3089.176470588235,61,13,27,74
7951,14.352500000000962,2486.0,47,13,9,60
7952,-40.197749999998486,2730.6315789473683,21,13,25,34
7953,-23.477999999998797,2441.7894736842104,26,13,21,39
7954,-17.378249999999603,3110.842105263158,28,16,19,44
7955,-21.298249999999612,1997.1052631578948,21,12,25,33
7956,-14.159249999999698,2931.157894736842,54,19,14,73
7957,-8.072749999998644,2346.1666666666665,39,15,16,54
7958,-9.271499999998685,3454.235294117647,48,8,27,56
7959,13.757500000001068,2608.6875,53,10,24,63
7960,5.082750000000699,2899.4210526315787,50,12,19,62
7961,-18.281499999998378,3165.6,29,14,17,43
7962,-1.7119999999986746,3631.315789473684,46,18,19,64
7963,-9.98399999999902,2123.625,33,13,16,46
7964,-17.855999999999412,2588.722222222222,27,19,15,46
7965,-18.18774999999932,2493.3684210526317,19,10,31,29
7966,-16.95724999999903,3675.1,29,9,30,38
7967,-5.536499999999801,3297.9473684210525,48,5,26,53
7968,-30.502249999999606,2068.2631578947367,11,14,17,25
7969,-2.3897499999982927,3078.1111111111113,49,9,18,58
7970,-6.115999999998275,2890.3333333333335,46,24,19,70
7971,-8.186749999998508,3227.4117647058824,53,15,21,68
7972,-29.50899999999985,1957.2777777777778,20,19,24,39
7973,-10.428999999998933,1974.75,26,10,17,36
7974,3.994750000001752,3687.4444444444443,64,15,13,79
7975,-12.863999999999217,4096.5,48,13,23,61
7976,-15.391999999999063,3829.1,41,9,22,50
7977,-32.353499999999926,3136.6315789473683,19,9,46,28
7978,3.6982500000014182,4857.75,58,6,23,64
7979,-14.725999999998862,2930.0555555555557,37,16,16,53
7980,-18.511749999998667,3146.65,35,14,15,49
7981,-24.225750000000016,2302.842105263158,25,5,27,30
7982,-10.996249999998238,2493.3888888888887,34,6,20,40
7983,-31.091999999999064,2899.3684210526317,33,15,18,48
7984,-21.620999999998695,1496.5,23,20,18,43
7985,4.75425000000058,2798.9411764705883,62,11,17,73
7986,-15.535249999999326,2951.0,39,8,18,47
7987,24.227250000004382,2922.0,76,5,28,81
7988,8.34625000000123,4019.684210526316,54,3,22,57
7989,-19.35499999999864,2385.9444444444443,29,10,21,39
7990,5.264250000003254,1864.5,57,6,33,63
7991,-8.47924999999938,2510.5,37,9,17,46
7992,-16.96124999999972,1885.8333333333333,27,13,18,40
7993,-5.270249999998375,3377.1111111111113,58,12,13,70
7994,-18.971249999997355,2432.5,43,11,26,54
7995,-10.24424999999864,2328.176470588235,36,10,25,46
7996,-26.828249999999294,3470.3,26,3,25,29
7997,4.312250000001341,3974.7368421052633,61,10,17,71
7998,-35.195999999999295,2703.8947368421054,21,17,20,38
7999,14.378000000002277,5231.5,77,12,20,89
8000,-19.881250000000215,1429.0,30,7,19,37
8001,-14.259499999999045,2135.9411764705883,30,14,13,44
8002,-22.26949999999874,3624.4736842105262,43,11,22,54
8003,6.453249999999812,3484.6111111111113,61,23,17,84
8004,-25.431999999999654,2623.8888888888887,20,9,25,29
8005,3.7605000000011843,2954.764705882353,41,13,23,54
8006,-41.89599999999979,2132.5263157894738,14,8,35,22
8007,-25.1987499999996,2630.4210526315787,35,10,19,45
8008,-18.4284999999983,2059.0625,31,11,25,42
8009,-10.710749999999269,2138.6470588235293,29,8,28,37
8010,-22.27774999999962,1438.5333333333333,18,17,21,35
8011,-0.8167499999989474,2862.0,58,12,26,70
8012,7.9000000000018105,4553.6,50,15,18,65
8013,-34.03799999999942,1528.25,12,17,14,29
8014,-25.841499999998877,3529.85,38,14,16,52
8015,-20.960999999999707,2857.75,42,21,20,63
8016,-17.44249999999887,3421.3,25,13,30,38
8017,-21.535249999999085,2766.8333333333335,32,8,24,40
8018,10.922750000001638,4435.789473684211,66,13,15,79
8019,-19.30524999999901,3420.222222222222,41,9,22,50
8020,-13.020499999998055,3465.277777777778,47,11,21,58
8021,-19.85099999999961,2362.1111111111113,20,17,13,37
8022,-1.175749999997972,2862.1111111111113,67,8,18,75
8023,5.692250000001168,4185.315789473684,68,9,23,77
8024,-27.10624999999853,2804.45,27,16,19,43
8025,-5.7372499999972835,3086.0555555555557,56,9,25,65
8026,-29.83774999999984,2385.777777777778,11,12,28,23
8027,-17.978499999999386,2017.235294117647,44,9,22,53
8028,-6.910749999997807,3934.5263157894738,46,23,14,69
8029,-29.060250000000416,1429.0,28,4,24,32
8030,17.98525000000189,4301.263157894737,61,13,15,74
8031,-0.7387499999982081,2741.0,46,14,19,60
8032,-33.02299999999856,2232.684210526316,21,13,21,34
8033,-20.55049999999938,2567.6111111111113,34,17,17,51
8034,-2.3849999999989477,3258.9444444444443,48,6,17,54
8035,-36.76524999999948,2495.7894736842104,22,9,27,31
8036,-32.00949999999925,2322.3333333333335,16,6,42,22
8037,-7.630499999998956,2892.722222222222,36,10,15,46
8038,-35.192999999999365,2362.0555555555557,38,7,29,45
8039,-16.26199999999852,3440.7368421052633,37,6,18,43
8040,-20.236499999999477,2795.1111111111113,34,10,31,44
8041,-33.87549999999959,2992.45,17,14,23,31
8042,5.916250000001045,4821.8,55,6,23,61
8043,13.51975000000094,2687.4444444444443,46,5,26,51
8044,-17.685499999999088,3058.5,31,1,23,32
8045,-9.427999999998415,3061.5263157894738,40,8,16,48
8046,4.569500000001199,4365.65,50,2,23,52
8047,1.426000000001051,2669.0588235294117,44,6,24,50
8048,-0.4909999999986738,3983.85,39,4,19,43
8049,-5.813499999999006,2677.4117647058824,34,10,25,44
8050,-13.22174999999876,2948.684210526316,37,11,22,48
8051,1.5835000000006267,3619.6111111111113,66,16,17,82
8052,-12.619749999999687,2790.0526315789475,38,17,21,55
8053,-1.4874999999993876,2514.9411764705883,55,12,17,67
8054,-16.448749999998537,3823.277777777778,56,14,20,70
8055,4.400750000002503,5742.5,56,13,15,69
8056,4.14400000000151,4163.3,54,10,19,64
8057,-31.842499999999223,2180.705882352941,23,17,23,40
8058,-25.395499999999323,3127.5,31,6,28,37
8059,0.5870000000008714,2711.1176470588234,39,7,17,46
8060,5.875250000000596,2974.6315789473683,71,8,19,79
8061,-9.768499999999046,2921.0,34,22,28,56
8062,-7.961249999997969,5371.1,63,9,18,72
8063,0.13250000000205714,4969.55,52,8,21,60
8064,-17.10574999999935,3314.6315789473683,32,8,31,40
8065,-14.94899999999885,2221.9444444444443,28,16,17,44
8066,-24.436499999999416,2756.0,19,12,22,31
8067,7.657000000000669,3084.3333333333335,60,7,14,67
8068,-11.590999999998623,2852.75,45,17,16,62
8069,-12.872249999999402,2786.5263157894738,27,18,19,45
8070,1.0650000000006858,4898.85,53,11,15,64
8071,-28.125999999999436,2813.4736842105262,20,2,28,22
8072,-20.917499999999436,2862.1111111111113,48,9,21,57
8073,-20.88449999999922,1866.4444444444443,23,11,18,34
8074,-20.529999999998637,2785.7894736842104,32,17,19,49
8075,-7.972499999998289,4672.75,49,6,25,55
8076,-34.85674999999876,2544.15,19,17,19,36
8077,-16.176249999999065,2164.823529411765,44,3,29,47
8078,-30.698499999999648,2111.6,11,9,20,20
8079,-35.425749999999724,2027.0,13,15,20,28
8080,-19.761499999998446,2517.705882352941,42,9,29,51
8081,-36.62224999999944,2723.1052631578946,19,12,17,31
8082,9.444250000001833,6207.7,69,13,19,82
8083,-14.560499999998163,3318.1176470588234,52,12,24,64
8084,-4.825999999997845,2896.1052631578946,46,8,20,54
8085,-28.052999999999553,1528.25,10,15,20,25
8086,-10.28899999999983,2034.0588235294117,35,24,18,59
8087,-36.416249999999756,2275.3684210526317,25,6,22,31
8088,-3.7407499999981355,1773.3125,43,18,22,61
8089,-17.674499999999718,2463.3888888888887,17,7,20,24
8090,-12.942999999999259,3418.2105263157896,44,12,21,56
8091,-6.074499999998526,3156.85,36,8,22,44
8092,-17.066999999998544,4251.35,37,5,28,42
8093,1.203000000000568,3749.0526315789475,59,20,15,79
8094,-13.5977499999994,2425.5555555555557,35,8,31,43
8095,-7.1457499999984835,2640.176470588235,39,11,20,50
8096,-25.074749999999383,2198.470588235294,24,11,17,35
8097,-13.906249999999606,2925.5555555555557,51,18,15,69
8098,-10.318999999997443,4924.3,52,8,28,60
8099,-14.238249999999818,2366.5625,47,6,31,53
8100,-17.319999999998515,3972.75,33,6,28,39
8101,-29.137749999999876,1979.9411764705883,20,17,22,37
8102,-16.39424999999892,2955.5,45,12,36,57
8103,-26.97324999999862,3369.1111111111113,38,5,32,43
8104,-24.9367499999992,2505.8947368421054,25,8,17,33
8105,-7.413999999999279,3332.15,30,9,23,39
8106,-8.664749999999149,4222.7,48,9,18,57
8107,-17.60799999999917,3008.5,25,3,26,28
8108,-27.46924999999942,2533.5263157894738,30,13,19,43
8109,-4.590999999997533,2969.6666666666665,42,1,29,43
8110,-12.341999999999892,2198.4117647058824,34,16,20,50
8111,-3.453999999999182,1979.9411764705883,40,10,17,50
8112,-41.933749999999556,1429.0,0,21,18,21
8113,5.3627500000001,2834.0,79,11,20,90
8114,-10.284749999998814,2157.3125,35,17,18,52
8115,-28.2219999999994,2391.9444444444443,26,10,15,36
8116,-26.569749999999555,2949.75,16,11,30,27
8117,-5.577999999998033,4502.631578947368,54,6,21,60
8118,-13.825999999999112,2719.3529411764707,32,10,23,42
8119,-0.1562499999987038,2438.4117647058824,49,5,22,54
8120,-9.118499999998921,3294.05,38,10,21,48
8121,0.12250000000147772,4279.95,43,1,25,44
8122,-13.092999999998352,3422.315789473684,39,8,28,47
8123,-11.763999999998674,2903.5789473684213,32,13,10,45
8124,1.4902500000013774,3213.5263157894738,41,18,13,59
8125,-23.66674999999962,2147.777777777778,19,16,16,35
8126,-5.388749999998762,3548.8888888888887,52,5,19,57
8127,11.20325000000068,2425.5555555555557,45,13,14,58
8128,-25.898500000000173,2252.6470588235293,50,11,41,61
8129,8.240500000000768,4841.736842105263,65,4,20,69
8130,-28.455499999999283,1858.5294117647059,16,8,24,24
8131,8.953250000000462,3321.2631578947367,61,5,16,66
8132,-17.52299999999847,3383.1,33,7,29,40
8133,1.638000000001361,3092.277777777778,58,20,13,78
8134,19.659000000002443,4482.526315789473,61,5,27,66
8135,-4.182749999998569,2133.375,45,16,24,61
8136,11.821500000003333,4475.0,62,7,24,69
8137,13.805000000002687,4687.1,61,11,23,72
8138,-7.664249999998631,3088.6666666666665,38,10,24,48
8139,4.490250000001367,4585.3,58,5,26,63
8140,-10.71150000000013,1902.25,52,14,25,66
8141,-12.940499999999057,3699.7368421052633,39,7,22,46
8142,-8.989499999998861,2103.8125,40,7,29,47
8143,-23.23549999999944,2803.470588235294,46,22,12,68
8144,-38.28849999999942,2560.2631578947367,18,11,23,29
8145,-24.589749999999675,2162.5263157894738,15,13,20,28
8146,-26.838999999998492,2148.6666666666665,33,7,26,40
8147,3.7462500000018686,1967.8235294117646,43,9,20,52
8148,-8.970999999997895,3790.9473684210525,54,3,24,57
8149,-11.66250000000022,3198.8888888888887,52,9,25,61
8150,3.204750000000149,3223.5263157894738,48,7,23,55
8151,-14.472249999999338,3135.45,26,11,18,37
8152,-1.1587499999992832,2838.0,54,7,22,61
8153,-22.33774999999924,2735.45,27,11,16,38
8154,-11.822249999998515,2758.8333333333335,33,8,26,41
8155,-3.6689999999988294,3165.3888888888887,43,10,30,53
8156,-28.139499999998048,1835.8125,36,20,21,56
8157,3.4350000000010623,3290.5263157894738,46,5,33,51
8158,4.826250000001908,5245.65,67,8,15,75
8159,-20.182250000000046,1448.0666666666666,56,11,25,67
8160,-34.2124999999998,1648.25,14,5,25,19
8161,-30.44324999999953,1429.0,14,6,31,20
8162,-9.689249999999104,2714.764705882353,63,20,15,83
8163,-9.240749999998881,3902.15,43,7,17,50
8164,5.931750000003257,3318.8888888888887,66,4,24,70
8165,-31.02424999999932,4225.8,37,6,31,43
8166,-30.535999999999053,2099.1052631578946,13,10,28,23
8167,-0.10199999999748517,4648.85,52,17,23,69
8168,-10.91849999999896,2326.9375,44,19,14,63
8169,-20.423999999999193,3602.8947368421054,49,6,26,55
8170,-7.798999999998484,4830.6,46,13,21,59
8171,-33.50849999999915,2790.6111111111113,32,4,34,36
8172,-20.41524999999887,3115.1111111111113,50,9,29,59
8173,-16.603749999999998,2540.1666666666665,36,15,25,51
8174,-17.25974999999891,2152.1666666666665,20,21,18,41
8175,-5.135999999998507,2643.5,65,18,23,83
8176,-9.905749999998012,3162.777777777778,49,13,19,62
8177,-13.434249999999356,3013.6666666666665,40,10,27,50
8178,-8.993250000000106,1429.0,41,14,25,55
8179,2.2460000000018203,5775.05,62,14,17,76
8180,-18.263999999999065,2110.6470588235293,25,1,25,26
8181,9.22275000000203,3332.823529411765,59,12,18,71
8182,1.49200000000241,2203.1176470588234,50,6,25,56
8183,-23.46524999999892,2063.9411764705883,29,12,22,41
8184,-18.488999999997485,3927.3888888888887,62,9,18,71
8185,-10.749999999999307,2347.8333333333335,40,14,24,54
8186,-31.08174999999929,2072.777777777778,15,10,23,25
8187,-33.60999999999915,2174.2631578947367,9,8,30,17
8188,2.849250000000506,2899.4210526315787,35,9,27,44
8189,3.2192500000001956,2235.1111111111113,42,11,18,53
8190,-8.136249999998185,4172.8,50,8,17,58
8191,-25.595499999998427,3283.7368421052633,30,8,28,38
8192,-41.21299999999896,2219.4210526315787,11,1,37,12
8193,-13.720499999998509,3151.764705882353,47,14,13,61
8194,-16.835749999999084,2152.705882352941,27,11,16,38
8195,-4.185749999998922,4484.6,53,9,28,62
8196,-29.408000000000207,1429.0,25,9,23,34
8197,-14.0554999999996,3165.8947368421054,38,12,18,50
8198,-9.914999999998228,2794.0555555555557,44,9,15,53
8199,3.0755000000014205,3454.3529411764707,78,8,30,86
8200,-24.023749999998977,2806.5,35,10,20,45
8201,-3.9844999999996076,3256.9473684210525,67,8,20,75
8202,-15.130249999998687,1598.0588235294117,31,9,20,40
8203,-6.2414999999986005,4025.0,39,6,29,45
8204,-5.8082499999996475,3508.5,48,7,21,55
8205,-21.070749999999183,2769.8947368421054,21,8,35,29
8206,-27.391999999999292,1963.1764705882354,37,4,30,41
8207,1.7297500000030162,4822.7,57,3,24,60
8208,7.751750000001823,2986.3888888888887,52,9,19,61
8209,-18.609249999999353,1429.0,20,5,28,25
8210,5.815750000001914,4418.263157894737,67,7,20,74
8211,-17.566999999999684,3045.4736842105262,41,11,21,52
8212,1.520000000000564,5646.45,56,11,22,67
8213,-41.77449999999921,2038.8947368421052,10,9,32,19
8214,-15.877999999998911,3124.2105263157896,32,12,22,44
8215,-12.805499999998906,2841.6666666666665,40,8,21,48
8216,-21.150499999998075,2025.2777777777778,23,15,24,38
8217,-16.618249999998234,4560.05,57,10,17,67
8218,-7.257249999999883,2324.470588235294,50,9,20,59
8219,13.808000000000456,3215.9473684210525,54,7,21,61
8220,-5.824249999999144,5548.9,52,15,26,67
8221,-13.26099999999918,2882.3888888888887,53,9,21,62
8222,14.09775000000118,3302.9444444444443,40,11,19,51
8223,-46.71599999999942,2331.4,11,18,22,29
8224,-8.274999999997643,3711.222222222222,50,8,27,58
8225,-21.409999999999,3110.842105263158,45,11,26,56
8226,-20.745499999998987,4610.8,32,10,24,42
8227,-21.94174999999911,1889.375,32,9,24,41
8228,-23.6357499999997,2817.8888888888887,53,27,24,80
8229,-37.30849999999933,2300.3888888888887,16,12,19,28
8230,-20.82349999999932,2165.6470588235293,29,5,26,34
8231,-21.866499999999842,2687.5,41,19,20,60
8232,-12.76624999999906,2563.222222222222,39,13,20,52
8233,-35.34624999999999,1429.0,8,9,40,17
8234,0.5360000000014107,2192.9375,41,10,27,51
8235,-24.21324999999792,2325.0555555555557,32,4,36,36
8236,-25.647000000000066,1941.6470588235295,30,7,28,37
8237,-31.968999999999863,2601.1052631578946,21,8,24,29
8238,-10.37499999999903,3160.1,34,9,19,43
8239,10.90000000000182,3937.0526315789475,68,6,20,74
8240,3.6575000000003706,2584.277777777778,47,7,25,54
8241,7.139749999999916,3202.294117647059,55,10,24,65
8242,-13.134499999998962,2736.3529411764707,47,12,22,59
8243,-10.355749999998064,3124.0,40,9,31,49
8244,4.914000000000888,2106.0,45,16,18,61
8245,-11.961999999997733,4479.95,47,7,32,54
8246,0.746500000001193,2291.125,53,13,22,66
8247,-8.998499999998863,2560.4444444444443,30,20,31,50
8248,-24.59374999999896,2666.3684210526317,27,6,27,33
8249,-7.765749999998318,3065.777777777778,46,12,14,58
8250,-15.424249999998617,3154.4,29,12,20,41
8251,-2.5577499999992903,3869.315789473684,45,13,22,58
8252,-35.875499999999775,2086.3,13,11,14,24
8253,-10.18624999999815,3174.2631578947367,40,12,23,52
8254,-24.38324999999897,1951.0,15,9,29,24
8255,-34.84624999999903,2702.315789473684,23,10,27,33
8256,-11.100499999998892,2248.9411764705883,38,9,23,47
8257,-3.8129999999986617,5035.45,58,7,16,65
8258,-4.580249999999667,3004.8888888888887,44,9,25,53
8259,-15.953749999998795,3259.0,55,2,27,57
8260,14.359000000000378,2778.277777777778,55,18,19,73
8261,-41.86725000000046,1429.0,1,19,30,20
8262,-22.87674999999883,3264.4736842105262,31,9,19,40
8263,-10.253499999999182,2679.5555555555557,38,10,22,48
8264,-2.5147499999992298,1946.2941176470588,33,4,30,37
8265,2.384500000000675,2032.1875,50,8,31,58
8266,-26.053249999999714,2429.842105263158,24,18,18,42
8267,-20.631249999999017,2573.0588235294117,28,9,25,37
8268,-3.0877499999986293,4137.473684210527,62,14,20,76
8269,-3.883999999999896,3278.684210526316,46,13,34,59
8270,-13.952999999998218,2730.7368421052633,30,12,24,42
8271,-15.983249999999009,3012.8333333333335,39,17,16,56
8272,-17.191999999999304,2615.65,23,8,21,31
8273,-9.176999999999765,2990.4736842105262,37,10,19,47
8274,-8.116499999999345,3076.277777777778,39,9,17,48
8275,16.095500000001202,2967.9411764705883,52,11,12,63
8276,-10.167749999998383,3108.1111111111113,48,11,24,59
8277,-8.803499999999172,2295.0555555555557,25,8,25,33
8278,-10.27274999999951,2571.823529411765,61,10,23,71
8279,-5.591999999999165,4292.9473684210525,42,14,21,56
8280,-4.155749999999456,3132.4736842105262,46,10,17,56
8281,-8.29474999999857,2421.3125,43,4,19,47
8282,3.4740000000016664,3021.9411764705883,58,12,24,70
8283,-20.06375000000002,2171.5555555555557,25,7,22,32
8284,-15.149999999998647,1523.25,38,16,20,54
8285,-19.137999999999018,1934.1764705882354,31,8,17,39
8286,-2.8374999999974055,4241.9473684210525,55,7,27,62
8287,-24.054999999999524,2054.0,24,12,19,36
8288,-29.200749999998628,2350.5555555555557,28,5,25,33
8289,-15.083999999998037,3917.25,47,6,21,53
8290,-30.556499999998472,2790.9473684210525,25,7,29,32
8291,-11.935999999998696,2481.3529411764707,39,5,27,44
8292,-7.296749999997703,4038.0526315789475,61,5,21,66
8293,31.33900000000183,3771.222222222222,75,16,11,91
8294,-4.4454999999983995,2430.0,29,5,37,34
8295,-23.30049999999946,2640.2,30,7,16,37
8296,-12.761999999999144,3583.5789473684213,49,9,25,58
8297,-26.225499999999585,2028.8333333333333,25,11,22,36
8298,-12.143499999999728,2487.5263157894738,31,9,18,40
8299,-39.251999999999484,2451.5789473684213,25,17,16,42
8300,-10.649499999999076,3373.4444444444443,51,8,28,59
8301,-21.4272499999987,2589.5555555555557,29,9,24,38
8302,-25.234249999999072,2121.8823529411766,23,12,20,35
8303,-14.6024999999995,1481.9333333333334,39,1,32,40
8304,-16.529999999998303,2502.5263157894738,30,18,15,48
8305,-21.864999999999213,2001.3333333333333,17,16,18,33
8306,-5.91799999999879,2800.0625,44,15,16,59
8307,10.57325000000248,3765.0555555555557,66,10,23,76
8308,-12.061749999999439,3199.777777777778,40,7,29,47
8309,-2.8442499999979693,4908.45,51,13,18,64
8310,-13.369499999999096,3857.684210526316,46,15,15,61
8311,-5.024249999998252,3795.0,49,13,12,62
8312,-0.82949999999856,2287.176470588235,36,11,23,47
8313,-22.485249999999134,1457.6,39,19,24,58
8314,-11.124499999999234,2655.8333333333335,33,15,18,48
8315,-23.847249999998418,1862.2941176470588,27,14,29,41
8316,-6.1559999999982935,3036.6111111111113,52,18,20,70
8317,-13.120499999998339,1501.0,38,17,18,55
8318,0.45800000000024294,2996.8888888888887,51,10,13,61
8319,-44.85899999999926,2698.0526315789475,23,7,23,30
8320,-8.847499999998485,2157.25,39,17,15,56
8321,-14.824249999998804,2131.235294117647,33,7,32,40
8322,-5.979999999998513,2616.9444444444443,38,8,21,46
8323,-25.310499999999323,2559.3684210526317,25,12,20,37
8324,-25.986749999998278,2090.8125,32,15,17,47
8325,-26.32024999999853,2598.0588235294117,34,34,16,68
8326,-0.5562499999985556,3557.7894736842104,44,10,18,54
8327,-22.25249999999928,3222.7,26,19,12,45
8328,0.8822500000021579,4869.6,55,6,23,61
8329,2.5790000000029414,3818.9444444444443,60,8,24,68
8330,-8.468499999998581,3235.2631578947367,52,6,23,58
8331,-7.340249999998411,2800.6470588235293,59,19,18,78
8332,-29.886499999999536,2225.2105263157896,17,12,20,29
8333,-0.9777499999982353,2904.4117647058824,57,10,15,67
8334,-2.1907499999983884,2064.0,43,13,13,56
8335,-0.4734999999975521,5551.3,51,9,27,60
8336,4.081750000001831,3699.7368421052633,52,7,25,59
8337,-33.69799999999944,2454.3529411764707,22,10,26,32
8338,5.942500000001507,3693.0526315789475,49,8,28,57
8339,-8.175249999999052,4490.95,48,10,20,58
8340,20.725500000001613,4609.2,55,7,18,62
8341,-6.908749999999398,3463.315789473684,50,16,20,66
8342,-23.47274999999858,3435.7368421052633,32,13,30,45
8343,-26.734249999999246,2497.0555555555557,16,10,29,26
8344,-34.02149999999985,1937.8823529411766,20,5,34,25
8345,-22.88774999999942,2038.8235294117646,44,7,37,51
8346,1.8572500000011491,4474.25,39,13,34,52
8347,-18.748000000000072,2887.6315789473683,32,6,30,38
8348,-2.036499999999218,2541.125,70,4,28,74
8349,-21.39299999999909,2099.0,24,17,13,41
8350,-19.02274999999987,2302.0,39,14,37,53
8351,-5.6974999999986755,3539.3333333333335,58,13,20,71
8352,10.391250000000852,4870.35,60,9,15,69
8353,-15.9759999999992,1564.4117647058824,21,12,18,33
8354,-31.614499999999936,2041.0555555555557,14,14,20,28
8355,14.136750000002047,4241.894736842105,51,7,17,58
8356,-15.184749999998626,4015.5789473684213,43,4,22,47
8357,-6.094249999999041,4961.55,52,12,19,64
8358,-9.211999999999083,3245.722222222222,41,13,25,54
8359,-12.333749999999426,2512.8888888888887,28,22,21,50
8360,-13.583749999998677,3280.8,44,15,16,59
8361,-19.715999999999266,2741.5263157894738,38,5,31,43
8362,-30.688749999999192,2692.157894736842,23,12,24,35
8363,33.457250000003064,6101.4,73,6,20,79
8364,-22.50724999999913,2768.5555555555557,25,13,23,38
8365,-15.082999999999434,2989.6315789473683,35,8,27,43
8366,2.4370000000009946,2339.8125,45,12,25,57
8367,-15.70774999999993,2034.1176470588234,36,10,34,46
8368,-2.5574999999982433,2606.470588235294,36,12,22,48
8369,-41.8144999999995,2232.3,13,17,12,30
8370,11.135500000000821,3484.5555555555557,71,8,20,79
8371,-32.62024999999903,2599.8,23,10,22,33
8372,-25.79774999999928,2658.4,20,16,17,36
8373,-21.26874999999971,3410.7368421052633,36,14,20,50
8374,-8.450999999999363,2909.6111111111113,40,16,20,56
8375,1.3725000000008991,3286.235294117647,53,17,22,70
8376,-3.5704999999992006,2148.25,48,10,23,58
8377,-16.572499999999554,2493.4210526315787,37,10,19,47
8378,-18.522249999999058,2481.0,22,11,22,33
8379,-18.51874999999904,2026.6470588235295,23,10,21,33
8380,-15.897499999999493,2622.470588235294,32,7,30,39
8381,-32.59649999999944,3106.0,14,11,26,25
8382,0.5605000000013046,3794.2105263157896,55,6,30,61
8383,-17.4039999999997,1429.0,35,7,31,42
8384,-11.35324999999952,2176.9411764705883,32,23,21,55
8385,24.02450000000072,3054.0,80,13,15,93
8386,-0.3284999999978545,4756.05,67,6,13,73
8387,-1.1572499999984303,3106.0,53,11,21,64
8388,-11.060249999997602,3030.529411764706,46,16,16,62
8389,7.749250000002303,2323.0625,43,7,35,50
8390,-12.220999999999162,3475.1052631578946,47,15,19,62
8391,-9.859749999999408,2395.5555555555557,54,7,20,61
8392,-14.625499999999672,1496.5,20,19,25,39
8393,-12.199999999998168,4639.45,51,16,18,67
8394,-25.317749999999236,2052.5,22,12,21,34
8395,-18.23599999999852,2723.2105263157896,21,4,37,25
8396,-13.610749999998053,2971.3684210526317,40,6,24,46
8397,2.313750000000506,3701.4210526315787,53,6,26,59
8398,-1.9619999999996918,2592.222222222222,38,9,26,47
8399,-9.61024999999824,2067.9375,40,13,25,53
8400,-5.9592499999990105,3235.1111111111113,47,13,13,60
8401,-22.297249999998108,1608.625,28,17,22,45
8402,-20.488249999998374,2622.7,22,8,31,30
8403,-34.14174999999901,1510.5333333333333,25,3,34,28
8404,-8.453249999999366,3236.157894736842,38,15,13,53
8405,19.183750000001094,3131.3529411764707,53,15,21,68
8406,-12.568999999999914,2452.8333333333335,41,19,17,60
8407,-1.6432499999989028,2739.9411764705883,49,8,22,57
8408,-9.091749999999326,2424.294117647059,33,21,23,54
8409,-15.582499999997987,4432.3,43,17,20,60
8410,-8.574249999999793,2232.1176470588234,51,9,33,60
8411,-34.03424999999911,2662.9473684210525,27,20,22,47
8412,-4.368499999998516,3520.35,41,5,25,46
8413,12.682000000002017,3114.3529411764707,62,11,21,73
8414,-4.7494999999989975,3600.1111111111113,45,9,22,54
8415,3.111000000001296,4413.2,48,14,19,62
8416,-11.9187499999992,3304.5263157894738,49,6,25,55
8417,-53.50974999999984,2028.6666666666667,10,2,47,12
8418,-2.828249999999032,3138.8888888888887,42,9,22,51
8419,-42.40499999999994,1429.0,2,12,18,14
8420,1.1420000000003687,2450.5882352941176,47,12,20,59
8421,1.0085000000020767,3858.5555555555557,58,6,19,64
8422,21.18725000000176,3047.235294117647,65,18,11,83
8423,16.70575000000143,3698.1052631578946,59,6,28,65
8424,-10.731749999997776,3294.5789473684213,43,10,20,53
8425,-9.188499999998877,4071.5263157894738,53,7,18,60
8426,-4.786499999999341,2214.3529411764707,52,17,19,69
8427,-2.988999999997442,2152.705882352941,44,13,20,57
8428,-30.902999999999203,1652.1764705882354,21,11,27,32
8429,-19.540749999998585,2660.1666666666665,31,6,24,37
8430,-50.59124999999984,1429.0,1,8,28,9
8431,-11.111249999999831,2393.3125,40,17,23,57
8432,-4.359249999998925,4282.3,53,11,19,64
8433,-14.190749999999127,2658.7894736842104,40,13,17,53
8434,-18.814249999999245,3143.3,32,7,29,39
8435,-20.134499999999626,2598.5789473684213,32,13,16,45
8436,-7.698499999998717,2908.0,52,8,19,60
8437,-29.970999999999435,2358.4444444444443,15,8,22,23
8438,-12.247249999998942,2755.3,25,9,27,34
8439,-15.541249999997955,4052.0,49,10,18,59
8440,-5.778000000000228,2794.1666666666665,59,21,26,80
8441,-1.228249999997955,2690.6470588235293,53,5,21,58
8442,27.4895000000026,3080.764705882353,74,15,21,89
8443,-7.81899999999889,2906.222222222222,32,9,22,41
8444,16.52575000000292,2010.4375,58,11,22,69
8445,-25.70474999999903,2316.0588235294117,33,4,40,37
8446,6.030250000000814,3177.5263157894738,58,15,17,73
8447,2.667250000001571,4651.35,56,10,12,66
8448,-25.976499999998985,1590.75,19,5,26,24
8449,-48.74025000000054,1429.0,3,11,43,14
8450,-0.9349999999982602,2935.222222222222,44,13,16,57
8451,-37.81099999999955,2019.7368421052631,17,10,17,27
8452,-24.312249999999345,2168.8333333333335,19,17,24,36
8453,-28.313499999999873,1429.0,23,8,22,31
8454,-47.13674999999988,1429.0,11,19,17,30
8455,-9.514999999999626,4263.578947368421,58,16,16,74
8456,-8.546749999999772,1862.5625,44,4,30,48
8457,-21.86924999999936,2843.4210526315787,20,17,16,37
8458,4.317750000001739,4964.8,64,11,19,75
8459,-3.8152499999990317,1481.9333333333334,46,7,22,53
8460,-28.97724999999818,2782.6666666666665,34,7,39,41
8461,-10.607499999999868,1884.375,38,14,12,52
8462,-14.616000000000247,2048.1111111111113,40,14,20,54
8463,-10.834499999999442,3077.3684210526317,45,7,28,52
8464,-9.872249999997777,1644.3125,38,15,19,53
8465,-38.84049999999961,3200.1052631578946,34,6,31,40
8466,-17.93999999999931,2358.5555555555557,26,7,29,33
8467,-24.096499999998514,3012.2105263157896,31,12,22,43
8468,-8.485999999998722,3290.2,38,15,14,53
8469,-4.103749999998497,3411.294117647059,72,10,21,82
8470,14.184750000001566,3089.176470588235,59,12,16,71
8471,-15.445999999998156,3104.5,41,10,20,51
8472,2.053749999999958,2622.4117647058824,49,11,18,60
8473,-11.541499999998782,4496.55,54,2,17,56
8474,-11.997749999999687,2735.3529411764707,57,9,24,66
8475,-29.245749999999354,2518.1666666666665,24,16,17,40
8476,-21.967999999998806,3389.7894736842104,38,10,21,48
8477,-18.22849999999935,2548.4736842105262,28,7,22,35
8478,-0.9862499999986218,2782.6666666666665,48,2,29,50
8479,-4.126749999999031,3809.2631578947367,48,12,22,60
8480,-9.26899999999946,2525.4117647058824,48,11,22,59
8481,-17.617249999999007,3703.842105263158,47,6,26,53
8482,9.113500000001803,2740.9411764705883,47,14,18,61
8483,-13.65499999999912,3107.4736842105262,31,13,21,44
8484,-19.59024999999899,2720.5263157894738,33,5,15,38
8485,7.730500000001646,4064.9473684210525,57,18,14,75
8486,2.141250000000343,3482.5789473684213,50,13,13,63
8487,-21.104999999998245,3623.7368421052633,34,8,31,42
8488,-12.537499999998257,2282.25,42,14,24,56
8489,-17.679249999999477,2459.0,41,16,20,57
8490,-3.4934999999979865,4231.55,62,13,19,75
8491,-18.843999999998694,2848.8888888888887,39,7,19,46
8492,-11.08149999999976,2265.9444444444443,41,15,18,56
8493,4.72125000000043,3050.9411764705883,61,6,20,67
8494,-18.56574999999917,2204.0,48,6,25,54
8495,-7.5742499999994894,2733.9473684210525,39,2,28,41
8496,-5.712999999998078,2961.722222222222,43,10,18,53
8497,-14.301999999999433,2766.8888888888887,48,7,21,55
8498,-9.292749999999383,2248.823529411765,42,14,22,56
8499,-5.779749999996866,2055.0625,55,8,23,63
8500,-43.12874999999954,2667.95,23,12,16,35
8501,-10.582999999999714,3814.9,38,11,14,49
8502,-11.340499999998558,3751.4,36,5,24,41
8503,6.097000000001208,5064.8421052631575,69,12,18,81
8504,-5.120999999998359,3418.5,49,4,21,53
8505,-1.5419999999992418,2605.705882352941,59,7,23,66
8506,-24.748750000000328,2722.777777777778,35,8,28,43
8507,-8.53974999999876,2504.8888888888887,42,9,26,51
8508,-15.855749999999407,3179.95,29,8,21,37
8509,-20.258749999999136,2059.0625,31,16,15,47
8510,0.7770000000016554,2421.5882352941176,35,11,22,46
8511,23.460000000000466,3627.5,65,7,21,72
8512,12.376500000001851,2451.9375,65,11,18,76
8513,-8.520999999998242,1532.1875,49,6,23,55
8514,-8.241499999998771,3277.5,37,9,21,46
8515,-4.627999999999675,2112.625,41,18,10,59
8516,-4.898999999998388,4460.1,49,18,19,67
8517,-18.965999999998527,2982.2105263157896,39,20,12,59
8518,-6.7567499999981475,3091.222222222222,49,14,22,63
8519,-16.836999999999158,1481.9333333333334,30,5,35,35
8520,-8.869499999999231,3592.0,38,17,18,55
8521,-4.326999999997875,4383.105263157895,61,10,23,71
8522,10.499999999999698,3063.9444444444443,56,9,21,65
8523,-31.330500000000058,2338.222222222222,32,7,28,39
8524,-32.75399999999968,2607.0,21,7,27,28
8525,-26.28724999999908,1973.6875,25,11,25,36
8526,2.820750000001465,3287.9444444444443,49,12,16,61
8527,-15.556999999998965,1911.125,37,12,26,49
8528,-20.08174999999971,1429.0,33,5,35,38
8529,-17.60999999999977,2620.25,23,10,15,33
8530,-32.87274999999933,2621.1,16,10,22,26
8531,12.030000000001467,2616.5625,60,12,19,72
8532,5.201500000000389,2504.8888888888887,46,6,23,52
8533,-24.558499999999444,1500.5,24,13,28,37
8534,16.440750000000325,2950.0,66,24,17,90
8535,12.922750000000914,3116.0555555555557,67,11,15,78
8536,-28.54824999999955,1429.0,13,15,20,28
8537,-6.6494999999995885,1824.0,51,11,31,62
8538,-33.71399999999939,2762.4,23,6,19,29
8539,-15.929999999999708,3181.7368421052633,30,8,23,38
8540,-22.460749999999685,1684.0,42,10,29,52
8541,-37.33224999999839,4060.0,36,6,28,42
8542,-31.480749999999052,2571.1111111111113,22,13,21,35
8543,-26.432999999999215,2390.277777777778,35,15,34,50
8544,-19.33749999999913,2695.3333333333335,44,16,19,60
8545,7.246250000001649,3008.8823529411766,59,11,28,70
8546,-16.152499999999254,2383.3529411764707,41,13,17,54
8547,-23.793499999999334,2914.4210526315787,28,9,20,37
8548,9.652500000002288,4031.3333333333335,76,10,26,86
8549,-2.4597499999991643,3703.842105263158,70,7,15,77
8550,0.4070000000011006,3000.529411764706,59,14,22,73
8551,3.8297500000026536,5483.05,64,19,17,83
8552,-3.8027499999992322,3724.7894736842104,52,10,20,62
8553,-44.01524999999923,2068.2105263157896,12,7,31,19
8554,-7.06249999999927,3112.5555555555557,36,11,19,47
8555,-23.642999999998842,2028.3125,47,22,18,69
8556,13.621000000002178,2153.3125,53,14,13,67
8557,-25.512749999999176,2942.3888888888887,29,8,24,37
8558,-7.442499999998387,2415.9444444444443,35,17,24,52
8559,7.544750000002237,4028.0526315789475,61,5,30,66
8560,-3.0634999999985717,4455.8421052631575,57,0,35,57
8561,3.0472500000004614,2123.705882352941,47,17,16,64
8562,-9.998999999998148,2595.2105263157896,29,8,25,37
8563,-7.488749999997813,2979.9411764705883,61,8,26,69
8564,-22.31674999999935,1534.8666666666666,21,8,24,29
8565,-7.160499999998521,3362.2105263157896,47,12,27,59
8566,-2.9819999999977913,3019.0555555555557,46,11,18,57
8567,-14.114749999998873,3658.55,28,10,25,38
8568,-11.163999999999534,2105.9411764705883,29,8,29,37
8569,-2.454499999999917,4360.473684210527,49,6,23,55
8570,-7.9079999999987125,2072.8333333333335,30,13,14,43
8571,-4.505249999998845,3012.8888888888887,50,9,32,59
8572,-5.439249999998262,3584.277777777778,63,0,26,63
8573,-23.44174999999985,2577.7368421052633,19,5,28,24
8574,-27.41449999999795,2585.1666666666665,43,15,14,58
8575,-13.760499999999189,2854.315789473684,32,5,26,37
8576,-8.62249999999868,2284.1875,35,16,19,51
8577,-7.743499999998413,3360.5789473684213,42,9,23,51
8578,2.016000000001283,2173.25,36,6,24,42
8579,-8.38449999999894,3768.2631578947367,46,16,24,62
8580,-23.538499999998994,2678.0,20,7,26,27
8581,-16.876249999999338,2254.5882352941176,22,8,25,30
8582,2.129250000001892,2771.823529411765,48,7,18,55
8583,5.2690000000006725,3167.1666666666665,45,11,19,56
8584,-8.943249999998923,1907.1875,28,11,27,39
8585,-4.308249999999154,2896.3333333333335,32,21,17,53
8586,-3.494749999997964,3008.3888888888887,44,17,18,61
8587,-22.588249999997792,2706.9444444444443,42,8,25,50
8588,-22.10499999999884,2537.684210526316,28,9,20,37
8589,9.263500000002393,4632.0,79,4,26,83
8590,-1.0934999999976862,3869.1111111111113,63,14,23,77
8591,-18.870249999999565,2259.4375,47,9,25,56
8592,3.2037500000008294,2996.8823529411766,59,4,21,63
8593,-27.795249999999697,2696.3684210526317,17,2,34,19
8594,-15.65899999999987,1988.4117647058824,41,4,22,45
8595,-24.36649999999952,2952.157894736842,22,7,22,29
8596,-21.914749999998634,3261.6,29,6,28,35
8597,0.5952500000022575,2638.5,47,10,24,57
8598,-39.7084999999996,2839.4,19,12,21,31
8599,-11.13249999999764,3074.294117647059,54,7,22,61
8600,6.165000000002706,4790.15,76,13,18,89
8601,-19.177999999999276,2883.9,25,6,27,31
8602,18.59175000000188,2677.4117647058824,65,10,22,75
8603,2.605750000001195,3523.4736842105262,46,8,32,54
8604,-16.66149999999775,2203.222222222222,41,7,34,48
8605,-11.579999999999448,3339.5263157894738,33,10,25,43
8606,-29.089499999998885,4177.5,32,7,25,39
8607,11.007750000002252,2332.9411764705883,62,4,27,66
8608,18.0160000000017,5359.3,57,13,16,70
8609,-42.41499999999944,1901.7222222222222,9,15,33,24
8610,-26.693999999999154,2065.55,14,6,30,20
8611,-16.071749999999323,2592.1666666666665,27,9,30,36
8612,5.0390000000003115,2854.8888888888887,49,8,18,57
8613,-23.32874999999969,2504.8888888888887,27,8,25,35
8614,-38.49824999999966,1568.1176470588234,8,8,29,16
8615,-21.9457499999999,2960.8333333333335,46,10,24,56
8616,4.450250000001232,2660.5882352941176,50,17,23,67
8617,-8.393499999999795,2429.0,49,19,15,68
8618,-15.9274999999989,3660.0555555555557,41,13,27,54
8619,9.058250000000246,4023.8947368421054,61,6,21,67
8620,-10.394999999998737,3787.4736842105262,41,13,19,54
8621,5.310500000000954,3531.0,44,6,25,50
8622,-37.63174999999951,2917.7368421052633,19,12,27,31
8623,-15.657999999999188,3779.1052631578946,36,12,30,48
8624,-35.088999999999366,2267.15,14,14,19,28
8625,2.377250000001005,4170.3,43,8,23,51
8626,-38.80824999999966,2170.35,11,9,24,20
8627,-14.684999999999022,3373.0,34,5,21,39
8628,-10.153249999998867,2342.6111111111113,31,6,22,37
8629,-27.441499999999404,3251.3,27,8,18,35
8630,-15.586749999999729,1476.6,62,15,27,77
8631,-39.770500000000155,1984.611111111111,14,6,56,20
8632,-16.4544999999991,2916.9473684210525,24,9,24,33
8633,-9.710749999998699,3550.722222222222,47,14,26,61
8634,9.721250000000227,2658.7894736842104,42,21,20,63
8635,-17.057749999999025,3181.5,24,8,26,32
8636,9.731500000001862,2685.8823529411766,56,9,25,65
8637,-12.131249999999298,3061.3333333333335,46,5,28,51
8638,-25.89924999999918,3295.85,26,6,24,32
8639,-33.119999999999465,2473.222222222222,37,10,34,47
8640,-32.31699999999911,1550.0625,17,9,26,26
8641,10.380750000002433,2251.5,57,10,22,67
8642,-25.791749999999393,2480.1111111111113,27,8,28,35
8643,-7.868499999998228,4111.666666666667,60,15,22,75
8644,-27.38549999999949,2640.4736842105262,14,9,27,23
8645,-12.305499999998853,3254.45,37,9,13,46
8646,-22.528749999999814,1617.5625,15,7,19,22
8647,-31.078249999999894,1429.0,11,15,25,26
8648,-23.67924999999854,4525.85,44,14,25,58
8649,-17.966999999998556,2652.176470588235,33,14,23,47
8650,-14.466249999999002,2628.3888888888887,27,10,21,37
8651,-25.33824999999888,2565.315789473684,23,2,37,25
8652,-1.3194999999992347,2766.777777777778,43,8,26,51
8653,21.41525000000251,3512.9444444444443,76,10,23,86
8654,-19.83549999999996,1585.75,42,17,20,59
8655,1.433250000000434,2731.529411764706,72,14,18,86
8656,-4.883499999999147,2349.705882352941,40,11,30,51
8657,-34.36449999999987,2454.4,14,8,23,22
8658,-11.548499999998663,2316.1176470588234,47,12,27,59
8659,-2.536750000000056,2295.0625,53,15,17,68
8660,0.24075000000131813,2935.277777777778,48,7,22,55
8661,-31.26099999999921,2227.1111111111113,22,14,26,36
8662,-22.64049999999931,2122.823529411765,47,6,27,53
8663,-6.583999999999892,1429.0,43,13,35,56
8664,-19.63474999999948,1657.25,16,10,22,26
8665,-16.183499999999242,2539.277777777778,39,10,15,49
8666,-11.180499999999086,3110.05,34,9,16,43
8667,-41.61024999999932,1956.2631578947369,12,1,29,13
8668,-27.369749999999677,2611.7,19,13,22,32
8669,-23.653999999999137,2546.842105263158,24,9,19,33
8670,-27.23099999999807,2747.3684210526317,26,13,36,39
8671,-17.942249999998943,3667.9473684210525,37,6,24,43
8672,-41.48099999999893,1606.4705882352941,9,10,32,19
8673,-27.08874999999771,3407.3684210526317,37,7,33,44
8674,-5.2474999999989285,2630.705882352941,49,20,20,69
8675,3.1327500000020114,4880.65,55,9,18,64
8676,15.668250000000743,2971.3888888888887,63,16,18,79
8677,6.779750000003565,5879.95,72,12,23,84
8678,5.771500000001493,4094.1052631578946,50,5,21,55
8679,4.018500000002333,4729.9,55,1,26,56
8680,2.8070000000008144,3229.3684210526317,53,10,19,63
8681,-20.421999999999333,2025.764705882353,17,7,27,24
8682,-5.930749999999524,2944.9444444444443,44,9,26,53
8683,-7.124249999997827,3585.1111111111113,48,7,40,55
8684,-24.336749999999046,2752.1,23,10,22,33
8685,-14.242999999998272,2290.5555555555557,40,10,24,50
8686,-7.055499999998733,3046.5263157894738,35,10,20,45
8687,-35.540249999999766,1429.0,28,6,30,34
8688,-40.42199999999953,2097.25,10,0,30,10
8689,-21.965249999999,2336.3888888888887,27,11,22,38
8690,11.961250000001066,3500.7894736842104,70,7,22,77
8691,14.7882500000019,2607.4117647058824,51,8,23,59
8692,-12.696499999998586,2870.2631578947367,35,6,23,41
8693,-5.434499999999533,4386.15,32,6,30,38
8694,-4.29449999999767,2789.470588235294,64,9,21,73
8695,-12.328999999999299,2683.1,26,12,21,38
8696,8.818750000001437,2867.0588235294117,43,4,22,47
8697,-3.4377499999974246,2589.705882352941,48,7,29,55
8698,-23.626999999998695,1692.875,28,9,33,37
8699,-15.150999999999456,3117.4210526315787,39,2,27,41
8700,-1.7252499999987698,2081.5555555555557,42,13,18,55
8701,-38.290749999999136,2124.1052631578946,16,10,28,26
8702,-17.635999999998848,2207.777777777778,25,6,27,31
8703,13.304750000001963,2252.5882352941176,55,9,22,64
8704,-15.159749999998885,3433.2105263157896,34,11,28,45
8705,2.832000000000706,3857.6111111111113,67,8,22,75
8706,1.587500000002656,2260.375,49,7,24,56
8707,-13.246249999998913,2705.0,31,7,21,38
8708,-12.042499999998803,4214.315789473684,47,11,25,58
8709,-22.00899999999995,2135.0,36,21,25,57
8710,-18.20249999999929,3499.7,26,15,22,41
8711,-21.336499999999628,2594.4736842105262,23,8,20,31
8712,-19.1632499999984,3493.4210526315787,40,14,24,54
8713,-22.726749999999086,2011.9444444444443,19,8,29,27
8714,-17.90199999999941,2117.777777777778,21,8,21,29
8715,-21.68399999999985,3613.2,22,11,23,33
8716,-17.740749999998513,3714.7368421052633,51,15,21,66
8717,-28.446999999999115,2017.2222222222222,12,9,29,21
8718,-30.896999999999338,2135.8823529411766,18,11,19,29
8719,-6.722999999998947,3463.315789473684,52,6,31,58
8720,-7.668249999998548,2378.0526315789475,33,9,21,42
8721,-21.81374999999895,3152.5789473684213,34,14,30,48
8722,0.5847499999999917,2054.0,48,7,28,55
8723,-0.9999999999992493,2758.8333333333335,37,17,21,54
8724,-19.61074999999945,3102.1,21,10,26,31
8725,-2.3594999999984663,4206.8,48,9,23,57
8726,9.600250000002433,5103.65,59,10,17,69
8727,4.762750000001299,4317.9473684210525,72,13,14,85
8728,-3.206249999999207,4167.578947368421,47,16,15,63
8729,12.061500000000704,3891.8947368421054,73,9,15,82
8730,13.750000000002007,3278.764705882353,55,9,25,64
8731,-17.942249999998705,4974.3,59,8,31,67
8732,2.6295000000018587,4502.2,56,8,23,64
8733,-4.207499999998315,2309.0625,59,9,22,68
8734,-23.42224999999997,2282.9473684210525,32,15,24,47
8735,7.006750000001214,3425.7368421052633,61,3,23,64
8736,-27.274999999999324,2571.85,19,8,26,27
8737,16.470000000001253,4049.7894736842104,57,14,19,71
8738,-12.530249999998968,4117.15,38,8,21,46
8739,2.809250000001996,2287.1176470588234,48,8,22,56
8740,-0.29874999999830865,3018.176470588235,56,2,39,58
8741,-18.118749999999174,3256.85,33,15,19,48
8742,-34.938750000000205,1429.0,20,17,33,37
8743,-11.22199999999966,2749.0526315789475,38,10,28,48
8744,-21.856499999999045,2246.842105263158,19,9,21,28
8745,-19.92324999999837,1951.8125,34,9,26,43
8746,-3.510999999999669,3177.684210526316,48,1,23,49
8747,20.733000000001503,2877.8888888888887,76,7,29,83
8748,-9.928999999999332,2916.294117647059,44,17,19,61
8749,-13.228999999998447,2691.8888888888887,28,17,20,45
8750,-15.868499999998367,2618.684210526316,30,12,21,42
8751,-18.80349999999933,2761.5882352941176,31,16,27,47
8752,-0.2539999999978983,4750.45,64,14,17,78
8753,-42.304499999999635,1457.6,13,22,24,35
8754,-11.689499999998878,2764.1052631578946,37,8,21,45
8755,-12.127749999999848,2476.6666666666665,27,12,26,39
8756,-18.222999999999395,3101.6315789473683,41,12,23,53
8757,-4.09399999999837,4560.210526315789,75,18,13,93
8758,-26.09549999999989,1528.25,11,13,14,24
8759,-2.184749999999073,5039.45,43,10,22,53
8760,-15.807249999998845,2235.9444444444443,27,10,21,37
8761,-1.2237499999989365,2995.9444444444443,42,15,23,57
8762,-13.430499999998204,1528.25,28,21,14,49
8763,10.247500000001903,3241.625,80,17,20,97
8764,-6.279249999999806,2865.6111111111113,52,18,14,70
8765,18.85900000000205,2966.1111111111113,44,16,21,60
8766,-13.499499999999458,2144.277777777778,41,6,24,47
8767,0.7912500000018138,2464.529411764706,43,5,21,48
8768,-17.129999999998265,2425.125,37,1,35,38
8769,-26.011749999998653,1429.0,30,6,27,36
8770,-16.362499999998796,3228.5263157894738,34,13,24,47
8771,-21.856749999998463,2071.875,35,13,20,48
8772,-15.917999999999186,3477.5,29,18,23,47
8773,-39.07324999999885,1429.0,6,4,40,10
8774,-33.20874999999962,2598.7368421052633,34,10,23,44
8775,8.71650000000131,3861.842105263158,51,6,26,57
8776,-20.571499999998856,3063.95,33,7,24,40
8777,-24.038499999999452,2122.7,14,5,22,19
8778,-0.9499999999982045,2844.8125,57,4,22,61
8779,-31.93899999999993,1996.764705882353,18,19,28,37
8780,-4.085999999998263,4374.736842105263,51,7,15,58
8781,3.0122500000012655,5236.15,61,10,24,71
8782,-2.3087499999985646,4110.0,47,27,11,74
8783,-13.043499999999835,2897.222222222222,33,12,24,45
8784,-23.83599999999905,2575.95,27,7,23,34
8785,-3.294749999999447,3192.684210526316,40,10,15,50
8786,-27.084999999999262,2532.25,25,11,21,36
8787,17.702750000002286,2694.176470588235,73,7,19,80
8788,4.63875000000066,2344.8125,54,6,18,60
8789,-4.286749999999254,2608.0,37,4,29,41
8790,-9.608749999998988,2525.1666666666665,38,4,24,42
8791,-34.788749999999695,2433.157894736842,20,4,38,24
8792,-16.29874999999879,2387.9411764705883,26,4,28,30
8793,0.366500000001216,2945.8888888888887,35,7,20,42
8794,-36.36174999999966,2317.9473684210525,11,18,17,29
8795,-6.834499999998455,4518.85,48,13,22,61
8796,-22.71849999999869,2941.2105263157896,34,6,18,40
8797,22.791000000003102,3285.3529411764707,71,8,27,79
8798,-14.229749999999498,2741.5789473684213,34,10,17,44
8799,-16.745749999999326,1643.764705882353,25,12,27,37
8800,-12.972999999998475,2181.6470588235293,35,8,25,43
8801,2.6640000000022104,4594.95,50,7,26,57
8802,-20.182499999999592,1757.764705882353,23,2,25,25
8803,-11.176999999999918,2023.3125,41,11,20,52
8804,-28.028999999998767,1534.8666666666666,20,15,21,35
8805,-9.275499999998342,2888.684210526316,31,9,33,40
8806,-16.638749999999582,2598.684210526316,21,12,30,33
8807,-8.198749999999295,2538.294117647059,45,20,15,65
8808,2.130250000001392,4350.5,57,14,15,71
8809,-8.652999999998869,2537.294117647059,35,7,19,42
8810,-19.25399999999893,1862.235294117647,37,14,23,51
8811,-16.032249999999358,2981.9444444444443,27,9,21,36
8812,-10.029499999998581,3777.4210526315787,42,8,23,50
8813,-13.705499999998755,3068.4444444444443,44,5,26,49
8814,-1.9072499999989092,3834.65,41,11,18,52
8815,-36.732999999998775,2576.5882352941176,25,22,18,47
8816,-17.90724999999889,3331.2631578947367,37,7,27,44
8817,-14.514999999999963,3121.222222222222,47,13,22,60
8818,-15.608249999998957,5137.8,44,6,21,50
8819,-12.105499999998923,3454.8947368421054,39,12,17,51
8820,-10.544749999999834,2636.2631578947367,27,12,18,39
8821,-15.027999999998352,3697.2631578947367,48,12,20,60
8822,3.3010000000017987,2628.4444444444443,36,13,25,49
8823,-13.856999999998047,3187.5,44,15,22,59
8824,-12.580249999999205,2867.2,20,8,24,28
8825,-31.54899999999791,2154.0,36,14,23,50
8826,-7.452249999998233,3338.222222222222,55,12,25,67
8827,12.172000000001834,5064.9473684210525,81,13,15,94
8828,8.518000000000864,2652.375,60,12,21,72
8829,-14.046999999998675,2159.1176470588234,41,9,28,50
8830,-28.515999999999444,2393.777777777778,33,5,30,38
8831,11.514250000001457,2398.3125,58,8,19,66
8832,-25.500749999999876,2166.0625,24,14,19,38
8833,-6.194249999999147,2807.1176470588234,35,5,25,40
8834,-10.818499999999043,2449.3888888888887,29,15,20,44
8835,5.713500000000229,4016.3888888888887,77,3,16,80
8836,-0.31124999999947783,2657.764705882353,59,9,21,68
8837,13.631500000001694,5347.3,59,9,20,68
8838,-15.031749999998217,3259.777777777778,47,11,27,58
8839,-21.06699999999933,3163.1,37,1,19,38
8840,-13.25049999999871,2521.0,31,9,21,40
8841,-26.92950000000014,1429.0,25,8,23,33
8842,-3.848249999998069,3662.1052631578946,46,19,15,65
8843,-9.592749999998526,4363.9473684210525,60,14,20,74
8844,-11.146999999999032,2309.1875,39,6,21,45
8845,-17.112999999999225,3812.4736842105262,52,14,20,66
8846,-17.414249999997757,2885.5882352941176,48,10,25,58
8847,-12.48574999999835,3208.5555555555557,48,9,18,57
8848,7.953750000000566,3500.9473684210525,58,12,16,70
8849,-25.4392499999994,2151.684210526316,15,11,24,26
8850,-17.00299999999931,4010.75,39,10,18,49
8851,-8.84124999999879,2046.125,31,6,23,37
8852,-3.12199999999804,2953.8333333333335,40,5,23,45
8853,-11.951749999998789,3653.0,40,18,22,58
8854,-21.334750000000035,2563.5882352941176,32,17,18,49
8855,0.5942500000014345,2624.176470588235,59,8,21,67
8856,-29.445499999999505,3251.9473684210525,24,11,31,35
8857,-28.049499999999163,3566.1052631578946,31,15,22,46
8858,-36.4509999999995,2028.7777777777778,14,20,17,34
8859,-1.085749999999526,2338.1666666666665,40,12,21,52
8860,-12.98749999999922,2114.4117647058824,33,10,22,43
8861,-6.796249999998821,2679.5,36,11,18,47
8862,5.13750000000108,2897.222222222222,61,19,15,80
8863,-39.308500000000066,2880.157894736842,22,12,58,34
8864,-30.792249999999306,2779.0,22,21,12,43
8865,-0.3867499999992289,3535.9473684210525,50,15,21,65
8866,-16.62249999999916,2258.8333333333335,39,12,24,51
8867,-10.726249999998211,3218.4736842105262,36,15,20,51
8868,-21.03049999999849,2018.2941176470588,25,4,33,29
8869,-18.81274999999896,3851.3,30,14,25,44
8870,-6.733999999998355,2501.5,49,7,26,56
8871,-37.14299999999991,1429.0,9,0,39,9
8872,21.87300000000048,3869.315789473684,72,8,14,80
8873,-1.972749999998505,2207.722222222222,29,8,22,37
8874,-20.904999999998875,3447.3,30,7,24,37
8875,-0.2867499999998618,1491.4666666666667,40,13,21,53
8876,-4.100499999999354,3732.2,36,10,15,46
8877,17.03075000000203,3170.3529411764707,60,17,20,77
8878,-11.843749999997788,2216.5,38,18,20,56
8879,-16.706499999997952,2328.5555555555557,36,18,15,54
8880,-13.122249999999017,2708.2105263157896,28,8,23,36
8881,-15.326499999999402,2643.842105263158,36,7,28,43
8882,-12.524999999998979,4088.2105263157896,58,20,19,78
8883,-13.025749999999482,2214.75,31,16,17,47
8884,6.044250000000454,3490.0526315789475,46,15,20,61
8885,-29.986999999999814,3163.6666666666665,37,3,28,40
8886,-13.530999999999114,3564.05,28,12,16,40
8887,-11.743749999998782,2866.3888888888887,37,12,17,49
8888,-16.420249999998354,3093.9411764705883,43,1,23,44
8889,7.8570000000016265,3913.1111111111113,65,11,21,76
8890,-0.9227499999978137,2953.8333333333335,51,11,19,62
8891,-9.522249999997538,2704.277777777778,44,4,30,48
8892,-17.707249999999647,2064.0,22,7,26,29
8893,-26.409999999998586,2941.0,24,11,25,35
8894,1.158250000000605,3544.3684210526317,55,15,27,70
8895,-14.134499999999644,3213.5263157894738,33,9,34,42
8896,-17.686249999999042,2290.823529411765,32,5,23,37
8897,-9.610499999998593,2621.5625,48,11,26,59
8898,-13.943249999999304,2399.176470588235,37,19,9,56
8899,2.47025000000153,3123.705882352941,44,9,23,53
8900,-18.09549999999866,2552.5555555555557,44,3,24,47
8901,-12.302249999997844,2262.9411764705883,46,11,22,57
8902,-16.089999999998824,3552.2,33,16,14,49
8903,-3.929249999999544,2618.6470588235293,32,12,21,44
8904,20.679750000000983,4215.263157894737,67,7,16,74
8905,-14.471749999998423,3261.9473684210525,35,10,25,45
8906,-31.39799999999992,2126.6315789473683,12,6,36,18
8907,-2.3489999999993376,3609.4736842105262,59,8,23,67
8908,-37.66099999999882,2223.6470588235293,25,4,40,29
8909,-23.53799999999845,3365.55,40,9,24,49
8910,-13.411749999998033,2255.3888888888887,35,14,21,49
8911,-13.905249999999782,1429.0,38,14,21,52
8912,13.233000000001704,3190.9444444444443,56,2,22,58
8913,-6.422999999999829,2929.5263157894738,41,6,20,47
8914,-15.489249999999052,3310.0,35,4,19,39
8915,-27.137250000000336,2017.235294117647,17,13,45,30
8916,0.6115000000002286,2196.9375,54,12,18,66
8917,22.53849999999961,2348.625,59,14,15,73
8918,-19.98599999999945,1961.6666666666667,37,7,24,44
8919,-19.320749999999695,1938.0,34,17,16,51
8920,-13.004749999998822,3243.35,40,10,11,50
8921,-22.93799999999938,1572.8823529411766,21,11,19,32
8922,-34.95774999999963,1572.8235294117646,4,15,24,19
8923,8.611250000001084,1505.4375,49,16,17,65
8924,-31.12349999999885,1429.0,10,20,24,30
8925,-30.69799999999921,2520.722222222222,27,10,26,37
8926,-25.835249999999956,1429.0,19,18,23,37
8927,-12.442749999998922,4343.35,59,10,16,69
8928,-21.711499999998487,2888.4444444444443,38,12,25,50
8929,-6.16374999999938,2866.0588235294117,65,11,24,76
8930,-23.028749999999157,3377.45,29,6,29,35
8931,-33.58399999999902,1429.0,17,6,27,23
8932,-22.62974999999926,2026.3125,34,13,30,47
8933,-7.241999999999328,2076.875,45,11,19,56
8934,5.798750000003087,2974.0555555555557,57,15,15,72
8935,2.156750000001435,4714.8,45,8,24,53
8936,-19.19874999999916,2753.315789473684,22,10,25,32
8937,-6.381749999998855,3493.3684210526317,45,7,18,52
8938,-19.361499999998493,2033.111111111111,28,3,26,31
8939,-14.220499999999609,2257.235294117647,38,12,21,50
8940,-25.849999999998413,2232.1176470588234,50,9,22,59
8941,-19.311250000000246,2944.8888888888887,41,5,24,46
8942,-23.05874999999776,2971.2105263157896,42,9,20,51
8943,-21.619999999998875,2631.8888888888887,36,5,28,41
8944,-24.998749999999188,2845.7,23,8,23,31
8945,-8.598249999999181,2400.1176470588234,38,12,17,50
8946,8.429500000000647,2887.529411764706,49,12,15,61
8947,0.51975000000196,4192.631578947368,72,14,16,86
8948,-27.588749999998868,1429.0,16,9,25,25
8949,-16.11349999999992,1429.0,40,16,14,56
8950,-19.344999999998205,1963.235294117647,34,14,35,48
8951,-28.396749999999646,1710.75,22,6,25,28
8952,-18.442999999999422,2277.764705882353,56,16,26,72
8953,-10.180999999998166,2765.0555555555557,38,16,23,54
8954,-9.866749999998834,1528.25,33,9,23,42
8955,-10.515500000000134,3524.3333333333335,57,8,26,65
8956,-6.042749999999621,3862.6315789473683,48,7,23,55
8957,-16.413249999999078,2033.111111111111,19,11,22,30
8958,-25.90449999999918,3365.55,26,19,21,45
8959,-28.990249999999588,2529.315789473684,18,10,17,28
8960,-3.249999999999072,3181.7368421052633,33,7,25,40
8961,-15.209499999998107,2732.529411764706,42,8,20,50
8962,-40.411249999999754,1429.0,16,16,17,32
8963,-17.037749999998958,3075.5789473684213,39,9,18,48
8964,-6.6522499999996345,3145.0,35,14,13,49
8965,-3.010249999998764,2988.3529411764707,47,7,32,54
8966,-8.632249999997947,1429.0,32,7,28,39
8967,-33.98999999999913,1429.0,29,14,32,43
8968,-27.146499999999712,2462.6470588235293,38,10,33,48
8969,-0.6557499999997548,3022.5555555555557,58,6,26,64
8970,-0.8659999999987184,2453.777777777778,35,16,16,51
8971,-31.182750000000084,2103.6666666666665,21,13,23,34
8972,-16.91649999999916,3437.0555555555557,45,16,21,61
8973,-23.773999999999155,1429.0,53,15,22,68
8974,2.617750000001757,3809.15,44,12,28,56
8975,-25.870999999999544,2894.9,22,8,20,30
8976,-35.20149999999978,1541.125,8,7,21,15
8977,-9.544749999998691,3275.3684210526317,40,5,13,45
8978,-11.361249999998845,3698.95,39,8,24,47
8979,-27.83224999999881,2679.4444444444443,31,12,26,43
8980,-12.441999999998833,2035.0,30,3,23,33
8981,2.135750000000023,2731.705882352941,60,7,24,67
8982,2.010500000001206,4583.1,51,8,20,59
8983,-20.387749999999212,2783.315789473684,23,14,22,37
8984,4.865250000002187,4887.0,55,3,22,58
8985,4.440500000001467,4267.894736842105,60,8,21,68
8986,17.813750000000983,4839.315789473684,67,12,17,79
8987,-5.807749999998464,3560.6470588235293,54,14,30,68
8988,9.7915000000002,2539.235294117647,48,15,15,63
8989,-21.60474999999938,2655.6666666666665,28,5,26,33
8990,16.366000000002398,3013.5882352941176,76,12,20,88
8991,-27.601999999999823,3394.0,38,9,25,47
8992,-3.186249999998984,3022.315789473684,42,11,13,53
8993,-33.457499999999314,2329.0,14,8,23,22
8994,-31.9599999999992,1593.4117647058824,11,13,27,24
8995,-0.4457499999992688,2822.5,38,2,24,40
8996,-16.15174999999924,2261.0,37,16,13,53
8997,-20.73724999999836,3163.4736842105262,38,3,24,41
8998,-25.886249999999762,2675.0555555555557,25,8,34,33
8999,-11.667749999997556,2967.823529411765,51,7,20,58
9000,-6.1157499999979965,3515.8947368421054,44,5,24,49
9001,-23.110499999999867,2199.0,32,18,18,50
9002,-13.22699999999946,2408.5882352941176,39,4,26,43
9003,-18.927999999999155,2592.222222222222,36,2,28,38
9004,-17.731499999999244,2564.0,31,21,22,52
9005,-7.301749999999285,2584.277777777778,45,10,24,55
9006,-11.482999999998516,3267.777777777778,48,13,18,61
9007,-2.431749999998659,4219.5,41,10,18,51
9008,3.321000000001078,4752.1,60,6,20,66
9009,-6.8532499999991074,3688.0,43,16,22,59
9010,12.594500000002023,4102.421052631579,74,7,19,81
9011,-27.411499999999457,2722.2631578947367,29,9,28,38
9012,8.362000000001297,2580.235294117647,55,17,18,72
9013,-1.9507499999985032,2307.6470588235293,33,12,29,45
9014,-5.168249999999373,2679.5,32,8,25,40
9015,-5.74174999999949,2497.0,44,8,23,52
9016,-25.018249999998503,2843.5263157894738,30,1,31,31
9017,-29.94299999999796,1978.842105263158,10,12,46,22
9018,-13.051749999999194,2250.9444444444443,40,9,25,49
9019,-5.069249999998984,4623.55,42,6,29,48
9020,-35.08924999999944,3019.5,19,6,24,25
9021,-34.05600000000029,2049.7894736842104,17,8,48,25
9022,-40.819749999999864,1429.0,0,9,26,9
9023,-2.6654999999984383,4781.5,51,12,14,63
9024,-20.67524999999882,1563.4666666666667,25,17,14,42
9025,-6.676750000000338,3200.157894736842,43,8,23,51
9026,-5.016749999998153,4142.6,53,7,18,60
9027,-19.67974999999889,2819.157894736842,33,15,17,48
9028,-22.713749999999727,2064.0,35,12,19,47
9029,-2.1862499999988843,2268.375,43,13,25,56
9030,-2.239499999998606,3007.0588235294117,53,4,32,57
9031,-16.169999999998044,1841.764705882353,36,5,26,41
9032,0.8102500000002181,2313.0625,62,11,21,73
9033,-11.42299999999889,3152.15,34,8,17,42
9034,-23.856499999998558,2465.1666666666665,29,7,35,36
9035,-8.037499999999111,2005.1764705882354,45,11,20,56
9036,-11.584999999999411,3649.684210526316,42,8,37,50
9037,-17.969749999999205,2005.4375,24,8,28,32
9038,-18.982749999997914,3491.7894736842104,52,7,19,59
9039,-31.49049999999906,2365.55,15,17,17,32
9040,-5.698249999996881,3390.277777777778,50,8,24,58
9041,-10.85674999999858,3055.684210526316,35,13,23,48
9042,-19.869499999999384,3305.4210526315787,44,11,27,55
9043,-34.55849999999948,1496.5,11,5,25,16
9044,-17.448999999999863,2889.3888888888887,32,10,36,42
9045,-36.12899999999994,1429.0,6,5,35,11
9046,10.200500000000769,5294.1,60,9,13,69
9047,-22.25699999999938,2598.684210526316,36,6,27,42
9048,-32.81724999999953,2311.5,15,9,20,24
9049,-36.71099999999909,3104.1052631578946,26,9,27,35
9050,8.598250000001064,3611.2631578947367,66,14,17,80
9051,-17.40974999999841,3508.5,33,5,22,38
9052,15.014500000000965,3341.8333333333335,53,20,12,73
9053,-8.31224999999891,2651.3684210526317,28,16,18,44
9054,-4.438999999998605,3102.8333333333335,45,16,20,61
9055,-31.04924999999858,4237.0,42,8,35,50
9056,-30.924249999998615,4029.8,41,8,25,49
9057,4.2252500000006625,1486.1333333333334,60,10,24,70
9058,-8.367749999998587,4339.4,41,9,24,50
9059,-25.81999999999868,2379.5882352941176,31,8,26,39
9060,-9.560999999999382,2596.5555555555557,50,9,21,59
9061,-5.3822499999995905,2631.8888888888887,41,3,22,44
9062,-16.400249999999303,2139.777777777778,27,6,24,33
9063,0.7045000000023551,3628.684210526316,53,10,24,63
9064,-26.97949999999944,2948.684210526316,23,2,26,25
9065,6.22250000000121,3092.8823529411766,68,9,23,77
9066,-6.854999999998594,3914.4736842105262,49,6,26,55
9067,-7.980749999997736,2484.1176470588234,63,12,24,75
9068,-15.979249999998302,2825.0555555555557,36,8,25,44
9069,-1.9742499999986456,3956.9,37,17,20,54
9070,-29.041499999999814,2410.7368421052633,27,7,21,34
9071,-2.0777499999984164,3745.75,45,9,21,54
9072,-26.988749999997886,2927.7368421052633,39,8,26,47
9073,-28.532749999999403,1684.0,35,18,25,53
9074,-1.6674999999990647,2266.8333333333335,45,10,30,55
9075,1.6680000000037687,5393.888888888889,105,6,25,111
9076,-6.090499999998915,3076.3888888888887,48,10,19,58
9077,7.617750000001957,2727.823529411765,64,12,21,76
9078,21.539500000000384,3368.277777777778,53,16,16,69
9079,-8.275749999998652,1976.235294117647,31,9,21,40
9080,-35.00399999999949,2825.8333333333335,26,23,19,49
9081,-1.358499999998471,3179.4444444444443,58,10,22,68
9082,-37.74274999999907,2324.6315789473683,5,16,27,21
9083,-18.457499999999303,2561.1052631578946,33,21,15,54
9084,-5.223999999999042,3164.1,38,6,22,44
9085,-27.61024999999902,3063.15,29,18,25,47
9086,-11.548249999999474,3031.4210526315787,31,14,16,45
9087,-14.186249999999557,2609.95,13,14,24,27
9088,-46.16374999999972,2432.2,11,19,15,30
9089,-8.198499999999012,3026.1666666666665,39,8,22,47
9090,-15.21724999999889,2565.2631578947367,24,15,20,39
9091,5.962000000002155,4227.0,57,6,29,63
9092,-0.8907499999990112,4820.35,57,12,20,69
9093,12.965000000000419,3810.8947368421054,54,7,23,61
9094,11.42075000000076,3694.4444444444443,58,9,17,67
9095,-11.111749999998356,2459.0,30,9,29,39
9096,8.827500000001397,3969.6666666666665,60,8,16,68
9097,2.3710000000012394,3706.9444444444443,68,10,24,78
9098,-15.060749999998905,2648.3125,37,10,15,47
9099,-5.464249999999162,3687.2105263157896,59,14,16,73
9100,-24.305499999999892,3071.9444444444443,39,22,27,61
9101,-15.519249999998298,2949.222222222222,47,14,20,61
9102,-17.03924999999978,1429.0,43,13,21,56
9103,-10.245749999999207,3265.3684210526317,56,6,26,62
9104,-16.16574999999854,2178.823529411765,38,9,21,47
9105,-19.914749999998143,1617.5625,29,12,23,41
9106,-31.919499999999385,1539.0666666666666,22,9,23,31
9107,-37.44349999999882,3179.9,19,14,29,33
9108,29.57625000000284,6512.45,89,4,24,93
9109,-17.18574999999798,3345.5789473684213,47,13,15,60
9110,-25.747249999999873,2281.470588235294,18,11,27,29
9111,-5.031999999999373,3643.3333333333335,59,22,9,81
9112,-8.556249999998085,2593.470588235294,45,7,21,52
9113,-3.3819999999972135,3448.5,50,16,25,66
9114,-1.6824999999992662,3839.35,43,12,18,55
9115,-16.162249999997925,3738.157894736842,46,23,20,69
9116,-32.32099999999926,2568.684210526316,19,14,21,33
9117,-27.18999999999921,2414.0,25,11,19,36
9118,-24.66549999999948,2635.35,22,14,19,36
9119,-6.488749999998984,4243.3,47,6,26,53
9120,0.21450000000161246,2649.5,53,9,32,62
9121,-7.497999999997276,2676.777777777778,47,10,22,57
9122,13.207500000001627,3341.294117647059,62,9,24,71
9123,-16.395249999998352,2933.7368421052633,32,10,27,42
9124,0.18800000000126377,2673.277777777778,60,9,18,69
9125,4.220750000000356,3328.0,53,12,13,65
9126,-23.118500000000203,2118.0588235294117,19,6,40,25
9127,-24.64375000000062,2076.1176470588234,27,14,23,41
9128,-11.798249999999822,2989.684210526316,48,8,23,56
9129,13.297500000002017,4485.894736842105,78,13,23,91
9130,-18.222749999999287,3004.8888888888887,36,3,25,39
9131,-10.013749999998184,3855.9473684210525,40,16,21,56
9132,12.594500000000822,2541.375,56,9,21,65
9133,0.3825000000003868,2274.0,46,12,15,58
9134,3.5605000000013702,3829.0,47,8,18,55
9135,-28.738249999999102,2460.0526315789475,15,13,22,28
9136,-40.74699999999971,1778.235294117647,7,4,27,11
9137,-7.258749999999745,3415.684210526316,48,15,18,63
9138,-7.976749999999045,2559.4210526315787,27,13,21,40
9139,-13.739750000000033,2210.529411764706,40,11,19,51
9140,-4.832749999996745,3965.222222222222,66,9,30,75
9141,10.803250000001825,3471.3888888888887,51,6,23,57
9142,12.386000000000475,3600.222222222222,65,8,20,73
9143,-5.225249999998914,3202.235294117647,62,10,18,72
9144,-6.198749999999555,3935.3684210526317,58,17,17,75
9145,4.6120000000019985,1760.375,41,11,26,52
9146,-14.631999999999564,3445.8,32,12,17,44
9147,-0.6694999999992357,2613.0,43,10,22,53
9148,0.24950000000145228,2389.375,60,13,19,73
9149,-12.1762499999993,3387.0,22,5,26,27
9150,-24.87099999999895,3279.15,31,18,18,49
9151,-21.88624999999948,2176.0,19,9,25,28
9152,-23.927499999999576,2824.0,71,11,37,82
9153,-17.03674999999975,1705.875,47,24,14,71
9154,-15.363499999998899,2823.1666666666665,34,6,23,40
9155,-19.11774999999934,3199.2631578947367,55,10,26,65
9156,-11.741749999998492,2870.8333333333335,48,9,18,57
9157,-36.76949999999966,2182.3,15,9,19,24
9158,-14.609499999998722,2695.235294117647,39,11,25,50
9159,-21.26824999999929,1467.1333333333334,47,15,24,62
9160,-11.853999999997983,3611.157894736842,46,10,24,56
9161,-28.823499999999093,2020.7777777777778,26,6,24,32
9162,-12.078749999998967,3831.5,41,4,24,45
9163,-5.248999999999876,3175.0555555555557,46,6,27,52
9164,-12.167749999999325,3297.842105263158,24,10,24,34
9165,-5.147749999999225,2774.777777777778,53,4,19,57
9166,-5.1569999999985585,5673.5,60,5,21,65
9167,-13.645249999996944,2287.1176470588234,39,15,29,54
9168,-12.849999999998904,4121.9,40,6,15,46
9169,-6.397999999998442,2476.625,45,3,21,48
9170,-25.10874999999892,2362.157894736842,26,5,20,31
9171,-4.968999999998635,2434.0,52,13,20,65
9172,-9.159000000000555,2479.4117647058824,57,18,21,75
9173,-10.51749999999922,2954.764705882353,48,13,21,61
9174,-11.01575000000025,1476.6,39,16,19,55
9175,-12.909749999999752,3074.842105263158,30,9,22,39
9176,6.177750000001888,3869.4210526315787,53,14,29,67
9177,-0.5979999999971402,2131.176470588235,50,13,24,63
9178,-11.432749999998979,3431.6315789473683,49,7,23,56
9179,-22.29149999999965,2632.8947368421054,15,5,25,20
9180,21.19000000000315,3253.6470588235293,66,7,21,73
9181,-5.905749999997859,2687.5,44,23,17,67
9182,-15.108249999998488,3557.7368421052633,43,5,17,48
9183,-1.1434999999995352,3235.0555555555557,64,3,22,67
9184,0.6695000000005626,2223.6470588235293,63,7,22,70
9185,-9.788749999998789,3527.6315789473683,36,9,21,45
9186,3.0995000000012345,3473.222222222222,66,8,21,74
9187,-40.14024999999941,2548.85,9,10,29,19
9188,4.212500000000888,2925.0,46,12,21,58
9189,-20.982499999999785,2531.0,35,11,27,46
9190,-13.30224999999885,3087.3684210526317,37,9,14,46
9191,-28.500999999999287,2470.35,15,14,23,29
9192,-26.46574999999991,2026.421052631579,16,10,29,26
9193,-4.407999999999142,3098.4444444444443,37,9,18,46
9194,-17.750249999999312,3183.1111111111113,34,19,18,53
9195,-8.551749999999457,2764.0526315789475,49,13,19,62
9196,-21.10349999999931,2736.5263157894738,30,16,21,46
9197,-14.93624999999832,3332.2105263157896,37,12,24,49
9198,10.365499999999603,3050.8823529411766,59,19,13,78
9199,-0.6659999999977001,3642.842105263158,52,10,17,62
9200,-25.75349999999987,2762.4210526315787,28,20,12,48
9201,10.190000000000769,2767.0588235294117,64,13,14,77
9202,-8.68124999999976,2708.8947368421054,29,8,26,37
9203,-36.29924999999916,1481.9333333333334,22,15,27,37
9204,-36.934499999998565,2106.0,26,16,21,42
9205,-8.141249999998234,2217.75,47,13,17,60
9206,10.442000000002333,2825.0,62,5,18,67
9207,-43.559999999998965,1606.4117647058824,11,4,31,15
9208,-2.4942499999984253,1925.0625,37,18,19,55
9209,-2.0789999999984077,2782.6666666666665,44,10,26,54
9210,-1.220999999998268,2103.6875,65,10,41,75
9211,-7.772749999999232,3429.9473684210525,41,8,16,49
9212,20.58275000000092,3674.222222222222,67,5,20,72
9213,2.0682500000013997,2217.75,43,8,16,51
9214,-30.391499999999233,1867.5625,19,14,15,33
9215,-22.728999999999186,2113.470588235294,23,11,19,34
9216,8.799500000000943,4835.894736842105,67,10,26,77
9217,-32.60325000000017,1585.75,18,15,19,33
9218,13.959250000002442,3321.315789473684,58,7,15,65
9219,-0.8129999999994378,3465.0526315789475,39,19,17,58
9220,8.334000000000618,4286.2,50,7,17,57
9221,-26.74274999999944,2810.8947368421054,16,17,25,33
9222,-2.5484999999984956,3457.3888888888887,53,9,16,62
9223,-13.89599999999939,4033.0,40,8,21,48
9224,-17.9597499999984,2652.222222222222,35,9,22,44
9225,-21.53099999999974,2054.0625,46,11,28,57
9226,-18.234999999999758,1627.0,37,2,27,39
9227,1.8455000000010795,4508.4,37,15,17,52
9228,-9.44199999999957,3448.315789473684,59,4,28,63
9229,-12.3162499999988,2497.294117647059,31,14,18,45
9230,-9.604499999999108,2905.1666666666665,47,10,19,57
9231,-24.842499999999138,2433.823529411765,18,20,30,38
9232,-15.614249999998908,2212.4117647058824,34,5,19,39
9233,-3.8607499999999133,2675.0555555555557,21,9,32,30
9234,-9.546999999998373,2694.5555555555557,40,5,21,45
9235,0.19025000000247588,2501.3888888888887,45,16,13,61
9236,-10.547499999999172,3543.5263157894738,44,12,22,56
9237,-20.812250000000034,2476.777777777778,41,21,16,62
9238,0.6117500000006831,3083.277777777778,54,4,24,58
9239,-3.6764999999986636,2099.277777777778,36,12,16,48
9240,-2.293499999998945,3873.4736842105262,47,8,21,55
9241,-23.483999999998453,2408.529411764706,37,12,25,49
9242,-4.22549999999775,2255.4444444444443,39,8,24,47
9243,-11.35249999999774,3207.777777777778,47,2,28,49
9244,-28.95324999999865,3132.5263157894738,29,7,32,36
9245,10.239250000002162,2338.875,56,19,7,75
9246,11.99375000000243,2567.5,50,14,16,64
9247,-2.9144999999980192,2957.3333333333335,51,9,28,60
9248,-23.18799999999914,3271.1,30,7,29,37
9249,-25.39999999999825,2186.5555555555557,31,12,18,43
9250,-18.166499999999235,3128.95,30,7,17,37
9251,12.354750000001522,5073.45,68,11,26,79
9252,-10.009749999997961,3211.3333333333335,68,12,20,80
9253,-11.608499999998518,2885.777777777778,38,11,19,49
9254,-33.09425000000002,1567.9375,7,10,30,17
9255,-1.0277499999983317,4183.1,50,5,18,55
9256,0.1692500000012677,3517.3333333333335,53,8,24,61
9257,-4.475999999999309,3606.2105263157896,49,14,18,63
9258,-3.7822499999983705,4925.0,61,10,17,71
9259,-37.10899999999931,1606.4705882352941,11,5,27,16
9260,1.8800000000012105,3376.1666666666665,45,12,23,57
9261,3.8582500000011137,4524.25,58,9,13,67
9262,-29.672999999999558,2722.65,22,11,17,33
9263,-10.945499999999594,2641.9411764705883,36,4,23,40
9264,-12.233499999998958,3724.35,43,14,16,57
9265,-6.137249999998717,3136.684210526316,33,13,18,46
9266,-24.76049999999996,2460.8333333333335,41,13,15,54
9267,0.812250000003031,4084.0526315789475,59,8,24,67
9268,-9.562499999999172,3185.5,31,13,20,44
9269,-40.59749999999956,2772.7,13,6,25,19
9270,14.989750000001132,2917.5555555555557,54,11,16,65
9271,-2.1649999999983214,2046.2941176470588,70,16,15,86
9272,-6.311499999998726,2886.722222222222,36,9,20,45
9273,-29.97549999999986,1966.8823529411766,33,12,27,45
9274,-23.66899999999907,2721.1,20,11,23,31
9275,3.3420000000015313,2332.823529411765,49,5,20,54
9276,-20.37199999999897,3241.8947368421054,39,16,21,55
9277,-20.5047499999986,3933.6315789473683,40,8,19,48
9278,-8.707749999998128,2589.705882352941,47,19,18,66
9279,-14.300499999998388,3267.15,30,3,30,33
9280,-7.749750000000061,2849.176470588235,55,10,28,65
9281,-12.35974999999954,3222.6111111111113,49,15,25,64
9282,-13.215999999999056,2391.705882352941,41,16,18,57
9283,-15.098749999997676,2060.294117647059,35,12,22,47
9284,-42.59624999999912,3352.0,23,3,28,26
9285,-15.308499999999437,2239.625,35,16,17,51
9286,-13.41299999999946,2092.0,35,11,18,46
9287,-22.593749999999027,2437.9444444444443,18,10,28,28
9288,-22.4804999999994,3924.3,31,14,17,45
9289,-33.76574999999944,2258.8888888888887,20,8,39,28
9290,-26.652499999999726,2799.157894736842,36,8,28,44
9291,-13.499499999998923,2242.6875,27,3,29,30
9292,-3.263749999997883,4094.842105263158,54,8,31,62
9293,-18.251999999999633,2092.8823529411766,32,12,22,44
9294,-6.211749999999191,3358.6666666666665,51,12,22,63
9295,-24.251749999999436,3951.25,38,12,21,50
9296,-35.0187499999998,3815.6,31,11,18,42
9297,-20.885249999999527,2425.5,27,6,25,33
9298,-0.5659999999987615,4822.7,47,9,23,56
9299,-25.5912499999987,2677.1052631578946,30,8,20,38
9300,15.155750000000662,3713.0,55,12,25,67
9301,-22.03574999999939,3176.842105263158,44,9,23,53
9302,-4.283749999999962,2243.0,34,6,22,40
9303,-36.065249999999594,1429.0,12,7,32,19
9304,0.15750000000096734,2383.3529411764707,55,6,27,61
9305,-12.73974999999906,1429.0,24,4,22,28
9306,-13.352499999998845,3083.9473684210525,40,8,18,48
9307,-4.542499999998851,2679.5,39,13,25,52
9308,-20.731999999999452,2064.0588235294117,19,13,22,32
9309,-2.0764999999991205,2933.235294117647,60,10,27,70
9310,-37.40049999999944,2726.75,22,10,17,32
9311,-13.856999999998957,2304.125,51,4,24,55
9312,-0.2747499999985791,4779.1578947368425,68,11,17,79
9313,-6.427749999997656,3243.0,61,12,25,73
9314,-6.52199999999951,2190.0588235294117,35,12,25,47
9315,-0.35974999999915547,3343.0,40,15,16,55
9316,16.835500000001627,6216.4,71,16,16,87
9317,-8.181999999998258,3245.6666666666665,49,5,17,54
9318,9.701000000001594,3160.1666666666665,51,17,12,68
9319,-5.451499999999504,3161.684210526316,35,12,29,47
9320,-1.952999999999745,2161.125,61,16,27,77
9321,-7.627249999999681,2171.5555555555557,29,8,18,37
9322,-15.486749999998855,3363.8947368421054,40,11,16,51
9323,-30.9584999999994,2775.15,19,13,22,32
9324,-33.80624999999938,3025.8,26,5,24,31
9325,7.126000000001907,4438.210526315789,62,11,19,73
9326,-10.957999999998702,3835.4,41,8,26,49
9327,-19.78474999999925,3281.2105263157896,50,6,35,56
9328,-21.87899999999846,2445.8333333333335,29,7,23,36
9329,-25.431499999998515,4346.421052631579,63,11,22,74
9330,-3.0572499999992937,3386.95,33,6,16,39
9331,-13.917499999998778,2416.125,48,6,27,54
9332,-26.356499999998885,1946.2941176470588,31,11,23,42
9333,10.050750000001887,4579.1,62,13,17,75
9334,-10.634249999999309,1835.8125,37,11,25,48
9335,-27.67625000000004,2568.3888888888887,36,11,26,47
9336,-21.78599999999849,2453.315789473684,25,7,28,32
9337,6.477000000002407,3227.0555555555557,55,11,19,66
9338,-20.93249999999866,3617.1052631578946,33,7,35,40
9339,-8.874249999999284,2779.1666666666665,35,17,18,52
9340,-33.73649999999891,2151.684210526316,13,1,39,14
9341,-8.009499999997939,2315.294117647059,49,13,26,62
9342,15.73450000000087,5533.0,62,13,12,75
9343,-19.84799999999826,2527.6315789473683,31,6,24,37
9344,-15.318249999998793,3775.9,41,26,18,67
9345,-6.570499999998174,2978.7368421052633,31,15,28,46
9346,-34.077749999999625,2660.5263157894738,25,10,20,35
9347,-20.12324999999986,2618.6111111111113,33,11,24,44
9348,-8.292999999997315,2920.235294117647,57,14,24,71
9349,-13.488749999998845,2526.1176470588234,44,6,41,50
9350,-12.567999999998841,3223.5789473684213,31,11,31,42
9351,11.29300000000152,4935.368421052632,65,14,22,79
9352,-33.132999999999456,2034.0,14,17,28,31
9353,-24.242499999997836,3093.823529411765,39,3,30,42
9354,-22.309249999999377,3143.25,30,9,22,39
9355,-13.951750000000178,2685.6666666666665,40,6,19,46
9356,-11.88099999999918,4606.894736842105,62,15,17,77
9357,-36.63875000000015,1610.1764705882354,12,6,32,18
9358,0.28825000000071677,4054.0526315789475,45,9,18,54
9359,-10.172749999998723,3004.9444444444443,42,13,20,55
9360,3.325499999999972,1938.0,66,29,15,95
9361,-17.865499999999624,2849.6666666666665,50,19,22,69
9362,-12.30274999999909,3896.4,42,10,16,52
9363,-45.835249999999014,2600.315789473684,13,6,36,19
9364,-12.354499999999442,2534.529411764706,42,11,23,53
9365,-8.99974999999897,3331.2631578947367,52,3,16,55
9366,-4.467749999999108,3343.0,33,8,20,41
9367,-26.12224999999936,2465.1666666666665,18,9,30,27
9368,9.276250000001664,4431.631578947368,88,18,21,106
9369,-29.6992500000001,2114.157894736842,15,1,31,16
9370,-29.60324999999957,2513.4736842105262,16,10,26,26
9371,-30.243249999999886,1959.578947368421,16,10,23,26
9372,-27.832999999998872,2927.5,27,8,24,35
9373,-18.755250000000085,2997.157894736842,35,16,22,51
9374,-13.02474999999895,3519.55,32,17,15,49
9375,-23.525499999998875,3207.684210526316,37,3,26,40
9376,3.2730000000008204,1962.4666666666667,61,8,13,69
9377,-12.464000000000182,2563.9444444444443,47,16,21,63
9378,-4.991749999998685,2354.294117647059,34,9,23,43
9379,1.7680000000004958,3027.2631578947367,38,9,24,47
9380,-12.463749999998317,1606.4705882352941,23,11,28,34
9381,-6.113499999999012,3829.2631578947367,46,6,21,52
9382,-32.91975000000029,2347.2105263157896,21,5,32,26
9383,0.1705000000012072,4572.8421052631575,73,8,21,81
9384,-26.645999999998832,3005.0,37,5,38,42
9385,-18.370749999999642,2671.6111111111113,38,3,29,41
9386,-11.886499999999181,3708.5,29,11,20,40
9387,-10.021249999998902,1429.0,54,21,19,75
9388,-22.975999999999424,2940.1,20,13,20,33
9389,-9.374249999999432,2918.4444444444443,36,13,25,49
9390,-11.026749999999291,4980.7,46,10,26,56
9391,-13.922250000000096,3079.9444444444443,41,22,29,63
9392,-10.123499999999211,2665.4736842105262,33,5,23,38
9393,-2.741749999998099,2076.875,45,8,19,53
9394,-17.527749999999337,1924.764705882353,31,9,27,40
9395,-26.667249999998905,3132.5263157894738,29,21,16,50
9396,-18.79974999999923,2616.0555555555557,27,12,28,39
9397,-11.011999999997839,2795.0555555555557,40,13,21,53
9398,-27.23599999999817,1862.235294117647,37,11,28,48
9399,-30.605249999998904,2622.222222222222,31,27,19,58
9400,-26.10899999999927,2173.176470588235,21,16,18,37
9401,-33.12524999999909,2649.6,17,10,24,27
9402,-12.170499999999501,2284.25,35,8,21,43
9403,-30.471249999999696,1429.0,20,9,27,29
9404,-14.559249999998325,4274.35,45,4,18,49
9405,-19.526249999999123,2072.777777777778,20,15,22,35
9406,-28.501999999999935,2214.777777777778,34,8,28,42
9407,14.007250000001966,4936.2,64,14,17,78
9408,20.74375000000054,3962.842105263158,63,16,18,79
9409,-34.06649999999982,2087.3684210526317,8,4,30,12
9410,11.070750000002102,3120.0,52,7,18,59
9411,-17.072749999999903,1746.5,20,9,23,29
9412,-2.0627499999984567,2603.5882352941176,43,9,16,52
9413,-20.487250000000355,2131.9444444444443,39,18,19,57
9414,-8.484249999998934,3325.5263157894738,34,7,29,41
9415,-20.01799999999931,2036.125,39,28,19,67
9416,-9.897749999999728,1964.75,32,12,27,44
9417,-43.806999999999434,1528.25,12,8,21,20
9418,-13.464499999998807,1671.125,30,12,15,42
9419,-16.01649999999922,1849.6875,26,12,18,38
9420,-21.094499999999382,3091.7,31,15,12,46
9421,-4.386999999997258,2707.294117647059,57,11,27,68
9422,7.844000000001593,3922.8888888888887,64,20,18,84
9423,-14.75024999999764,2103.777777777778,45,7,21,52
9424,-20.19549999999937,2433.5,37,6,26,43
9425,-34.839749999999995,2718.9473684210525,15,9,29,24
9426,-7.113749999999615,2527.25,47,17,16,64
9427,-20.741999999999404,3377.4,30,10,24,40
9428,13.79825000000065,2727.8823529411766,64,10,16,74
9429,-3.3589999999990687,3659.684210526316,44,4,37,48
9430,-0.13599999999921436,4251.3,54,7,15,61
9431,14.461000000002766,4378.210526315789,75,13,19,88
9432,-9.926250000000021,2034.235294117647,39,10,18,49
9433,-27.111249999999234,2578.0555555555557,25,14,20,39
9434,-19.34274999999927,2385.8888888888887,28,8,27,36
9435,-24.66899999999874,2272.0,23,16,16,39
9436,-25.191249999999336,2966.2105263157896,22,16,31,38
9437,-18.156499999998584,2067.9375,40,4,25,44
9438,-21.43224999999949,1448.0666666666666,24,5,22,29
9439,30.725750000000893,5681.45,71,4,27,75
9440,-40.81899999999911,2546.842105263158,20,7,30,27
9441,-20.82574999999933,2870.0,32,7,24,39
9442,-12.672999999998815,3374.8823529411766,48,8,19,56
9443,-21.22099999999962,2105.9411764705883,27,6,28,33
9444,-3.653999999998999,2375.5625,61,9,13,70
9445,-14.07849999999878,1719.75,31,10,22,41
9446,-11.932249999998454,3088.6666666666665,47,20,18,67
9447,-16.722749999999923,2672.705882352941,28,12,24,40
9448,-24.41149999999937,2945.8888888888887,29,5,37,34
9449,-27.29974999999977,2055.529411764706,37,6,22,43
9450,-15.77449999999836,2601.823529411765,43,12,30,55
9451,3.057250000000775,2319.9375,51,21,16,72
9452,-25.748749999998857,2873.5,24,19,14,43
9453,-29.76250000000009,1764.0,15,15,20,30
9454,-29.416249999999224,3698.95,35,11,20,46
9455,-5.211749999998441,2500.5625,48,10,13,58
9456,-2.6454999999983,2941.3888888888887,41,12,23,53
9457,-14.680999999998713,3631.45,44,1,24,45
9458,-22.715999999999124,2366.4210526315787,23,20,14,43
9459,-16.89699999999885,3183.15,40,13,11,53
9460,-9.18824999999868,2341.235294117647,58,14,27,72
9461,-33.98424999999988,1550.0625,15,12,15,27
9462,-36.894249999999666,2297.9473684210525,8,11,27,19
9463,-33.00924999999878,1707.3529411764705,22,12,26,34
9464,35.02050000000269,4952.105263157895,90,12,22,102
9465,-21.38774999999875,3008.55,31,13,15,44
9466,-17.300749999998175,2178.9375,44,16,16,60
9467,-17.604999999998466,2765.0555555555557,39,16,13,55
9468,-15.839249999999609,2548.0,36,10,27,46
9469,-25.491999999999102,1946.9375,31,16,19,47
9470,1.7492500000010818,1973.6875,50,8,22,58
9471,14.63875000000193,2237.5625,74,16,15,90
9472,-12.425499999998408,3089.9473684210525,42,4,20,46
9473,4.433750000002238,2977.6666666666665,44,14,21,58
9474,-11.401499999998624,2708.6666666666665,38,10,17,48
9475,-3.5094999999984267,2416.1875,52,8,24,60
9476,-14.275499999999468,3762.4,28,13,24,41
9477,-21.358749999999457,3747.45,27,7,28,34
9478,-3.140499999998005,2153.25,44,11,15,55
9479,-10.5812499999991,2493.4736842105262,31,16,12,47
9480,-2.3297499999995335,2651.315789473684,40,8,23,48
9481,-1.868749999998963,2526.176470588235,57,5,19,62
9482,-30.044499999998454,2378.777777777778,20,13,34,33
9483,-42.013999999998546,2869.8888888888887,35,7,26,42
9484,-12.238749999998685,2715.684210526316,32,15,13,47
9485,-2.62799999999829,2738.0588235294117,44,10,22,54
9486,-26.474499999998805,2675.5263157894738,23,11,25,34
9487,-18.10549999999921,2954.5789473684213,36,13,23,49
9488,-44.173250000000095,1429.0,9,15,30,24
9489,-13.323749999999517,2505.8333333333335,34,4,23,38
9490,-1.9702499999978973,4607.65,62,9,19,71
9491,-36.766749999999405,2621.2105263157896,21,11,24,32
9492,38.180250000002,3156.470588235294,87,5,17,92
9493,-23.139500000000172,1984.5555555555557,26,13,25,39
9494,2.547000000000892,2543.0,66,17,19,83
9495,2.3487500000012136,2450.529411764706,49,6,25,55
9496,-28.946999999999587,2210.529411764706,30,15,25,45
9497,-9.349749999999167,2366.529411764706,31,6,28,37
9498,-20.919749999999016,3033.0,27,7,24,34
9499,-7.596499999999109,3905.315789473684,53,19,17,72
9500,-24.023749999998778,3946.5,39,8,20,47
9501,-31.652249999999196,2270.2631578947367,10,17,25,27
9502,-23.490749999998577,2467.294117647059,36,11,22,47
9503,-30.279999999998914,2726.65,24,3,25,27
9504,6.365000000001395,2415.125,60,16,18,76
9505,-6.04399999999916,2774.722222222222,52,16,21,68
9506,-12.109499999998786,2789.722222222222,32,17,17,49
9507,6.955500000000785,3022.0,41,8,26,49
9508,-19.52074999999829,2515.9473684210525,34,13,19,47
9509,-15.644499999999109,2729.1,23,11,18,34
9510,-6.752249999997604,3903.6315789473683,55,9,22,64
9511,-16.450499999999167,3810.9,34,12,21,46
9512,-10.379999999999526,2378.8333333333335,51,16,19,67
9513,-1.7332499999982953,4223.5,42,15,22,57
9514,-16.11199999999944,2021.9411764705883,25,9,22,34
9515,-28.996750000000162,2164.5,25,12,25,37
9516,-9.18324999999906,1929.5882352941176,42,12,25,54
9517,-10.821749999999806,2631.0555555555557,40,12,17,52
9518,-8.217749999997986,3129.4117647058824,56,7,21,63
9519,-21.57899999999828,2730.7368421052633,19,5,38,24
9520,-23.33249999999932,2385.8888888888887,38,24,13,62
9521,-8.112499999998903,2066.823529411765,31,11,18,42
9522,1.6880000000016804,2908.1176470588234,48,15,16,63
9523,11.867250000002091,3485.1052631578946,55,9,23,64
9524,-18.08149999999953,2841.722222222222,36,5,17,41
9525,9.030250000000699,2670.1875,51,16,12,67
9526,-25.246999999999296,3083.05,24,5,26,29
9527,-34.85349999999968,3059.7894736842104,26,5,38,31
9528,-12.951999999999382,3322.157894736842,45,15,17,60
9529,-20.15299999999923,2416.8823529411766,26,9,17,35
9530,-8.034499999998731,2225.529411764706,36,13,21,49
9531,-7.257749999998606,3076.7,32,7,25,39
9532,-25.61749999999916,2036.7222222222222,16,4,44,20
9533,-10.572249999999425,3319.6315789473683,39,7,17,46
9534,-0.3894999999967723,3119.0588235294117,57,13,24,70
9535,-3.193499999998662,3121.6315789473683,41,11,19,52
9536,-3.6354999999993907,2080.764705882353,48,9,25,57
9537,-7.35224999999687,2542.8333333333335,51,6,27,57
9538,-34.09025000000001,2133.05,10,13,14,23
9539,-16.771249999999664,3424.7894736842104,38,12,23,50
9540,-14.901749999998193,3722.315789473684,47,5,27,52
9541,-21.40424999999845,1715.7058823529412,31,5,24,36
9542,-11.742249999998984,2543.6666666666665,29,11,21,40
9543,9.731750000002144,1528.25,44,13,14,57
9544,-18.77049999999919,2348.6875,39,17,19,56
9545,-13.658249999997953,2512.7894736842104,32,11,26,43
9546,-1.5017499999983857,2406.1111111111113,42,6,25,48
9547,-15.727499999999617,3115.7368421052633,39,16,24,55
9548,-38.63149999999861,2147.1176470588234,20,12,41,32
9549,-14.088999999999933,1902.25,58,20,29,78
9550,0.7170000000028873,2228.3529411764707,48,6,33,54
9551,1.6995000000000438,3413.1111111111113,59,6,28,65
9552,0.16450000000061565,2338.222222222222,44,13,17,57
9553,-4.102999999998801,3151.7894736842104,34,0,22,34
9554,-9.03174999999831,3546.0526315789475,46,23,10,69
9555,-9.280249999998667,2501.3888888888887,32,17,17,49
9556,-0.6422499999993022,3185.1052631578946,40,4,24,44
9557,-38.341749999999124,2218.5263157894738,11,2,35,13
9558,-44.743249999999186,1643.8235294117646,16,9,25,25
9559,1.4630000000014425,4880.65,47,10,20,57
9560,-4.942749999997721,2736.3529411764707,68,4,32,72
9561,-28.572500000000353,2210.529411764706,29,17,24,46
9562,0.8145000000021747,2140.375,49,8,25,57
9563,-0.9444999999971678,1528.25,45,12,21,57
9564,-4.417499999998715,2990.235294117647,69,10,16,79
9565,-8.966749999998745,2970.6470588235293,45,13,15,58
9566,-1.3769999999984637,4173.65,42,8,23,50
9567,-11.423499999998665,3818.4210526315787,48,10,22,58
9568,22.390250000003366,2295.0555555555557,68,5,19,73
9569,-25.79699999999999,2022.3157894736842,15,13,29,28
9570,5.141500000001271,3490.722222222222,48,12,18,60
9571,-29.800499999999637,1429.0,16,7,28,23
9572,0.40975000000147394,2624.0555555555557,39,7,25,46
9573,-21.008249999998252,2688.6470588235293,45,19,22,64
9574,-4.252999999997954,4783.95,60,7,21,67
9575,-14.376499999999618,2063.8823529411766,23,17,13,40
9576,-1.9522499999989278,3470.8947368421054,60,14,14,74
9577,7.320000000000706,2156.4117647058824,40,10,14,50
9578,-5.114749999999448,2425.5555555555557,47,20,18,67
9579,-6.608499999997373,3049.0555555555557,53,2,26,55
9580,-5.380749999996935,3009.8823529411766,46,3,41,49
9581,-13.074499999999546,2131.8333333333335,29,11,27,40
9582,-0.8512499999984373,3088.722222222222,43,5,16,48
9583,-20.80374999999894,3521.9,31,14,19,45
9584,-10.498249999999144,3114.4117647058824,44,12,22,56
9585,-18.141249999998664,2143.3125,41,6,21,47
9586,-16.450999999999517,2994.6315789473683,22,7,26,29
9587,-14.18574999999839,3738.2631578947367,45,6,23,51
9588,-21.78374999999964,2855.25,23,7,22,30
9589,-15.123499999999883,2004.578947368421,13,15,33,28
9590,-30.86049999999991,2578.1111111111113,33,12,23,45
9591,-24.472999999999345,2588.65,20,11,16,31
9592,-22.75574999999942,1885.4375,29,11,16,40
9593,-14.75649999999828,2287.176470588235,30,8,25,38
9594,-21.040249999998192,3683.0,43,14,19,57
9595,-3.3537499999989797,2942.1052631578946,31,18,13,49
9596,-14.049000000000248,1505.4375,27,12,13,39
9597,-13.183749999999218,2905.277777777778,33,9,24,42
9598,-25.440249999998535,3308.5,25,13,26,38
9599,0.7375000000011266,3370.35,43,6,14,49
9600,-11.494249999998981,3010.1111111111113,44,13,16,57
9601,-1.0694999999992008,3726.4736842105262,43,10,31,53
9602,-6.054499999997155,3207.8888888888887,59,4,25,63
9603,4.397500000001299,3655.25,40,14,17,54
9604,-15.393749999998843,3144.9,32,11,17,43
9605,-38.98674999999939,1534.5294117647059,13,19,18,32
9606,2.8632500000011563,1429.0,43,25,21,68
9607,-8.97974999999872,3847.6315789473683,44,20,17,64
9608,-8.726499999999215,2627.842105263158,27,10,20,37
9609,-4.567749999998222,2631.6470588235293,38,10,19,48
9610,-21.549499999999497,1996.9444444444443,35,14,19,49
9611,-25.280249999999363,2100.3529411764707,34,15,25,49
9612,-29.266249999999026,2416.6666666666665,25,16,26,41
9613,-0.0707499999984682,2295.6470588235293,32,14,21,46
9614,-10.382249999998445,4541.0,50,15,19,65
9615,-18.94699999999957,2592.222222222222,38,5,26,43
9616,-16.001249999998812,3204.5,31,14,21,45
9617,1.06950000000083,3851.0526315789475,58,5,20,63
9618,-14.620749999999077,4035.4,47,10,18,57
9619,-6.6549999999994025,2017.3125,36,14,13,50
9620,-24.891499999998565,2430.0,20,6,40,26
9621,-13.409499999999241,2805.0,33,8,16,41
9622,-21.8272499999989,2537.1875,37,18,14,55
9623,-7.30274999999839,1429.0,33,13,27,46
9624,1.745000000000712,3215.2631578947367,51,10,25,61
9625,-6.420499999998422,2394.375,40,15,10,55
9626,-18.092999999999336,2500.5,36,11,23,47
9627,-1.9852499999991107,3444.1176470588234,76,13,19,89
9628,-35.16874999999945,2142.6,12,13,17,25
9629,-27.45949999999932,2878.5789473684213,23,7,30,30
9630,-10.674499999999274,3020.5263157894738,30,9,23,39
9631,-3.7877499999989004,2871.0,35,3,26,38
9632,-6.023249999999501,2092.222222222222,31,10,23,41
9633,-12.007499999999215,2706.3684210526317,31,16,13,47
9634,5.198000000000147,2873.4444444444443,66,12,31,78
9635,7.799750000001671,3515.1052631578946,57,10,15,67
9636,-35.51949999999969,2885.1052631578946,23,13,23,36
9637,-21.242249999999565,2713.0588235294117,35,12,20,47
9638,2.023250000001506,2321.6470588235293,42,11,16,53
9639,13.00325000000178,4644.25,61,5,16,66
9640,17.411000000001625,2963.235294117647,49,10,21,59
9641,-16.17899999999924,2760.7368421052633,32,18,17,50
9642,-24.427499999998886,2786.95,24,16,18,40
9643,-14.792749999999549,3952.0526315789475,42,16,16,58
9644,-24.051749999999355,2693.35,19,9,26,28
9645,-17.915249999998455,2339.684210526316,29,17,16,46
9646,-0.4512499999983358,3568.6315789473683,73,14,13,87
9647,3.0005000000013426,4482.25,43,9,20,52
9648,-6.8322499999993465,3337.157894736842,46,17,15,63
9649,-16.99149999999926,2719.6,21,13,19,34
9650,-15.402249999998745,3050.5789473684213,38,9,20,47
9651,-24.779249999999788,2857.6666666666665,28,25,16,53
9652,-20.069999999999126,2093.9411764705883,24,10,22,34
9653,-4.656999999999417,3205.0526315789475,38,16,17,54
9654,-6.132749999998129,3063.0,44,20,18,64
9655,-22.730749999999293,2202.176470588235,42,23,13,65
9656,-6.899999999999153,2484.1176470588234,55,13,19,68
9657,-9.533499999997876,2464.3888888888887,36,7,29,43
9658,-1.1284999999975462,2703.222222222222,61,8,28,69
9659,2.643250000002992,2153.3125,56,12,20,68
9660,-18.281249999998757,4241.0,40,12,16,52
9661,6.375750000001097,4949.421052631579,70,15,13,85
9662,-30.02199999999965,2591.2105263157896,16,9,28,25
9663,-25.959999999998814,2423.470588235294,29,7,23,36
9664,-20.637999999998755,4477.5,55,7,20,62
9665,-30.410999999999508,2139.777777777778,19,12,23,31
9666,-9.028249999999524,1496.5,32,10,26,42
9667,-11.464999999998808,2568.1176470588234,48,1,41,49
9668,-0.10699999999905216,2952.0,31,16,18,47
9669,11.867250000003251,4783.315789473684,69,10,16,79
9670,-5.912749999999028,2704.6315789473683,29,11,18,40
9671,-8.222499999998654,4059.7368421052633,60,24,13,84
9672,2.430250000001363,4133.315789473684,54,11,20,65
9673,-14.59174999999912,4377.45,44,7,18,51
9674,-17.26924999999852,3431.722222222222,54,7,18,61
9675,4.114750000002265,3490.1052631578946,54,5,18,59
9676,-7.815999999999444,2618.705882352941,42,10,26,52
9677,-32.71224999999924,1809.0,26,6,41,32
9678,-14.18774999999864,3794.2,37,4,23,41
9679,0.8097500000020424,3258.8888888888887,60,14,19,74
9680,-27.56199999999946,1760.5294117647059,13,14,21,27
9681,-7.69499999999977,2170.0625,66,22,20,88
9682,-4.658749999997791,3333.7894736842104,50,6,25,56
9683,-33.505499999999195,1606.4705882352941,18,13,14,31
9684,32.90225000000271,5001.35,69,9,16,78
9685,-21.68899999999956,2663.722222222222,42,13,15,55
9686,-15.971249999999056,2489.1111111111113,30,8,20,38
9687,-21.471749999999112,2731.5,25,13,20,38
9688,-13.554999999998861,3168.4210526315787,40,10,15,50
9689,-18.25574999999862,2982.1052631578946,34,7,28,41
9690,-11.172249999998872,3671.2631578947367,50,9,18,59
9691,8.95425000000392,3612.6111111111113,69,11,25,80
9692,-14.155499999999563,2433.705882352941,43,15,20,58
9693,20.23975000000246,5500.9473684210525,90,8,17,98
9694,-9.54549999999916,4235.5,56,4,16,60
9695,-19.20050000000021,1947.0,45,8,26,53
9696,-29.717249999998206,2694.5555555555557,24,21,26,45
9697,-8.044499999999665,2420.705882352941,37,18,21,55
9698,13.051000000002054,2818.0,71,15,14,86
9699,-1.0997499999996794,2181.5882352941176,33,8,25,41
9700,-23.19599999999948,2457.222222222222,28,11,19,39
9701,-18.234749999998865,2138.764705882353,31,10,17,41
9702,-2.925249999999238,3410.684210526316,47,4,29,51
9703,-16.317999999998808,2667.157894736842,28,10,22,38
9704,-4.639749999996352,2902.5882352941176,69,19,11,88
9705,-0.24499999999935868,3385.5789473684213,40,11,15,51
9706,-37.409999999999584,3198.5263157894738,39,9,25,48
9707,20.80375000000071,3629.1666666666665,62,9,18,71
9708,-8.993749999999483,2750.8888888888887,43,1,25,44
9709,-22.518249999999092,2750.5,23,10,26,33
9710,8.617750000000392,4309.578947368421,64,6,17,70
9711,-4.846249999999243,3667.1111111111113,56,10,19,66
9712,-29.59999999999976,3438.2631578947367,34,7,22,41
9713,-19.07099999999837,3494.1052631578946,42,14,18,56
9714,-27.440999999999843,2195.3888888888887,14,6,22,20
9715,-7.132499999998968,2637.1666666666665,39,14,30,53
9716,-0.09924999999867348,3683.05,46,8,14,54
9717,-23.711249999999524,3397.222222222222,36,10,20,46
9718,-16.038249999998747,3796.65,45,9,16,54
9719,-17.812999999999388,3083.05,24,8,23,32
9720,-23.431249999999373,3380.6315789473683,34,3,24,37
9721,2.1387500000021595,4198.95,58,5,20,63
9722,-14.352749999998725,3794.2105263157896,44,7,25,51
9723,-18.994499999999444,2612.35,25,8,16,33
9724,-18.467749999998976,1960.8125,38,7,38,45
9725,-21.478749999998968,3557.55,31,15,21,46
9726,-18.442249999999095,3659.15,31,5,25,36
9727,-20.313499999999152,2560.5,29,10,32,39
9728,8.730750000000517,2285.1875,51,12,15,63
9729,-38.70124999999898,1837.0588235294117,13,17,29,30
9730,-13.887749999999254,3054.4,29,14,18,43
9731,-15.030249999999208,3794.157894736842,35,14,28,49
9732,-0.19699999999906465,2742.764705882353,54,7,27,61
9733,-8.10074999999879,2911.1052631578946,35,10,21,45
9734,-17.163249999999046,2318.0,28,13,25,41
9735,-14.783999999999025,3490.0,31,13,22,44
9736,-19.383249999999663,2508.4210526315787,20,6,33,26
9737,-14.607499999998932,3872.75,35,12,20,47
9738,-7.408749999999041,2619.5,40,9,24,49
9739,10.261500000002346,3247.3333333333335,50,7,27,57
9740,-9.594249999999072,2882.823529411765,48,8,21,56
9741,-3.8287499999990153,3290.95,36,9,24,45
9742,-16.638249999999225,2110.6470588235293,23,13,19,36
9743,-20.631499999999267,2433.6470588235293,30,7,28,37
9744,-25.815249999999356,2901.6666666666665,32,9,25,41
9745,1.0087500000020548,2590.75,45,8,22,53
9746,2.6325000000019125,4328.0,49,11,25,60
9747,-8.900249999999007,2383.294117647059,43,16,19,59
9748,16.03950000000298,4553.526315789473,74,12,21,86
9749,8.791000000001642,3494.315789473684,45,7,20,52
9750,-5.028249999998364,2559.0,53,8,21,61
9751,-24.511999999998487,3572.7894736842104,33,4,29,37
9752,-9.064249999998427,1581.235294117647,28,16,23,44
9753,-10.761499999997904,3595.315789473684,50,5,24,55
9754,-21.761749999999342,2250.0555555555557,17,11,21,28
9755,-40.52899999999936,2237.05,10,10,24,20
9756,37.59750000000386,3516.3888888888887,83,13,15,96
9757,0.2020000000011768,2692.722222222222,50,15,18,65
9758,-4.042749999999887,3279.4736842105262,60,11,17,71
9759,-28.582749999999532,2560.5,22,16,23,38
9760,-29.726249999999386,2584.222222222222,26,6,23,32
9761,-2.6484999999984575,4184.6,55,2,26,57
9762,-26.960000000000377,1429.0,17,4,34,21
9763,-5.6917499999981285,3198.5263157894738,43,13,22,56
9764,-20.737499999998807,3147.777777777778,40,17,17,57
9765,-13.622999999998532,2208.6111111111113,31,6,23,37
9766,-15.69974999999894,2482.0,19,12,26,31
9767,-9.794749999999173,3790.15,40,6,18,46
9768,6.916000000000854,4092.3684210526317,40,6,19,46
9769,-30.874749999999445,2249.4210526315787,9,5,27,14
9770,-9.32049999999963,3036.722222222222,33,12,21,45
9771,-30.7552499999994,2560.0,23,10,22,33
9772,-38.24724999999948,2159.2105263157896,9,11,27,20
9773,-13.197999999998794,3626.7,34,4,26,38
9774,-23.180999999998438,3649.6315789473683,42,7,26,49
9775,2.046750000001692,2349.6470588235293,54,10,23,64
9776,-12.704249999999039,2798.3888888888887,32,6,23,38
9777,-19.258999999999155,2572.75,25,8,18,33
9778,-32.37124999999879,1603.625,18,6,37,24
9779,6.134750000001828,2338.1666666666665,44,10,20,54
9780,-18.938749999999708,2278.222222222222,32,16,19,48
9781,-6.589999999997143,2539.294117647059,56,7,22,63
9782,-26.77474999999945,3137.4210526315787,33,10,26,43
9783,-11.945499999998999,4242.65,45,17,14,62
9784,-7.439249999998822,3611.65,38,9,20,47
9785,-16.094999999999278,3314.5263157894738,30,6,23,36
9786,5.655750000000453,2870.0,60,13,17,73
9787,10.682750000002784,5257.7,67,10,23,77
9788,-3.070499999999981,2198.4117647058824,56,13,21,69
9789,-20.091999999998315,4015.5,39,6,32,45
9790,-11.88050000000003,2369.9444444444443,40,7,25,47
9791,-14.972749999999143,2133.5,34,9,25,43
9792,-32.12099999999968,1909.611111111111,28,16,22,44
9793,-3.767999999998586,4267.8421052631575,80,11,21,91
9794,14.28225000000173,2963.176470588235,55,7,19,62
9795,-32.1329999999993,2697.4,20,9,22,29
9796,-14.169249999999158,2152.25,38,10,22,48
9797,-19.560249999999474,2548.4736842105262,24,12,18,36
9798,-29.02324999999837,2277.3333333333335,32,17,24,49
9799,-29.424499999999615,1539.0666666666666,22,16,18,38
9800,-3.057999999999251,3143.277777777778,45,19,18,64
9801,15.764750000001243,4921.1,59,6,21,65
9802,-15.953249999998476,2876.294117647059,46,8,30,54
9803,-27.10449999999952,2568.6315789473683,20,8,35,28
9804,-2.862499999999538,2949.3333333333335,55,7,28,62
9805,-24.574999999999406,2120.0588235294117,22,14,17,36
9806,-4.481500000000187,2054.1875,38,12,25,50
9807,-1.7184999999979447,4997.210526315789,62,20,26,82
9808,-20.87799999999872,3084.7894736842104,36,10,21,46
9809,-33.0005000000001,1429.0,11,10,23,21
9810,-33.94899999999902,2968.7368421052633,26,15,19,41
9811,-45.098250000000334,1429.0,11,8,30,19
9812,-5.2812499999990035,3049.842105263158,34,4,24,38
9813,-33.258999999999425,2390.6315789473683,11,7,30,18
9814,-1.4724999999981767,2603.6875,52,13,15,65
9815,1.0180000000008746,3670.4736842105262,59,13,19,72
9816,-12.460749999998791,2513.0588235294117,49,23,15,72
9817,-14.186999999998,3347.2105263157896,33,6,33,39
9818,-10.924249999998674,2692.8333333333335,42,14,19,56
9819,-6.614249999998276,3320.5555555555557,49,8,23,57
9820,-2.1509999999990965,2722.6666666666665,48,10,22,58
9821,2.572500000000935,3009.7894736842104,40,11,15,51
9822,-4.785249999998469,2787.1111111111113,39,13,17,52
9823,4.622750000002069,3210.3888888888887,48,8,24,56
9824,-38.205250000000056,1429.0,9,10,18,19
9825,-14.537749999998486,3286.25,36,8,21,44
9826,-11.189249999999436,2533.5263157894738,25,4,24,29
9827,0.23500000000173724,3651.35,35,5,26,40
9828,18.996000000002105,6047.35,69,10,22,79
9829,7.76775000000182,2314.125,45,9,19,54
9830,9.242750000002415,3322.705882352941,59,11,15,70
9831,-18.451499999999076,3257.0,28,14,13,42
9832,2.0072500000003948,4832.25,58,12,16,70
9833,-3.206749999997199,3410.684210526316,59,12,18,71
9834,-0.33624999999917937,3312.842105263158,44,2,27,46
9835,-31.756999999998982,2446.764705882353,29,6,18,35
9836,-41.95549999999984,1496.5,8,12,30,20
9837,-13.744749999997953,3790.8947368421054,38,7,21,45
9838,3.901750000001056,5584.6,61,5,18,66
9839,0.6487500000021125,4722.75,59,6,23,65
9840,-1.8432499999991592,3485.9473684210525,46,12,23,58
9841,-2.146999999998654,4501.2,45,13,18,58
9842,-8.856999999999871,2100.1111111111113,28,11,22,39
9843,-20.42649999999985,1429.0,29,16,20,45
9844,-12.053249999998586,3762.4736842105262,42,13,24,55
9845,-17.267499999997973,3301.157894736842,43,9,20,52
9846,-4.693249999999529,3550.5,34,8,18,42
9847,-27.51075000000002,2607.0,20,6,24,26
9848,-22.98799999999826,2506.6666666666665,33,19,19,52
9849,-40.09824999999946,2117.4736842105262,14,12,35,26
9850,-17.098999999999496,2113.529411764706,33,19,33,52
9851,-17.274749999999806,2036.125,32,8,24,40
9852,-10.045749999998742,5059.2,41,15,23,56
9853,-21.71174999999882,2764.0526315789475,20,11,32,31
9854,4.3685000000013705,4078.15,45,18,20,63
9855,-11.368249999998676,2598.625,53,20,22,73
9856,-10.732499999998172,1429.0,28,3,31,31
9857,-29.975249999999864,1429.0,31,7,33,38
9858,3.4620000000012907,4347.35,50,12,22,62
9859,-9.688749999998441,3489.157894736842,44,9,22,53
9860,-18.46674999999844,3158.45,43,7,16,50
9861,-24.81975000000039,1616.5,33,17,27,50
9862,-7.633249999998893,1902.25,45,10,20,55
9863,24.491000000002867,2322.9375,65,7,21,72
9864,0.43075000000055275,2839.2631578947367,42,14,13,56
9865,-2.850749999998839,3396.3888888888887,49,13,31,62
9866,-3.6007499999989365,2380.6666666666665,35,15,18,50
9867,2.3205000000018536,1528.25,46,6,19,52
9868,-48.17874999999955,1429.0,0,9,31,9
9869,-26.832749999999532,2484.777777777778,21,16,24,37
9870,-17.449499999999556,3633.8,29,13,25,42
9871,-12.017249999999214,2967.8888888888887,52,8,28,60
9872,23.97000000000266,5982.25,66,7,20,73
9873,-18.761749999999275,2542.0588235294117,35,12,13,47
9874,-2.8457499999974765,2573.0,54,7,19,61
9875,6.93450000000234,5185.45,56,5,21,61
9876,-31.61024999999929,2460.0,14,17,15,31
9877,-0.1682500000000248,3093.0,58,13,19,71
9878,-20.17749999999945,2439.6111111111113,36,8,24,44
9879,-11.833249999999598,3018.0555555555557,32,20,22,52
9880,-27.2384999999988,2032.25,25,7,26,32
9881,-11.698749999999144,2507.5555555555557,28,6,29,34
9882,-10.071999999996956,5147.3,60,19,23,79
9883,-51.52849999999934,2775.7894736842104,15,4,35,19
9884,-19.99249999999813,3730.7,41,7,25,48
9885,-24.84849999999965,2854.4,23,9,22,32
9886,-23.289249999999974,2719.684210526316,24,11,22,35
9887,-28.88199999999914,2235.0555555555557,22,11,36,33
9888,12.78675000000337,4607.8421052631575,62,8,25,70
9889,-37.73274999999851,2439.0526315789475,22,11,24,33
9890,-23.382999999998198,3222.7,41,6,18,47
9891,5.0640000000009575,3259.4375,48,13,20,61
9892,7.064500000000679,3116.3529411764707,50,7,15,57
9893,4.482750000002566,3023.5,41,14,26,55
9894,-17.080499999999887,2802.4736842105262,44,16,15,60
9895,-13.61449999999831,2110.6470588235293,31,12,23,43
9896,-28.331999999999972,2319.684210526316,16,7,25,23
9897,6.63650000000168,2374.4444444444443,43,3,25,46
9898,23.982750000000852,2348.75,66,17,10,83
9899,4.586750000001997,5029.0,62,10,24,72
9900,-22.100999999999747,2421.9444444444443,41,22,21,63
9901,-23.50324999999957,2602.0526315789475,22,8,41,30
9902,-27.56249999999838,1820.2941176470588,32,15,27,47
9903,-0.21199999999932279,4097.421052631579,45,9,21,54
9904,-34.546249999999276,2062.9375,31,9,31,40
9905,12.454500000001723,2612.625,58,10,20,68
9906,-8.534999999999252,3427.3684210526317,35,11,24,46
9907,-16.49950000000024,2050.8823529411766,42,13,24,55
9908,-7.4967499999992615,1848.6875,44,11,22,55
9909,-6.618499999999261,3244.25,31,6,21,37
9910,-18.602750000000327,3057.2631578947367,44,9,25,53
9911,15.74825000000223,2815.764705882353,62,10,13,72
9912,0.7647500000021654,2099.8125,51,5,23,56
9913,-2.8949999999989244,2027.3125,42,13,11,55
9914,-7.081249999999022,2547.5882352941176,55,8,25,63
9915,-38.190249999998265,2681.315789473684,26,5,32,31
9916,-23.153499999998836,2725.6315789473683,26,12,26,38
9917,-11.208749999998101,2303.0,34,1,32,35
9918,-22.029499999999686,1857.625,31,11,24,42
9919,-4.3864999999991685,2358.176470588235,54,10,21,64
9920,-15.03849999999847,2344.8125,47,8,22,55
9921,-28.274999999999682,2124.0,23,14,38,37
9922,-31.454249999999483,2595.6666666666665,25,8,29,33
9923,-30.64799999999954,1612.5625,15,10,18,25
9924,-6.107000000000077,3262.3888888888887,71,19,14,90
9925,-3.7962499999980914,4948.0,44,12,27,56
9926,-16.96249999999813,2791.6315789473683,37,15,18,52
9927,3.1182500000007436,3929.4736842105262,43,16,26,59
9928,-19.6842499999998,3458.45,36,13,14,49
9929,-15.964499999999244,2034.3125,37,15,23,52
9930,-6.59699999999914,2954.6111111111113,45,7,26,52
9931,-15.389250000000072,1429.0,41,5,22,46
9932,2.2732500000009837,4235.263157894737,61,14,14,75
9933,-22.989249999997586,3674.7894736842104,42,15,21,57
9934,-40.707999999999515,2181.7894736842104,8,13,22,21
9935,-16.90049999999868,2893.0,54,9,30,63
9936,-40.06874999999921,1539.235294117647,8,12,27,20
9937,-5.775999999999537,2798.823529411765,55,15,21,70
9938,-7.97799999999891,3638.684210526316,35,19,21,54
9939,-4.265249999997222,4563.684210526316,71,13,17,84
9940,-8.463249999999856,3521.6111111111113,62,11,18,73
9941,-7.32149999999821,3931.4,50,10,17,60
9942,-36.38424999999806,3785.7368421052633,40,14,26,54
9943,-11.085999999998498,2119.9411764705883,35,5,20,40
9944,-17.90024999999823,2896.1052631578946,36,9,23,45
9945,-10.33599999999764,4865.6,52,10,21,62
9946,-5.849499999998904,3458.315789473684,42,9,26,51
9947,-2.625499999998241,4151.789473684211,53,5,17,58
9948,-8.22749999999856,3566.0,42,10,19,52
9949,-21.429499999998534,2776.6315789473683,31,11,17,42
9950,-27.02449999999908,1429.0,18,10,22,28
9951,-44.120499999999325,1617.5625,9,11,23,20
9952,-17.391499999999617,2444.9473684210525,32,8,22,40
9953,7.5140000000013645,5191.7,61,5,15,66
9954,7.730750000000998,4225.263157894737,64,14,20,78
9955,-8.209999999997784,2681.277777777778,44,15,20,59
9956,-10.331999999998532,2516.8823529411766,49,23,18,72
9957,-15.316749999998976,3168.1,29,16,16,45
9958,-4.104999999999441,2651.315789473684,41,12,13,53
9959,1.5352500000011002,3052.5555555555557,53,10,23,63
9960,10.812750000001916,5230.65,65,5,19,70
9961,-37.909999999999705,1505.4375,22,11,34,33
9962,-30.667749999999028,2794.0555555555557,31,12,25,43
9963,-7.544999999998718,3771.15,54,12,11,66
9964,-18.933249999999305,1832.4117647058824,51,14,19,65
9965,-19.394999999999847,2937.0526315789475,29,11,24,40
9966,-19.56349999999833,2228.294117647059,30,11,28,41
9967,-3.8409999999983704,4416.526315789473,54,9,20,63
9968,-17.71249999999939,2025.578947368421,15,5,31,20
9969,-7.532499999998434,2640.0588235294117,37,7,29,44
9970,-26.346499999998382,3079.95,30,3,31,33
9971,-27.364249999999988,2437.0,31,20,23,51
9972,-1.7929999999972437,2604.6111111111113,51,11,18,62
9973,-4.311749999999079,3504.2631578947367,48,6,27,54
9974,10.832250000000432,2753.0588235294117,61,10,15,71
9975,-17.722249999998848,3075.1,31,10,21,41
9976,-25.64799999999954,2838.277777777778,51,12,31,63
9977,-31.874999999999204,2826.684210526316,23,12,29,35
9978,-0.33774999999956995,2540.3125,51,13,19,64
9979,-2.995250000000143,3032.222222222222,62,6,23,68
9980,6.566500000000976,3729.777777777778,59,6,24,65
9981,-16.050999999998684,2554.3684210526317,29,11,22,40
9982,-23.181749999999298,3215.2105263157896,34,3,32,37
9983,-18.202749999998836,3159.315789473684,37,10,23,47
9984,-22.10249999999949,2564.0,21,13,20,34
9985,-22.430749999999676,2619.5,45,17,23,62
9986,-8.752499999998097,4321.85,41,10,33,51
9987,0.978000000002841,4967.95,65,5,28,70
9988,10.420500000001729,4687.1,69,9,18,78
9989,-7.254499999998982,2772.9444444444443,40,20,13,60
9990,-11.471749999998476,3444.8947368421054,34,3,25,37
9991,-35.6179999999993,3019.7368421052633,27,9,31,36
9992,-37.52774999999935,2055.1666666666665,18,19,12,37
9993,-2.6679999999986532,2496.235294117647,53,14,14,67
9994,-24.492999999998066,2203.176470588235,25,8,25,33
9995,25.137500000000884,3587.722222222222,77,16,24,93
9996,-10.192749999999133,2455.176470588235,36,17,18,53
9997,-10.43524999999875,2014.4375,38,20,12,58
9998,27.036500000005475,2617.625,89,12,25,101
9999,-26.750749999999407,1961.7222222222222,18,10,19,28
10000,-27.08424999999924,1929.4705882352941,26,7,27,33
10001,-22.202749999998172,3974.35,46,11,14,57
10002,-39.103749999999394,1965.2222222222222,14,8,21,22
10003,-14.139499999999575,2148.3125,30,24,13,54
10004,-11.62800000000028,2151.705882352941,39,16,19,55
10005,1.989750000001821,4611.65,46,16,19,62
10006,-9.92174999999962,2595.777777777778,25,5,28,30
10007,9.466500000000586,3317.9444444444443,69,11,28,80
10008,-4.218499999998614,4026.7,48,5,21,53
10009,-10.038749999999432,3551.842105263158,35,16,23,51
10010,-23.459499999999203,2150.3888888888887,21,13,19,34
10011,-4.742000000000071,2489.0555555555557,30,14,21,44
10012,-24.070999999999575,2759.842105263158,32,14,15,46
10013,5.823750000001505,2964.875,66,21,9,87
10014,-14.23649999999948,2584.277777777778,41,12,21,53
10015,-22.476749999998102,2236.705882352941,30,5,30,35
10016,-22.667999999998965,2341.0,30,8,17,38
10017,0.0007500000010460361,3441.5,57,14,20,71
10018,-37.75224999999909,2987.7,23,16,18,39
10019,-3.7174999999992324,4026.75,39,12,14,51
10020,-9.316500000000095,4053.0526315789475,36,11,18,47
10021,-32.76799999999952,2779.1052631578946,19,6,38,25
10022,-6.690749999998191,4058.45,56,8,25,64
10023,-37.86499999999901,2605.3684210526317,18,17,22,35
10024,-13.118999999997689,2537.1875,48,6,19,54
10025,-16.958249999999758,2849.6666666666665,39,12,27,51
10026,-8.881499999997923,4328.0,53,8,21,61
10027,-0.5282499999971991,4758.5,54,5,24,59
10028,-2.6269999999998794,3142.4444444444443,45,9,17,54
10029,-1.23224999999894,3230.2631578947367,57,19,14,76
10030,-34.53949999999998,1429.0,8,13,21,21
10031,-23.891749999999146,2171.5555555555557,20,11,31,31
10032,-16.033249999998656,2417.0,34,12,26,46
10033,-25.93449999999972,2282.722222222222,40,18,17,58
10034,-10.487999999999726,2704.1666666666665,49,17,21,66
10035,-13.408749999999182,4300.55,41,4,21,45
10036,-0.24174999999915397,3222.7894736842104,45,7,20,52
10037,2.5660000000025964,4655.3,60,5,23,65
10038,-13.704499999999825,2008.8823529411766,36,19,22,55
10039,-25.31924999999987,2323.8947368421054,12,14,20,26
10040,-22.049499999998993,2835.5,44,19,38,63
10041,-19.256749999998927,3076.0,31,13,18,44
10042,-1.7597499999980044,3174.277777777778,44,7,27,51
10043,-0.16274999999903894,3068.3888888888887,47,12,21,59
10044,-2.0372499999995872,3460.8333333333335,44,5,25,49
10045,0.8392500000010272,3160.222222222222,60,12,15,72
10046,-5.538749999998104,2505.157894736842,30,17,19,47
10047,16.610500000000446,1853.6875,62,19,16,81
10048,-18.77749999999905,2271.235294117647,38,8,21,46
10049,-12.08924999999797,2525.235294117647,51,15,22,66
10050,-11.793499999999018,2786.7894736842104,24,7,29,31
10051,-16.525499999999504,2546.0,33,6,28,39
10052,-16.813999999999915,1550.0625,32,8,23,40
10053,-22.729999999999343,2295.0555555555557,22,8,23,30
10054,0.32825000000122406,3097.6470588235293,66,12,16,78
10055,3.852250000000711,1601.764705882353,41,9,22,50
10056,-35.00799999999869,2084.842105263158,14,12,32,26
10057,8.703750000001556,2382.3529411764707,60,9,18,69
10058,-34.249749999999864,2211.470588235294,25,12,33,37
10059,-10.42624999999873,3794.9,47,7,20,54
10060,-4.940749999998106,4894.15,51,13,16,64
10061,-13.645999999999324,3123.55,35,13,10,48
10062,3.5672500000008087,3350.5789473684213,55,18,16,73
10063,-1.1852499999993669,2035.0,42,17,14,59
10064,-8.128499999999672,2028.6666666666667,36,4,20,40
10065,-20.537499999998722,2958.7894736842104,35,3,17,38
10066,5.415500000002645,2310.529411764706,57,22,11,79
10067,-22.03474999999938,2393.777777777778,18,9,32,27
10068,-25.142999999999184,2981.0555555555557,29,16,18,45
10069,9.854000000000994,3083.3333333333335,68,6,22,74
10070,-23.166249999999156,1922.0555555555557,22,7,20,29
10071,-26.877999999999464,2479.470588235294,42,11,24,53
10072,1.350500000001364,2543.0,56,12,11,68
10073,-26.803999999999338,2041.125,26,11,45,37
10074,5.743750000000685,3214.777777777778,63,5,21,68
10075,-9.89099999999914,3793.4210526315787,54,8,13,62
10076,10.208500000001832,2416.823529411765,51,14,11,65
10077,3.0635000000019277,4278.736842105263,59,8,20,67
10078,-17.325999999998945,2134.0588235294117,25,16,15,41
10079,0.9527500000006774,3170.1052631578946,40,18,15,58
10080,-13.56124999999813,3309.5789473684213,40,7,22,47
10081,-0.02499999999902336,3676.65,52,17,7,69
10082,-29.990499999999496,2630.65,20,18,18,38
10083,-12.842749999999365,2089.176470588235,28,10,16,38
10084,-27.46049999999978,2179.0625,24,18,22,42
10085,-29.27699999999994,2071.8333333333335,26,15,23,41
10086,21.903250000002036,4426.526315789473,70,22,11,92
10087,-13.736249999998805,2621.2105263157896,27,10,24,37
10088,-3.868999999998516,6397.3,60,3,25,63
10089,1.357250000002247,2367.6875,52,8,22,60
10090,-24.505249999998977,2477.6111111111113,22,11,22,33
10091,-17.051999999999683,2925.6111111111113,36,14,19,50
10092,-14.63599999999939,3246.5555555555557,40,15,16,55
10093,-15.697999999999018,3539.3684210526317,47,6,27,53
10094,-3.364999999999206,1951.875,39,7,28,46
10095,-30.931749999999123,1585.8125,20,2,32,22
10096,-17.792749999999607,2698.8888888888887,47,6,21,53
10097,-31.03799999999932,2202.85,15,20,14,35
10098,6.814500000001749,3840.0,66,10,17,76
10099,13.29350000000187,4572.736842105263,55,16,12,71
10100,4.247500000000423,2618.6470588235293,57,12,22,69
10101,-21.08374999999892,2891.8947368421054,29,4,28,33
10102,6.243750000002699,3151.25,66,5,18,71
10103,-11.140249999999396,2457.277777777778,34,11,21,45
10104,-24.266500000000356,1524.2666666666667,26,12,26,38
10105,-23.40175000000029,1580.8125,19,16,30,35
10106,-12.424749999997776,4171.1,51,6,19,57
10107,-16.555999999998726,3136.25,39,6,17,45
10108,-16.99299999999868,3304.4,37,12,21,49
10109,-21.584500000000382,2111.6111111111113,41,19,25,60
10110,-12.303499999998383,2147.9411764705883,39,7,18,46
10111,-14.597250000000042,2028.7777777777778,33,16,16,49
10112,-14.1907499999997,3468.8333333333335,68,24,14,92
10113,-11.310249999998986,2742.4210526315787,29,14,16,43
10114,-28.120249999999622,2635.45,20,17,16,37
10115,-38.335749999998804,2563.1666666666665,36,12,42,48
10116,-26.711499999999386,2901.35,21,13,20,34
10117,-3.6154999999978505,2930.0,47,13,16,60
10118,-7.669249999998312,3680.5263157894738,49,8,12,57
10119,0.6987500000018594,3168.5882352941176,71,3,25,74
10120,-17.658499999999496,2212.0,19,9,21,28
10121,-2.322749999997373,4580.315789473684,64,13,13,77
10122,-23.13074999999889,2778.3529411764707,34,8,21,42
10123,-2.132749999998732,2885.777777777778,49,17,19,66
10124,-0.7249999999983764,2545.125,71,16,20,87
10125,-21.636749999999594,2130.9444444444443,22,14,12,36
10126,-0.5087499999989202,4309.3,48,6,13,54
10127,-15.021499999998216,3733.05,37,12,23,49
10128,-15.48024999999944,2121.277777777778,19,15,17,34
10129,-30.893249999999775,2000.4117647058824,16,9,56,25
10130,17.044750000003333,2574.6111111111113,69,12,13,81
10131,-12.541749999998567,3891.8947368421054,47,6,19,53
10132,-5.763499999999541,2357.75,44,14,16,58
10133,-4.454999999999151,2307.705882352941,42,10,19,52
10134,22.058250000003767,2539.294117647059,70,16,15,86
10135,-7.541499999999028,1481.9333333333334,35,25,16,60
10136,-12.389499999999021,2750.9444444444443,35,9,18,44
10137,16.2095000000016,2643.823529411765,51,8,21,59
10138,6.760500000001359,4211.0526315789475,58,12,19,70
10139,-0.48524999999930446,3095.7368421052633,38,7,21,45
10140,-5.5647500000003145,3927.842105263158,57,11,16,68
10141,-3.8054999999991344,2612.1176470588234,41,3,20,44
10142,-24.50824999999879,2750.684210526316,28,10,18,38
10143,-26.57549999999989,2194.315789473684,19,6,30,25
10144,10.202750000000567,3341.777777777778,58,17,25,75
10145,-12.423499999998137,3009.277777777778,42,5,18,47
10146,-13.012249999997996,3670.5263157894738,49,5,22,54
10147,-6.021749999999022,2581.875,31,9,20,40
10148,-22.630499999999866,2219.1666666666665,34,12,23,46
10149,-14.793249999998329,3340.5263157894738,35,15,21,50
10150,-23.145749999998763,3979.9,33,6,21,39
10151,-25.755249999999013,2474.157894736842,22,18,19,40
10152,-1.32224999999984,2063.9411764705883,46,13,17,59
10153,-16.975499999999577,2563.5882352941176,37,9,19,46
10154,-16.96999999999882,3448.2105263157896,39,13,19,52
10155,-6.791499999997383,3370.8333333333335,53,20,13,73
10156,-18.58824999999931,4207.684210526316,55,17,17,72
10157,-1.4467499999989624,2442.1176470588234,55,19,15,74
10158,-19.56924999999898,2936.2,26,21,20,47
10159,-19.543499999999373,2412.294117647059,48,17,23,65
10160,1.9875000000025491,2169.470588235294,47,14,18,61
10161,-22.16099999999938,3120.7894736842104,31,7,37,38
10162,-26.401749999999204,1904.2941176470588,28,10,22,38
10163,-9.083749999997373,2413.1875,43,8,30,51
10164,-30.46774999999902,3396.55,26,17,23,43
10165,-8.467749999999675,2063.9411764705883,27,15,17,42
10166,-6.308999999998541,2458.9411764705883,59,8,19,67
10167,-10.402249999999613,4293.684210526316,53,8,17,61
10168,-10.763499999999269,3520.722222222222,47,10,22,57
10169,1.7100000000017175,3672.7,38,8,26,46
10170,-18.626749999999646,2131.8888888888887,22,18,8,40
10171,-8.457999999998487,1564.4117647058824,31,13,16,44
10172,-21.80824999999931,3341.7,33,5,27,38
10173,-13.994749999999701,2064.1176470588234,40,9,16,49
10174,-25.89774999999915,2647.9473684210525,19,5,28,24
10175,-15.047749999999718,1949.388888888889,29,14,21,43
10176,-32.33474999999921,2481.6315789473683,24,8,18,32
10177,-15.556749999998413,2300.235294117647,35,8,24,43
10178,-20.95299999999875,3009.6315789473683,30,16,22,46
10179,-20.397499999999138,2846.45,20,14,22,34
10180,7.135000000001774,5282.15,72,11,16,83
10181,-8.124749999999297,3606.157894736842,49,5,27,54
10182,-23.980499999999537,2666.3684210526317,27,5,30,32
10183,-21.148499999999686,2867.6315789473683,22,22,12,44
10184,-21.6984999999994,2161.1875,33,15,47,48
10185,-4.521750000000003,3830.8947368421054,71,9,18,80
10186,-14.76874999999924,2551.1052631578946,31,12,16,43
10187,-22.105749999999404,2708.5,17,18,15,35
10188,-20.539499999998803,1733.625,24,11,18,35
10189,-22.982249999999553,2948.684210526316,29,17,18,46
10190,-12.697749999998823,3105.7368421052633,57,14,19,71
10191,-6.364999999998001,3559.3684210526317,47,6,20,53
10192,-14.189999999998872,1930.0625,36,13,20,49
10193,13.772250000002122,5508.45,54,12,18,66
10194,-27.461249999999193,3642.55,28,8,26,36
10195,10.822000000001324,4594.95,48,16,19,64
10196,3.676500000002824,3986.315789473684,59,5,26,64
10197,-5.138749999999223,3966.2105263157896,46,16,16,62
10198,-5.140749999998337,3706.1,47,7,15,54
10199,-18.593999999998626,2869.9444444444443,34,17,12,51
10200,11.30325000000139,3457.222222222222,57,9,21,66
10201,-2.6474999999992996,2096.6470588235293,55,12,16,67
10202,8.775750000001407,2790.3529411764707,59,17,21,76
10203,-27.650749999999828,2818.7,13,11,23,24
10204,-24.313499999999618,1921.1176470588234,21,9,18,30
10205,16.254750000004005,2171.125,73,8,22,81
10206,-19.869999999998676,2158.375,30,16,19,46
10207,9.991750000001797,3714.777777777778,61,24,16,85
10208,-17.165749999999786,2193.6470588235293,56,4,21,60
10209,-24.349249999999337,3754.4,36,11,17,47
10210,10.682250000000844,3432.3684210526317,46,15,22,61
10211,6.751250000000951,3383.0526315789475,51,18,25,69
10212,-4.15699999999878,2509.3529411764707,39,11,20,50
10213,7.119750000000127,1481.9333333333334,44,10,18,54
10214,-19.902249999998936,3272.75,36,12,20,48
10215,-25.240999999998728,2640.4736842105262,34,3,23,37
10216,-9.208999999998793,2370.176470588235,36,10,26,46
10217,-18.121749999998862,1894.3125,31,7,21,38
10218,-33.117499999999104,1429.0,9,13,23,22
10219,-5.8524999999983045,1635.4375,36,8,30,44
10220,23.977000000002892,3898.222222222222,75,0,21,75
10221,-1.1339999999986219,4043.9473684210525,54,9,11,63
10222,-14.05774999999866,4434.65,45,7,20,52
10223,-24.442999999999493,3430.55,30,8,19,38
10224,-5.826749999998815,4027.2105263157896,51,9,17,60
10225,-22.258999999999116,2685.823529411765,43,21,14,64
10226,-6.376749999998844,2610.176470588235,44,20,21,64
10227,-41.14224999999963,2075.3888888888887,13,11,30,24
10228,-10.416499999999155,3365.722222222222,46,20,16,66
10229,-17.236000000000026,2627.4444444444443,35,16,20,51
10230,-9.97574999999983,2856.842105263158,29,6,22,35
10231,-43.87624999999968,2737.0,13,15,19,28
10232,-24.483749999998132,1717.5882352941176,19,15,30,34
10233,-32.38549999999988,1429.0,21,12,23,33
10234,-28.07199999999948,1438.5333333333333,47,10,27,57
10235,-17.211499999998903,2771.9,29,14,18,43
10236,-19.99899999999954,2561.0526315789475,26,13,14,39
10237,-8.42799999999951,2068.3333333333335,36,6,30,42
10238,-20.340499999998826,3051.6315789473683,37,8,23,45
10239,-13.562499999998527,2389.375,44,10,23,54
10240,-14.03824999999892,2942.7894736842104,31,18,19,49
10241,3.078500000001415,3647.0,62,7,28,69
10242,-18.91024999999942,1884.375,44,18,29,62
10243,-13.441249999999496,3702.85,34,10,15,44
10244,6.870000000001272,3166.7894736842104,46,5,24,51
10245,-8.791999999996618,2844.4444444444443,52,11,38,63
10246,-22.652249999998972,3449.157894736842,30,19,20,49
10247,-7.497499999997613,3550.8333333333335,72,16,23,88
10248,-8.625499999998445,3179.4444444444443,49,22,20,71
10249,-21.933249999998637,2592.3529411764707,37,11,22,48
10250,-11.8334999999986,1865.5625,28,8,26,36
10251,-18.035249999999042,2575.2631578947367,25,9,24,34
10252,6.71975000000011,4068.157894736842,57,17,20,74
10253,-2.1809999999976433,3334.722222222222,52,8,18,60
10254,-0.6587499999981239,2698.8888888888887,41,11,25,52
10255,-22.149999999997846,2068.6470588235293,38,5,24,43
10256,-20.909499999998438,2947.5555555555557,40,8,26,48
10257,-5.316749999997647,3655.4736842105262,45,6,23,51
10258,3.725500000001081,3132.777777777778,37,17,14,54
10259,-28.448749999999045,2794.1,32,10,16,42
10260,0.40325000000066746,3283.5,49,7,31,56
10261,-2.4374999999996674,3215.157894736842,34,8,26,42
10262,-25.59074999999954,3086.4736842105262,34,12,22,46
10263,-5.9637499999984565,2463.875,59,12,19,71
10264,-27.364999999999846,2368.8947368421054,21,10,27,31
10265,-38.51549999999913,2885.157894736842,24,10,23,34
10266,-34.12849999999982,1732.5625,27,15,22,42
10267,-12.00124999999977,2413.1111111111113,37,9,26,46
10268,-16.1294999999997,1911.125,26,11,26,37
10269,-5.608749999998544,2817.0555555555557,34,20,18,54
10270,-14.911249999999,3878.2,41,10,15,51
10271,-8.088499999999835,2353.4117647058824,36,6,24,42
10272,-38.08849999999922,2211.470588235294,18,10,28,28
10273,-40.24699999999986,1963.235294117647,14,15,25,29
10274,-43.23174999999945,1635.4375,10,7,30,17
10275,-16.002999999998362,2668.1111111111113,30,5,28,35
10276,-29.28124999999967,1528.25,10,17,16,27
10277,-2.9317499999989494,2513.176470588235,42,11,22,53
10278,-2.222749999998662,4800.5,47,11,24,58
10279,32.509000000001954,3450.529411764706,96,8,23,104
10280,-14.851249999999022,3155.25,31,17,13,48
10281,0.3912500000016097,3667.1052631578946,49,8,25,57
10282,3.7267500000003806,3155.6111111111113,59,2,19,61
10283,20.918250000001557,4838.315789473684,59,12,16,71
10284,1.289250000001621,3584.277777777778,52,7,29,59
10285,1.996750000001144,2681.176470588235,43,19,13,62
10286,-19.285249999999625,3048.1,28,4,18,32
10287,6.52150000000144,5201.25,56,7,23,63
10288,-30.407499999999818,1719.4117647058824,16,5,27,21
10289,5.050500000000668,2338.277777777778,45,13,19,58
10290,11.823000000000864,5659.1,54,21,20,75
10291,-19.65900000000013,1429.0,17,10,23,27
10292,-2.223499999999187,2886.529411764706,47,11,14,58
10293,5.899500000002048,5238.6,66,11,28,77
10294,4.006000000000509,3542.8333333333335,51,22,16,73
10295,9.604500000000664,3135.5,61,14,21,75
10296,-7.176999999998732,3451.3,35,5,24,40
10297,25.840250000002715,3228.0,65,16,18,81
10298,-19.78849999999866,2116.5,35,6,21,41
10299,-22.675249999999558,2662.9473684210525,45,9,29,54
10300,-12.148999999999473,2092.8823529411766,54,19,19,73
10301,-8.896999999998648,3799.7,35,12,27,47
10302,-8.841249999997636,5233.1,63,12,21,75
10303,-20.95374999999924,2013.5294117647059,31,7,25,38
10304,-18.4954999999989,3291.0,25,12,23,37
10305,-44.34699999999983,1429.0,2,6,28,8
10306,-11.28699999999912,2562.5,33,13,15,46
10307,-13.432999999998634,1978.625,43,13,23,56
10308,-12.542249999998527,2866.4444444444443,35,6,24,41
10309,-15.736249999999306,2576.0526315789475,21,7,20,28
10310,0.048750000002564506,3663.0526315789475,58,6,22,64
10311,-32.70424999999989,2591.9473684210525,23,8,25,31
10312,1.91050000000121,2085.75,47,8,21,55
10313,0.814750000001926,2224.5882352941176,33,15,26,48
10314,-5.6029999999983735,3884.5263157894738,48,8,23,56
10315,-4.466249999998429,3076.3888888888887,53,12,22,65
10316,-31.888999999999804,2212.35,13,8,19,21
10317,-12.207499999998955,2244.176470588235,39,12,18,51
10318,-32.14749999999956,2141.684210526316,15,7,27,22
10319,-5.388249999998579,1996.7058823529412,56,9,28,65
10320,-15.830999999999216,3012.157894736842,32,9,22,41
10321,-22.28149999999848,2110.6470588235293,27,8,25,35
10322,-20.540749999998773,3350.5263157894738,50,12,29,62
10323,-26.13849999999935,2158.4210526315787,16,7,24,23
10324,0.5507500000002409,3968.842105263158,46,12,23,58
10325,-22.59374999999947,2187.3888888888887,24,12,29,36
10326,-18.465249999997976,2616.2105263157896,36,14,23,50
10327,-10.63549999999982,3507.5789473684213,41,12,25,53
10328,-11.138499999998693,4289.35,45,7,17,52
10329,-34.0439999999988,2716.4736842105262,21,7,28,28
10330,-25.70124999999881,2972.3333333333335,30,5,33,35
10331,-17.098749999998642,2613.8823529411766,43,12,27,55
10332,16.22075000000168,2693.125,57,6,22,63
10333,11.230000000001848,2005.4375,66,7,26,73
10334,-4.130749999999529,3538.5263157894738,43,8,22,51
10335,-40.69924999999988,1685.8235294117646,4,14,22,18
10336,-21.6422499999992,2475.764705882353,32,5,27,37
10337,-4.914749999999966,3211.277777777778,51,19,20,70
10338,10.068000000001096,4929.473684210527,72,3,26,75
10339,-33.98049999999934,2721.5263157894738,27,10,21,37
10340,-14.539749999999653,2647.529411764706,53,11,21,64
10341,-21.209749999999815,2347.8888888888887,21,9,23,30
10342,-42.712999999999155,2038.8235294117646,22,5,38,27
10343,-30.86199999999811,1528.25,33,17,20,50
10344,-6.097749999997957,3589.4210526315787,46,6,21,52
10345,-29.644249999999243,2595.2631578947367,28,11,23,39
10346,-18.135249999999065,2559.9411764705883,39,12,21,51
10347,-0.8477499999989991,2246.6111111111113,37,13,17,50
10348,-33.41699999999954,1481.9333333333334,9,9,35,18
10349,8.984000000000353,4488.368421052632,69,15,24,84
10350,-25.424749999999513,2303.65,16,19,15,35
10351,-20.492999999999135,3048.15,33,6,17,39
10352,-30.773249999999443,2994.2,21,4,32,25
10353,-4.94274999999802,3542.8333333333335,47,8,33,55
10354,14.573750000002738,3873.5263157894738,61,9,19,70
10355,-13.692999999998813,3344.2,36,12,21,48
10356,-1.7514999999997627,5057.368421052632,50,8,22,58
10357,-27.64149999999948,2317.8888888888887,28,13,21,41
10358,-22.216999999999597,2689.684210526316,22,10,17,32
10359,-6.248499999998934,3648.7368421052633,35,7,26,42
10360,-30.02374999999922,2536.3,19,10,24,29
10361,-28.151749999999545,2196.842105263158,13,7,27,20
10362,-24.109249999999523,2532.2,26,8,13,34
10363,-1.4364999999995338,2588.722222222222,59,17,24,76
10364,-17.537500000000296,2897.3333333333335,39,9,24,48
10365,-36.26174999999932,2363.0526315789475,16,16,20,32
10366,-0.013999999996893475,2216.6875,65,17,14,82
10367,-8.208499999998352,3736.95,40,19,21,59
10368,-18.149249999999448,2022.0,36,4,32,40
10369,-13.429499999998722,3066.4736842105262,36,7,24,43
10370,-30.54299999999905,2072.8333333333335,19,6,27,25
10371,-8.197999999999105,2487.8823529411766,46,16,23,62
10372,-4.646249999999726,2064.0,22,11,26,33
10373,-9.327249999998115,3394.777777777778,55,13,26,68
10374,10.305500000000707,3905.3333333333335,57,21,19,78
10375,21.80300000000244,5064.75,74,13,19,87
10376,-7.652499999998573,5372.0,57,13,16,70
10377,-27.226249999998906,3084.0526315789475,26,9,31,35
10378,-4.569999999999033,4339.684210526316,55,15,14,70
10379,2.294500000000482,2655.6666666666665,42,6,26,48
10380,-21.669749999998906,2576.277777777778,25,3,31,28
10381,7.16650000000173,2320.705882352941,45,19,12,64
10382,-17.33899999999875,3608.55,36,7,17,43
10383,-9.790749999998702,2210.529411764706,32,10,19,42
10384,-35.05624999999998,2137.4736842105262,12,15,29,27
10385,0.7720000000013153,2237.5625,50,10,25,60
10386,-8.83249999999897,3207.55,40,12,18,52
10387,-22.121749999999317,2858.45,26,9,21,35
10388,-24.979499999999312,3479.75,32,6,25,38
10389,1.6595000000023543,4772.7,57,21,16,78
10390,-22.099750000000178,2185.4117647058824,41,19,26,60
10391,37.81275000000361,6808.5,96,8,14,104
10392,-9.203749999999213,2534.5882352941176,46,10,17,56
10393,-16.373499999999773,3571.0526315789475,52,1,22,53
10394,-17.48174999999896,2741.85,26,15,19,41
10395,-4.726249999998644,4597.4,47,10,27,57
10396,-14.159999999998465,2543.722222222222,45,8,30,53
10397,-8.001999999999086,3485.8947368421054,43,12,16,55
10398,-8.824749999998826,2681.277777777778,30,13,18,43
10399,-16.300249999999984,2485.9473684210525,42,8,26,50
10400,-31.106749999999835,2593.5789473684213,20,19,23,39
10401,-10.623499999998831,2970.5555555555557,32,8,23,40
10402,-6.403499999998623,2551.3529411764707,40,15,21,55
10403,9.49175000000236,2414.1176470588234,53,12,13,65
10404,-5.748749999999108,2429.9444444444443,49,12,24,61
10405,-35.644749999999945,2158.315789473684,22,14,42,36
10406,-18.61674999999877,3008.5,27,10,17,37
10407,-11.066249999999464,3050.8823529411766,50,12,19,62
10408,10.211000000001869,5259.25,58,9,28,67
10409,0.9047500000011504,5229.1,46,7,19,53
10410,-18.9392499999994,2693.842105263158,23,10,26,33
10411,-17.575499999999543,4075.9,36,3,28,39
10412,-23.517999999998985,2608.0555555555557,33,10,25,43
10413,-21.399250000000166,1429.0,25,6,29,31
10414,0.45225000000190246,4051.4210526315787,48,14,26,62
10415,3.2335000000016043,2513.1176470588234,43,12,19,55
10416,-13.230249999999065,3038.8947368421054,39,9,21,48
10417,-8.995499999997847,2121.625,49,17,14,66
10418,-4.341249999998846,3133.0,38,11,16,49
10419,0.47400000000266684,3333.722222222222,54,13,24,67
10420,-6.975249999997688,2503.823529411765,43,12,23,55
10421,-18.1877499999994,2403.823529411765,36,15,21,51
10422,-8.988249999999248,3399.65,36,13,14,49
10423,-14.598249999999165,2801.25,29,13,18,42
10424,11.715250000001438,3735.0555555555557,62,12,18,74
10425,4.075250000002481,5671.15,65,13,22,78
10426,-20.034999999999176,2975.294117647059,49,11,20,60
10427,6.035250000000322,3398.157894736842,53,9,22,62
10428,8.760250000002154,4079.9473684210525,58,16,19,74
10429,-34.50850000000027,1875.5,43,20,24,63
10430,-24.303999999998858,2724.7894736842104,29,14,21,43
10431,-2.0122499999988053,3223.6111111111113,35,9,28,44
10432,5.149250000002934,2189.125,55,14,13,69
10433,-10.009499999999353,2952.0,42,5,27,47
10434,-23.74099999999861,2572.7894736842104,29,5,24,34
10435,-29.00699999999959,2940.2631578947367,33,5,26,38
10436,-19.4654999999996,1514.375,27,23,36,50
10437,-12.575249999998556,3282.722222222222,43,9,36,52
10438,-2.4324999999991443,2369.9444444444443,44,13,21,57
10439,10.097000000001893,2771.277777777778,40,10,20,50
10440,-1.924749999999007,4380.631578947368,50,2,22,52
10441,-3.1297499999984923,2818.8888888888887,42,7,27,49
10442,-5.713499999998389,3223.6111111111113,40,16,16,56
10443,-27.031249999999808,3031.4,19,4,23,23
10444,25.710000000001788,4373.0526315789475,56,15,22,71
10445,-20.312999999999384,2041.0625,22,8,30,30
10446,-32.37199999999889,3657.65,41,1,23,42
10447,3.264750000002465,2527.176470588235,48,11,26,59
10448,-31.696999999999548,2135.0,20,12,16,32
10449,-22.1582499999987,3052.5,42,7,21,49
10450,-27.759749999999126,2709.0,24,8,22,32
10451,-19.345499999999017,3416.35,31,10,24,41
10452,-19.835999999999384,3105.7368421052633,28,15,25,43
10453,-18.295249999999868,1838.2222222222222,33,12,22,45
10454,-6.172249999999939,1634.375,43,22,23,65
10455,-36.39549999999919,1612.0,5,15,33,20
10456,-10.84374999999866,4338.65,43,1,23,44
10457,-3.1844999999987973,4358.0,72,5,19,77
10458,-7.009749999998124,2845.1052631578946,40,2,25,42
10459,-18.112749999997924,2773.6470588235293,45,11,19,56
10460,10.902750000002202,5807.65,65,9,25,74
10461,-3.395249999998171,3163.4210526315787,42,11,17,53
10462,-26.94749999999852,3218.4736842105262,24,8,43,32
10463,-13.950499999999588,2017.235294117647,28,7,23,35
10464,-35.18525000000015,1675.0625,18,12,24,30
10465,7.281750000001459,4238.6,61,6,18,67
10466,-24.921999999999574,2132.722222222222,12,20,18,32
10467,-15.103749999998787,3455.6111111111113,45,17,27,62
10468,5.417250000002444,5445.7,69,6,23,75
10469,-17.76324999999838,2152.764705882353,35,3,24,38
10470,1.5100000000022102,3870.0,60,20,16,80
10471,1.790000000002491,3625.4210526315787,62,0,21,62
10472,-2.005999999999291,2802.0,49,13,15,62
10473,-7.777499999997533,4072.7,51,6,25,57
10474,-5.952249999998976,2989.0555555555557,45,12,14,57
10475,-20.021499999999122,3052.5,39,8,20,47
10476,-33.188999999999524,2172.75,12,8,24,20
10477,5.00275000000236,2851.5,45,16,20,61
10478,-27.297499999999026,3471.7368421052633,42,17,18,59
10479,-16.850999999999466,1941.0,28,10,20,38
10480,-15.631999999999,2683.1111111111113,23,9,30,32
10481,-9.532499999998702,3566.9473684210525,43,8,27,51
10482,10.766250000000639,2954.6470588235293,47,4,17,51
10483,-14.376249999998851,2836.0,33,2,24,35
10484,1.0167500000015635,4104.894736842105,50,12,22,62
10485,-13.310999999998511,2882.277777777778,40,13,15,53
10486,-34.0042499999997,1523.25,9,15,37,24
10487,-8.6679999999985,2257.235294117647,44,9,22,53
10488,-14.447999999998924,3224.5555555555557,42,14,13,56
10489,-23.246999999999094,2859.315789473684,25,15,20,40
10490,-7.250749999999078,3028.777777777778,45,13,25,58
10491,8.743500000002985,2242.6875,62,6,24,68
10492,13.647750000000931,3155.470588235294,58,10,19,68
10493,-4.749499999998677,4245.368421052632,57,6,19,63
10494,-1.170499999999029,2608.1666666666665,38,11,24,49
10495,-22.39399999999892,2191.1052631578946,18,9,30,27
10496,-24.29699999999911,2139.6470588235293,29,13,15,42
10497,5.866750000002332,4237.0,50,4,21,54
10498,3.7132500000013238,4431.55,49,5,30,54
10499,-23.007749999999497,2271.85,16,14,18,30
10500,-0.07224999999936302,3221.0526315789475,43,8,21,51
10501,-8.109999999998774,2660.1666666666665,40,7,22,47
10502,11.29050000000379,2991.235294117647,73,14,21,87
10503,-15.233749999997993,1481.9333333333334,32,6,35,38
10504,-13.366999999998905,2206.823529411765,38,15,22,53
10505,-11.174249999999487,2244.1176470588234,38,15,19,53
10506,-6.726999999999601,2335.5,44,15,18,59
10507,-16.90599999999917,1675.0625,25,8,27,33
10508,-12.612249999997871,4198.95,51,10,22,61
10509,19.83525000000347,3476.6666666666665,67,12,21,79
10510,4.001500000001238,2274.1176470588234,58,9,16,67
10511,-34.209499999999,3228.5263157894738,31,13,26,44
10512,-5.8684999999987095,2358.1176470588234,63,12,25,75
10513,-12.600749999998419,3136.6315789473683,37,3,28,40
10514,-12.360499999999213,2428.0,32,12,21,44
10515,-2.5319999999986385,3839.2631578947367,48,10,22,58
10516,0.5250000000023872,4661.6,55,14,13,69
10517,-14.481249999999454,1567.9375,33,12,25,45
10518,2.320250000001219,3801.684210526316,63,11,22,74
10519,13.173500000002118,3973.1666666666665,70,8,18,78
10520,3.0685000000025355,4673.894736842105,60,4,27,64
10521,18.191750000002436,2148.733333333333,81,13,19,94
10522,-28.4252499999997,3392.55,20,12,22,32
10523,-21.132249999998997,2824.1111111111113,35,8,19,43
10524,3.899749999999654,2205.875,70,14,25,84
10525,-8.46099999999938,3460.8333333333335,41,15,23,56
10526,5.327000000000605,2797.722222222222,56,15,25,71
10527,-37.65674999999971,1554.0,14,17,30,31
10528,-8.424749999998365,4030.65,43,6,27,49
10529,7.627000000001966,4517.25,64,10,17,74
10530,-33.08100000000007,1908.0,23,12,21,35
10531,-21.850999999999026,2826.75,26,11,19,37
10532,-24.999999999999194,3091.75,31,13,15,44
10533,-9.500249999999898,2314.5555555555557,37,10,14,47
10534,-9.51574999999967,2190.176470588235,33,9,28,42
10535,-23.43124999999906,3999.8,29,14,19,43
10536,-31.94374999999934,2647.529411764706,29,22,16,51
10537,-18.76549999999866,3150.0,30,11,23,41
10538,-27.213999999998983,2582.7368421052633,20,11,26,31
10539,4.317750000001296,4459.25,51,15,18,66
10540,-25.058499999999263,2459.157894736842,26,11,17,37
10541,0.13800000000203722,4815.6,54,5,23,59
10542,14.774250000001548,4845.9473684210525,70,10,19,80
10543,-2.1122499999987503,3597.842105263158,37,3,29,40
10544,-23.282249999998847,2724.842105263158,27,3,37,30
10545,-18.31749999999896,3927.5,40,21,10,61
10546,-14.582749999999189,2709.7894736842104,36,9,20,45
10547,-26.552249999999646,2774.157894736842,24,13,24,37
10548,32.31925000000158,3846.277777777778,73,1,25,74
10549,-26.660999999998648,3221.0,44,23,29,67
10550,-10.468499999998674,3527.7368421052633,37,18,14,55
10551,-12.860999999998239,3590.2631578947367,47,18,16,65
10552,-26.54049999999835,1719.6875,34,6,31,40
10553,-5.578749999997319,4951.35,49,2,36,51
10554,-3.858999999997663,3482.5789473684213,49,3,28,52
10555,-27.08024999999905,2930.315789473684,31,7,15,38
10556,21.646750000001816,3324.470588235294,62,10,20,72
10557,-30.509749999999297,2060.4444444444443,31,6,33,37
10558,4.363500000000263,2322.3333333333335,36,13,21,49
10559,10.013750000000629,4531.105263157895,69,13,19,82
10560,-31.224499999999416,2551.157894736842,25,11,16,36
10561,-3.6892499999999986,2060.3888888888887,34,12,14,46
10562,-7.122249999998898,2771.6470588235293,41,9,20,50
10563,-20.840749999998327,3788.6,39,18,15,57
10564,-7.412999999999629,4045.5263157894738,43,14,17,57
10565,-35.200749999999424,3234.4210526315787,27,5,39,32
10566,-30.799999999999233,2727.45,20,10,22,30
10567,-26.071749999998453,2080.777777777778,25,8,28,33
10568,-11.702999999999495,3576.6470588235293,49,4,28,53
10569,-29.698499999998916,2565.55,19,8,26,27
10570,-8.009499999998491,3983.75,41,12,26,53
10571,14.97650000000021,4169.315789473684,58,9,18,67
10572,-0.8477499999982129,2437.0,53,9,23,62
10573,-4.321749999998007,3314.7368421052633,51,11,18,62
10574,-31.26899999999997,1909.611111111111,15,8,30,23
10575,-14.754249999998146,3331.315789473684,37,10,24,47
10576,-25.815499999999766,2510.1111111111113,32,4,24,36
10577,2.983750000001961,4087.4736842105262,54,11,27,65
10578,-38.13499999999928,1671.125,10,11,22,21
10579,10.903250000003023,3265.0555555555557,63,9,15,72
10580,-5.755249999997952,3679.5555555555557,51,9,28,60
10581,-11.630499999999227,4040.15,44,8,16,52
10582,-26.576499999998767,4322.210526315789,45,12,26,57
10583,-26.514499999999373,2576.4444444444443,26,14,19,40
10584,-36.57399999999943,2616.0,25,10,24,35
10585,-14.93749999999982,1429.0,44,7,33,51
10586,-9.853249999999019,2903.294117647059,49,8,21,57
10587,-20.29474999999922,2771.5789473684213,25,13,14,38
10588,-21.150749999999597,2859.25,24,8,21,32
10589,16.417750000001668,3700.6111111111113,69,15,19,84
10590,-20.929249999999165,2440.7368421052633,25,6,20,31
10591,-2.3224999999990006,3229.4210526315787,49,11,15,60
10592,-38.093749999999645,2009.2777777777778,11,10,27,21
10593,-24.425999999998687,2608.1111111111113,23,10,27,33
10594,-11.872999999997795,4265.6,41,12,23,53
10595,-22.715749999998184,4098.05,37,13,23,50
10596,1.9382500000006075,4463.315789473684,64,11,21,75
10597,22.897000000003207,2278.823529411765,59,12,24,71
10598,-26.347499999999037,3271.25,27,2,27,29
10599,-35.58850000000004,1567.9375,12,28,34,40
10600,-24.953249999998622,3869.55,45,9,25,54
10601,-22.54324999999914,1429.0,15,24,23,39
10602,-24.440499999998828,2779.1052631578946,16,6,41,22
10603,-23.60424999999825,2543.777777777778,43,11,24,54
10604,-34.54774999999867,2577.7368421052633,21,9,32,30
10605,-2.53774999999881,2545.125,50,13,11,63
10606,-16.070999999999664,1429.0,30,20,14,50
10607,-7.501249999998265,2892.0,48,11,20,59
10608,-12.7344999999986,3444.15,30,17,17,47
10609,-18.9099999999995,2266.8333333333335,38,5,26,43
10610,-8.585999999999487,2698.9,26,16,15,42
10611,-33.49924999999966,2711.4736842105262,24,8,30,32
10612,10.201250000001318,2712.8823529411766,88,7,19,95
10613,-37.78450000000008,1429.0,8,8,23,16
10614,0.5510000000017486,4738.6,59,10,26,69
10615,-44.78449999999912,2206.823529411765,32,9,43,41
10616,-0.3589999999982473,3460.1052631578946,43,11,16,54
10617,9.773250000001289,3103.176470588235,45,17,15,62
10618,-12.090749999999883,2076.3333333333335,25,10,23,35
10619,-9.03324999999884,3636.25,32,9,22,41
10620,-23.068499999999407,2708.4,21,7,23,28
10621,-16.84724999999812,4448.85,50,3,32,53
10622,-0.5742499999968922,3656.2631578947367,39,11,44,50
10623,3.64325000000109,3794.157894736842,46,8,29,54
10624,-1.8314999999990735,3672.4444444444443,46,12,20,58
10625,-3.7169999999979595,3054.0,44,0,25,44
10626,-15.42299999999857,2778.294117647059,46,16,19,62
10627,6.407750000001111,4475.0526315789475,84,9,20,93
10628,1.0137500000009718,3590.5,60,12,24,72
10629,-26.784249999998174,2257.0555555555557,33,12,37,45
10630,-13.711499999999265,2652.842105263158,28,14,24,42
10631,-36.10274999999954,2975.05,16,5,32,21
10632,6.229750000001344,3286.235294117647,70,15,17,85
10633,-6.536749999998807,2358.0588235294117,32,13,25,45
10634,-31.989499999999754,2946.157894736842,27,3,30,30
10635,-14.440249999999414,2786.1666666666665,35,9,23,44
10636,-13.684499999999826,2261.0,44,17,23,61
10637,-25.65224999999905,1585.75,19,14,18,33
10638,-37.257999999999136,1528.25,14,11,23,25
10639,-12.00074999999869,3076.3333333333335,47,3,26,50
10640,-17.697999999998604,3712.3,42,4,19,46
10641,-17.739999999999046,2997.0,44,7,25,51
10642,-4.708999999998559,2702.5882352941176,41,13,24,54
10643,-32.58999999999912,2617.9,20,8,23,28
10644,-16.62499999999988,3252.7894736842104,40,8,22,48
10645,-14.686999999998807,1429.0,26,14,23,40
10646,-37.978749999999856,1429.0,8,3,26,11
10647,-5.54149999999882,2746.470588235294,52,11,19,63
10648,-19.17124999999816,2753.2105263157896,35,15,20,50
10649,-10.997249999999479,2952.9444444444443,53,10,25,63
10650,-8.466500000000064,3003.0526315789475,44,7,17,51
10651,5.774500000001383,1983.75,43,9,16,52
10652,-12.837999999999692,2400.1176470588234,38,14,15,52
10653,-13.827249999999527,3162.5263157894738,32,9,25,41
10654,-1.754999999998995,3828.4210526315787,52,13,16,65
10655,-24.922749999998683,3956.9,37,5,26,42
10656,-9.600249999998578,2812.0,42,6,28,48
10657,-3.706749999997858,4061.6315789473683,61,13,16,74
10658,-9.287749999999315,2171.722222222222,42,15,25,57
10659,-7.898249999998671,3170.2105263157896,50,7,22,57
10660,11.179500000002232,2978.5,58,12,15,70
10661,-36.78949999999941,1666.125,9,15,22,24
10662,-14.031749999998388,3433.5,52,12,23,64
10663,-6.364249999999062,3351.3,30,19,18,49
10664,-12.390999999999993,2441.5263157894738,22,6,22,28
10665,5.40925000000175,3094.9444444444443,47,9,22,56
10666,-18.379249999998816,2087.294117647059,49,10,26,59
10667,-24.19849999999962,2906.9473684210525,28,13,28,41
10668,-3.163249999997755,3174.176470588235,45,9,23,54
10669,-16.08649999999905,3523.4736842105262,44,3,36,47
10670,-7.260999999999633,2683.0555555555557,39,8,28,47
10671,-10.176499999999269,2054.125,36,11,19,47
10672,-3.8862499999963105,6615.6,50,11,42,61
10673,-7.4137499999989105,2640.1176470588234,41,11,17,52
10674,-34.71474999999901,1708.1052631578948,11,12,25,23
10675,-15.10924999999873,4286.25,43,5,27,48
10676,-0.7462499999977751,5540.25,78,10,23,88
10677,12.660000000001812,2028.25,48,8,24,56
10678,-24.39574999999936,3064.7894736842104,24,6,24,30
10679,-13.229999999998844,3689.35,39,11,20,50
10680,-25.17949999999958,1594.6875,23,8,22,31
10681,-19.775499999999468,3294.1666666666665,37,13,28,50
10682,-38.13524999999954,2911.842105263158,42,6,28,48
10683,-26.950249999999592,3628.842105263158,45,15,22,60
10684,-6.668999999998651,3632.0526315789475,38,8,21,46
10685,1.3672500000011698,3019.684210526316,37,16,17,53
10686,-16.236999999998588,2214.294117647059,31,8,27,39
10687,-19.819749999999416,1979.9411764705883,27,9,21,36
10688,-19.354749999999513,2651.222222222222,31,15,15,46
10689,-17.870999999999157,2906.1,27,20,12,47
10690,-7.598499999997888,4516.4,53,5,23,58
10691,-1.5279999999986904,3373.1052631578946,60,11,21,71
10692,1.8165000000018972,3700.5789473684213,52,12,19,64
10693,-2.163249999999546,2917.6111111111113,43,13,17,56
10694,-18.186999999999372,2764.0,42,13,31,55
10695,10.292750000000618,3635.4444444444443,60,9,23,69
10696,-18.875999999998296,2870.8888888888887,32,11,26,43
10697,-2.734499999999715,3206.8333333333335,55,16,19,71
10698,-27.066999999999297,2072.777777777778,19,9,22,28
10699,1.6510000000008378,3081.4736842105262,58,13,15,71
10700,8.525500000002019,3088.6666666666665,55,4,23,59
10701,5.738000000002173,1876.5,55,4,19,59
10702,-41.51399999999937,2184.65,14,2,26,16
10703,-12.603499999999547,2695.3888888888887,39,13,20,52
10704,10.090500000001763,4695.05,72,6,15,78
10705,-29.0722499999992,2038.8235294117646,26,11,19,37
10706,7.962500000001162,2103.6875,52,14,17,66
10707,-13.39824999999895,1639.375,29,12,24,41
10708,7.396500000002618,5218.85,70,8,16,78
10709,-25.736999999999096,2180.2105263157896,19,10,20,29
10710,-14.478749999998303,3508.55,40,2,28,42
10711,-2.7749999999993418,1481.9333333333334,51,13,16,64
10712,7.057000000000551,3413.222222222222,47,11,29,58
10713,17.151750000000412,3024.0,68,10,15,78
10714,-0.18699999999999034,2811.777777777778,43,1,21,44
10715,1.2442500000020715,4054.0526315789475,46,11,19,57
10716,-26.74574999999927,2063.9411764705883,17,9,32,26
10717,-9.282999999996647,1481.9333333333334,62,12,22,74
10718,-21.306499999998707,2476.684210526316,25,5,30,30
10719,-0.427249999998258,3538.5789473684213,67,12,18,79
10720,-31.40674999999923,3945.4210526315787,40,11,25,51
10721,0.5440000000013022,2775.6666666666665,35,13,16,48
10722,-13.229499999997213,2001.4444444444443,40,14,23,54
10723,-19.935750000000102,2131.8888888888887,32,11,22,43
10724,-7.744500000000121,2454.294117647059,41,17,22,58
10725,-19.41799999999981,2062.9375,26,9,27,35
10726,10.254000000001586,4020.8333333333335,68,8,15,76
10727,-18.530999999999374,3354.7368421052633,29,16,11,45
10728,-33.74424999999913,2700.65,21,13,22,34
10729,-18.211749999998425,4008.55,42,8,19,50
10730,0.5450000000011492,3476.6666666666665,49,15,12,64
10731,-15.414249999998983,2899.3684210526317,24,7,32,31
10732,5.0515000000037515,2589.6470588235293,71,6,23,77
10733,-15.887249999998977,3676.65,31,9,16,40
10734,-9.343999999999792,3049.0555555555557,54,11,21,65
10735,-13.872249999999378,3129.222222222222,37,6,20,43
10736,-8.82874999999908,2154.529411764706,55,15,18,70
10737,-0.6447499999978336,2287.235294117647,47,14,15,61
10738,-31.51074999999882,3265.65,27,11,25,38
10739,-1.5654999999990482,3516.3888888888887,53,11,18,64
10740,-12.691249999998679,1692.9375,37,8,19,45
10741,-46.341999999999885,2109.8947368421054,8,10,35,18
10742,-15.314749999998932,2322.3333333333335,28,16,15,44
10743,-3.3747499999987993,3583.6315789473683,51,5,29,56
10744,-5.584999999998319,2138.3125,45,7,19,52
10745,-12.509749999999244,2890.3333333333335,37,7,25,44
10746,-21.404249999998985,3442.4210526315787,40,5,27,45
10747,-6.511749999998919,3206.8333333333335,57,17,21,74
10748,-3.327499999999526,3431.5789473684213,57,14,13,71
10749,-30.867499999999723,2322.3333333333335,23,9,23,32
10750,15.530000000003366,2537.5555555555557,65,12,17,77
10751,-14.728999999999385,1529.5333333333333,32,18,14,50
10752,-24.055499999999018,1945.7777777777778,15,12,20,27
10753,-17.121499999998015,2364.705882352941,49,11,25,60
10754,-20.03899999999898,1930.0,20,15,17,35
10755,-43.73275000000022,1891.1764705882354,29,16,34,45
10756,4.039250000002489,5205.3,66,12,20,78
10757,10.99050000000131,2509.3529411764707,56,8,23,64
10758,4.210000000000565,2353.75,53,18,15,71
10759,-15.323749999998247,4117.95,40,14,22,54
10760,-2.8062499999987582,3555.2105263157896,60,12,27,72
10761,-23.389999999999688,1481.9333333333334,38,4,28,42
10762,-13.939249999997765,2141.4117647058824,42,24,14,66
10763,-25.046749999998998,3308.45,32,12,14,44
10764,-29.849749999999574,2625.15,19,8,19,27
10765,-21.57899999999933,2496.8888888888887,28,26,10,54
10766,-10.728249999998933,3197.7368421052633,36,9,20,45
10767,4.389750000000563,3343.842105263158,52,14,17,66
10768,-8.68349999999916,2258.4375,40,13,18,53
10769,-13.117499999999504,2589.5555555555557,36,14,13,50
10770,-17.410749999998632,3633.7368421052633,51,13,15,64
10771,-4.25299999999937,3453.777777777778,60,16,12,76
10772,-6.769999999998953,3310.8888888888887,43,10,21,53
10773,-8.31124999999886,2545.764705882353,50,16,25,66
10774,-17.04624999999904,1429.0,23,13,23,36
10775,-11.172749999999727,3028.722222222222,42,8,22,50
10776,-23.772749999998396,3746.6315789473683,35,11,21,46
10777,-23.912249999998664,2736.235294117647,35,9,17,44
10778,-10.778999999998899,2312.529411764706,30,15,23,45
10779,-13.392250000000137,1429.0,31,14,13,45
10780,-10.613499999999036,3245.315789473684,58,8,18,66
10781,-6.423499999999114,3984.55,42,3,26,45
10782,-25.461749999999018,2861.0,24,12,24,36
10783,-26.11999999999869,2430.777777777778,27,14,22,41
10784,-2.3452499999983365,5115.65,48,13,17,61
10785,-12.8927499999985,3680.8,45,12,16,57
10786,0.6032500000006493,3804.157894736842,63,11,16,74
10787,-23.973749999999693,2211.222222222222,16,8,23,24
10788,-1.9609999999988061,3655.722222222222,44,18,17,62
10789,-9.646249999998554,2219.8125,39,13,26,52
10790,15.448500000000104,2958.470588235294,71,14,22,85
10791,-31.387749999999244,2155.6666666666665,11,16,28,27
10792,-32.22499999999925,1429.0,23,13,18,36
10793,-17.15999999999947,2846.7368421052633,27,12,24,39
10794,13.226250000001874,2110.823529411765,44,8,27,52
10795,-40.824749999999284,1615.764705882353,7,11,26,18
10796,-11.80399999999862,4071.95,39,15,17,54
10797,-29.193000000000048,2095.0,13,13,32,26
10798,20.56775000000184,3952.8888888888887,65,11,17,76
10799,8.381000000001537,3774.777777777778,66,5,20,71
10800,5.975000000000948,2998.722222222222,62,15,17,77
10801,-12.68449999999915,2844.3684210526317,32,13,21,45
10802,-25.222999999998756,3274.5263157894738,33,14,14,47
10803,-10.763499999999965,3394.7368421052633,37,15,16,52
10804,-31.710999999999494,2120.7368421052633,10,13,24,23
10805,-24.32549999999815,4564.05,54,17,17,71
10806,-20.862999999999282,2538.294117647059,40,11,29,51
10807,-7.572499999999176,3788.315789473684,41,18,13,59
10808,4.914750000001067,3734.8947368421054,60,11,17,71
10809,-24.600749999999508,1585.75,20,19,21,39
10810,-10.237249999998875,4161.6,44,8,20,52
10811,-23.14574999999891,2154.0555555555557,28,9,13,37
10812,-10.913999999999643,2667.222222222222,42,18,21,60
10813,-22.588499999998824,2715.684210526316,26,20,18,46
10814,-30.124249999998803,2270.3684210526317,19,13,26,32
10815,-8.928249999998153,2134.5555555555557,44,23,16,67
10816,-34.54149999999967,1643.764705882353,10,22,14,32
10817,-27.928749999999315,2538.5263157894738,30,11,18,41
10818,-8.978999999998953,2005.5,49,7,22,56
10819,-25.609499999998825,2675.9,25,17,19,42
10820,-27.921749999998816,2755.3888888888887,28,8,20,36
10821,-31.459750000000355,1643.8235294117646,27,12,24,39
10822,-24.815999999999335,2109.705882352941,33,13,10,46
10823,-12.634249999999167,2577.1111111111113,39,13,18,52
10824,-17.878499999999267,1848.625,33,10,18,43
10825,3.0990000000015065,1934.235294117647,30,24,10,54
10826,-5.694749999999509,2849.6111111111113,46,12,27,58
10827,-27.389999999998604,2257.294117647059,32,4,34,36
10828,-25.77049999999884,1988.3529411764705,28,13,14,41
10829,-1.9442499999987675,2534.5882352941176,52,9,32,61
10830,-30.095999999999076,2021.9411764705883,17,10,26,27
10831,-39.611249999999735,2317.2105263157896,9,11,21,20
10832,-5.507499999997618,2961.3529411764707,56,7,16,63
10833,-10.923749999997654,2180.0,51,8,18,59
10834,-1.7584999999987574,2635.4117647058824,38,7,18,45
10835,-5.751999999998596,3993.35,50,10,18,60
10836,-11.285499999998532,2240.4117647058824,49,13,25,62
10837,0.2667500000006354,2993.8947368421054,40,5,18,45
10838,4.030249999999721,2353.470588235294,66,4,19,70
10839,-7.054999999998964,4449.75,45,11,21,56
10840,3.1530000000021303,2491.722222222222,47,12,16,59
10841,-7.472499999999009,4254.5,44,9,19,53
10842,-26.622249999998882,2657.1052631578946,26,6,25,32
10843,-8.98399999999783,4003.75,48,14,21,62
10844,-2.537249999998953,2064.0588235294117,61,18,13,79
10845,2.3119999999998244,2177.0,41,13,17,54
10846,-26.103999999999143,2409.6111111111113,16,6,42,22
10847,-9.835999999998638,3188.4210526315787,41,7,20,48
10848,-3.618999999998389,2816.6470588235293,44,12,18,56
10849,-6.228249999999678,3320.4736842105262,52,10,30,62
10850,-20.047499999999104,2794.157894736842,27,7,28,34
10851,-6.448999999998212,2779.1666666666665,41,11,22,52
10852,10.4965000000009,4207.789473684211,54,5,14,59
10853,-19.292999999999203,3251.25,31,6,21,37
10854,-13.836999999998437,2760.684210526316,30,9,24,39
10855,5.158000000003476,3354.4117647058824,73,2,26,75
10856,3.2582500000015386,3656.6666666666665,53,10,22,63
10857,-15.574499999998356,3679.1,45,15,14,60
10858,-23.77574999999935,2852.1,24,10,18,34
10859,-16.284499999998765,2286.1875,53,12,23,65
10860,-11.231999999998347,5022.75,65,10,23,75
10861,-4.689999999998879,3243.1666666666665,51,12,16,63
10862,-4.188499999999303,2399.235294117647,39,15,16,54
10863,-4.420749999999099,3927.4,41,18,16,59
10864,-38.40024999999851,1528.25,11,20,29,31
10865,-28.671499999998566,2474.1111111111113,27,14,25,41
10866,-1.0949999999988203,3772.75,43,5,22,48
10867,-15.01399999999769,2265.705882352941,49,14,17,63
10868,11.481250000001216,3180.3333333333335,45,15,25,60
10869,-9.651999999998335,2528.6666666666665,45,6,31,51
10870,-12.025249999999811,4004.6315789473683,60,10,18,70
10871,-8.609249999999033,3072.315789473684,47,12,22,59
10872,-12.399499999998756,4444.9473684210525,54,10,17,64
10873,-3.9929999999980836,4496.684210526316,60,15,15,75
10874,-12.845249999998927,3094.157894736842,57,12,15,69
10875,-11.279749999999712,2683.0555555555557,47,27,18,74
10876,-23.362999999999072,2758.45,26,10,16,36
10877,-4.159999999998669,3246.9473684210525,49,8,23,57
10878,-10.706999999999095,2727.222222222222,37,18,13,55
10879,-46.42749999999988,2032.2222222222222,14,12,44,26
10880,-20.921999999999326,1528.25,18,8,23,26
10881,0.2825000000007771,2695.3888888888887,46,10,28,56
10882,-19.12149999999965,2370.176470588235,34,20,22,54
10883,-8.208749999999174,2127.4117647058824,34,22,23,56
10884,-19.906749999999096,1429.0,32,14,27,46
10885,-0.8127499999992214,3211.3333333333335,37,7,36,44
10886,-6.934499999998829,2214.75,46,8,20,54
10887,-29.742499999999723,2309.6315789473683,21,19,19,40
10888,1.3282500000016377,4579.9,51,11,14,62
10889,-54.69324999999981,2094.842105263158,5,14,27,19
10890,-15.461249999998364,2026.6470588235295,34,9,18,43
10891,-18.169999999999547,1429.0,26,10,25,36
10892,-30.979749999999484,1853.8235294117646,15,22,18,37
10893,-4.304999999998541,2965.9411764705883,40,11,24,51
10894,5.7607500000009155,3358.0526315789475,49,7,22,56
10895,-10.453999999997489,2635.3529411764707,49,13,22,62
10896,4.9037500000011365,3989.6315789473683,67,9,16,76
10897,-15.048249999999594,3165.842105263158,44,18,27,62
10898,7.537750000000257,2671.5,43,19,17,62
10899,-37.371249999999264,1606.4705882352941,10,13,22,23
10900,5.906250000001757,3272.9444444444443,46,10,18,56
10901,-17.663249999998243,2447.764705882353,44,7,23,51
10902,-29.017999999999603,2561.157894736842,22,14,18,36
10903,-24.03574999999963,2757.65,23,12,19,35
10904,-14.07649999999899,2223.6470588235293,33,12,23,45
10905,-20.49824999999986,2064.1176470588234,37,12,25,49
10906,-24.703499999999444,1495.6666666666667,32,21,22,53
10907,-31.82674999999899,2136.6315789473683,13,13,27,26
10908,20.88525000000282,4060.3888888888887,86,9,14,95
10909,-26.224249999998335,2815.3888888888887,33,14,24,47
10910,-30.631999999998463,3743.157894736842,38,12,28,50
10911,-23.482249999999592,2485.842105263158,15,9,26,24
10912,-4.484999999998372,3544.4736842105262,40,17,15,57
10913,-5.6709999999972505,2026.764705882353,41,11,24,52
10914,-21.162749999998677,3941.7,42,10,18,52
10915,-5.814749999999551,2889.3333333333335,62,28,14,90
10916,-24.10999999999986,2097.5882352941176,16,12,20,28
10917,-9.68399999999844,3008.55,29,7,29,36
10918,-6.517999999998212,2451.9375,59,14,18,73
10919,-8.633749999999264,3532.222222222222,50,19,16,69
10920,1.048250000000851,2465.222222222222,41,10,25,51
10921,-28.376499999999915,1612.5625,17,15,24,32
10922,-5.099499999998682,2640.0588235294117,44,3,22,47
10923,-10.451999999999485,2735.1666666666665,45,8,18,53
10924,-26.70974999999863,3586.25,37,8,21,45
10925,-17.441499999999373,2702.6470588235293,35,11,15,46
10926,-11.472249999998686,3863.9,41,10,23,51
10927,-13.43624999999949,2564.6315789473683,28,14,16,42
10928,11.380500000001586,2064.0,58,11,25,69
10929,3.930000000000338,3156.529411764706,40,9,19,49
10930,-13.798499999999933,2429.1111111111113,32,20,11,52
10931,-17.376249999999693,3342.0526315789475,26,14,25,40
10932,-13.146249999999139,2584.277777777778,29,10,20,39
10933,1.193000000000474,2950.0,71,14,16,85
10934,1.8052500000007747,1429.0,47,21,22,68
10935,5.041250000000715,4223.55,40,17,17,57
10936,2.7545000000005606,3238.5555555555557,56,14,22,70
10937,-1.0692499999978322,2760.6666666666665,55,18,17,73
10938,-13.43924999999875,2027.25,36,5,18,41
10939,-30.630749999998592,2309.6315789473683,21,13,18,34
10940,-18.15299999999963,2135.0,44,11,29,55
10941,-31.532499999998674,3460.05,27,14,18,41
10942,-15.387000000000095,2817.9444444444443,47,12,20,59
10943,-13.654249999999283,3673.7894736842104,37,15,21,52
10944,1.4135000000009157,3465.1666666666665,48,19,18,67
10945,-10.86999999999811,3156.4117647058824,47,14,15,61
10946,12.70175000000326,4572.789473684211,58,19,15,77
10947,-0.32949999999919016,3048.1111111111113,43,10,16,53
10948,-3.0819999999988936,2438.3529411764707,37,16,13,53
10949,-19.350249999999576,2691.0,21,17,16,38
10950,8.278750000000901,3061.5263157894738,37,10,16,47
10951,-5.863749999998349,3060.5,41,9,24,50
10952,16.710500000001073,4139.9473684210525,75,10,17,85
10953,-9.080999999999866,2227.222222222222,31,11,21,42
10954,18.729500000001803,3643.9473684210525,61,7,26,68
10955,-23.66299999999938,2675.15,21,12,15,33
10956,-0.5167499999998044,3088.6111111111113,58,13,21,71
10957,-2.611999999998019,1680.0625,36,13,25,49
10958,-17.665499999999405,2723.6111111111113,42,16,15,58
10959,2.0882500000035398,2727.823529411765,60,5,31,65
10960,-5.720999999998772,1719.6875,35,8,16,43
10961,1.0162500000003665,2531.277777777778,59,14,25,73
10962,-6.485249999998115,2628.4444444444443,39,12,18,51
10963,-24.312749999999163,2762.4210526315787,25,9,25,34
10964,-35.45799999999971,2275.4210526315787,21,11,20,32
10965,0.7800000000011104,4746.55,57,6,9,63
10966,-10.437249999998315,2240.4117647058824,60,7,23,67
10967,-2.580999999998037,4490.1,52,9,19,61
10968,-15.300499999999383,2170.0625,34,8,16,42
10969,-13.529249999998829,2719.470588235294,32,20,13,52
10970,-19.63749999999894,2631.6470588235293,30,5,23,35
10971,25.303500000002522,3614.3333333333335,63,7,25,70
10972,-22.662499999999756,2221.842105263158,31,11,17,42
10973,2.801000000002367,2093.8823529411766,48,13,18,61
10974,-25.03874999999959,2642.8947368421054,23,6,22,29
10975,3.3655000000004613,3124.0,55,8,20,63
10976,0.31375000000072034,3512.777777777778,67,15,29,82
10977,-14.17524999999888,3036.3,38,12,16,50
10978,-17.371249999997765,3014.6666666666665,52,8,18,60
10979,-35.39774999999905,2416.1875,36,7,27,43
10980,-4.186499999998024,2818.9444444444443,39,13,25,52
10981,-11.929749999999444,2441.3888888888887,19,13,25,32
10982,-13.311999999999568,2078.0555555555557,39,5,27,44
10983,4.468000000001253,2103.5625,53,20,9,73
10984,-6.300749999998898,3266.9473684210525,37,4,36,41
10985,-10.562500000000021,2147.777777777778,40,7,35,47
10986,-3.693749999998686,2005.4375,41,8,28,49
10987,-22.303499999999488,2583.5789473684213,40,6,25,46
10988,-20.221249999998815,3290.3684210526317,55,13,23,68
10989,6.715250000001815,3967.1052631578946,57,10,21,67
10990,14.235750000004256,2262.0,64,6,23,70
10991,-1.3307499999998502,3232.684210526316,48,15,12,63
10992,4.906750000001733,4077.315789473684,54,14,20,68
10993,-24.855999999998815,2310.9444444444443,24,17,18,41
10994,-19.288499999999505,2535.9473684210525,17,12,24,29
10995,-18.132499999998664,2795.0,36,12,16,48
10996,-16.216749999999713,2139.6470588235293,28,10,22,38
10997,-9.614249999998227,2005.4375,43,15,16,58
10998,-5.57324999999863,2528.6666666666665,34,8,19,42
10999,-8.776999999998617,3684.777777777778,48,9,23,57
11000,-26.9937499999992,3835.0526315789475,33,11,23,44
11001,-41.80249999999971,1429.0,0,7,43,7
11002,-1.7089999999987255,3305.4736842105262,49,13,18,62
11003,-19.082249999999398,2097.6470588235293,46,13,27,59
11004,-15.910499999998956,2072.4117647058824,55,21,12,76
11005,-9.573250000000368,1652.25,36,18,21,54
11006,-20.377749999998727,4529.9,48,7,21,55
11007,6.575750000000625,4188.421052631579,60,17,12,77
11008,8.153249999999979,2960.8333333333335,58,11,15,69
11009,-8.443999999998386,3384.7894736842104,42,9,23,51
11010,-37.45274999999944,1528.25,11,9,22,20
11011,-11.678249999999448,3177.45,31,16,10,47
11012,-3.239749999998307,2869.9444444444443,46,5,23,51
11013,-4.50499999999885,4542.7,55,5,19,60
11014,-24.97199999999898,2046.421052631579,14,10,30,24
11015,-39.923499999999414,1556.0588235294117,10,15,16,25
11016,2.7250000000016366,3641.05,46,16,15,62
11017,-22.09249999999907,3222.777777777778,39,11,12,50
11018,-20.122999999999628,2290.3684210526317,27,8,21,35
11019,-25.65499999999932,2219.3684210526317,19,6,22,25
11020,1.0865000000013525,3909.6666666666665,44,13,19,57
11021,-13.853749999999048,2349.6470588235293,38,7,20,45
11022,-35.478249999998624,2551.7894736842104,27,8,28,35
11023,15.948750000002041,4713.9473684210525,72,9,24,81
11024,-28.43025000000012,1429.0,14,11,24,25
11025,4.25200000000019,2433.764705882353,44,6,16,50
11026,13.03375000000201,5393.4,88,17,9,105
11027,1.9557500000014862,1534.8666666666666,35,18,10,53
11028,-27.900249999999755,2048.1111111111113,22,15,21,37
11029,-5.280749999998425,4208.5,42,9,17,51
11030,-23.552249999999624,1965.1666666666667,19,9,21,28
11031,-13.998249999999624,3468.315789473684,59,9,23,68
11032,2.6970000000015713,4703.9473684210525,73,8,24,81
11033,-22.609499999999247,2226.470588235294,24,12,17,36
11034,-15.072500000000119,1429.0,37,15,19,52
11035,-2.3232499999992324,2457.277777777778,42,14,17,56
11036,-10.308249999997901,4049.7894736842104,56,10,17,66
11037,10.259250000002975,3386.722222222222,66,13,20,79
11038,-17.948000000000185,1429.0,56,14,18,70
11039,-12.818249999998475,3025.277777777778,37,10,20,47
11040,-29.24599999999945,1429.0,25,9,24,34
11041,-32.31599999999876,2596.777777777778,29,14,16,43
11042,12.30400000000204,2589.705882352941,53,16,19,69
11043,-11.818249999998148,4326.6,47,11,16,58
11044,-6.155749999998898,2857.6470588235293,75,12,20,87
11045,-13.442499999999338,1684.0,26,18,12,44
11046,-26.16149999999946,2894.2,26,11,19,37
11047,-1.1157499999987763,3663.15,41,11,22,52
11048,-4.464499999998866,2493.3888888888887,34,7,20,41
11049,-19.051499999998278,3327.9473684210525,41,13,20,54
11050,-40.64724999999966,2080.684210526316,11,18,23,29
11051,-26.681249999999018,2334.5789473684213,20,11,21,31
11052,-21.70724999999928,2146.0555555555557,17,16,17,33
11053,-2.1327499999977753,3730.7368421052633,53,9,15,62
11054,3.2250000000005263,2487.823529411765,58,9,17,67
11055,-18.273749999999282,1973.625,40,22,16,62
11056,-2.355249999999264,3801.6315789473683,53,20,8,73
11057,-2.582499999999203,3192.777777777778,39,14,21,53
11058,-32.0599999999989,2554.0625,43,12,28,55
11059,-16.958499999999823,2365.5555555555557,33,20,26,53
11060,-16.8482499999991,2646.315789473684,22,20,20,42
11061,-15.560499999999186,2543.6666666666665,43,16,26,59
11062,-23.326000000000185,2563.9444444444443,37,22,14,59
11063,-8.291749999999206,2769.1052631578946,36,16,13,52
11064,-0.36474999999955493,3200.2105263157896,48,18,7,66
11065,-21.009249999999636,2038.8947368421052,14,15,16,29
11066,-4.377749999998043,4366.4,47,17,17,64
11067,-17.076499999998557,2624.777777777778,35,9,24,44
11068,-28.236249999999576,2173.176470588235,34,10,26,44
11069,-33.07724999999881,3972.7,41,9,21,50
11070,-21.230499999999818,1588.75,22,1,34,23
11071,-16.610499999999377,2813.95,22,15,17,37
11072,-4.775499999999068,2700.722222222222,37,9,17,46
11073,-9.5927499999992,3696.4210526315787,49,8,17,57
11074,-14.194749999998347,2477.6111111111113,43,16,14,59
11075,5.512250000001344,1871.5,57,15,16,72
11076,-22.14199999999981,2185.157894736842,14,9,28,23
11077,-6.616749999999311,3290.3684210526317,39,4,19,43
11078,2.713000000001606,3805.0526315789475,47,9,21,56
11079,-0.6047499999978984,2727.8823529411766,54,8,24,62
11080,-37.6517499999997,1438.5333333333333,35,22,30,57
11081,-28.675249999998492,3652.157894736842,41,17,21,58
11082,-14.228999999999413,2914.9444444444443,34,11,21,45
11083,-16.632249999999846,2598.5789473684213,22,12,23,34
11084,-10.863749999999895,2862.1111111111113,62,4,21,66
11085,-5.563249999998767,2110.823529411765,30,19,13,49
11086,-5.3664999999989105,3142.5,48,12,17,60
11087,17.93500000000306,3086.294117647059,65,12,17,77
11088,-7.664499999998588,3590.95,37,10,21,47
11089,-27.333999999998372,3324.6315789473683,32,8,22,40
11090,-5.419499999998326,2318.0,50,9,20,59
11091,-29.62049999999862,3730.6,31,17,14,48
11092,-7.490249999999856,3306.2631578947367,43,16,10,59
11093,-29.821249999999726,2422.3684210526317,17,16,20,33
11094,-32.86799999999967,2059.842105263158,12,11,20,23
11095,5.610500000002075,4012.157894736842,60,20,16,80
11096,-5.726999999997987,3505.8947368421054,54,10,16,64
11097,24.148250000002257,5529.05,70,12,18,82
11098,-0.40349999999769004,3161.0588235294117,53,17,18,70
11099,-32.05749999999989,2410.684210526316,18,21,22,39
11100,-13.526999999998898,2830.277777777778,36,17,14,53
11101,-4.8902499999988445,3613.684210526316,52,7,24,59
11102,-2.8947499999980257,4084.65,51,3,24,54
11103,-4.343499999998689,2264.375,59,17,15,76
11104,-9.118499999997713,3338.529411764706,59,8,21,67
11105,-23.001999999999878,1685.8235294117646,23,15,21,38
11106,-29.8597499999997,2266.8888888888887,22,14,15,36
11107,10.911250000001672,3127.470588235294,64,13,16,77
11108,-5.894249999999191,3527.0,54,16,15,70
11109,-2.2507499999973186,3665.4736842105262,58,8,16,66
11110,-16.984999999999395,1692.9375,18,15,20,33
11111,-3.826999999998562,4510.85,50,7,23,57
11112,-40.97899999999994,2157.5263157894738,10,5,29,15
11113,-11.800749999999336,3155.157894736842,53,8,26,61
11114,4.6312500000017485,4123.55,52,6,20,58
11115,-13.553499999998541,3568.5789473684213,40,10,19,50
11116,-4.996499999998555,5996.55,62,7,16,69
11117,-11.940499999997648,2642.4444444444443,45,15,18,60
11118,-16.522249999999353,3712.35,38,13,19,51
11119,-29.007749999999817,2636.315789473684,22,5,28,27
11120,-26.183249999999255,1942.7058823529412,27,6,19,33
11121,-30.98049999999941,2097.705882352941,24,6,25,30
11122,7.778000000001102,2409.4117647058824,61,4,21,65
11123,-25.96599999999887,1635.375,30,16,17,46
11124,-22.359249999999676,2603.7,21,20,14,41
11125,5.456000000000648,3366.4444444444443,55,7,17,62
11126,-0.704499999998295,2895.375,52,13,10,65
11127,-25.16999999999927,2653.0,21,22,18,43
11128,-18.594499999998867,1942.9375,58,20,16,78
11129,-12.913499999999038,2893.8333333333335,39,16,25,55
11130,-24.03199999999934,2755.25,25,14,12,39
11131,-9.650999999998861,3587.75,46,9,10,55
11132,-28.701749999998288,2613.3888888888887,33,19,25,52
11133,-20.118249999998696,4516.3,49,14,20,63
11134,5.036500000000548,3403.2105263157896,51,9,24,60
11135,6.107500000000596,2534.705882352941,52,13,12,65
11136,-25.503999999999376,2782.722222222222,31,10,26,41
11137,-15.952249999999491,4027.2105263157896,43,9,28,52
11138,-7.715249999998821,2582.7368421052633,35,8,20,43
11139,1.8427500000009807,2891.294117647059,63,12,13,75
11140,-12.84424999999986,2009.5,52,20,10,72
11141,-1.6519999999999135,2691.0,39,15,12,54
11142,-30.54899999999966,3057.2631578947367,44,15,34,59
11143,-1.0532499999990539,3544.5555555555557,46,12,17,58
11144,-5.702749999998532,3772.8,44,14,17,58
11145,3.526250000001516,4235.210526315789,57,18,23,75
11146,3.8912500000011705,4294.25,56,9,17,65
11147,4.5775000000012955,3391.705882352941,64,7,20,71
11148,-15.987499999998713,2303.0,29,4,26,33
11149,-13.26724999999901,3108.1666666666665,38,13,17,51
11150,-27.082249999999128,3078.9473684210525,53,9,25,62
11151,-20.52699999999924,2710.05,27,6,18,33
11152,-24.295499999999386,3225.9,32,19,12,51
11153,-12.759499999998699,3558.4,35,12,21,47
11154,-31.271749999999138,2110.823529411765,29,14,11,43
11155,-25.529749999999286,3067.4210526315787,27,12,24,39
11156,-21.976499999998854,2476.705882352941,30,5,23,35
11157,-17.113249999999994,1977.5555555555557,34,16,15,50
11158,-23.153249999999183,2780.0,24,15,16,39
11159,-26.95649999999988,2148.0,34,13,24,47
11160,-25.317499999999633,1429.0,11,16,19,27
11161,-19.825749999998465,3499.75,31,19,17,50
11162,-13.739999999998867,3476.7368421052633,39,3,19,42
11163,-26.802249999998672,2552.9,24,7,24,31
11164,18.084500000001082,2874.470588235294,68,13,22,81
11165,-1.9404999999977952,5021.85,48,7,24,55
11166,-12.266749999998726,2098.625,21,12,29,33
11167,-9.446249999998349,1528.25,43,8,15,51
11168,-39.19824999999913,2188.0,24,8,22,32
11169,-28.64724999999887,3420.3,31,8,23,39
11170,7.801500000001451,6240.1,72,8,18,80
11171,3.6892500000012083,2102.235294117647,41,9,16,50
11172,8.182250000001023,4687.15,46,1,25,47
11173,-1.5624999999993148,3275.4210526315787,60,9,19,69
11174,-2.7109999999988084,3005.235294117647,56,9,16,65
11175,-13.495999999997371,1563.4666666666667,47,9,20,56
11176,-28.201249999999078,3319.5,31,8,18,39
11177,-18.6382499999988,1974.3529411764705,45,19,9,64
11178,-7.570499999998122,2021.6666666666667,38,20,17,58
11179,-1.1047499999985766,3412.3684210526317,51,10,15,61
11180,-6.950999999998598,3142.5,54,17,16,71
11181,0.08150000000122173,3558.45,32,9,20,41
11182,1.4055000000008173,3843.35,45,7,19,52
11183,1.6247500000011357,4355.473684210527,62,12,14,74
11184,-27.910249999999678,2434.0526315789475,20,16,18,36
11185,-0.7742499999985124,1880.4375,46,11,13,57
11186,-19.013749999999725,3127.5,22,9,18,31
11187,-11.385249999998106,2382.3529411764707,37,15,20,52
11188,-0.9682499999996482,2766.8888888888887,51,13,16,64
11189,-37.59824999999968,1993.388888888889,12,9,21,21
11190,-13.091249999998317,2520.777777777778,35,17,17,52
11191,-14.26724999999924,3153.65,33,5,18,38
11192,-15.27949999999856,2766.777777777778,40,19,18,59
11193,-33.495249999999146,3505.25,27,13,22,40
11194,-3.0304999999992503,3309.5789473684213,39,13,14,52
11195,15.676750000001643,2585.0588235294117,68,18,8,86
11196,-3.5324999999985494,1929.0,48,12,21,60
11197,-30.029749999997694,4772.75,44,9,16,53
11198,-7.287249999999038,2225.6470588235293,36,11,15,47
11199,-33.23350000000001,1429.0,18,4,31,22
11200,0.6352500000006662,3399.0555555555557,55,10,20,65
11201,-27.785499999999473,2338.222222222222,19,15,16,34
11202,6.615250000001895,2161.1176470588234,46,8,14,54
11203,-6.617499999998415,3096.6666666666665,32,10,22,42
11204,-40.513999999999484,2186.235294117647,17,2,28,19
11205,-16.213749999998953,2686.6111111111113,37,7,19,44
11206,-24.604000000000536,2403.764705882353,45,31,22,76
11207,-9.790249999998816,3896.0526315789475,71,14,13,85
11208,-3.3772499999992385,1550.0625,51,8,23,59
11209,11.77950000000174,2827.705882352941,51,14,15,65
11210,-33.33649999999936,1505.2,22,19,16,41
11211,-12.851999999998991,2901.777777777778,31,9,29,40
11212,8.254750000000978,3546.1052631578946,60,15,18,75
11213,-2.6289999999985385,2343.3333333333335,67,15,18,82
11214,1.7797500000010438,4153.421052631579,49,11,22,60
11215,1.1090000000026063,2929.5882352941176,68,17,18,85
11216,18.700500000000368,3632.9473684210525,56,8,20,64
11217,3.6450000000007554,3328.235294117647,53,16,15,69
11218,-25.904749999998664,2251.1052631578946,23,17,15,40
11219,2.9435000000018237,4122.75,53,11,18,64
11220,-30.163749999999204,2072.8333333333335,19,9,24,28
11221,22.60325000000114,3869.315789473684,67,9,16,76
11222,-34.6897499999997,2200.1052631578946,14,13,20,27
11223,-19.897499999999614,2143.3529411764707,28,13,20,41
11224,9.18225000000065,2023.25,47,15,13,62
11225,-20.787749999998947,2655.25,25,12,20,37
11226,-17.564249999999383,2502.5789473684213,38,13,17,51
11227,-49.4182499999996,1429.0,0,13,24,13
11228,-20.636999999998984,2643.7894736842104,24,12,35,36
11229,-4.735749999998776,2618.6470588235293,41,17,15,58
11230,-11.15049999999757,1930.0625,46,15,13,61
11231,-17.83274999999926,2385.777777777778,28,4,27,32
11232,-25.893999999999057,2612.842105263158,29,17,14,46
11233,-23.852999999999103,3279.0,28,13,18,41
11234,-5.958499999998652,2452.5263157894738,21,13,25,34
11235,-22.864249999998783,3107.65,28,13,18,41
11236,-38.02524999999998,1429.0,7,9,20,16
11237,4.2980000000024585,2711.0588235294117,61,17,12,78
11238,-25.811249999998278,3106.6315789473683,28,3,37,31
11239,-27.565499999999084,1878.0,30,12,23,42
11240,-8.606499999998288,2878.6875,56,18,12,74
11241,-10.227749999998272,3280.315789473684,45,12,15,57
11242,-11.1979999999993,3094.8947368421054,35,11,24,46
11243,-11.394749999999798,2936.1052631578946,43,16,14,59
11244,-16.50224999999838,3688.65,41,3,25,44
11245,-28.95599999999859,4181.35,39,13,17,52
11246,-5.676999999998998,3338.55,37,11,21,48
11247,1.3120000000011767,2718.222222222222,45,6,24,51
11248,11.691500000003325,2623.235294117647,64,1,27,65
11249,-26.022249999998927,4762.4,49,13,11,62
11250,-36.06274999999938,2738.65,27,9,15,36
11251,-8.929999999998609,2452.4736842105262,33,18,9,51
11252,-17.63099999999931,1429.0,26,6,35,32
11253,-13.354249999998274,2416.8823529411766,45,16,26,61
11254,-3.6114999999995847,3237.7894736842104,45,9,15,54
11255,5.147250000002418,4398.1578947368425,61,7,22,68
11256,-24.30024999999873,2308.3333333333335,25,18,18,43
11257,-1.5087499999992173,3606.277777777778,46,19,15,65
11258,-25.26124999999971,2658.7368421052633,30,9,23,39
11259,-8.89499999999986,2500.9411764705883,50,8,24,58
11260,-15.886249999999004,2530.0,20,8,23,28
11261,-20.28249999999867,4048.85,35,10,18,45
11262,-45.37724999999999,1429.0,6,12,30,18
11263,-7.1299999999992565,3740.95,40,13,18,53
11264,-38.38924999999974,2290.3684210526317,19,18,12,37
11265,-36.55324999999941,1996.6470588235295,8,15,33,23
11266,8.937500000003102,2097.529411764706,73,8,26,81
11267,-27.19849999999881,3179.9,34,15,16,49
11268,-13.543999999999551,2778.2105263157896,35,15,16,50
11269,3.103750000000281,2820.294117647059,52,15,16,67
11270,-22.40124999999913,2384.7894736842104,21,7,23,28
11271,17.24025000000163,3441.4444444444443,61,9,15,70
11272,-4.419750000000002,2512.9444444444443,41,16,12,57
11273,-5.289249999999839,3501.0,49,8,21,57
11274,-26.984749999999092,3192.55,27,12,24,39
11275,-10.857499999999238,2598.7368421052633,39,9,20,48
11276,-22.962249999998853,3094.842105263158,37,6,26,43
11277,-22.648249999999308,2113.315789473684,21,11,20,32
11278,-14.208999999998596,4141.75,42,6,19,48
11279,-11.805999999997804,2194.705882352941,35,10,24,45
11280,-30.488499999999455,2883.0,19,12,21,31
11281,-1.2544999999985933,2397.176470588235,63,7,26,70
11282,-27.02824999999976,2429.8947368421054,25,1,28,26
11283,-16.754749999998744,3168.315789473684,40,11,16,51
11284,-44.243249999999506,2084.1052631578946,14,13,19,27
11285,-7.597749999999246,3028.6111111111113,40,11,28,51
11286,-24.202999999999243,2144.157894736842,16,5,25,21
11287,-10.467749999998293,2271.3333333333335,32,15,15,47
11288,-24.25249999999948,3327.5,31,9,19,40
11289,-29.330249999998735,2542.684210526316,21,5,24,26
11290,-7.952499999997613,1706.8125,37,10,26,47
11291,-4.340999999997409,4124.9473684210525,51,11,25,62
11292,-15.48849999999853,4192.6,36,16,22,52
11293,-1.3969999999982103,4553.473684210527,62,7,17,69
11294,-18.64149999999938,2594.5263157894738,19,9,18,28
11295,-17.708749999997885,2921.1111111111113,41,5,30,46
11296,-15.889499999998685,2533.1666666666665,41,12,20,53
11297,6.4630000000018,4173.55,44,17,14,61
11298,2.9345000000007953,2679.6666666666665,46,5,25,51
11299,-22.989499999998362,3663.95,36,15,15,51
11300,0.8722500000012807,2312.9375,50,12,18,62
11301,-19.338749999999013,3737.75,34,15,16,49
11302,-5.63624999999991,2711.5263157894738,34,6,22,40
11303,-18.685249999997996,2183.529411764706,41,14,25,55
11304,-14.34249999999983,2134.9411764705883,32,16,28,48
11305,-7.807749999999163,2949.277777777778,39,11,12,50
11306,-32.95924999999999,2201.842105263158,21,17,15,38
11307,-6.249749999998889,3957.277777777778,60,11,24,71
11308,2.4572500000012774,4576.1578947368425,54,9,19,63
11309,-4.984749999999215,3812.6111111111113,69,7,24,76
11310,-28.6329999999986,2516.7894736842104,25,13,19,38
11311,-4.200749999999407,2532.222222222222,36,21,13,57
11312,7.579250000001737,2652.294117647059,66,11,25,77
11313,-6.577499999997803,1539.1333333333334,38,16,19,54
11314,-16.99674999999822,2290.8823529411766,53,7,20,60
11315,10.875250000002776,1988.5625,58,7,30,65
11316,-0.07899999999912347,3100.1666666666665,54,9,22,63
11317,-26.438749999999157,4403.65,46,11,19,57
11318,-26.20449999999953,1457.6,29,16,21,45
11319,-2.1702499999990272,2830.875,67,19,18,86
11320,-7.857499999997723,2626.0588235294117,41,10,21,51
11321,-24.04149999999917,2607.222222222222,40,14,24,54
11322,-12.514999999998494,1974.3529411764705,36,10,17,46
11323,-8.052249999999257,3042.2105263157896,25,13,20,38
11324,9.821750000000746,2960.777777777778,66,10,18,76
11325,-15.867749999998324,3549.8888888888887,50,19,21,69
11326,-17.094749999998996,3026.4210526315787,28,22,14,50
11327,-24.60174999999895,2033.0555555555557,28,10,17,38
11328,-4.117749999999969,2788.315789473684,53,10,17,63
11329,5.608249999999757,3222.722222222222,61,15,12,76
11330,-5.005249999999236,2429.125,60,10,27,70
11331,-14.224999999999596,3651.277777777778,55,26,9,81
11332,-17.104749999999466,2457.222222222222,31,13,20,44
11333,-18.244749999998707,3797.35,44,7,24,51
11334,-14.222749999999206,2030.3529411764705,29,17,18,46
11335,-11.842999999999263,3259.5263157894738,38,19,16,57
11336,-16.904499999999018,3159.2105263157896,31,9,16,40
11337,-15.849999999999833,2640.4210526315787,41,10,15,51
11338,0.5985000000020577,2963.235294117647,57,16,14,73
11339,-1.6979999999996331,2542.9411764705883,35,22,11,57
11340,-34.69574999999886,1523.25,23,18,19,41
11341,-18.481999999999257,3147.3,28,14,17,42
11342,-17.76674999999897,2854.2105263157896,28,19,11,47
11343,-19.74649999999931,3200.1052631578946,36,12,27,48
11344,-17.79474999999892,2643.764705882353,41,9,22,50
11345,-0.8072499999984839,1481.9333333333334,51,10,26,61
11346,-4.401499999998579,3083.85,40,14,15,54
11347,-11.484749999999126,2101.235294117647,38,16,18,54
11348,14.415750000000944,4739.4,49,15,14,64
11349,-15.607499999999245,2148.25,41,13,16,54
11350,-22.340499999999444,2816.7894736842104,23,7,35,30
11351,-17.655749999999024,3168.4210526315787,40,12,34,52
11352,-23.49299999999977,2911.8947368421054,26,11,23,37
11353,-10.864499999997909,3041.0555555555557,45,12,14,57
11354,-19.196999999999708,2598.7894736842104,44,13,13,57
11355,-25.826249999999174,2208.45,18,10,18,28
11356,-9.26274999999907,3529.9,37,9,13,46
11357,-5.389749999997926,2825.0,48,3,22,51
11358,-11.742249999999746,2672.8823529411766,48,14,19,62
11359,-12.618999999999307,1572.875,20,11,23,31
11360,-21.43474999999872,1542.125,28,11,23,39
11361,-10.07024999999933,2683.8947368421054,23,16,17,39
11362,-3.4662499999980936,2152.705882352941,41,7,25,48
11363,-47.40299999999984,1429.0,0,17,13,17
11364,23.132250000003197,3965.222222222222,85,12,14,97
11365,-14.61274999999831,3639.4,43,4,22,47
11366,-6.596499999998497,3429.1052631578946,38,13,20,51
11367,-8.573249999998911,2568.294117647059,54,16,20,70
11368,3.095250000002145,2712.875,69,15,22,84
11369,-21.531999999999638,2072.4210526315787,24,14,15,38
11370,-14.330749999999615,2627.5,38,15,17,53
11371,11.045250000000816,3090.4444444444443,58,8,20,66
11372,-24.525999999999485,2629.5789473684213,24,7,22,31
11373,-22.43349999999969,1429.0,19,23,17,42
11374,-16.908249999998326,3490.2,38,17,18,55
11375,-13.842999999998966,2231.5555555555557,25,12,15,37
11376,0.6617500000009312,3825.0,41,16,15,57
11377,-30.573499999998877,2927.45,22,14,17,36
11378,-6.638749999998903,3565.6,40,7,13,47
11379,0.3547500000019438,3364.6666666666665,57,14,18,71
11380,-2.0649999999969912,3060.294117647059,60,6,18,66
11381,-14.542249999999228,3806.0,37,20,17,57
11382,-5.356499999999411,4455.15,44,7,24,51
11383,-34.5302499999994,2591.9473684210525,23,10,26,33
11384,2.162000000001103,2185.722222222222,39,12,17,51
11385,-17.94524999999904,2596.55,22,11,14,33
11386,-2.3039999999991654,2215.235294117647,40,13,17,53
11387,-28.857749999999772,2140.15,9,17,15,26
11388,-29.47875000000015,1429.0,26,9,33,35
11389,-13.073499999999834,1429.0,19,19,9,38
11390,-8.629999999997715,2415.8888888888887,44,11,19,55
11391,-36.30349999999903,2602.9473684210525,18,5,34,23
11392,-13.040249999998583,2977.9473684210525,34,20,13,54
11393,-26.996499999999422,2826.65,22,8,21,30
11394,-7.895499999999281,3311.6,32,10,17,42
11395,-4.045999999998055,3093.222222222222,45,6,25,51
11396,-20.35075000000003,1429.0,27,28,10,55
11397,18.292250000001765,3055.5882352941176,62,12,16,74
11398,-28.191999999998835,3567.7368421052633,32,19,19,51
11399,-25.330999999999413,3079.8888888888887,30,18,27,48
11400,1.778250000000306,2681.277777777778,56,12,17,68
11401,-17.313499999999276,2676.0,24,11,17,35
11402,10.88624999999948,2080.875,54,20,22,74
11403,2.374500000001371,4948.736842105263,45,4,24,49
11404,-2.7342499999982897,4616.0,67,12,24,79
11405,-36.486749999999546,2148.1,9,21,19,30
11406,-6.006499999998732,2445.8333333333335,28,7,29,35
11407,-23.23999999999902,2228.3529411764707,26,6,26,32
11408,9.266000000001302,2495.5,63,13,14,76
11409,-6.380499999999257,2627.0,40,20,14,60
11410,14.259750000001645,4718.75,61,17,10,78
11411,-14.16449999999925,2184.470588235294,43,12,21,55
11412,13.036000000000831,3462.5882352941176,74,22,9,96
11413,4.352750000002308,3811.8888888888887,71,12,15,83
11414,39.70750000000217,5663.25,69,11,16,80
11415,-22.715749999999183,3287.9,32,12,17,44
11416,-0.9220000000000095,3094.9473684210525,39,4,26,43
11417,-4.570749999998627,2794.176470588235,43,17,16,60
11418,-18.45324999999914,3421.9,27,15,15,42
11419,4.001500000002588,5076.65,64,13,18,77
11420,12.36550000000197,2774.5882352941176,51,9,19,60
11421,5.27300000000115,4273.631578947368,60,13,17,73
11422,-4.904749999999038,3844.25,41,3,18,44
11423,0.31850000000137707,2711.277777777778,48,23,17,71
11424,-5.781999999998412,3084.0,42,10,16,52
11425,-25.15749999999965,2143.375,31,21,13,52
11426,-35.06975000000036,1429.0,19,11,27,30
11427,-19.000749999997385,1534.8666666666666,36,16,25,52
11428,4.346750000001275,3266.777777777778,55,11,19,66
11429,10.249000000001498,5127.4,62,12,16,74
11430,5.610500000001167,4042.2631578947367,63,2,19,65
11431,-7.837749999998903,2803.470588235294,55,8,33,63
11432,-7.344749999998498,2938.722222222222,42,18,13,60
11433,-12.371999999998826,3242.9444444444443,48,10,26,58
11434,-23.722249999999566,2533.5263157894738,25,10,22,35
11435,-24.257999999998596,2578.9444444444443,34,13,24,47
11436,9.52450000000216,5094.894736842105,77,3,21,80
11437,-32.001249999998635,3406.1,35,5,24,40
11438,1.7055000000030802,4501.35,67,9,13,76
11439,-0.524749999999921,2690.9444444444443,52,15,23,67
11440,-17.033499999999197,3087.722222222222,52,8,28,60
11441,4.189500000000088,2311.4117647058824,50,19,22,69
11442,-21.208999999999484,2155.1052631578946,35,6,26,41
11443,-10.436999999999937,2117.5263157894738,27,12,30,39
11444,-3.9132499999990316,2400.1176470588234,36,9,22,45
11445,-26.447749999998774,2116.5789473684213,15,14,25,29
11446,1.041000000000324,3169.2631578947367,41,18,16,59
11447,15.945000000002244,5052.15,69,9,14,78
11448,-52.43049999999961,1429.0,2,13,21,15
11449,-13.41774999999933,4971.1,55,17,15,72
11450,-17.361749999999546,2752.315789473684,31,12,14,43
11451,9.716500000002595,4873.526315789473,67,13,22,80
11452,-11.02899999999863,3632.8947368421054,73,15,17,88
11453,-33.11674999999947,2108.1111111111113,22,3,30,25
11454,-32.86474999999923,3047.2105263157896,23,8,30,31
11455,-22.014249999998803,2746.65,28,11,21,39
11456,10.28400000000094,4409.25,54,5,20,59
11457,-11.747999999999262,3397.277777777778,62,12,34,74
11458,-32.20199999999935,2691.3684210526317,19,14,23,33
11459,-23.690499999999354,2133.176470588235,41,17,19,58
11460,-9.238999999998835,2104.0588235294117,31,17,17,48
11461,-12.664999999998026,2349.764705882353,46,10,25,56
11462,11.19825000000069,3600.1666666666665,56,18,15,74
11463,-23.757249999998713,2471.0588235294117,32,13,20,45
11464,-9.579249999998957,2005.5625,32,5,26,37
11465,-11.032249999999834,2660.6470588235293,39,13,24,52
11466,7.062000000000916,3190.0588235294117,54,18,20,72
11467,-7.954999999998181,4535.5,44,9,23,53
11468,-1.5012499999991709,2899.1111111111113,44,12,18,56
11469,7.251000000000265,2366.5625,53,5,24,58
11470,-26.25374999999882,2072.2631578947367,18,13,27,31
11471,17.277000000001962,4050.5263157894738,62,7,21,69
11472,-7.791249999998755,3594.0,71,9,15,80
11473,-22.116499999999196,2944.5263157894738,38,13,22,51
11474,-8.561249999999468,2174.315789473684,16,6,30,22
11475,-12.866999999998834,1979.9411764705883,40,14,36,54
11476,-4.476999999998858,2335.8125,45,15,16,60
11477,-12.839999999999728,2620.5555555555557,28,10,18,38
11478,-2.6674999999980287,4643.789473684211,67,8,24,75
11479,-11.874749999998322,2221.8888888888887,34,20,13,54
11480,1.4555000000022857,2082.75,42,19,20,61
11481,-11.185499999999841,1576.875,32,15,17,47
11482,-0.45174999999969784,3087.8888888888887,53,15,21,68
11483,-17.452499999998352,1481.9333333333334,41,10,30,51
11484,-20.084999999998523,3731.55,43,4,21,47
11485,-5.158749999999076,2454.294117647059,47,16,18,63
11486,-36.28199999999926,2944.8,23,21,16,44
11487,-10.51899999999858,2612.1052631578946,34,20,9,54
11488,9.77775000000043,4019.7368421052633,55,7,16,62
11489,-19.164749999999938,2601.842105263158,35,21,12,56
11490,7.945000000002541,3888.6315789473683,57,8,19,65
11491,4.081000000001753,5757.6,56,13,22,69
11492,-7.3369999999980235,2110.705882352941,48,10,20,58
11493,-38.27025000000036,2185.1052631578946,23,10,27,33
11494,8.21025000000103,4494.15,54,13,16,67
11495,-25.016250000000177,1857.625,45,11,30,56
11496,0.3315000000019196,4833.8,56,22,29,78
11497,-31.659749999999992,1429.0,26,13,18,39
11498,-4.52299999999878,3270.5,42,11,16,53
11499,4.644000000001688,4096.526315789473,59,18,10,77
11500,-19.76899999999869,2974.5789473684213,35,10,21,45
11501,2.7935000000005408,3216.9473684210525,52,20,15,72
11502,-7.12774999999921,2080.764705882353,39,11,25,50
11503,-20.252499999999067,2925.5,37,17,21,54
11504,-17.184749999999177,3141.684210526316,31,20,18,51
11505,-26.198749999999343,2151.3333333333335,22,17,14,39
11506,-2.704749999998443,2866.6111111111113,35,6,29,41
11507,-6.205999999998693,2762.4117647058824,50,13,18,63
11508,-3.0507499999988115,2560.5,33,7,30,40
11509,-13.225749999998106,4817.25,50,12,17,62
11510,27.780750000002126,2724.1176470588234,54,4,27,58
11511,-8.332999999997918,2391.705882352941,50,14,17,64
11512,15.803000000002518,2835.294117647059,59,10,13,69
11513,-6.5097499999989115,2876.1111111111113,50,11,14,61
11514,-7.59374999999873,3624.45,46,15,10,61
11515,-9.660749999999295,3476.05,32,12,20,44
11516,-14.784749999999269,3205.25,36,14,12,50
11517,-7.9127499999986926,3212.1111111111113,48,7,23,55
11518,2.112750000002264,2425.294117647059,62,7,19,69
11519,0.06150000000063036,2116.8888888888887,45,19,14,64
11520,10.830250000001048,3628.684210526316,68,13,12,81
11521,8.516750000001363,2444.9411764705883,52,11,13,63
11522,-3.2177499999977854,5194.15,49,7,26,56
11523,-27.471499999998866,1608.625,13,11,26,24
11524,-7.855499999998199,2517.277777777778,38,19,12,57
11525,8.886500000000789,3360.6315789473683,62,12,21,74
11526,-0.3237499999993233,3627.1052631578946,51,7,23,58
11527,-4.3117499999975815,2660.6470588235293,65,11,32,76
11528,-23.319499999999756,2649.6315789473683,33,11,26,44
11529,-26.605499999998624,3787.0,41,15,22,56
11530,-13.49799999999928,2544.5555555555557,28,14,17,42
11531,7.069250000000622,3931.157894736842,45,11,20,56
11532,-21.221499999998333,3766.45,42,7,22,49
11533,-40.73849999999938,2144.294117647059,24,11,22,35
11534,2.5102500000015096,3020.777777777778,51,9,20,60
11535,-36.45199999999978,1925.4444444444443,10,19,18,29
11536,-13.063249999999798,3207.7368421052633,40,8,18,48
11537,-5.508749999997531,2085.75,45,12,26,57
11538,-11.119249999998775,3455.7894736842104,34,10,17,44
11539,-22.70774999999948,2548.15,22,12,16,34
11540,-14.466999999999626,2383.3529411764707,38,19,18,57
11541,4.606500000000982,5161.65,56,15,15,71
11542,-25.251499999998124,1528.25,27,10,26,37
11543,-30.983749999999475,3384.6,34,13,16,47
11544,-3.89524999999918,3230.157894736842,51,6,23,57
11545,-15.331749999998644,2633.6111111111113,46,15,19,61
11546,-15.076249999999494,2497.8333333333335,29,10,19,39
11547,-20.688499999999124,3962.45,34,7,21,41
11548,-32.72575000000032,1429.0,9,12,27,21
11549,8.189000000001649,3422.529411764706,48,11,21,59
11550,-21.285749999998565,2482.5789473684213,29,6,21,35
11551,-28.891249999999367,2953.7894736842104,38,7,23,45
11552,-2.5637499999989855,3049.7894736842104,39,14,12,53
11553,-17.232249999999357,2114.4117647058824,27,13,39,40
11554,-5.974249999998067,3305.823529411765,48,17,11,65
11555,1.2820000000021434,4013.8333333333335,62,8,17,70
11556,9.68100000000167,3459.9473684210525,49,11,13,60
11557,-9.218499999999148,2206.823529411765,42,7,29,49
11558,-18.144249999999204,2956.315789473684,37,7,26,44
11559,-12.726749999998855,3131.8888888888887,58,14,18,72
11560,0.04800000000131206,3591.157894736842,55,17,20,72
11561,-29.748999999998734,2684.7368421052633,23,21,16,44
11562,-3.638999999997927,4241.75,54,10,16,64
11563,-17.282249999999227,2979.6315789473683,30,1,28,31
11564,-0.4369999999994182,2324.529411764706,44,6,23,50
11565,-7.876249999998032,4258.4,58,11,21,69
11566,-5.611499999999193,3487.5789473684213,47,8,27,55
11567,-11.82874999999984,1481.9333333333334,33,8,29,41
11568,-7.897749999998142,1534.8666666666666,39,13,16,52
11569,-26.37024999999887,1675.0625,23,10,18,33
11570,-10.61124999999867,2817.5789473684213,30,14,24,44
11571,18.07650000000144,3952.0526315789475,68,6,13,74
11572,-30.969499999999023,1481.9333333333334,24,13,31,37
11573,-14.973999999997025,1984.6470588235295,37,8,27,45
11574,15.134000000001384,3711.3888888888887,72,6,20,78
11575,-32.18724999999945,2724.7894736842104,26,9,25,35
11576,-8.849749999998968,2822.3333333333335,50,9,22,59
11577,-3.3464999999996285,3183.8,36,12,14,48
11578,-11.239999999999498,2723.6111111111113,36,14,19,50
11579,-2.6972499999997366,2630.8823529411766,57,25,23,82
11580,-15.470249999999425,3972.9473684210525,49,2,23,51
11581,-1.1662499999992275,3891.8947368421054,51,8,20,59
11582,-18.580749999998893,2131.8888888888887,32,3,29,35
11583,-38.268999999999885,2220.2105263157896,11,21,15,32
11584,-12.70474999999971,2361.823529411765,38,14,13,52
11585,-1.4397499999996526,2063.8823529411766,41,13,23,54
11586,15.437750000001946,3583.684210526316,54,5,20,59
11587,-28.992749999999454,2129.1052631578946,16,21,12,37
11588,-30.040249999999173,1429.0,15,12,25,27
11589,-42.83824999999981,1429.0,6,5,28,11
11590,-8.777749999998754,2080.8125,39,32,14,71
11591,3.556750000002057,2985.5882352941176,53,15,12,68
11592,3.3017500000013813,3183.5263157894738,40,8,24,48
11593,-30.95774999999897,2144.157894736842,17,16,21,33
11594,-18.92724999999964,1670.0625,38,24,17,62
11595,-14.88999999999795,3151.7368421052633,47,4,15,51
11596,-13.847999999998416,3210.277777777778,50,9,18,59
11597,-9.577499999998274,2985.4444444444443,45,7,18,52
11598,-9.407749999998375,2752.235294117647,48,12,21,60
11599,-18.85774999999797,1976.235294117647,34,11,24,45
11600,-8.599249999998865,1925.0625,32,13,25,45
11601,-32.25124999999983,2958.684210526316,19,11,18,30
11602,-24.80724999999926,2391.764705882353,39,14,27,53
11603,-1.95374999999895,2273.375,47,9,21,56
11604,-10.103749999999291,2064.0,48,17,20,65
11605,12.325750000001323,2624.0,48,13,20,61
11606,-7.567749999998957,4202.9,48,14,15,62
11607,-20.06724999999954,3111.6315789473683,45,6,26,51
11608,-4.952999999998331,3875.1,42,10,22,52
11609,-8.137999999997621,2139.375,46,16,19,62
11610,-24.714999999999897,1839.75,26,11,27,37
11611,-1.7822499999991415,3397.3333333333335,56,4,21,60
11612,-14.242249999999672,2623.1111111111113,38,7,17,45
11613,-20.14774999999908,2758.55,17,12,22,29
11614,-3.123999999999156,3115.294117647059,51,20,16,71
11615,-13.189999999998374,2534.5882352941176,53,5,23,58
11616,-2.6594999999982822,3655.4736842105262,52,17,14,69
11617,-20.394999999999385,3854.4,41,16,10,57
11618,2.3500000000005246,3636.2631578947367,41,10,22,51
11619,-4.068499999999764,2462.5882352941176,60,8,18,68
11620,-30.208999999999588,2097.4,12,9,17,21
11621,-25.11024999999813,2600.1111111111113,21,4,46,25
11622,-22.114499999999133,2672.75,19,21,14,40
11623,-26.288499999997867,2253.6470588235293,34,14,23,48
11624,-9.39399999999854,2527.25,47,14,23,61
11625,-34.834999999999354,2831.7894736842104,27,4,39,31
11626,4.545500000000904,2429.0,58,12,21,70
11627,-5.948999999998948,3237.8,36,12,13,48
11628,-2.995749999999677,2496.294117647059,46,17,19,63
11629,18.120000000001188,3502.823529411765,73,10,16,83
11630,-11.769249999999476,2501.823529411765,40,16,23,56
11631,6.862500000001559,2893.176470588235,49,8,16,57
11632,-22.048999999999413,2639.8333333333335,32,12,26,44
11633,1.1665000000019565,2703.529411764706,59,7,28,66
11634,-15.983749999999592,3452.4736842105262,36,13,18,49
11635,-5.748999999998944,3490.0526315789475,36,12,18,48
11636,-14.980499999998779,3748.15,35,11,25,46
11637,-29.87399999999992,2319.823529411765,24,8,30,32
11638,-25.79799999999846,3419.842105263158,41,7,23,48
11639,-10.98949999999964,2774.6666666666665,40,8,21,48
11640,-26.30274999999973,2523.4210526315787,23,7,23,30
11641,0.6150000000012413,4751.35,39,25,12,64
11642,-29.406249999999698,2450.7368421052633,21,15,13,36
11643,-19.967749999999473,3159.15,31,6,26,37
11644,-0.21524999999879063,2122.8823529411766,33,10,22,43
11645,-1.029499999998607,3474.35,42,14,15,56
11646,-5.137749999999148,3243.0555555555557,63,11,18,74
11647,-14.592000000000041,2076.176470588235,62,16,19,78
11648,-4.323999999998418,3649.0,47,8,19,55
11649,-1.5984999999992417,3182.1111111111113,52,11,16,63
11650,-35.49024999999917,2158.45,15,20,13,35
11651,-37.29599999999824,3583.6315789473683,41,17,15,58
11652,11.77375000000159,2787.6470588235293,50,18,10,68
11653,-5.009499999997737,3901.3,46,13,23,59
11654,-3.701499999999419,3135.0,37,3,26,40
11655,-0.21299999999797875,3322.4444444444443,68,9,15,77
11656,-18.269999999998827,2953.0,36,6,27,42
11657,23.794000000002733,3459.0,75,9,19,84
11658,2.410999999999786,4024.277777777778,68,14,22,82
11659,-23.796749999999797,2538.4117647058824,37,22,17,59
11660,-22.310249999998966,2514.3684210526317,26,8,20,34
11661,-0.3584999999985918,2413.235294117647,39,4,22,43
11662,-5.8482499999982505,4914.85,66,14,21,80
11663,-20.801499999999383,2366.4210526315787,32,15,21,47
11664,-22.53849999999864,2631.8333333333335,43,20,14,63
11665,-31.123249999999512,2623.0,27,14,18,41
11666,-29.783499999999037,2454.176470588235,28,14,19,42
11667,-5.614749999999394,3825.05,36,5,15,41
11668,-11.158499999999746,3262.3888888888887,40,15,15,55
11669,-34.91024999999952,1429.0,8,12,26,20
11670,-11.84599999999905,3024.3888888888887,45,14,27,59
11671,-15.772749999997895,4360.8,42,15,26,57
11672,-4.257249999998979,2063.9411764705883,39,5,20,44
11673,-0.5402499999988014,3818.0,65,16,15,81
11674,-18.710999999998997,2084.0526315789475,22,9,22,31
11675,-9.900749999999398,2675.1666666666665,38,22,7,60
11676,-12.606749999997918,2997.705882352941,46,8,21,54
11677,9.551250000001573,3914.4736842105262,65,6,23,71
11678,-17.3737499999987,2584.3333333333335,34,12,25,46
11679,-5.039999999998983,2416.9411764705883,41,19,29,60
11680,-15.909749999998883,3015.55,33,5,19,38
11681,-20.242749999997663,2434.0,43,15,31,58
11682,-30.062749999999816,2421.5263157894738,29,11,20,40
11683,1.7730000000022481,4553.65,52,13,17,65
11684,14.577750000002345,2749.3529411764707,61,14,10,75
11685,-11.344249999998471,1965.8125,36,5,28,41
11686,8.726500000001852,2232.0588235294117,53,13,20,66
11687,-19.802249999999297,2286.176470588235,37,15,14,52
11688,-34.70349999999922,2987.8,25,16,20,41
11689,-13.887249999999515,1893.7222222222222,29,10,17,39
11690,-15.907999999998697,3509.3888888888887,41,23,14,64
11691,-18.13974999999792,2419.125,41,8,21,49
11692,-35.66149999999949,2429.0555555555557,20,9,23,29
11693,-6.6379999999988915,2826.777777777778,43,13,20,56
11694,-24.12999999999937,2057.2631578947367,12,21,17,33
11695,-6.777499999998584,2569.3888888888887,37,13,15,50
11696,-29.24224999999938,1987.625,20,8,27,28
11697,-20.478749999999042,3487.5789473684213,47,8,23,55
11698,-16.178249999999213,4344.95,46,10,26,56
11699,-1.3249999999989428,3091.5263157894738,40,6,16,46
11700,-5.107749999998644,3664.75,40,12,16,52
11701,-19.959999999999383,2846.5,28,10,14,38
11702,-30.97924999999994,2282.0,19,7,42,26
11703,-19.021249999998627,2735.9444444444443,39,8,18,47
11704,1.9060000000003778,3139.8888888888887,41,10,18,51
11705,-12.996499999998832,3531.0,48,8,31,56
11706,-12.090499999999134,3468.75,33,17,11,50
11707,-43.89199999999964,1429.0,0,11,27,11
11708,-16.120250000000258,2084.470588235294,43,14,20,57
11709,-23.21949999999916,2982.9473684210525,27,10,21,37
11710,-30.985250000000104,1429.0,11,24,16,35
11711,6.05100000000207,2421.6470588235293,52,7,19,59
11712,4.5987500000013,4019.684210526316,64,5,22,69
11713,-5.181499999998398,2085.8125,36,21,11,57
11714,-2.016249999998707,3574.4210526315787,50,9,29,59
11715,5.891500000001615,5385.4,61,15,16,76
11716,9.835250000001553,3766.45,52,16,14,68
11717,-28.226499999998946,3421.5789473684213,31,18,18,49
11718,-35.23249999999974,2298.5555555555557,19,12,30,31
11719,-4.267999999998613,2482.6315789473683,33,10,18,43
11720,-16.97299999999935,3561.1052631578946,41,8,21,49
11721,6.387000000000692,2437.470588235294,54,19,15,73
11722,-17.835499999999165,2660.8,21,15,17,36
11723,-17.9687499999988,3125.7894736842104,33,19,13,52
11724,-23.690749999999817,1830.8125,57,28,18,85
11725,-12.460249999998416,2602.842105263158,32,16,16,48
11726,-16.22774999999906,3108.0555555555557,45,8,21,53
11727,2.786250000000627,3287.1052631578946,50,14,13,64
11728,-14.442499999999134,2514.0,48,11,21,59
11729,-27.701999999999504,1438.5333333333333,19,16,12,35
11730,-12.357499999996715,2573.705882352941,52,9,25,61
11731,-14.337749999998664,2270.3529411764707,31,14,16,45
11732,-22.36199999999902,2469.6666666666665,20,6,31,26
11733,-23.344999999999477,2672.75,22,6,19,28
11734,-34.7027499999994,2576.9473684210525,18,14,22,32
11735,-15.871999999999247,4268.75,41,8,22,49
11736,-3.9312499999994968,2045.125,32,23,15,55
11737,-23.21149999999854,3976.7,39,9,22,48
11738,-30.47824999999965,2583.5263157894738,25,6,28,31
11739,-18.350999999999413,1429.0,31,19,16,50
11740,17.68175000000335,1841.764705882353,63,12,15,75
11741,-14.017749999998477,4129.210526315789,63,17,21,80
11742,-26.87449999999986,1429.0,14,8,24,22
11743,7.3912500000023815,5417.1,73,10,19,83
11744,-5.041749999998016,4698.85,61,13,19,74
11745,-10.178499999999856,2393.8333333333335,29,5,34,34
11746,-14.934999999998741,2568.5,37,10,19,47
11747,-7.747999999998972,2384.0555555555557,35,3,20,38
11748,-5.904499999998292,3829.2105263157896,47,17,16,64
11749,-27.423749999998858,2726.9411764705883,36,12,18,48
11750,14.112250000000543,4798.9,51,5,29,56
11751,-11.204249999999103,3043.2105263157896,38,11,20,49
11752,-36.63075000000002,2617.8947368421054,18,5,53,23
11753,0.3847500000004237,2869.9444444444443,44,11,20,55
11754,-3.1919999999990827,3538.5263157894738,49,15,17,64
11755,-11.81949999999956,2794.0555555555557,50,3,21,53
11756,-9.165249999999572,2224.6875,50,16,22,66
11757,5.824750000001329,3831.7894736842104,45,8,23,53
11758,-30.05374999999875,2702.315789473684,24,19,18,43
11759,-23.430749999998852,2351.529411764706,29,11,21,40
11760,-43.04249999999978,1429.0,0,15,19,15
11761,-8.72549999999853,2820.3529411764707,44,9,17,53
11762,2.4507500000018254,3004.3529411764707,52,8,27,60
11763,2.560750000001911,4790.15,67,8,17,75
11764,-11.27699999999927,2441.277777777778,31,8,18,39
11765,-30.11699999999899,1534.8666666666666,24,8,23,32
11766,2.3207500000009262,2685.8823529411766,37,8,27,45
11767,-10.026499999997629,1481.9333333333334,41,19,17,60
11768,-20.557999999999645,1643.3125,26,17,18,43
11769,-33.70549999999915,1541.125,14,10,23,24
11770,-20.1557499999991,2475.7894736842104,32,16,15,48
11771,-5.937249999999457,2581.235294117647,56,10,16,66
11772,-5.5574999999980115,2166.6470588235293,31,13,22,44
11773,13.692750000001363,5197.736842105263,86,10,16,96
11774,-12.369749999999138,3167.3888888888887,52,8,20,60
11775,-23.487749999999274,3114.1052631578946,37,8,22,45
11776,-8.830249999999602,3278.277777777778,45,11,16,56
11777,-10.168499999999478,2754.4444444444443,42,22,22,64
11778,-1.9332499999999506,2921.0555555555557,53,21,19,74
11779,-23.07299999999907,2383.294117647059,30,12,24,42
11780,-1.1364999999988512,2014.375,37,7,23,44
11781,-11.944249999998581,3531.0,35,11,25,46
11782,-6.113749999997679,4160.105263157895,61,13,14,74
11783,-24.369249999999585,2147.4210526315787,21,10,14,31
11784,-27.103249999999868,2588.684210526316,21,8,27,29
11785,-2.9957499999979373,2110.823529411765,41,0,31,41
11786,-3.9352499999984474,3181.8947368421054,50,8,14,58
11787,-27.44599999999944,2556.05,16,20,14,36
11788,2.202750000000962,2773.529411764706,53,3,19,56
11789,-21.119749999998483,4747.4,51,9,24,60
11790,-28.137249999999785,1719.75,30,13,24,43
11791,-21.238999999999827,1696.875,22,8,21,30
11792,-8.886749999997807,3084.157894736842,35,7,30,42
11793,-6.430749999999111,3646.3684210526317,62,14,16,76
11794,-25.510999999999463,2535.9473684210525,21,6,23,27
11795,-39.789249999999605,1732.5294117647059,8,2,29,10
11796,11.31475000000078,3330.277777777778,43,12,18,55
11797,-24.839499999999138,2471.6315789473683,28,7,20,35
11798,5.172000000001438,3852.9,48,2,18,50
11799,-5.052749999999743,2034.0,43,17,19,60
11800,-15.282749999999151,3658.45,36,9,19,45
11801,-11.71999999999812,3669.7368421052633,51,7,18,58
11802,-39.37524999999935,2553.4444444444443,27,15,22,42
11803,-8.853749999999357,2233.9411764705883,37,4,28,41
11804,-19.820749999999848,2448.315789473684,27,21,17,48
11805,-23.949249999998905,2307.6470588235293,37,8,22,45
11806,-20.93774999999937,2248.823529411765,23,23,14,46
11807,-10.003499999998631,3098.15,35,15,18,50
11808,-16.673999999998827,3400.5,27,20,16,47
11809,-19.85824999999861,1841.7058823529412,25,24,12,49
11810,-33.944249999999485,1699.875,13,12,23,25
11811,5.284000000000349,3038.4444444444443,52,7,18,59
11812,-17.04999999999849,3038.8823529411766,52,14,23,66
11813,-13.73749999999978,2017.2941176470588,32,11,20,43
11814,-6.0629999999999304,2169.8333333333335,39,13,20,52
11815,8.70450000000177,2866.9411764705883,48,9,22,57
11816,-23.892249999998235,3091.5263157894738,27,11,28,38
11817,-20.666499999999356,2611.55,18,17,18,35
11818,0.5617500000008795,2883.1111111111113,75,23,13,98
11819,-24.954249999998446,1925.8235294117646,10,15,31,25
11820,-10.263749999999522,1866.0,47,12,25,59
11821,7.319500000000479,2891.235294117647,70,23,8,93
11822,-12.390999999998797,2763.4375,40,8,15,48
11823,-25.595999999998973,2623.8888888888887,33,13,24,46
11824,-31.19249999999972,2322.5,21,22,11,43
11825,0.2097500000025576,3525.222222222222,58,12,20,70
11826,-8.250249999999744,2017.2941176470588,32,7,24,39
11827,-15.86949999999914,3095.7,34,10,18,44
11828,-10.041999999997945,3933.05,44,6,30,50
11829,-10.117499999999584,2457.222222222222,46,9,19,55
11830,6.031250000001893,3685.4736842105262,46,8,22,54
11831,-20.08249999999894,2529.4736842105262,23,11,20,34
11832,-29.91249999999959,3116.5789473684213,26,5,28,31
11833,6.5737500000011435,3876.842105263158,56,18,11,74
11834,-17.84774999999905,1782.25,28,8,20,36
11835,3.2442500000016694,4525.85,56,10,15,66
11836,-21.952749999999607,2619.6315789473683,26,11,17,37
11837,-9.382999999999948,1481.9333333333334,24,13,20,37
11838,-14.87974999999987,2829.3333333333335,29,6,28,35
11839,-22.810999999999005,4075.9,33,12,24,45
11840,-14.249749999999855,4589.473684210527,55,10,27,65
11841,-10.173249999999651,2885.8333333333335,35,10,21,45
11842,0.5790000000000651,2311.3529411764707,47,22,18,69
11843,-6.669749999999661,2883.1111111111113,45,13,26,58
11844,30.327750000001352,5764.894736842105,93,14,12,107
11845,5.245250000001783,2649.3125,55,11,14,66
11846,26.28425000000191,3664.3529411764707,81,5,23,86
11847,-22.07674999999874,2166.1875,23,21,16,44
11848,-16.181999999999498,2898.277777777778,31,9,21,40
11849,-12.836499999999006,2653.0,29,11,16,40
11850,-27.98049999999957,2787.9,25,14,16,39
11851,-5.998249999999613,2054.0625,62,10,23,72
11852,-20.28299999999918,1534.8666666666666,26,4,23,30
11853,-17.966499999999368,2365.5555555555557,26,14,21,40
11854,21.70525000000203,2317.9375,74,7,18,81
11855,-31.54299999999862,1528.25,11,12,31,23
11856,-14.708249999999277,1920.125,39,20,10,59
11857,-0.265999999999398,4375.85,42,13,17,55
11858,-1.7189999999984351,2179.5,37,12,16,49
11859,6.680000000002198,2291.1875,58,24,22,82
11860,-11.740499999999432,2854.1111111111113,44,13,12,57
11861,10.217250000003355,3354.0555555555557,65,14,14,79
11862,1.7382500000015995,4075.8,45,7,22,52
11863,3.1172500000010763,2509.4117647058824,55,11,19,66
11864,-31.451999999999778,2008.4,12,9,17,21
11865,-15.055999999998301,2986.2631578947367,36,8,21,44
11866,-8.84399999999902,2640.722222222222,29,13,19,42
11867,-11.128499999998937,3186.6111111111113,33,13,22,46
11868,-4.004749999997691,3162.722222222222,52,10,15,62
11869,7.384250000001335,3052.5555555555557,57,17,17,74
11870,5.779000000003224,3731.5555555555557,61,4,26,65
11871,-26.39924999999861,3460.0526315789475,34,15,22,49
11872,0.9120000000014288,3821.0,58,9,13,67
11873,-22.156749999999132,3398.95,41,10,18,51
11874,-28.240999999999566,2294.5263157894738,15,7,25,22
11875,10.249750000001422,2342.8125,59,10,14,69
11876,-12.10299999999921,3054.7894736842104,33,12,18,45
11877,-10.737749999997133,2502.8823529411766,50,15,15,65
11878,-3.1467499999979,3391.1666666666665,61,21,16,82
11879,-23.00899999999875,2734.0,29,8,27,37
11880,4.387000000001208,4108.315789473684,75,14,17,89
11881,-21.324749999999106,2810.8947368421054,28,6,20,34
11882,4.08925000000166,2421.6470588235293,32,13,26,45
11883,-10.048999999998959,3756.8,40,7,19,47
11884,-24.72975000000006,2276.157894736842,20,8,22,28
11885,-1.9507499999982856,4072.315789473684,41,15,16,56
11886,-31.93249999999888,1429.0,32,21,29,53
11887,-19.240249999998944,2876.8947368421054,28,7,27,35
11888,0.5732500000013381,2929.0555555555557,49,10,21,59
11889,-8.63499999999885,3236.157894736842,30,18,18,48
11890,-24.923499999999116,2592.1666666666665,30,11,22,41
11891,-6.040999999998,2728.8333333333335,53,10,14,63
11892,-12.917999999998765,2638.8888888888887,40,5,35,45
11893,-4.888999999998554,3100.0555555555557,37,10,21,47
11894,-15.205499999998366,4867.95,45,4,25,49
11895,-22.49324999999869,3156.0,36,5,23,41
11896,-21.242249999998712,2338.222222222222,28,8,18,36
11897,-21.37274999999949,2735.1111111111113,31,6,24,37
11898,-19.035749999998284,3775.85,46,8,18,54
11899,-41.25749999999899,2116.0,22,8,35,30
11900,-39.92949999999966,2120.7368421052633,15,27,14,42
11901,14.706250000000384,4071.9444444444443,58,20,13,78
11902,-22.542999999998372,3575.2631578947367,38,7,25,45
11903,-7.746499999999588,2371.5625,48,11,24,59
11904,0.8800000000011282,2322.3888888888887,41,13,20,54
11905,-8.926499999998242,5107.65,62,11,21,73
11906,-21.802749999999232,1755.375,27,12,24,39
11907,-11.632749999998321,3565.2631578947367,40,13,13,53
11908,-23.50049999999887,2043.6666666666667,22,19,19,41
11909,-17.274249999998336,2628.3888888888887,36,3,25,39
11910,-16.88149999999941,3591.157894736842,47,14,18,61
11911,12.40525000000164,4410.736842105263,64,7,23,71
11912,17.604250000003546,5170.105263157895,74,19,21,93
11913,-10.08449999999834,4857.55,50,20,18,70
11914,2.070250000000881,3888.5263157894738,44,23,11,67
11915,1.6867500000021298,3713.9473684210525,46,8,20,54
11916,5.698500000002023,2587.823529411765,59,10,24,69
11917,-2.9587499999985614,2787.9444444444443,41,12,21,53
11918,9.28250000000156,5837.9,63,8,19,71
11919,-17.321999999998877,2081.75,29,10,19,39
11920,-0.036250000000335805,2508.3888888888887,58,13,18,71
11921,-27.782999999999312,2944.5263157894738,19,3,30,22
11922,-34.15699999999915,2200.235294117647,20,12,19,32
11923,-7.340749999999038,3266.777777777778,45,15,14,60
11924,-4.452499999999263,2475.764705882353,46,12,23,58
11925,-4.964249999998079,3465.3333333333335,59,14,16,73
11926,-23.95774999999893,2366.5,33,10,16,43
11927,-34.51949999999955,2533.5789473684213,27,12,19,39
11928,-21.88574999999837,2337.5882352941176,36,7,19,43
11929,-10.07649999999893,4343.35,46,15,17,61
11930,-20.613749999998785,3064.8947368421054,44,12,15,56
11931,-22.74799999999853,2916.1052631578946,30,7,30,37
11932,-14.671749999998696,2758.8333333333335,30,10,22,40
11933,1.0090000000010235,2750.625,44,12,21,56
11934,9.406750000001718,2501.4444444444443,44,6,22,50
11935,-24.14624999999873,1715.75,25,8,23,33
11936,-9.999499999999067,2324.470588235294,33,15,22,48
11937,-18.896999999999274,3660.05,38,12,14,50
11938,-2.9142499999997042,3207.6666666666665,47,22,22,69
11939,-29.23999999999969,2961.6,24,10,19,34
11940,-38.260249999999395,2215.65,12,13,19,25
11941,-34.26524999999951,2287.0,12,10,22,22
11942,-8.92499999999867,3603.7,36,19,15,55
11943,7.926500000002198,4060.05,58,5,19,63
11944,-8.816749999998986,2705.8888888888887,42,11,10,53
11945,-12.210499999999287,2813.4736842105262,30,5,21,35
11946,-19.58449999999899,3233.75,30,11,27,41
11947,-22.324999999998987,1481.9333333333334,26,3,25,29
11948,-7.684249999998374,4049.7368421052633,56,10,34,66
11949,-27.07824999999923,2082.705882352941,22,15,14,37
11950,-21.57274999999897,3087.0,30,7,16,37
11951,-0.7872499999993502,2693.294117647059,66,6,22,72
11952,-37.54749999999998,1429.0,9,17,27,26
11953,-1.6697499999989869,2973.1666666666665,50,12,18,62
11954,-20.08824999999883,1534.8666666666666,34,4,21,38
11955,-30.165749999998404,1853.625,32,14,19,46
11956,-38.054249999999065,1429.0,30,17,29,47
11957,-36.65724999999968,1528.25,7,16,14,23
11958,7.2827500000013785,3921.9444444444443,53,12,24,65
11959,12.510000000000264,2952.8823529411766,49,26,18,75
11960,-17.820249999998435,2459.8823529411766,42,14,23,56
11961,-22.53324999999978,2831.7368421052633,39,13,19,52
11962,-14.269749999998378,3318.9473684210525,40,7,21,47
11963,-17.92349999999929,2248.8823529411766,39,13,21,52
11964,-14.01549999999898,2452.0,37,12,18,49
11965,-17.066249999998835,4225.1,42,7,14,49
11966,-7.6775000000002125,1949.9411764705883,42,14,19,56
11967,-15.520500000000155,2282.6111111111113,32,10,20,42
11968,-8.422499999999236,4357.7,42,9,15,51
11969,-25.060749999998684,3119.55,32,14,21,46
11970,2.098500000001396,3593.6315789473683,54,6,17,60
11971,-2.643499999999405,2623.9444444444443,36,4,25,40
11972,-21.610249999998345,1697.875,28,13,19,41
11973,-8.261249999999437,3358.2105263157896,51,14,18,65
11974,6.203000000000662,2778.4117647058824,68,15,22,83
11975,-21.803249999999036,3806.05,42,23,12,65
11976,-6.476249999998652,3048.2,39,14,15,53
11977,3.781750000002666,3274.777777777778,57,9,31,66
11978,-0.4557499999977262,5979.9,52,7,22,59
11979,-9.11599999999898,2930.8333333333335,36,15,17,51
11980,-29.00724999999907,3268.7368421052633,28,13,21,41
11981,-24.563999999998714,2164.823529411765,37,5,26,42
11982,-12.034999999998714,2589.823529411765,37,9,19,46
11983,-11.71249999999841,2896.0526315789475,27,19,19,46
11984,-5.705499999998997,4094.0526315789475,49,25,22,74
11985,9.104000000000557,2532.1875,54,21,15,75
11986,-16.35699999999907,4346.368421052632,48,23,15,71
11987,-18.536500000000082,2442.4210526315787,20,17,48,37
11988,2.02350000000121,3217.7368421052633,41,11,15,52
11989,-31.884249999999618,1576.875,14,5,32,19
11990,-27.026499999999203,2485.842105263158,21,8,21,29
11991,14.684000000001726,3005.176470588235,68,18,12,86
11992,10.542250000001378,4439.9473684210525,69,9,18,78
11993,-13.03874999999779,2931.157894736842,49,10,16,59
11994,-33.7957499999997,1545.125,30,17,23,47
11995,-7.184999999998995,2685.764705882353,38,7,19,45
11996,-26.953249999999247,2560.0,28,11,15,39
11997,-17.679249999999705,3657.157894736842,46,19,12,65
11998,-10.840499999999528,2800.0,39,15,15,54
11999,-25.872999999998832,2846.1666666666665,24,19,23,43
12000,-27.703749999999282,1567.9375,33,8,27,41
12001,-35.402499999999954,2274.722222222222,21,13,23,34
12002,-25.69124999999972,1429.0,20,7,32,27
12003,-8.644749999999966,2059.294117647059,43,9,31,52
12004,13.34975000000127,2545.0625,60,19,12,79
12005,-25.59074999999909,3280.6,21,12,19,33
12006,-5.414249999998695,2349.764705882353,42,12,20,54
12007,-10.54274999999888,2965.4736842105262,37,7,18,44
12008,-22.422999999998503,2869.315789473684,31,22,17,53
12009,-19.37099999999963,2666.2631578947367,22,6,22,28
12010,3.6132500000008947,4230.315789473684,56,23,12,79
12011,-3.289249999998502,2232.0588235294117,48,19,13,67
12012,6.850250000001379,2607.3529411764707,55,20,19,75
12013,-6.273499999998457,3054.1052631578946,36,11,20,47
12014,-24.883249999998917,3159.315789473684,36,15,13,51
12015,-11.809999999999466,2701.3684210526317,33,9,25,42
12016,-9.460749999999413,2718.9473684210525,26,15,15,41
12017,4.150250000000993,3090.5,55,25,8,80
12018,-16.328749999998376,3702.2631578947367,44,14,23,58
12019,-3.9474999999998097,2384.3125,51,8,25,59
12020,-19.112250000000238,1429.0,34,6,17,40
12021,-7.1297499999985,1476.6666666666667,44,18,17,62
12022,-34.80824999999896,2457.4210526315787,21,8,23,29
12023,-17.38474999999857,1751.5,26,7,23,33
12024,-22.247499999999217,2509.2631578947367,26,15,15,41
12025,-13.302749999998387,4939.4,46,11,25,57
12026,-22.796749999999708,2042.4705882352941,24,13,27,37
12027,-2.383249999998104,2164.8823529411766,44,4,22,48
12028,-18.792499999999144,2885.157894736842,40,8,10,48
12029,-23.633999999999364,3199.7,26,18,11,44
12030,-0.4289999999994107,2951.2105263157896,42,10,20,52
12031,-25.859999999999012,2691.7,18,10,19,28
12032,-10.834999999998498,2480.470588235294,31,16,23,47
12033,-2.567499999997554,5884.65,71,13,20,84
12034,-5.7204999999977995,2937.9444444444443,42,12,21,54
12035,-28.491999999999614,2312.4,16,11,19,27
12036,-7.102499999998083,3202.15,37,10,23,47
12037,-7.976999999998758,4396.6,52,19,16,71
12038,-23.219499999999233,2608.0,39,9,21,48
12039,-38.95349999999938,1429.0,6,13,23,19
12040,-45.94850000000008,1958.5294117647059,16,20,23,36
12041,-3.1374999999992887,2821.3888888888887,30,13,17,43
12042,-24.738499999999192,1917.5555555555557,34,9,28,43
12043,1.7575000000016814,4662.4,57,2,18,59
12044,-13.423249999998808,2672.764705882353,48,21,24,69
12045,-1.8979999999981867,3727.315789473684,41,18,12,59
12046,2.763000000001045,2184.0,57,12,17,69
12047,-27.099999999998364,2715.6666666666665,25,11,27,36
12048,-11.76574999999877,4410.05,46,14,15,60
12049,-9.058749999999707,3048.0526315789475,33,18,17,51
12050,-9.681499999999202,3206.7894736842104,38,15,18,53
12051,6.028000000000589,3393.8333333333335,51,18,11,69
12052,2.401750000002532,2674.5882352941176,66,14,23,80
12053,-3.700999999998934,4178.473684210527,64,12,17,76
12054,-37.336749999999526,2171.0,11,6,28,17
12055,-17.517999999999383,2383.3529411764707,32,10,19,42
12056,-6.234999999999156,2666.25,49,13,19,62
12057,4.885000000002046,4898.2,58,7,21,65
12058,0.19900000000296156,3354.1666666666665,60,15,16,75
12059,-11.39574999999775,2745.6666666666665,47,6,24,53
12060,-31.52149999999994,2958.45,20,10,25,30
12061,-21.49724999999861,2465.222222222222,55,7,26,62
12062,-3.507999999998991,1841.75,30,3,26,33
12063,-14.719249999999054,3119.6,36,7,21,43
12064,-13.050499999998403,1769.3125,27,13,19,40
12065,-12.696749999999346,2923.9411764705883,50,5,27,55
12066,-14.365499999998343,2073.294117647059,36,10,28,46
12067,7.296250000002667,3391.705882352941,60,13,15,73
12068,-15.535499999999121,2572.0,35,8,26,43
12069,-2.3582499999982356,3052.5,45,9,26,54
12070,4.029500000002331,4001.315789473684,54,7,20,61
12071,-7.130999999997935,3651.35,43,14,14,57
12072,-22.498999999999462,2130.235294117647,28,13,27,41
12073,-21.952749999999163,3744.7894736842104,46,14,25,60
12074,-21.68824999999996,3150.0526315789475,39,7,35,46
12075,-10.3157499999999,2126.470588235294,40,19,26,59
12076,0.3175000000007522,4685.3,44,15,18,59
12077,8.700750000001394,2601.9411764705883,56,13,15,69
12078,-24.279499999998627,2735.5789473684213,34,12,22,46
12079,0.8852500000020267,2188.125,47,17,14,64
12080,-9.59999999999927,2386.6666666666665,44,7,23,51
12081,-4.786249999998843,3350.5263157894738,65,14,16,79
12082,-9.870249999998347,2837.176470588235,46,7,23,53
12083,-33.027749999999365,2718.9473684210525,22,6,28,28
12084,-11.985499999998256,2350.6666666666665,36,12,16,48
12085,3.4585000000000554,1889.4375,45,20,13,65
12086,-18.789749999999025,2678.0,24,12,17,36
12087,-6.1752500000001005,1648.25,43,4,24,47
12088,2.103750000001323,3308.7894736842104,42,12,17,54
12089,-14.809999999999906,2397.277777777778,55,6,26,61
12090,-10.925499999999506,1996.7058823529412,26,3,26,29
12091,-9.809249999999082,1719.6875,38,11,33,49
12092,-6.170499999999175,3253.6666666666665,59,10,31,69
12093,-29.41574999999994,1429.0,21,9,22,30
12094,-18.111249999998382,4175.15,45,16,18,61
12095,-6.381499999999268,2840.764705882353,51,14,26,65
12096,-11.082499999998904,2388.0,32,9,20,41
12097,-9.559749999999571,3685.5263157894738,33,10,21,43
12098,-2.9039999999982324,2446.823529411765,48,4,17,52
12099,-11.557999999999282,3475.0526315789475,38,11,28,49
12100,-11.14874999999936,2290.8823529411766,42,11,22,53
12101,-14.148249999999635,1791.1875,38,11,27,49
12102,-3.743249999997129,5293.4,69,10,19,79
12103,-24.653749999999313,2922.0,38,11,24,49
12104,-12.588999999999423,2227.1666666666665,25,9,24,34
12105,-3.311249999999665,2274.0,52,6,19,58
12106,3.158000000000297,3307.157894736842,40,21,13,61
12107,-30.82274999999932,2261.9473684210525,17,3,28,20
12108,-3.7007499999982536,2110.6470588235293,34,14,19,48
12109,-15.079249999999755,3532.6315789473683,29,10,31,39
12110,-3.101749999999298,2509.3529411764707,49,19,23,68
12111,25.936750000001343,3481.1111111111113,70,14,16,84
12112,-17.467999999998852,2021.9411764705883,34,13,29,47
12113,-26.159249999998973,1539.0666666666666,28,16,18,44
12114,-3.0172499999989464,3420.7368421052633,46,9,21,55
12115,-33.20174999999952,2036.25,15,14,12,29
12116,-18.574499999999166,2038.842105263158,18,9,25,27
12117,-20.454249999998403,3928.3,48,12,19,60
12118,-8.813499999998466,3085.1666666666665,43,4,26,47
12119,-24.28624999999966,2883.0,22,16,19,38
12120,-0.2052499999995822,2825.8333333333335,46,3,32,49
12121,-10.187249999998167,3775.85,41,14,18,55
12122,-14.462999999998681,2749.1666666666665,38,7,23,45
12123,-12.68749999999902,3677.5,38,7,14,45
12124,-8.316999999997975,5144.2,53,9,32,62
12125,-25.08499999999895,2676.315789473684,30,11,19,41
12126,-1.9964999999994923,3228.5789473684213,49,13,15,62
12127,-28.02924999999957,2639.4,22,11,12,33
12128,-17.360499999998275,2692.777777777778,35,7,26,42
12129,2.132000000001335,3711.4736842105262,58,8,17,66
12130,-13.187999999999528,1809.0,25,6,27,31
12131,-2.687999999998573,2884.9444444444443,43,2,22,45
12132,-1.2984999999979885,4236.35,60,5,16,65
12133,3.162500000002666,2945.8333333333335,49,7,22,56
12134,-8.957249999999481,3382.2631578947367,39,11,22,50
12135,-18.998999999999533,2929.5789473684213,26,10,21,36
12136,-13.855499999998784,2358.0588235294117,41,10,24,51
12137,-6.964749999998956,2989.294117647059,43,13,11,56
12138,-14.537749999999054,3481.45,28,19,17,47
12139,-7.143999999999403,2528.722222222222,29,11,20,40
12140,-7.90149999999919,3946.2105263157896,45,12,19,57
12141,-21.248499999998824,2183.9444444444443,27,8,19,35
12142,-17.069749999999342,3398.15,30,16,22,46
12143,-2.8824999999974947,4394.2,47,3,26,50
12144,-16.246999999999016,3240.25,34,5,25,39
12145,-25.398249999999365,1576.875,7,18,22,25
12146,-3.6374999999975146,2398.1666666666665,51,17,15,68
12147,-0.006249999999544897,4500.9473684210525,51,3,21,54
12148,-27.746999999998973,2460.0,20,11,23,31
12149,-34.44849999999916,2804.2105263157896,10,6,43,16
12150,-20.633499999999053,2160.9473684210525,22,12,17,34
12151,-13.773999999997889,4156.9,47,12,25,59
12152,-9.765749999997457,3136.684210526316,47,6,21,53
12153,-11.61624999999872,3283.9,30,10,22,40
12154,-3.5717499999987097,4975.05,42,13,25,55
12155,-3.4287499999980526,3211.277777777778,42,10,24,52
12156,-1.9092499999988164,3317.9444444444443,49,10,20,59
12157,-29.71849999999889,2516.4,21,7,22,28
12158,-7.179999999998833,1558.1333333333334,61,8,32,69
12159,-15.561999999998255,2460.8125,42,4,25,46
12160,-7.640249999998639,4824.35,49,10,13,59
12161,-4.754499999998572,3678.6111111111113,43,11,22,54
12162,6.731500000002768,2810.8823529411766,60,5,22,65
12163,-26.943999999999875,2054.0625,29,13,41,42
12164,-27.44524999999847,2402.0,29,20,31,49
12165,-8.461749999999197,3004.6315789473683,49,8,21,57
12166,-20.81349999999886,3023.0526315789475,32,9,20,41
12167,-13.620999999998753,2822.3888888888887,41,11,27,52
12168,3.4597500000015,4133.0,50,6,20,56
12169,4.437500000002344,2119.0588235294117,45,13,15,58
12170,-20.366999999999017,4287.8,41,4,22,45
12171,-32.376749999998495,2364.842105263158,22,16,21,38
12172,-10.49724999999961,2457.277777777778,34,1,24,35
12173,5.871250000000908,3589.5263157894738,51,5,27,56
12174,-11.876749999999067,3283.9,31,11,19,42
12175,-14.013999999999005,2416.0,33,12,29,45
12176,-26.668749999999232,2363.8333333333335,23,4,23,27
12177,-14.663499999999354,2226.4117647058824,40,8,29,48
12178,-22.577249999998806,2446.875,43,6,25,49
12179,-18.19924999999859,4075.684210526316,53,17,14,70
12180,-20.85824999999901,2027.25,36,9,32,45
12181,-23.643499999998607,1648.25,44,5,20,49
12182,0.903000000000954,3708.2105263157896,37,7,21,44
12183,-13.401999999997708,2475.8823529411766,39,7,29,46
12184,-4.222999999998975,3484.2631578947367,41,6,18,47
12185,4.428500000001742,5332.25,58,15,17,73
12186,-18.26699999999944,2425.684210526316,21,11,26,32
12187,-30.70549999999854,2110.7894736842104,19,5,33,24
12188,-14.83074999999933,2780.7894736842104,28,6,26,34
12189,-24.170749999999355,2488.3684210526317,22,10,28,32
12190,4.211250000000513,2854.1111111111113,30,13,19,43
12191,12.361750000002273,4211.894736842105,52,3,24,55
12192,2.812250000001645,4338.166666666667,68,5,24,73
12193,5.663250000001755,4965.421052631579,85,10,26,95
12194,-33.51199999999926,2254.3888888888887,23,15,19,38
12195,-9.204499999998067,3364.722222222222,53,8,19,61
12196,3.1917500000016767,5278.3,57,12,21,69
12197,-14.862499999999404,3353.470588235294,50,14,16,64
12198,-23.57649999999958,1528.25,17,6,23,23
12199,-4.418999999998832,4281.1578947368425,48,10,26,58
12200,-36.7414999999991,2835.5555555555557,21,7,36,28
12201,-4.852999999997789,1983.6875,39,4,32,43
12202,-20.654499999999537,2681.4736842105262,32,6,45,38
12203,-0.7847499999996959,2967.842105263158,48,3,21,51
12204,-1.4737499999989025,2103.625,39,11,21,50
12205,3.372250000001517,4522.65,56,15,15,71
12206,-20.811499999998563,1438.5333333333333,22,16,20,38
12207,4.628000000001489,4701.3,51,18,16,69
12208,-18.878999999997397,2842.6111111111113,37,9,34,46
12209,-24.43774999999979,2540.1666666666665,35,13,26,48
12210,-23.453999999998008,2313.9375,34,21,28,55
12211,-17.546999999999436,3301.4,32,6,19,38
12212,3.6909999999999386,2436.8888888888887,51,12,15,63
12213,-24.77724999999968,2876.9473684210525,25,3,35,28
12214,11.704000000000963,2202.0,72,6,17,78
12215,-9.139249999998569,2128.5,44,10,19,54
12216,19.4982500000012,3977.1052631578946,56,10,17,66
12217,-19.118250000000042,3277.0,30,9,21,39
12218,-20.62049999999898,2750.8888888888887,35,8,25,43
12219,3.1680000000013147,4286.263157894737,57,5,21,62
12220,-9.754249999999654,2868.277777777778,47,13,12,60
12221,-3.2619999999996523,2050.0625,62,11,14,73
12222,-0.4787499999993658,4519.55,44,6,24,50
12223,-2.528249999998861,4206.75,60,7,17,67
12224,-2.735999999999428,3238.6666666666665,47,8,26,55
12225,-3.526999999998062,5478.25,55,11,25,66
12226,-34.130749999998784,2352.2105263157896,23,11,22,34
12227,-25.964999999999186,3301.2,21,8,25,29
12228,-17.857249999998743,4118.7,45,8,29,53
12229,-12.827249999998571,3419.1052631578946,39,12,19,51
12230,18.428750000002623,2505.6470588235293,58,8,20,66
12231,-26.095499999999713,1438.5333333333333,19,13,25,32
12232,-16.291749999999357,3175.05,30,7,22,37
12233,-8.672749999998606,5269.6,46,9,27,55
12234,2.856250000001461,4051.3,51,7,20,58
12235,-5.573999999997902,2467.4117647058824,43,8,25,51
12236,-25.1094999999992,2490.8947368421054,22,14,19,36
12237,0.9915000000006178,2889.3888888888887,52,15,18,67
12238,-22.467749999999285,2702.05,27,16,12,43
12239,-36.19624999999987,2229.3684210526317,12,9,30,21
12240,-23.676499999999155,2441.3888888888887,23,19,25,42
12241,-8.924249999999471,2122.8823529411766,38,6,19,44
12242,-33.66424999999889,1555.0625,6,8,42,14
12243,1.9207500000013336,3272.1111111111113,50,13,18,63
12244,-27.410999999998673,2009.2777777777778,18,9,29,27
12245,-5.494499999998508,3409.6666666666665,47,11,28,58
12246,-18.06574999999929,2489.8888888888887,30,8,19,38
12247,-27.806749999999294,2221.0526315789475,17,7,27,24
12248,-17.870749999998658,4034.65,43,19,14,62
12249,-4.398999999998763,3393.1052631578946,39,9,21,48
12250,-26.518999999998993,2852.15,26,9,21,35
12251,-8.493249999999257,2528.722222222222,40,11,24,51
12252,-44.3079999999998,1429.0,12,8,24,20
12253,-7.332749999997807,3056.0,56,10,19,66
12254,-16.03974999999847,2371.6666666666665,29,10,25,39
12255,14.44625000000048,3179.5555555555557,47,12,16,59
12256,0.08525000000227526,3703.157894736842,57,7,28,64
12257,3.8402500000017086,2613.0,48,5,24,53
12258,-6.940499999998947,3095.722222222222,40,22,20,62
12259,-3.0424999999988396,1894.375,32,7,22,39
12260,-17.40049999999892,3718.8,41,2,22,43
12261,-11.070499999999122,2344.9411764705883,37,16,19,53
12262,-11.85449999999775,4159.15,46,0,29,46
12263,-4.834749999999695,2063.9411764705883,58,7,23,65
12264,-13.675249999998854,3529.315789473684,31,20,18,51
12265,-12.803999999999352,3222.684210526316,38,12,18,50
12266,-18.28199999999786,3325.230769230769,45,6,21,51
12267,19.81900000000281,5621.2,73,13,16,86
12268,-29.252499999999863,2116.1666666666665,27,9,35,36
12269,15.533750000001017,3774.9473684210525,69,12,18,81
12270,22.017750000001993,3265.705882352941,71,12,16,83
12271,-10.138999999999779,2579.8333333333335,42,18,20,60
12272,-22.256750000000064,2410.7368421052633,21,7,45,28
12273,-21.039999999998862,2805.7894736842104,30,12,24,42
12274,-0.13074999999808182,4479.95,51,6,14,57
12275,-2.408999999999441,2616.9444444444443,31,18,23,49
12276,9.173750000000844,3422.0,56,7,22,63
12277,-36.418999999999,2762.3684210526317,18,15,28,33
12278,-4.157249999998756,3928.684210526316,55,20,15,75
12279,-7.9427499999987985,3591.157894736842,61,7,25,68
12280,-8.530999999998432,4270.3,56,10,22,66
12281,5.2382500000011705,1925.0625,53,9,18,62
12282,-1.5534999999988865,2551.4117647058824,48,13,17,61
12283,-37.623249999998976,1697.875,13,5,39,18
12284,12.21000000000286,5072.85,61,10,22,71
12285,-15.680749999999861,3349.722222222222,40,5,29,45
12286,-25.444249999998657,2531.7894736842104,28,12,22,40
12287,-20.496999999998877,3347.4,38,13,20,51
12288,3.2485000000007163,2400.1176470588234,41,11,16,52
12289,2.7992500000009173,2339.75,57,19,23,76
12290,-4.047999999999773,1467.1333333333334,69,11,27,80
12291,-16.830749999998,4662.4,39,11,26,50
12292,-21.391999999998085,3354.1666666666665,40,12,23,52
12293,-17.203499999998577,3752.3684210526317,36,10,22,46
12294,-2.073999999997549,4163.611111111111,65,6,23,71
12295,-8.235499999999057,2969.722222222222,34,7,16,41
12296,11.4497500000029,5483.05,71,15,18,86
12297,-27.14849999999858,2435.222222222222,23,8,36,31
12298,6.338250000003261,5470.3,78,14,16,92
12299,-4.3217499999982625,3673.3333333333335,57,16,12,73
12300,0.28825000000147244,4149.555555555556,53,18,19,71
12301,-0.6905000000001607,2116.0,41,9,17,50
12302,-39.02999999999937,2121.277777777778,12,17,24,29
12303,-4.265749999999356,3109.9473684210525,36,9,22,45
12304,-7.514999999998681,3019.8888888888887,37,7,32,44
12305,-26.76874999999963,3298.9,29,11,20,40
12306,-26.19149999999967,1830.8125,36,16,19,52
12307,12.256500000000099,2598.625,62,8,21,70
12308,3.023500000000398,2716.5,58,5,19,63
12309,-37.01424999999825,3018.1111111111113,34,16,41,50
12310,-14.492999999998114,4433.9,49,14,22,63
12311,-28.21499999999957,2985.4210526315787,24,9,25,33
12312,-33.35399999999941,2653.0526315789475,23,20,11,43
12313,-3.814499999998039,1848.625,56,15,32,71
12314,-22.31899999999916,3167.95,32,11,17,43
12315,-42.25974999999953,2051.3,10,8,22,18
12316,-37.4742499999994,2049.7368421052633,13,13,20,26
12317,-19.139999999998953,3691.05,42,21,13,63
12318,5.019250000000918,3467.5263157894738,23,8,32,31
12319,-24.323499999998354,3669.55,37,10,27,47
12320,-22.954249999999444,2571.9,19,12,23,31
12321,-12.805999999998761,2963.176470588235,55,11,20,66
12322,-7.741249999999285,3077.55,32,4,24,36
12323,-13.444749999999123,3298.6315789473683,34,5,23,39
12324,-16.338499999999442,3573.6315789473683,34,6,21,40
12325,-13.071499999998903,4033.85,41,15,15,56
12326,-5.401999999999926,2106.0,45,8,15,53
12327,-7.503249999999392,1684.0,21,14,25,35
12328,-3.193749999998731,3385.8888888888887,45,20,16,65
12329,18.095500000001604,3545.5,60,18,23,78
12330,-22.216749999998385,2229.235294117647,35,7,22,42
12331,-26.826249999999902,2094.842105263158,19,7,20,26
12332,-7.641499999999607,2089.176470588235,33,7,27,40
12333,-19.240999999999133,3320.4210526315787,33,15,19,48
12334,-23.633749999999615,2332.8823529411766,23,15,18,38
12335,-37.15874999999965,1567.9375,18,7,32,25
12336,-1.0697499999979407,2461.6666666666665,49,12,17,61
12337,-14.76049999999882,2110.705882352941,31,2,25,33
12338,-14.03174999999992,2667.1666666666665,49,10,20,59
12339,-16.763999999999122,2106.0,42,10,21,52
12340,-40.763999999999456,2060.5,18,4,28,22
12341,-4.461249999997894,4515.105263157895,65,13,16,78
12342,-35.753500000000145,1429.0,2,5,29,7
12343,-14.349749999999418,3242.7368421052633,52,7,26,59
12344,-10.269999999998694,2302.9444444444443,29,15,11,44
12345,-10.586499999997802,2875.222222222222,39,15,22,54
12346,-14.946749999997952,2497.8333333333335,33,7,28,40
12347,-8.234999999998315,3009.3333333333335,46,8,10,54
12348,-23.525749999999768,3261.157894736842,28,23,15,51
12349,4.410500000001899,5418.75,64,12,15,76
12350,-13.626249999998867,2367.5625,37,5,26,42
12351,0.7692500000019352,1680.0625,41,13,16,54
12352,-21.55224999999983,2749.0,23,6,23,29
12353,-22.672999999999146,2243.684210526316,7,6,34,13
12354,-46.6544999999996,1429.0,0,1,34,1
12355,-11.121499999999415,2330.8125,42,21,15,63
12356,-12.24624999999848,1481.9333333333334,47,16,31,63
12357,15.216750000001227,2951.8823529411766,59,7,16,66
12358,-4.158749999998697,2530.823529411765,41,5,26,46
12359,0.32775000000135324,4291.1,52,5,19,57
12360,4.467500000002138,3836.0,49,13,17,62
12361,0.25500000000139433,2269.3529411764707,47,19,17,66
12362,-30.144249999998685,2563.5789473684213,22,8,31,30
12363,-34.401749999999204,3121.7368421052633,15,11,32,26
12364,0.5567500000013594,1808.1764705882354,35,14,16,49
12365,-7.881500000000196,1476.6,47,7,26,54
12366,-13.257249999999157,2715.6111111111113,30,9,22,39
12367,-16.69799999999905,2009.3125,36,10,25,46
12368,-4.916999999998798,2751.8333333333335,37,6,23,43
12369,-29.744249999998715,3684.6,42,10,18,52
12370,-4.037249999999377,2698.0,55,16,21,71
12371,-10.378499999999288,2681.1176470588234,48,12,19,60
12372,-12.589999999998744,3351.3684210526317,38,14,18,52
12373,7.102500000001413,3591.1052631578946,59,9,25,68
12374,-1.5424999999990692,2416.125,42,12,21,54
12375,-7.64474999999851,4897.35,66,14,12,80
12376,3.40550000000079,4873.5,61,10,19,71
12377,13.403500000001301,2925.5,43,16,20,59
12378,-10.703999999998883,3629.222222222222,47,9,19,56
12379,-8.325249999999869,3064.0,56,10,29,66
12380,-6.487749999998698,3070.222222222222,58,14,20,72
12381,-0.09675000000013938,2924.823529411765,66,21,20,87
12382,-4.338249999998215,2952.8947368421054,35,8,27,43
12383,-36.31424999999895,2560.0,19,8,25,27
12384,-39.40574999999966,2028.8333333333333,19,7,26,26
12385,-24.018749999999034,2179.2631578947367,18,13,24,31
12386,20.233500000001744,4648.8421052631575,75,13,15,88
12387,-26.149249999999377,2354.0555555555557,33,12,25,45
12388,-13.185999999997478,2257.235294117647,45,12,24,57
12389,-5.00199999999876,3733.9,41,8,17,49
12390,-12.535749999999213,3496.6,28,1,34,29
12391,-13.802499999998815,3842.65,37,11,14,48
12392,14.630000000001246,3600.0555555555557,63,11,20,74
12393,-13.84149999999955,2192.5789473684213,31,17,17,48
12394,-14.98724999999941,2362.764705882353,37,15,29,52
12395,-11.321249999998122,1833.3529411764705,38,15,13,53
12396,-41.06424999999969,2254.4117647058824,22,8,21,30
12397,-11.273749999999085,2993.8947368421054,37,10,17,47
12398,6.7065000000018475,3057.777777777778,44,15,22,59
12399,1.9755000000007599,2893.722222222222,42,5,21,47
12400,-1.8269999999979134,2411.3333333333335,43,11,20,54
12401,-23.632249999999477,2440.7894736842104,23,7,28,30
12402,-16.310999999999204,2710.1,30,18,8,48
12403,-7.601499999998268,2977.0588235294117,49,9,23,58
12404,-13.251999999998734,2525.235294117647,35,22,14,57
12405,-10.393499999998829,3378.1052631578946,43,14,14,57
12406,-8.80349999999824,2482.6875,49,13,21,62
12407,-28.10474999999918,3509.2,27,14,21,41
12408,-20.26974999999938,1965.1666666666667,23,12,19,35
12409,-7.209249999998346,3591.9473684210525,49,9,22,58
12410,-18.2794999999997,2553.5789473684213,38,14,30,52
12411,18.77850000000311,3461.722222222222,66,3,26,69
12412,-20.836499999999308,1514.375,32,13,33,45
12413,-2.0897499999983107,2166.1875,50,11,18,61
12414,-10.451999999999504,3227.0555555555557,44,7,31,51
12415,-10.479999999999425,3114.157894736842,30,9,16,39
12416,0.7740000000016456,2245.1176470588234,38,12,20,50
12417,-11.856249999998754,2602.722222222222,32,11,21,43
12418,-3.667749999998142,2368.3888888888887,39,24,11,63
12419,-14.467499999999237,3012.8888888888887,52,10,21,62
12420,-12.404999999999218,2425.3529411764707,36,9,23,45
12421,-17.760249999999044,3587.75,36,6,19,42
12422,-31.318249999998717,3063.842105263158,25,9,31,34
12423,-6.6804999999995,3012.2105263157896,36,2,31,38
12424,-11.92899999999931,3313.7368421052633,47,7,16,54
12425,-32.0924999999989,3267.15,28,10,23,38
12426,-37.89724999999912,2705.6315789473683,30,9,20,39
12427,-24.79674999999921,2608.55,23,10,23,33
12428,-14.320999999999387,1481.9333333333334,29,17,14,46
12429,-13.248749999997784,2484.0588235294117,44,10,20,54
12430,19.89200000000253,4054.222222222222,73,8,26,81
12431,-8.38199999999868,2564.8888888888887,32,4,28,36
12432,-9.08949999999935,3749.6,35,9,19,44
12433,-18.50849999999764,4761.65,53,6,27,59
12434,-24.6969999999999,2173.235294117647,41,8,22,49
12435,-28.078749999999314,1975.1764705882354,22,21,22,43
12436,-5.9054999999985025,4129.05,40,13,25,53
12437,7.933750000000694,4251.9473684210525,58,12,18,70
12438,-21.415749999998525,3374.3,34,13,21,47
12439,-27.336499999999667,1429.0,9,11,21,20
12440,7.300250000001763,3004.8888888888887,64,11,27,75
12441,5.860000000001248,2291.25,48,16,14,64
12442,-29.149499999999954,2109.8947368421054,21,7,23,28
12443,-25.273500000000556,2555.1176470588234,37,2,32,39
12444,-12.333999999999051,3108.4210526315787,34,7,28,41
12445,13.738750000001076,2130.4375,62,8,19,70
12446,-21.90374999999965,1895.9411764705883,39,9,28,48
12447,-38.28824999999916,3018.0,25,7,19,32
12448,11.426000000002029,5556.1,79,2,16,81
12449,3.2080000000015865,4508.5,54,7,14,61
12450,-20.28749999999944,3935.4,33,10,16,43
12451,-2.349499999998226,2488.9411764705883,51,13,16,64
12452,-15.545999999999264,2955.4210526315787,36,10,20,46
12453,-7.131749999997822,2422.0555555555557,43,11,23,54
12454,2.361750000002656,4810.9,64,17,15,81
12455,-4.236499999999036,3071.85,33,15,14,48
12456,-32.61149999999933,1429.0,15,20,13,35
12457,-30.402249999999594,2076.3333333333335,16,15,18,31
12458,-19.381249999998424,1541.125,28,5,24,33
12459,-8.914999999998262,1976.1764705882354,36,4,25,40
12460,-15.20074999999826,2866.842105263158,30,9,27,39
12461,-8.721249999998905,4078.2631578947367,56,8,19,64
12462,5.750750000000967,3822.8,54,7,16,61
12463,12.394250000001168,4896.5,57,17,16,74
12464,-24.466499999999108,3325.1,32,11,20,43
12465,5.854000000000688,3502.277777777778,65,17,12,82
12466,-24.325249999998782,2084.4117647058824,26,13,25,39
12467,-19.75124999999937,1514.375,24,16,27,40
12468,-26.632999999999498,1795.0625,30,16,17,46
12469,-27.40574999999875,3267.8947368421054,27,5,37,32
12470,-3.0230000000001507,2619.5,46,18,23,64
12471,-18.241999999999113,3766.4,43,5,18,48
12472,-17.174750000000284,2770.3333333333335,60,15,16,75
12473,2.5040000000012297,3080.8333333333335,38,9,21,47
12474,-18.240249999997676,3417.6111111111113,56,5,38,61
12475,0.28200000000144215,3513.722222222222,51,17,20,68
12476,-19.274249999999512,3027.2105263157896,28,4,27,32
12477,9.06275000000024,2593.470588235294,47,15,14,62
12478,-28.651999999998914,4303.65,44,8,21,52
12479,-14.015249999998654,2608.9444444444443,25,11,35,36
12480,-19.771999999999203,2425.3529411764707,38,11,25,49
12481,-0.6894999999993839,3132.4736842105262,38,7,30,45
12482,-3.113499999997908,4177.578947368421,54,15,19,69
12483,-11.311749999998105,2628.3888888888887,42,5,23,47
12484,5.505750000002042,3297.8947368421054,49,6,24,55
12485,-4.235499999998458,3681.3684210526317,62,8,22,70
12486,1.0105000000008104,4216.0526315789475,61,8,24,69
12487,-26.453249999999382,2092.222222222222,35,8,21,43
12488,-39.770500000000524,1429.0,17,14,20,31
12489,-20.144749999998652,2846.1666666666665,32,19,22,51
12490,2.46200000000217,3603.6315789473683,52,18,11,70
12491,13.880000000000809,4297.894736842105,58,7,20,65
12492,-7.436249999998552,4736.25,47,10,20,57
12493,-24.94274999999939,1799.764705882353,15,15,20,30
12494,-13.486749999998619,2771.95,30,11,19,41
12495,-17.209999999998526,2500.8823529411766,42,19,23,61
12496,-22.091999999999082,3552.0526315789475,40,2,26,42
12497,-5.743749999999062,2164.823529411765,37,18,16,55
12498,-24.71274999999915,2721.95,23,16,15,39
12499,0.20150000000141172,4053.2105263157896,56,3,21,59
12500,-26.268499999999232,3413.2105263157896,26,9,28,35
12501,14.51475000000126,2130.4375,45,18,15,63
12502,-3.7194999999991962,2608.1111111111113,43,12,24,55
12503,-22.813749999998333,3148.15,32,12,28,44
12504,-29.738249999999663,2076.5263157894738,14,9,22,23
12505,-0.5464999999983537,4170.0526315789475,61,8,21,69
12506,-22.999999999999307,3098.157894736842,27,23,14,50
12507,16.335500000002607,3831.7894736842104,67,9,13,76
12508,-10.311249999998665,3726.4736842105262,57,11,28,68
12509,-22.281500000000165,2347.9473684210525,23,6,24,29
12510,-31.314249999999266,2786.6315789473683,29,13,25,42
12511,-9.821249999998805,2574.5555555555557,38,7,25,45
12512,5.228500000002162,3391.764705882353,58,10,22,68
12513,-31.933249999999056,1707.3529411764705,16,10,24,26
12514,-2.207499999997419,3568.4444444444443,55,3,42,58
12515,-8.472749999998104,1680.0625,35,14,21,49
12516,-4.716749999999331,1429.0,46,7,26,53
12517,-26.89325000000023,1559.0,22,6,28,28
12518,-4.6827499999990625,2103.75,48,6,31,54
12519,4.643250000001012,4377.263157894737,49,9,20,58
12520,-15.07099999999935,2375.1666666666665,27,8,36,35
12521,-13.456749999998749,3101.3,33,9,23,42
12522,-16.032249999998406,2833.529411764706,38,5,29,43
12523,1.17200000000183,2262.4375,59,13,22,72
12524,-22.201999999999636,2651.315789473684,25,9,18,34
12525,4.367500000001544,2758.9444444444443,65,7,23,72
12526,-11.144249999999648,2246.0,42,14,23,56
12527,-6.048249999999632,3319.823529411765,59,12,15,71
12528,-11.288499999998983,3365.5789473684213,37,3,21,40
12529,-2.6477499999984344,4160.894736842105,60,9,35,69
12530,-13.203499999998584,4508.4,50,9,23,59
12531,-3.3767499999988937,1429.0,44,10,17,54
12532,-3.629749999998566,2396.3529411764707,36,12,14,48
12533,-17.177749999999257,1698.9411764705883,18,16,17,34
12534,-21.606249999999417,3379.8,31,15,23,46
12535,3.5250000000011363,3405.3333333333335,70,15,20,85
12536,-17.927499999998425,2457.4210526315787,31,4,24,35
12537,-19.12749999999928,2735.1111111111113,38,12,20,50
12538,-7.4352499999992885,2814.4444444444443,62,13,19,75
12539,2.5682500000010826,3591.157894736842,55,9,20,64
12540,-24.485249999997972,2466.4117647058824,47,7,27,54
12541,-44.863750000000515,1429.0,10,10,43,20
12542,5.500750000001562,4430.65,47,15,19,62
12543,-10.922249999998893,2755.3888888888887,38,2,21,40
12544,-24.90049999999941,3300.45,32,13,14,45
12545,-9.181249999999318,2330.3333333333335,26,9,23,35
12546,-14.390249999998101,3182.1111111111113,47,4,25,51
12547,0.3360000000010771,3004.684210526316,33,11,28,44
12548,-48.77649999999966,2177.0588235294117,11,7,42,18
12549,-33.69374999999907,2452.8333333333335,29,13,22,42
12550,-29.478999999998997,2665.4736842105262,25,9,19,34
12551,-1.1824999999986434,3118.1176470588234,59,15,18,74
12552,-20.476249999998345,3514.75,28,9,33,37
12553,-0.9754999999981088,4915.55,59,9,15,68
12554,-21.890749999998526,3216.176470588235,63,19,21,82
12555,-9.273749999998959,4228.25,49,9,14,58
12556,-4.453499999999134,3282.1,37,8,19,45
12557,-4.009249999999155,3055.1111111111113,46,10,21,56
12558,-14.462499999999931,2941.157894736842,40,6,20,46
12559,-8.70349999999797,1626.5,39,3,30,42
12560,-19.660749999998593,2492.6470588235293,44,6,28,50
12561,-22.391750000000155,2437.0,32,21,19,53
12562,-1.4919999999985625,3348.0,48,3,27,51
12563,2.0387500000008525,3786.684210526316,54,7,26,61
12564,-13.90149999999868,2684.7368421052633,31,11,23,42
12565,4.827500000000941,2536.25,55,19,15,74
12566,-17.046499999999217,3448.3684210526317,43,4,31,47
12567,1.463750000002271,5889.35,77,11,18,88
12568,-2.9834999999990113,4064.0555555555557,75,15,21,90
12569,-7.144499999998286,5443.35,58,11,26,69
12570,-15.174499999998963,3580.6,41,7,16,48
12571,-10.492499999998827,3206.1,31,13,18,44
12572,-16.72649999999893,3692.6,36,6,17,42
12573,4.0867499999999115,2050.8823529411766,47,21,12,68
12574,-15.865499999999468,3032.222222222222,43,10,18,53
12575,-10.43749999999932,2051.9411764705883,31,5,20,36
12576,-19.121999999998387,4393.4,56,6,30,62
12577,-13.566249999999494,1964.75,47,9,20,56
12578,-6.199499999999644,1845.4705882352941,19,15,23,34
12579,-8.915749999998152,3104.6111111111113,45,3,23,48
12580,-8.756249999999081,3202.6315789473683,41,11,16,52
12581,-8.172749999998805,2738.315789473684,26,9,27,35
12582,-2.8964999999984244,2018.235294117647,40,9,26,49
12583,-10.785249999999305,3231.8947368421054,33,8,27,41
12584,2.3379999999998105,2508.4444444444443,53,8,31,61
12585,-9.66149999999904,4286.3,39,9,15,48
12586,-24.10174999999934,3542.684210526316,40,7,30,47
12587,-15.475499999998155,2714.705882352941,44,9,23,53
12588,3.5967500000013217,4281.263157894737,65,9,17,74
12589,-21.894499999998935,3380.6315789473683,26,12,26,38
12590,-8.690999999999828,3127.5,57,27,15,84
12591,-7.038749999998767,3127.3888888888887,39,13,26,52
12592,-7.895249999998457,2185.0,56,15,15,71
12593,-2.1402499999991247,4358.3,45,8,17,53
12594,-3.970499999999209,2437.470588235294,51,17,19,68
12595,-20.629999999998397,2673.0526315789475,40,14,17,54
12596,-0.8232499999991356,2744.6470588235293,66,10,22,76
12597,-11.137999999999373,2565.3529411764707,43,11,19,54
12598,-6.63549999999894,3968.7368421052633,58,6,25,64
12599,-16.626749999998765,3698.9,38,7,20,45
12600,8.855000000000597,3452.8333333333335,68,6,27,74
12601,0.5292500000017405,3067.6470588235293,60,11,21,71
12602,-15.460749999997782,2682.277777777778,24,12,41,36
12603,-14.505999999999322,3634.5555555555557,43,7,17,50
12604,6.016250000001327,3692.65,39,14,19,53
12605,-23.914250000000074,2067.5555555555557,25,17,17,42
12606,-28.442499999999324,2094.8947368421054,16,8,23,24
12607,1.4612500000005755,2750.5,59,17,20,76
12608,22.426500000002687,4568.388888888889,77,5,21,82
12609,3.558500000001466,4868.0,62,12,19,74
12610,-13.932499999998802,2952.9473684210525,34,3,28,37
12611,-12.277499999999833,2282.1875,38,18,18,56
12612,-8.177999999999006,2530.1052631578946,34,8,15,42
12613,-8.423999999999713,2555.176470588235,48,17,12,65
12614,-2.7092499999981974,4313.0,60,10,24,70
12615,-8.762999999998321,3317.9473684210525,36,10,27,46
12616,-26.79699999999886,2693.8947368421054,20,7,29,27
12617,4.372500000000158,2020.9411764705883,51,23,15,74
12618,-17.6329999999997,3286.176470588235,42,14,19,56
12619,-3.9074999999985116,3782.6666666666665,55,2,26,57
12620,-11.45824999999958,3478.3,29,11,20,40
12621,-9.02549999999896,4021.95,42,10,19,52
12622,3.57475000000097,3744.842105263158,40,12,24,52
12623,0.024000000001274557,2899.705882352941,46,10,29,56
12624,-21.349999999999433,1871.5,34,14,35,48
12625,-11.212249999999248,1996.9444444444443,30,12,21,42
12626,-18.26749999999901,2490.0,25,12,22,37
12627,4.0410000000009,2811.8823529411766,45,11,19,56
12628,11.135250000000603,2988.9444444444443,52,15,21,67
12629,6.478000000001975,4945.75,71,13,13,84
12630,-13.746249999998316,2648.470588235294,52,8,17,60
12631,-29.202249999999243,1429.0,14,12,20,26
12632,-27.94949999999954,1768.3125,24,14,30,38
12633,-48.78175000000002,1429.0,0,15,26,15
12634,-6.597499999998552,3804.5,46,13,19,59
12635,-4.04399999999939,2103.625,43,10,23,53
12636,3.397250000001079,3671.315789473684,54,9,26,63
12637,11.401000000001012,2268.3125,59,28,16,87
12638,-15.342500000000143,2076.1176470588234,52,18,16,70
12639,-10.664499999997844,3123.9444444444443,55,7,29,62
12640,-18.12799999999968,2708.8947368421054,33,15,23,48
12641,-11.959999999999384,2434.6470588235293,36,14,17,50
12642,-5.9629999999980035,4744.2,47,0,32,47
12643,-31.007749999998737,3338.842105263158,25,5,27,30
12644,-13.867249999999526,2375.5625,53,11,21,64
12645,-38.35974999999964,2419.55,14,11,20,25
12646,3.377750000001175,3516.7894736842104,39,20,12,59
12647,6.456000000001994,4587.0,54,2,23,56
12648,2.324250000000851,3198.470588235294,51,10,20,61
12649,2.1397500000024485,2191.8888888888887,52,10,16,62
12650,-23.7012499999992,2266.8888888888887,30,11,19,41
12651,-22.901999999999415,3187.5789473684213,31,3,29,34
12652,-33.21299999999977,1429.0,9,8,23,17
12653,2.775750000001002,2711.277777777778,50,13,17,63
12654,-33.04074999999917,2744.1,25,17,16,42
12655,-9.255499999999234,2592.277777777778,29,20,16,49
12656,-0.5409999999992696,2815.6470588235293,62,13,25,75
12657,10.996250000000197,2915.529411764706,58,14,16,72
12658,-9.012749999998682,3074.6111111111113,58,14,27,72
12659,11.393750000000564,3047.235294117647,49,8,34,57
12660,-28.09725000000021,2143.294117647059,40,18,23,58
12661,-4.991999999999115,3846.222222222222,53,14,19,67
12662,-13.803499999998603,3256.2631578947367,44,13,18,57
12663,-0.3834999999973864,5615.6,57,5,26,62
12664,-28.524499999999723,2600.55,20,13,10,33
12665,-0.13524999999940998,2933.5,30,5,20,35
12666,-16.799749999999207,1870.7058823529412,22,9,24,31
12667,-2.882500000000138,1992.0588235294117,43,21,19,64
12668,-14.273250000000221,2689.529411764706,56,14,25,70
12669,-30.319249999998004,2881.1052631578946,30,6,31,36
12670,-28.70099999999922,3280.315789473684,31,11,24,42
12671,-11.660249999999051,3410.05,41,9,14,50
12672,-9.847749999998783,2562.9375,53,15,18,68
12673,2.7840000000010994,2926.3888888888887,38,14,11,52
12674,0.8125000000015193,3294.1111111111113,54,17,20,71
12675,-2.8959999999988675,5326.7,41,4,20,45
12676,0.8252500000007025,2687.3888888888887,26,17,20,43
12677,-12.748499999999698,4052.85,42,12,20,54
12678,-5.9927499999987415,3110.842105263158,41,6,25,47
12679,-33.23274999999982,2425.5555555555557,18,11,27,29
12680,-24.831249999999933,2714.722222222222,28,7,28,35
12681,28.96300000000206,3807.4444444444443,58,16,18,74
12682,-14.435749999998388,3190.1176470588234,54,17,18,71
12683,3.65800000000185,4125.0,64,9,20,73
12684,-13.048749999999156,3148.6666666666665,42,21,17,63
12685,-33.867499999999666,1429.0,21,9,19,30
12686,1.0007500000013185,3597.5,60,7,16,67
12687,-10.573249999998872,3714.75,46,9,21,55
12688,-0.620749999998942,2108.0,39,9,15,48
12689,-2.7262499999990446,3007.5,42,12,15,54
12690,14.670000000003066,3527.0,65,14,17,79
12691,-13.629999999998756,2794.157894736842,40,21,14,61
12692,-14.000749999998348,4433.8,41,12,17,53
12693,-2.648999999998396,4571.9,54,10,16,64
12694,-30.513499999999503,2579.3684210526317,18,17,15,35
12695,-18.999249999998856,3665.6,32,14,16,46
12696,-2.5889999999988365,2890.294117647059,43,20,16,63
12697,-15.553249999998986,2691.8888888888887,26,2,27,28
12698,-19.680499999997764,1429.0,39,18,26,57
12699,-16.77949999999957,3338.6,39,11,19,50
12700,-8.373999999999935,3233.6315789473683,38,10,23,48
12701,-8.13524999999873,3794.1052631578946,38,18,24,56
12702,-11.897499999998029,2433.764705882353,47,9,26,56
12703,3.8032500000024947,3950.5789473684213,57,11,21,68
12704,-4.606499999998894,2148.0,71,7,24,78
12705,6.872500000001433,4047.315789473684,56,6,15,62
12706,-12.19524999999858,3088.6666666666665,48,10,21,58
12707,0.7182500000017278,1983.6875,35,11,25,46
12708,-13.35274999999939,3160.8947368421054,40,6,22,46
12709,-6.232749999999685,2079.9411764705883,30,12,18,42
12710,-12.801499999998853,3289.777777777778,51,9,19,60
12711,-21.145749999999637,2663.0526315789475,24,12,27,36
12712,-7.888999999998113,2648.5882352941176,38,21,15,59
12713,-16.813749999999754,3250.2631578947367,51,12,22,63
12714,-24.27999999999914,2319.823529411765,25,10,21,35
12715,-22.370499999999243,3129.95,21,13,18,34
12716,11.504500000001887,3315.3333333333335,64,9,18,73
12717,7.06200000000282,2153.1875,55,15,17,70
12718,-5.89449999999856,3580.2631578947367,53,7,17,60
12719,-18.960999999998748,4333.789473684211,52,10,16,62
12720,-19.202499999999727,2918.6315789473683,41,11,15,52
12721,-20.153999999998877,3973.5,43,14,15,57
12722,-2.421999999998607,2282.529411764706,48,15,26,63
12723,-10.602999999998948,2198.470588235294,45,20,9,65
12724,-25.322999999998594,1648.4705882352941,18,15,19,33
12725,-6.198249999999473,2789.6666666666665,43,8,16,51
12726,-11.114249999998634,4591.75,49,12,23,61
12727,-29.96424999999989,1429.0,11,9,24,20
12728,-22.39849999999828,2898.1666666666665,35,6,26,41
12729,-17.48849999999979,2160.1176470588234,30,28,9,58
12730,-14.568749999998687,1740.8823529411766,36,6,20,42
12731,-26.56024999999874,2009.2777777777778,23,10,18,33
12732,-21.14374999999864,3009.277777777778,28,10,30,38
12733,-1.7717499999989499,3091.5789473684213,48,4,22,52
12734,-13.61224999999919,3393.8888888888887,40,6,20,46
12735,-0.17274999999890292,2958.470588235294,52,16,17,68
12736,-14.245499999997776,4002.1052631578946,52,10,23,62
12737,13.683000000000906,2697.0,57,14,24,71
12738,-34.08049999999908,2592.222222222222,29,14,22,43
12739,-10.555999999998068,2866.5,46,14,16,60
12740,-29.704500000000007,2260.8823529411766,39,23,35,62
12741,-22.032749999999115,2822.3333333333335,43,19,18,62
12742,0.43075000000323166,3168.0555555555557,61,5,23,66
12743,10.81475000000216,5325.05,69,11,17,80
12744,-2.788499999999589,2196.875,41,18,23,59
12745,-12.430999999998978,2670.5789473684213,25,16,17,41
12746,-26.261499999999266,2054.0526315789475,15,15,21,30
12747,2.711750000002227,2287.3125,46,7,23,53
12748,-29.031499999999312,2908.5,25,12,17,37
12749,-20.596500000000056,1976.6666666666667,33,23,15,56
12750,-35.39775000000007,1625.5,18,12,24,30
12751,-0.33149999999831703,3776.5263157894738,43,10,18,53
12752,-38.05074999999835,1706.8125,23,14,19,37
12753,-26.837249999999926,2028.7222222222222,32,8,26,40
12754,9.9257500000009,2862.3529411764707,53,19,16,72
12755,22.700000000002532,4621.263157894737,72,7,20,79
12756,-11.780749999999646,2922.0,59,9,21,68
12757,-15.01999999999867,4678.2,59,22,16,81
12758,-19.929999999999897,1429.0,42,15,20,57
12759,-15.050999999999494,1429.0,35,9,26,44
12760,-14.438249999999053,2477.6111111111113,28,12,17,40
12761,-11.717999999998964,3708.157894736842,33,18,22,51
12762,-30.76774999999922,3238.5789473684213,31,6,27,37
12763,-2.3452499999992384,2560.5,43,16,23,59
12764,-20.562249999998876,3377.9444444444443,44,11,24,55
12765,-9.459499999999286,3897.35,37,18,11,55
12766,-2.677499999998214,4085.684210526316,50,15,19,65
12767,-4.788499999999083,2164.823529411765,42,12,21,54
12768,-12.255749999996517,4223.526315789473,64,8,30,72
12769,-6.971749999998854,3078.2105263157896,37,10,21,47
12770,-19.86199999999807,4757.65,48,11,23,59
12771,1.2195000000008964,2201.8125,49,12,13,61
12772,-22.223749999999093,1912.6470588235295,23,13,15,36
12773,-28.239749999999145,3115.6,23,13,23,36
12774,-21.61399999999892,2580.315789473684,21,17,18,38
12775,-13.259749999998572,1639.375,37,10,18,47
12776,-17.349249999998165,3025.5263157894738,36,11,20,47
12777,-6.2509999999989665,2750.6315789473683,35,12,18,47
12778,-16.18349999999885,3908.5,32,13,20,45
12779,5.8802500000021825,5363.3,65,7,19,72
12780,-15.776249999997395,3110.777777777778,53,8,22,61
12781,-6.213749999998359,4302.9473684210525,45,20,17,65
12782,-25.481499999999023,3381.4,32,10,22,42
12783,-32.26174999999892,2689.7368421052633,27,9,19,36
12784,-5.93349999999746,3228.0,48,15,17,63
12785,-23.418499999997643,2414.842105263158,25,19,27,44
12786,2.6497500000023004,2452.0555555555557,47,10,17,57
12787,-2.634499999998681,3682.35,42,10,17,52
12788,-55.50150000000036,1429.0,0,13,40,13
12789,-4.047749999999484,2802.1666666666665,45,17,22,62
12790,-19.828750000000326,2627.4444444444443,52,11,18,63
12791,-23.708249999999037,2459.315789473684,25,8,26,33
12792,-16.987999999998713,3032.2631578947367,34,7,25,41
12793,-21.770749999999495,2560.05,24,13,19,37
12794,-8.14099999999954,4940.25,48,9,16,57
12795,-16.4687499999992,2989.5789473684213,34,9,23,43
12796,-37.334749999999666,2290.5555555555557,21,13,28,34
12797,-27.852249999998815,2229.4210526315787,24,10,25,34
12798,-4.518249999998109,3211.277777777778,51,11,16,62
12799,-15.54374999999915,2395.5789473684213,26,7,23,33
12800,-19.383749999999022,2121.9411764705883,28,19,17,47
12801,-14.362749999998105,3063.1111111111113,53,17,14,70
12802,0.7590000000025899,2867.9411764705883,51,13,28,64
12803,-10.407499999999184,2282.529411764706,42,15,15,57
12804,-12.842749999998977,3803.0,41,2,22,43
12805,12.238250000002697,2287.25,62,2,20,64
12806,3.7632500000026026,3389.7368421052633,53,13,23,66
12807,4.147750000000666,2830.277777777778,48,16,17,64
12808,-15.430749999999225,2487.5625,50,11,24,61
12809,-25.014999999999354,2591.1052631578946,20,8,25,28
12810,-16.270999999999496,3734.0,41,15,15,56
12811,2.439250000003251,2480.470588235294,61,7,22,68
12812,0.9007500000008486,4256.8,52,7,19,59
12813,-17.38824999999884,3937.842105263158,45,12,26,57
12814,-29.547750000000157,1429.0,25,17,20,42
12815,-3.8152499999999825,3541.0526315789475,48,15,17,63
12816,20.56650000000214,3646.0,60,7,20,67
12817,-4.137249999999383,2681.1176470588234,59,10,24,69
12818,-21.601500000000442,3218.9411764705883,60,24,25,84
12819,-14.964249999999305,3215.2105263157896,38,7,21,45
12820,-19.716249999999405,2576.277777777778,41,11,23,52
12821,-29.615999999999456,2087.05,16,18,9,34
12822,-27.742999999999494,1643.8235294117646,22,14,19,36
12823,8.435500000002026,2866.9411764705883,59,8,12,67
12824,-15.249749999998716,2399.9473684210525,39,4,16,43
12825,-15.343749999999279,4495.8421052631575,45,8,26,53
12826,-13.103500000000006,2484.777777777778,39,20,14,59
12827,5.835250000001735,3737.85,47,10,18,57
12828,-13.857249999998434,5022.7,60,18,15,78
12829,-17.24374999999882,3051.35,20,14,17,34
12830,-14.432749999998794,2866.5,36,7,22,43
12831,-18.980499999999637,2681.4210526315787,35,10,20,45
12832,4.152000000001546,2153.0555555555557,39,16,14,55
12833,-1.7112499999994604,2109.705882352941,42,16,17,58
12834,-0.040749999998020314,4882.35,55,11,17,66
12835,-6.712249999998744,2068.705882352941,32,16,15,48
12836,-20.34949999999872,3322.8,26,17,21,43
12837,-19.886249999999357,3179.2631578947367,49,14,23,63
12838,-21.57024999999886,2211.470588235294,28,5,25,33
12839,-5.505499999999067,2676.0,38,9,17,47
12840,-16.061500000000148,1705.8125,36,21,13,57
12841,-3.4514999999991693,4020.777777777778,58,12,14,70
12842,-21.211749999999526,2783.5555555555557,33,14,23,47
12843,-17.15899999999784,3731.5555555555557,55,14,25,69
12844,-28.234499999998654,2445.8333333333335,20,10,25,30
12845,-15.020249999998816,3315.6,27,5,26,32
12846,11.833250000001815,4571.9,59,10,14,69
12847,-36.7397499999993,1568.1176470588234,21,10,22,31
12848,-6.6682499999987765,3206.0,31,12,26,43
12849,12.609250000000221,2846.1111111111113,34,18,20,52
12850,-2.0029999999979524,4919.55,63,15,13,78
12851,-25.882499999998053,2204.3684210526317,15,4,46,19
12852,-12.827749999998854,2576.75,30,17,11,47
12853,0.6172500000007327,1969.75,39,8,23,47
12854,-13.377750000000088,3292.0526315789475,28,8,28,36
12855,2.91175000000162,5620.3,73,6,13,79
12856,-4.594999999999844,3000.5555555555557,70,12,26,82
12857,-3.3514999999995823,4214.368421052632,58,8,22,66
12858,-11.193249999999432,3871.1,39,8,16,47
12859,-36.956749999999786,1914.421052631579,13,7,23,20
12860,-10.55574999999791,2829.3888888888887,46,10,23,56
12861,-27.231249999999143,2356.6666666666665,21,12,19,33
12862,-22.60799999999907,2584.9411764705883,48,12,25,60
12863,-9.651999999999305,3583.5789473684213,32,18,19,50
12864,-25.195499999999154,2374.9411764705883,32,13,16,45
12865,1.3830000000010276,2790.470588235294,45,12,19,57
12866,-30.693749999998705,2342.6666666666665,44,14,28,58
12867,-13.872499999998505,2745.7368421052633,37,8,21,45
12868,-4.739249999998405,2214.75,54,12,19,66
12869,13.834250000002154,1606.4705882352941,51,20,13,71
12870,-20.487249999999406,1590.75,16,14,20,30
12871,7.529750000000433,2765.176470588235,67,21,15,88
12872,-8.611749999998738,2636.222222222222,29,15,19,44
12873,-10.664749999999197,2072.3529411764707,44,10,22,54
12874,0.779250000000691,2420.6470588235293,50,10,22,60
12875,-7.375749999999469,2106.0,30,7,29,37
12876,-22.028499999999333,2455.7894736842104,23,14,18,37
12877,5.6400000000009225,5625.15,63,7,14,70
12878,-16.65149999999998,3071.8888888888887,44,7,26,51
12879,-2.833249999999018,3921.9473684210525,48,13,12,61
12880,2.790250000001868,2187.9375,62,18,18,80
12881,-11.247749999999197,2452.0555555555557,39,16,23,55
12882,-32.672999999998595,2595.315789473684,31,25,14,56
12883,1.27375000000101,2504.4375,52,8,21,60
12884,-36.26899999999982,1429.0,11,17,17,28
12885,-1.791499999999818,2691.1111111111113,55,14,16,69
12886,-8.458749999999966,1759.375,41,13,32,54
12887,-15.57674999999902,2267.722222222222,25,11,21,36
12888,-17.342749999999036,2756.5789473684213,31,10,22,41
12889,-10.371999999999375,2103.75,44,7,21,51
12890,-7.346499999998981,4572.736842105263,59,16,16,75
12891,-19.49974999999946,2954.4736842105262,35,14,20,49
12892,-2.117499999997851,4152.1,57,12,17,69
12893,-26.889249999998775,2808.3684210526317,25,15,27,40
12894,-42.60499999999969,1528.25,8,14,23,22
12895,-17.507749999998488,2367.3333333333335,37,8,24,45
12896,-22.083249999999016,1954.7058823529412,25,11,25,36
12897,-8.202999999998255,2908.777777777778,40,16,19,56
12898,-20.068999999999782,2095.684210526316,17,15,11,32
12899,-21.684999999998062,2509.3333333333335,33,8,26,41
12900,3.685750000001844,3678.0,39,17,15,56
12901,-50.525499999999,1429.0,7,12,22,19
12902,-23.331250000000193,1429.0,30,11,25,41
12903,8.320750000000837,4195.105263157895,58,22,11,80
12904,-3.7347499999982907,3110.0,38,16,17,54
12905,-22.392249999999287,3130.7,39,11,12,50
12906,9.372750000001812,3063.1666666666665,57,9,16,66
12907,-12.092499999998584,3387.315789473684,39,14,18,53
12908,-22.28649999999923,2509.315789473684,27,14,19,41
12909,-0.7854999999988308,3241.230769230769,40,8,20,48
12910,-7.903749999998409,4283.8,42,6,26,48
12911,-22.289999999999008,3320.4736842105262,45,13,19,58
12912,-11.45549999999938,3715.7,29,8,15,37
12913,-21.857499999999042,3438.2105263157896,34,12,22,46
12914,-3.282999999998566,3042.722222222222,52,11,22,63
12915,3.176750000001171,3852.684210526316,67,12,12,79
12916,-5.169249999998321,2652.1666666666665,42,6,22,48
12917,-3.1892499999991957,2043.8666666666666,41,11,22,52
12918,-41.49849999999965,1585.75,11,14,18,25
12919,-6.182999999999091,2605.529411764706,40,12,21,52
12920,-24.70024999999675,1900.6470588235295,31,19,32,50
12921,-12.891499999999477,3472.7,28,3,23,31
12922,-33.70374999999924,3414.85,30,5,19,35
12923,-2.678499999998795,2452.0,40,6,26,46
12924,-20.740749999999352,2237.5625,22,12,25,34
12925,-23.323999999998456,3270.4,29,13,25,42
12926,-7.717249999997618,2278.375,45,7,25,52
12927,-8.414500000000197,1467.1333333333334,41,15,18,56
12928,-6.770749999998342,3596.2105263157896,50,11,17,61
12929,13.893750000001338,4532.277777777777,73,13,18,86
12930,-33.18524999999933,2754.4,19,5,25,24
12931,8.994000000002815,3745.7368421052633,55,10,21,65
12932,-3.6569999999972693,4627.5,58,6,20,64
12933,-13.448749999998691,1996.4375,38,15,20,53
12934,-6.302749999998559,2842.722222222222,39,1,20,40
12935,-25.00174999999937,3145.0,26,17,22,43
12936,-2.1207499999990502,2870.1111111111113,54,6,22,60
12937,7.724500000001024,4282.8421052631575,52,16,16,68
12938,-9.147999999998593,3686.25,37,10,22,47
12939,3.4860000000012312,2289.0,41,13,22,54
12940,-26.113249999998878,2975.1,25,13,17,38
12941,-10.026249999999461,3956.85,41,4,22,45
12942,3.795000000001918,3970.4444444444443,59,16,17,75
12943,5.081750000000929,4813.421052631579,51,25,24,76
12944,-17.567749999998853,2901.777777777778,36,12,17,48
12945,15.904250000000957,4023.0526315789475,60,15,13,75
12946,-12.34724999999894,1701.875,33,15,29,48
12947,-34.52149999999947,2144.1052631578946,15,12,22,27
12948,-6.5157499999987465,2952.8888888888887,35,13,19,48
12949,8.41625000000076,4149.263157894737,58,13,14,71
12950,-13.183749999998133,2316.1176470588234,53,17,19,70
12951,-4.333999999998201,2245.1176470588234,38,15,16,53
12952,1.2655000000009822,1633.4375,31,6,25,37
12953,-17.593499999998922,4337.0,38,6,23,44
12954,20.739500000003904,5789.35,83,12,17,95
12955,-7.355999999998471,3639.35,42,12,20,54
12956,4.5755000000002015,3016.277777777778,66,7,19,73
12957,-6.998499999999822,2644.823529411765,42,12,17,54
12958,-3.3247499999987298,1486.2,50,20,13,70
12959,-12.499749999998652,4925.9,55,3,18,58
12960,-29.373249999998734,1912.7058823529412,40,16,26,56
12961,-35.65649999999953,2028.7222222222222,39,4,33,43
12962,-7.631749999997422,2715.722222222222,51,16,14,67
12963,-30.58174999999963,1457.6,24,11,17,35
12964,6.325750000000456,4313.2,46,8,13,54
12965,-11.864999999998064,3551.3,39,13,17,52
12966,-20.655499999999257,2805.3,22,11,19,33
12967,-18.037999999999165,2648.0,23,8,24,31
12968,-11.059499999998827,3084.842105263158,39,18,14,57
12969,-1.3297499999986977,4806.578947368421,67,12,20,79
12970,-33.797999999999135,2124.9473684210525,13,13,21,26
12971,-18.651499999999324,2515.842105263158,18,12,20,30
12972,-13.09449999999938,2985.4210526315787,51,6,27,57
12973,-20.529749999999886,2521.470588235294,30,6,40,36
12974,-12.379249999998525,2612.4444444444443,29,5,29,34
12975,-13.052499999999089,2878.4736842105262,32,12,24,44
12976,3.6990000000006673,2544.6666666666665,46,15,22,61
12977,-9.069249999998945,2670.6111111111113,44,18,16,62
12978,-5.822249999998276,2223.5882352941176,54,4,26,58
12979,-13.942249999999447,3044.5555555555557,57,10,18,67
12980,-6.713749999999221,2544.5555555555557,45,15,18,60
12981,-31.74874999999967,2132.5789473684213,13,7,23,20
12982,-8.966249999999201,2080.75,54,17,21,71
12983,-21.124249999998945,2136.277777777778,29,5,22,34
12984,-18.937749999999763,3622.1052631578946,47,6,37,53
12985,2.0990000000008107,2584.9411764705883,47,5,19,52
12986,-39.374499999999436,2370.5263157894738,21,9,23,30
12987,-17.308249999998033,3838.6,42,16,17,58
12988,-44.779250000000374,1429.0,10,12,27,22
12989,-2.0634999999982746,4252.789473684211,60,16,23,76
12990,-39.27499999999996,1429.0,13,6,23,19
12991,-22.596250000000104,2321.4444444444443,39,8,28,47
12992,22.103500000002676,2130.4375,74,12,24,86
12993,-9.937999999997606,2945.4117647058824,45,19,28,64
12994,0.43800000000170025,4141.05,51,5,21,56
12995,-21.388999999998934,2714.0,21,11,24,32
12996,-21.389999999999084,2235.0555555555557,36,6,21,42
12997,-19.59999999999875,2095.75,35,15,17,50
12998,-18.258749999998635,3546.5,42,12,18,54
12999,-35.01674999999999,2435.222222222222,20,12,26,32
13000,-30.282749999999346,2449.8947368421054,15,19,16,34
13001,-8.778249999998526,2592.75,63,14,18,77
13002,-11.929999999998643,4477.45,43,4,28,47
13003,-17.949249999998933,3399.7,28,9,25,37
13004,9.461500000001992,2652.25,58,11,22,69
13005,-29.38324999999897,3656.8,30,9,23,39
13006,-9.863999999999798,1514.375,38,8,20,46
13007,-9.895999999998114,4237.1,45,9,20,54
13008,18.509250000003128,4599.684210526316,74,17,17,91
13009,-19.658749999999976,1719.6875,23,9,25,32
13010,-29.979249999999375,1606.4705882352941,11,19,18,30
13011,-11.694749999999619,3137.5789473684213,31,5,24,36
13012,0.5765000000017769,4299.75,53,7,21,60
13013,-33.013749999998105,2868.5263157894738,30,7,31,37
13014,-12.641249999999392,2818.8333333333335,40,14,17,54
13015,-36.539749999999145,1988.3529411764705,24,14,25,38
13016,-26.106499999999944,2579.6315789473683,20,15,37,35
13017,-19.865249999998447,1429.0,34,5,27,39
13018,0.3510000000015701,4046.55,52,8,13,60
13019,-10.493249999997895,2023.9473684210527,33,12,23,45
13020,-13.961249999999328,3260.2631578947367,37,9,28,46
13021,-2.3337499999990223,2830.3333333333335,33,12,22,45
13022,-21.55049999999956,1901.7222222222222,37,16,15,53
13023,-13.799749999998856,2478.6875,45,9,21,54
13024,-7.935999999998943,3410.684210526316,36,14,19,50
13025,-1.6859999999977142,2424.5555555555557,47,13,14,60
13026,-20.996249999999666,1875.5,44,14,23,58
13027,4.85600000000197,5163.2,65,10,13,75
13028,-5.542999999998699,2219.75,62,15,18,77
13029,0.9845000000008218,2966.823529411765,73,17,19,90
13030,-14.09774999999799,2803.529411764706,45,12,25,57
13031,2.9097500000008014,4937.8,58,4,21,62
13032,-29.09649999999931,2468.315789473684,20,11,19,31
13033,-6.548999999999262,3230.6666666666665,46,14,26,60
13034,-15.947749999998866,3310.4210526315787,42,10,23,52
13035,-1.7154999999978031,2636.3333333333335,46,1,26,47
13036,-5.7457499999986625,3987.85,44,4,18,48
13037,-23.934749999999237,2500.9473684210525,23,16,16,39
13038,11.812500000001451,4833.8,51,9,19,60
13039,9.267500000001089,2041.125,49,7,24,56
13040,-9.89549999999873,2914.9444444444443,43,24,14,67
13041,17.125500000001637,5488.55,73,12,13,85
13042,3.5645000000008347,2528.722222222222,44,9,24,53
13043,-8.256499999998649,4117.95,51,10,14,61
13044,-26.9087499999996,2479.9473684210525,20,10,21,30
13045,-21.278749999999153,3698.0526315789475,39,13,24,52
13046,-19.32649999999898,3597.35,35,9,22,44
13047,-7.894499999999068,1701.875,30,2,19,32
13048,13.213750000001946,2255.4375,68,10,22,78
13049,-7.114249999997474,3958.45,41,18,23,59
13050,-7.32599999999857,3119.6111111111113,41,10,19,51
13051,-22.587499999999192,3929.05,35,17,18,52
13052,-5.151999999998417,1817.875,39,11,29,50
13053,-16.951749999999866,2267.7894736842104,19,14,17,33
13054,1.2835000000007424,4917.1,64,5,16,69
13055,-1.1597499999992273,3655.35,37,7,20,44
13056,12.029750000001846,2969.6111111111113,53,12,16,65
13057,31.484500000002374,5508.45,64,12,12,76
13058,-9.256999999997943,3030.4444444444443,48,13,13,61
13059,-15.297249999999101,2622.3888888888887,35,9,14,44
13060,-12.43924999999857,2721.5789473684213,35,17,17,52
13061,-4.487999999997723,2929.0555555555557,48,7,20,55
13062,-21.159249999998885,3194.15,28,10,21,38
13063,-8.549749999998813,3206.0,31,11,23,42
13064,-23.4942499999991,1838.75,30,6,24,36
13065,-12.030249999999485,2116.625,57,17,17,74
13066,-4.658499999997123,3561.5,59,12,29,71
13067,-25.065249999999125,3599.4736842105262,32,3,44,35
13068,-0.5754999999997846,2642.823529411765,38,19,21,57
13069,-25.94949999999967,1692.2941176470588,27,13,22,40
13070,3.5640000000015357,4151.631578947368,50,6,24,56
13071,2.9717500000012707,5909.2,72,15,18,87
13072,2.204750000001558,3146.9444444444443,50,14,14,64
13073,-14.783249999998944,3145.0526315789475,30,16,15,46
13074,-17.140749999998718,3162.6315789473683,26,16,23,42
13075,-30.932499999999,2735.35,24,10,23,34
13076,-26.700249999997965,1942.6470588235295,13,12,41,25
13077,-10.511249999999205,2659.222222222222,37,11,21,48
13078,-12.058249999999324,2856.0526315789475,33,15,18,48
13079,-2.7284999999984754,3890.2105263157896,50,9,25,59
13080,-30.028499999999177,1429.0,18,8,26,26
13081,-14.153499999999738,2528.6666666666665,35,16,19,51
13082,-25.936749999999954,2488.764705882353,32,14,30,46
13083,-14.828249999999542,2155.0526315789475,19,18,22,37
13084,-37.843499999998734,2226.1052631578946,14,14,22,28
13085,-33.48925000000001,1429.0,7,16,19,23
13086,-21.302749999999115,2994.5789473684213,27,8,21,35
13087,2.4977499999997277,3825.8333333333335,65,10,20,75
13088,-34.79324999999958,2056.0,11,16,15,27
13089,-23.50224999999935,2540.1,23,8,19,31
13090,12.516750000002295,4577.736842105263,73,7,24,80
13091,-18.834749999998923,2618.7,28,7,21,35
13092,5.5260000000029095,2186.294117647059,56,9,19,65
13093,-13.932749999998752,2665.294117647059,24,6,28,30
13094,-15.131249999999929,2976.6666666666665,48,10,21,58
13095,-20.817999999999152,2690.05,23,15,22,38
13096,-12.094999999998876,2839.315789473684,26,10,28,36
13097,-19.399749999999408,2608.0555555555557,25,6,33,31
13098,-7.450249999998361,2742.9444444444443,69,6,18,75
13099,-42.867499999999986,2695.5263157894738,17,17,35,34
13100,-19.174999999998835,2628.3888888888887,36,14,13,50
13101,15.451750000001857,6021.95,78,13,23,91
13102,-22.19324999999908,2240.470588235294,26,11,28,37
13103,-12.184249999998837,3545.3888888888887,45,16,21,61
13104,-30.734999999998582,3559.25,27,19,21,46
13105,-9.228749999999433,1528.25,26,9,18,35
13106,-11.299749999998024,2201.9375,43,8,36,51
13107,-9.278999999999185,3855.3,37,12,16,49
13108,-0.36674999999951063,2952.0526315789475,43,11,22,54
13109,-14.200749999998555,1589.6470588235295,22,16,18,38
13110,-7.762249999998919,2268.4375,50,15,16,65
13111,3.03025000000177,1936.0,58,5,31,63
13112,-18.214499999998544,1977.611111111111,33,10,19,43
13113,6.869250000001839,3090.4444444444443,63,19,13,82
13114,-8.357249999998107,3038.0526315789475,39,14,19,53
13115,-13.764499999998227,2589.5263157894738,34,7,25,41
13116,-5.362749999998487,3508.4210526315787,57,5,31,62
13117,-8.473999999999728,3050.6315789473683,42,13,17,55
13118,3.946500000002139,1876.4375,49,9,26,58
13119,-22.020749999998937,2607.1666666666665,28,22,19,50
13120,-12.703999999999722,2757.0,69,20,9,89
13121,-29.021249999999583,2068.3333333333335,20,4,25,24
13122,-0.8867499999985806,1481.9333333333334,39,6,24,45
13123,-4.9944999999989586,1862.2941176470588,34,14,18,48
13124,-19.926749999999334,3903.75,31,12,17,43
13125,-13.801749999998918,3459.1052631578946,33,21,14,54
13126,-29.508249999999084,2787.0,23,8,22,31
13127,-13.938999999998497,3811.55,38,7,28,45
13128,6.778750000000626,2429.1875,53,4,26,57
13129,-31.626249999998826,2429.1111111111113,23,17,16,40
13130,-31.409999999999677,1429.0,13,11,18,24
13131,-25.27599999999912,2975.294117647059,57,16,19,73
13132,3.029000000002192,5451.25,62,11,16,73
13133,-20.710999999999395,2876.7894736842104,20,9,24,29
13134,-14.551999999997943,2488.823529411765,40,6,27,46
13135,-6.313999999998045,3587.1,31,13,29,44
13136,-26.444749999998418,3076.5263157894738,28,13,24,41
13137,-6.08374999999901,2950.0588235294117,53,7,26,60
13138,-5.320499999998922,4624.3,44,9,20,53
13139,-5.612999999998185,2414.125,49,9,19,58
13140,-23.126499999998607,2417.5555555555557,24,8,31,32
13141,6.406500000000928,2155.3125,58,11,15,69
13142,1.2952500000007183,3495.0,36,16,15,52
13143,-32.878999999999024,2668.7,20,12,24,32
13144,-24.954999999998755,1496.5,30,11,20,41
13145,-24.582749999999532,2067.705882352941,29,9,24,38
13146,-17.54474999999873,2731.6111111111113,29,11,19,40
13147,-17.974499999999065,3008.45,28,9,21,37
13148,-13.83674999999908,2092.222222222222,28,20,17,48
13149,6.504500000002207,2999.6666666666665,54,21,10,75
13150,-8.492249999998894,2632.8947368421054,35,6,21,41
13151,4.751250000001386,4036.15,51,11,16,62
13152,-23.43924999999964,3169.2105263157896,38,11,21,49
13153,-9.146499999998879,2089.235294117647,40,9,33,49
13154,-21.29199999999929,2585.2105263157896,27,12,20,39
13155,-14.742499999999808,2703.0526315789475,38,7,35,45
13156,24.207250000001537,3504.823529411765,75,20,15,95
13157,-28.347999999999708,3028.722222222222,39,14,20,53
13158,-40.750749999998334,1429.0,12,17,35,29
13159,16.78575000000073,3076.0588235294117,72,13,25,85
13160,-7.38049999999649,5140.2,66,18,20,84
13161,-11.002249999998511,4262.4,45,13,15,58
13162,-18.5187499999977,1862.625,46,14,45,60
13163,-15.30024999999929,2341.235294117647,31,11,42,42
13164,-39.84574999999845,2031.3684210526317,15,16,27,31
13165,-5.8587499999975385,3768.4210526315787,44,7,30,51
13166,0.007999999999916874,2695.4444444444443,63,18,13,81
13167,-34.2867499999994,2098.625,23,18,23,41
13168,14.505500000001039,3576.3333333333335,65,10,20,75
13169,-28.971249999998427,1528.25,16,17,27,33
13170,-30.772499999998463,1429.0,0,16,40,16
13171,-7.832749999999196,3576.7,40,8,16,48
13172,-19.29224999999907,1701.875,22,3,33,25
13173,31.352250000000247,2429.0,57,22,11,79
13174,-25.05324999999926,2613.684210526316,24,9,22,33
13175,2.8622500000007878,3026.6470588235293,38,10,19,48
13176,-0.6567499999985362,3084.222222222222,56,11,21,67
13177,-19.031499999998875,2866.0,58,9,23,67
13178,15.594750000002787,2403.3125,55,11,23,66
13179,-23.949999999998646,4227.5,44,14,29,58
13180,0.8667500000012517,3733.2105263157896,51,12,17,63
13181,-38.46374999999924,2506.7894736842104,21,6,28,27
13182,-2.4667499999992186,1911.3125,44,22,23,66
13183,8.451750000001212,2551.4117647058824,52,11,20,63
13184,19.216000000000868,2953.777777777778,66,12,16,78
13185,-24.217499999998704,1528.25,24,12,19,36
13186,-10.597749999998749,3383.1052631578946,42,3,25,45
13187,3.5832500000011676,4855.9473684210525,59,10,27,69
13188,-9.67199999999897,2960.235294117647,43,12,18,55
13189,-38.51624999999958,1676.0,3,11,27,14
13190,23.917000000001185,3212.470588235294,71,8,18,79
13191,-13.366999999999232,3692.5,35,16,18,51
13192,-7.606999999998793,2614.9411764705883,36,10,24,46
13193,25.40125000000209,4774.0526315789475,66,20,13,86
13194,-18.842499999999756,2290.5555555555557,31,19,21,50
13195,-10.5554999999983,2515.4444444444443,41,14,11,55
13196,10.735500000000732,4802.473684210527,79,10,15,89
13197,-15.391499999997034,2959.0555555555557,55,15,20,70
13198,-33.31199999999867,3299.5789473684213,32,10,22,42
13199,-15.531749999999178,2601.3,28,9,18,37
13200,-38.7097499999996,1528.25,6,13,19,19
13201,4.747250000000079,2758.8888888888887,44,15,16,59
13202,-0.6702499999996052,1729.625,36,12,13,48
13203,4.745000000002179,3485.5,60,12,15,72
13204,-3.2904999999984264,2013.5294117647059,57,17,19,74
13205,16.998499999999773,4766.578947368421,63,12,17,75
13206,-6.266749999998931,3996.5,44,14,27,58
13207,-17.0942499999989,2774.9473684210525,26,15,18,41
13208,-12.410499999998795,3100.7368421052633,39,6,19,45
13209,-1.3344999999995906,3758.8888888888887,59,7,20,66
13210,9.207500000001446,4358.45,56,8,13,64
13211,-24.072999999998157,1639.375,22,16,21,38
13212,-19.43274999999978,2429.0555555555557,38,19,17,57
13213,11.448750000000336,4211.0,56,20,9,76
13214,-13.676999999999305,2793.2631578947367,23,17,15,40
13215,-17.87449999999867,2580.85,29,7,22,36
13216,-1.7429999999978238,3181.277777777778,44,15,18,59
13217,-33.5404999999994,1988.3529411764705,23,19,12,42
13218,-11.449249999999214,3781.45,43,17,11,60
13219,-4.5187499999983185,2263.222222222222,33,10,19,43
13220,-5.8224999999982305,3049.9444444444443,47,7,21,54
13221,11.61200000000138,3158.3333333333335,59,9,22,68
13222,5.693500000002052,2672.705882352941,53,13,23,66
13223,-15.65824999999866,4056.1,44,10,13,54
13224,3.4587500000012232,2599.6875,45,9,18,54
13225,-19.975999999999686,1975.235294117647,29,20,14,49
13226,-17.876999999999445,1977.5555555555557,21,14,19,35
13227,-6.570250000000075,2597.1176470588234,39,10,20,49
13228,-26.369999999999344,2026.375,30,16,23,46
13229,-2.6414999999982394,3735.7894736842104,53,10,15,63
13230,15.783750000000959,4636.315789473684,78,12,10,90
13231,-23.35499999999919,2703.277777777778,35,3,27,38
13232,3.0237500000011535,2628.4444444444443,27,14,23,41
13233,-31.029749999999446,2290.3684210526317,26,4,31,30
13234,-11.978749999998552,4265.6,41,11,19,52
13235,-1.8579999999981531,3347.0555555555557,53,6,18,59
13236,-7.801500000000641,2378.705882352941,60,14,29,74
13237,-12.26699999999863,2913.1666666666665,36,13,19,49
13238,4.811500000002276,2785.277777777778,51,5,22,56
13239,-37.746249999999804,1429.0,11,12,19,23
13240,-10.493749999999622,2897.3333333333335,39,14,19,53
13241,-16.137999999998776,2461.722222222222,32,6,21,38
13242,-16.028249999998994,4062.35,37,16,19,53
13243,-29.092249999999076,2552.3529411764707,31,10,19,41
13244,-4.183499999999908,2944.9444444444443,59,9,22,68
13245,0.04800000000186566,2596.722222222222,44,17,15,61
13246,-4.365749999999603,3254.4444444444443,57,20,14,77
13247,-6.879499999998876,2781.8888888888887,28,17,20,45
13248,-24.927500000000048,1559.0,30,14,12,44
13249,-29.52074999999948,2017.4117647058824,22,11,22,33
13250,6.347500000001871,3131.294117647059,61,14,17,75
13251,-28.74999999999893,1598.0588235294117,13,20,19,33
13252,2.3352500000021106,2487.3333333333335,44,20,12,64
13253,0.9497500000011376,2605.529411764706,48,13,18,61
13254,-6.308249999999181,3206.777777777778,67,21,19,88
13255,-23.61749999999879,1917.4117647058824,24,13,20,37
13256,8.245250000002367,3257.176470588235,65,6,24,71
13257,-8.793499999998993,2592.0,36,5,15,41
13258,-27.421499999999458,1581.8125,18,1,25,19
13259,5.547000000002593,3154.6470588235293,72,14,7,86
13260,-17.040749999999246,2725.2,30,12,13,42
13261,-11.785749999998256,2324.529411764706,50,15,23,65
13262,8.821750000000236,3540.1111111111113,78,24,11,102
13263,-0.9714999999983677,2766.176470588235,44,8,20,52
13264,-12.219749999999014,3628.7368421052633,32,14,18,46
13265,-14.204499999998541,2162.25,35,8,21,43
13266,-7.659999999998954,3636.2631578947367,57,12,21,69
13267,-14.46374999999814,2921.9473684210525,40,12,24,52
13268,-1.2007499999990185,2133.4375,49,14,23,63
13269,9.89200000000137,3216.8947368421054,51,9,14,60
13270,-35.04049999999914,1528.25,8,23,19,31
13271,-5.20049999999851,2255.5,45,14,12,59
13272,-17.542999999998734,3851.3,27,18,17,45
13273,12.085750000000154,2836.3888888888887,44,9,19,53
13274,-4.21199999999977,1576.875,41,10,20,51
13275,-4.326499999998473,2971.3684210526317,33,14,19,47
13276,-26.80749999999879,2166.6470588235293,35,3,22,38
13277,-15.508999999999327,4029.85,39,16,15,55
13278,-21.485249999997627,4008.45,40,11,25,51
13279,-32.46524999999957,2470.842105263158,18,11,31,29
13280,-21.249249999999325,2555.35,21,18,10,39
13281,4.823250000002876,3493.5,52,22,30,74
13282,-12.382249999999123,2360.6875,40,13,16,53
13283,-13.35649999999931,3600.315789473684,40,4,30,44
13284,-11.601249999998922,3000.4736842105262,30,13,20,43
13285,-23.203249999999294,2189.1666666666665,22,21,13,43
13286,4.888000000001477,2304.0625,50,22,16,72
13287,-0.4044999999990743,3399.0,44,15,19,59
13288,-19.631999999999735,2314.4444444444443,33,5,39,38
13289,-21.62999999999925,3425.1,29,11,22,40
13290,-12.729999999999013,2876.277777777778,38,15,25,53
13291,6.391000000001755,4831.736842105263,72,10,24,82
13292,-10.21449999999857,2847.0555555555557,34,12,20,46
13293,-16.441250000000146,2294.1111111111113,26,10,20,36
13294,-5.361499999998449,3663.0526315789475,47,7,19,54
13295,-5.720999999999064,2534.5882352941176,48,1,23,49
13296,-19.08324999999771,2365.5,39,7,26,46
13297,-4.260749999998789,2237.5625,52,4,16,56
13298,-29.012749999999777,2036.6666666666667,20,13,23,33
13299,-7.933749999999639,2762.4444444444443,42,19,27,61
13300,-17.8409999999984,4324.25,41,8,25,49
13301,-24.910249999998886,1934.235294117647,23,17,15,40
13302,-35.2907499999994,2787.1,23,10,18,33
13303,-30.084749999999296,3171.15,22,19,16,41
13304,-6.052999999999086,3011.9444444444443,58,6,23,64
13305,-33.02474999999994,1429.0,19,9,20,28
13306,-26.371999999999314,2081.6111111111113,21,9,16,30
13307,-0.18374999999831215,4158.5,44,7,22,51
13308,-15.253749999999437,2473.1666666666665,30,12,21,42
13309,19.267750000001918,3190.9444444444443,53,18,11,71
13310,-5.40549999999956,3437.4210526315787,49,5,15,54
13311,25.383000000001424,3777.3888888888887,76,8,20,84
13312,-2.5802499999984,5017.95,78,7,18,85
13313,-33.03774999999974,2707.722222222222,38,7,31,45
13314,2.3960000000024975,2728.764705882353,55,11,18,66
13315,-14.916249999999115,3764.9473684210525,46,8,14,54
13316,6.689000000001106,5413.2,71,13,18,84
13317,-23.630499999999223,2729.7894736842104,27,15,23,42
13318,20.938250000000487,3535.6666666666665,66,4,22,70
13319,-8.203249999998317,3944.5263157894738,58,14,16,72
13320,-24.623750000000037,1429.0,21,22,25,43
13321,-16.10124999999892,3797.25,35,4,19,39
13322,14.029750000001405,5307.6,52,16,21,68
13323,-18.136249999998824,2631.8888888888887,40,14,27,54
13324,-15.61249999999886,3415.5,40,10,20,50
13325,18.20825000000074,5960.8,66,10,16,76
13326,-19.200749999999097,3314.8,31,13,19,44
13327,-27.550750000000257,2042.2105263157894,23,9,24,32
13328,-38.075999999999624,2274.777777777778,22,5,37,27
13329,-19.905500000000025,2131.1176470588234,35,12,15,47
13330,-20.65424999999859,4265.315789473684,62,4,32,66
13331,1.2332500000017408,4180.75,48,12,19,60
13332,-18.29224999999873,3826.7,44,18,17,62
13333,-3.276249999999088,2526.176470588235,46,11,21,57
13334,3.04975000000177,3831.7894736842104,58,14,20,72
13335,-25.759499999999356,2563.95,20,14,18,34
13336,8.147500000002447,3083.3888888888887,43,9,28,52
13337,-12.521999999999716,2786.684210526316,27,14,19,41
13338,-7.120749999998656,2299.294117647059,40,9,18,49
13339,-38.75324999999911,3541.75,31,18,15,49
13340,-17.808249999999713,2314.3888888888887,33,13,14,46
13341,-14.554999999998193,2487.277777777778,42,14,14,56
13342,-16.29274999999843,1824.9411764705883,30,16,16,46
13343,10.391750000002434,5292.65,79,9,19,88
13344,-3.618999999999238,3158.3684210526317,62,13,14,75
13345,-35.09999999999926,1840.8235294117646,32,29,14,61
13346,-30.358499999999054,2707.65,19,8,30,27
13347,-40.85974999999946,1429.0,11,10,24,21
13348,-15.934999999998519,3063.9411764705883,57,16,18,73
13349,-16.01174999999876,2416.8823529411766,36,6,26,42
13350,-3.4239999999981308,2663.6111111111113,44,17,15,61
13351,-8.812999999998343,2955.6470588235293,48,11,13,59
13352,0.32700000000221185,3171.5555555555557,57,9,25,66
13353,-12.091249999999697,3975.9,36,12,20,48
13354,-17.8757499999988,2121.5,41,15,21,56
13355,-18.306499999998962,3388.9473684210525,38,13,20,51
13356,-26.14149999999973,1949.2777777777778,23,13,22,36
13357,-5.774999999998036,2960.4117647058824,42,10,21,52
13358,-0.6347499999975807,2152.3333333333335,41,5,25,46
13359,-7.161999999998071,3544.15,43,13,18,56
13360,-9.715499999999452,2866.4444444444443,49,13,22,62
13361,-10.808749999997698,2602.6666666666665,47,19,15,66
13362,3.19050000000173,3701.4210526315787,52,9,19,61
13363,-14.524999999999077,3835.4,33,17,19,50
13364,-20.130749999999047,2709.7894736842104,20,12,28,32
13365,-8.146499999997562,2164.764705882353,41,12,26,53
13366,6.699500000002675,4130.0,65,11,15,76
13367,-19.614999999997764,3630.1666666666665,43,7,32,50
13368,11.923750000000368,2815.705882352941,82,18,14,100
13369,-1.7334999999983882,2447.9375,45,16,15,61
13370,4.467500000002141,3773.8888888888887,56,13,13,69
13371,24.085000000000328,2353.625,63,13,19,76
13372,-4.13924999999754,2106.6875,44,15,18,59
13373,-5.891749999999037,3424.8947368421054,45,19,16,64
13374,-12.67600000000007,1501.0,45,19,15,64
13375,-4.922249999998311,3326.315789473684,44,12,13,56
13376,-12.9904999999996,3072.3684210526317,33,2,29,35
13377,-46.528999999999584,1567.9375,12,11,26,23
13378,-19.357999999997325,4250.5,54,12,20,66
13379,-14.110499999997884,4343.0526315789475,58,17,21,75
13380,-14.092249999998566,2667.1111111111113,31,20,16,51
13381,-29.791499999997598,3542.684210526316,40,6,27,46
13382,-13.970999999998511,3052.5555555555557,47,4,22,51
13383,-22.2244999999996,2611.235294117647,47,14,23,61
13384,-15.465249999999745,2286.176470588235,42,13,29,55
13385,6.460250000000317,2103.625,49,9,27,58
13386,-16.292999999998905,3394.2,24,11,26,35
13387,-0.16774999999906104,2548.6470588235293,42,16,8,58
13388,1.6130000000016396,2417.8823529411766,33,11,21,44
13389,-3.4359999999990705,4559.25,47,6,21,53
13390,-0.9759999999990663,4703.6,52,11,19,63
13391,16.57600000000216,4527.789473684211,69,2,15,71
13392,13.045500000001761,2280.5882352941176,42,19,20,61
13393,-8.719749999997699,2724.1176470588234,56,10,18,66
13394,-2.058999999998453,3207.777777777778,47,10,23,57
13395,-33.7574999999989,1724.1176470588234,22,17,14,39
13396,1.344000000000555,2420.6470588235293,56,17,24,73
13397,-7.052000000000186,3270.277777777778,43,6,23,49
13398,-28.63349999999856,2553.4210526315787,19,16,27,35
13399,1.234000000000838,2482.5625,47,15,23,62
13400,-22.993749999999654,2586.25,14,17,14,31
13401,-10.382999999998326,3005.777777777778,44,14,25,58
13402,-37.46875000000025,1429.0,31,17,27,48
13403,-10.586999999999659,2572.823529411765,41,15,31,56
13404,-18.38899999999894,2587.842105263158,28,6,24,34
13405,-36.045749999999074,3196.6,26,9,22,35
13406,-19.76824999999931,2876.842105263158,29,15,13,44
13407,-15.606749999998424,3090.7894736842104,36,12,23,48
13408,-4.387249999998791,3218.5263157894738,37,2,25,39
13409,-17.393999999999302,2527.25,45,16,22,61
13410,-14.263749999999453,2445.8823529411766,56,23,17,79
13411,-6.054249999998161,2945.8333333333335,36,8,25,44
13412,-25.88849999999877,2072.8888888888887,25,15,16,40
13413,-8.123749999999292,3388.0526315789475,35,11,19,46
13414,12.268750000000932,3631.8888888888887,66,5,15,71
13415,-40.65775000000001,1429.0,0,15,23,15
13416,-0.6239999999988937,3409.6666666666665,56,8,20,64
13417,-5.403749999998712,3601.25,32,13,23,45
13418,-5.4302499999988765,2483.1176470588234,40,11,12,51
13419,-7.805499999998867,2599.3333333333335,34,10,16,44
13420,-15.191500000000113,2036.6666666666667,39,19,17,58
13421,-10.975499999998302,3727.4,41,14,14,55
13422,2.5590000000014634,3904.5,44,9,17,53
13423,-28.179999999999573,2894.3684210526317,34,6,36,40
13424,-18.125999999999387,3929.0555555555557,49,8,25,57
13425,0.10575000000102604,2014.3125,47,4,29,51
13426,-24.499999999999154,2808.222222222222,30,4,33,34
13427,-13.156249999999579,1987.5625,46,13,20,59
13428,-11.052749999998898,4318.7,41,13,20,54
13429,-14.378249999999671,1514.375,33,11,17,44
13430,-17.711749999999267,2221.0,24,15,14,39
13431,31.901250000001674,3398.294117647059,72,20,17,92
13432,-0.8052499999976058,3798.3684210526317,49,12,18,61
13433,-5.95799999999926,2497.0,36,5,30,41
13434,-40.71549999999916,2479.1,12,11,31,23
13435,-16.896999999999444,1991.625,45,17,15,62
13436,5.978000000001737,1592.0,42,7,24,49
13437,-7.090250000000063,3278.222222222222,68,16,18,84
13438,-14.42224999999919,3048.8888888888887,41,2,26,43
13439,12.085750000000617,3933.6315789473683,56,14,16,70
13440,-14.012999999998673,1481.9333333333334,47,12,23,59
13441,-22.92300000000001,1429.0,14,4,26,18
13442,-15.940499999998739,1612.625,37,12,24,49
13443,-0.020249999997195102,3374.4444444444443,53,12,25,65
13444,-21.254999999998937,3027.777777777778,41,15,19,56
13445,-0.36149999999830945,3989.6315789473683,57,6,24,63
13446,-1.5104999999993185,4018.842105263158,45,12,16,57
13447,-18.550250000000005,2384.1111111111113,23,18,26,41
13448,-13.371249999999566,2403.823529411765,35,16,19,51
13449,-41.748499999998685,2914.1111111111113,28,9,29,37
13450,-3.954249999998963,4299.75,46,10,24,56
13451,-35.4924999999994,1550.0625,34,16,22,50
13452,12.117250000002036,2556.9444444444443,57,18,9,75
13453,-22.387499999999005,2130.1111111111113,22,25,8,47
13454,-33.97674999999882,2271.222222222222,28,5,21,33
13455,-20.603749999998826,3269.55,29,16,19,45
13456,-21.869999999999358,3024.684210526316,22,7,25,29
13457,-20.27399999999923,2572.8947368421054,23,4,21,27
13458,0.7410000000022571,5117.25,59,6,23,65
13459,10.277000000001161,3540.1666666666665,51,13,25,64
13460,5.667000000000475,2479.4117647058824,56,26,13,82
13461,-7.767499999998695,3587.1,35,14,16,49
13462,-24.758749999998905,2560.4444444444443,33,19,21,52
13463,-4.635249999999351,2676.0,53,13,19,66
13464,-3.0197499999976753,4313.0,58,14,14,72
13465,-11.584249999998564,3002.222222222222,45,13,21,58
13466,-13.969749999999573,2853.4210526315787,32,10,20,42
13467,-4.932500000000327,2262.3888888888887,43,21,14,64
13468,1.0467500000018213,3769.5,61,8,20,69
13469,0.5130000000013405,3273.0555555555557,62,22,17,84
13470,-1.6097499999977756,1601.5333333333333,51,6,23,57
13471,-4.32274999999807,4119.5,53,16,20,69
13472,8.270250000001273,3141.470588235294,43,9,23,52
13473,-1.5747499999999859,2317.8888888888887,38,17,20,55
13474,-5.200249999997415,2463.6470588235293,53,2,27,55
13475,-5.627749999998282,3044.6666666666665,46,18,22,64
13476,-8.859249999998685,4679.05,58,10,22,68
13477,16.853000000001753,1534.8666666666666,46,15,14,61
13478,-30.41449999999947,3035.5789473684213,33,9,32,42
13479,-18.15799999999961,2125.705882352941,29,11,25,40
13480,-6.680999999997724,3428.222222222222,60,13,14,73
13481,-16.3904999999993,2849.315789473684,18,5,26,23
13482,5.356750000001737,4837.1,51,4,21,55
13483,1.3537500000012055,2142.3125,47,5,29,52
13484,-20.4432499999997,2484.6111111111113,22,10,31,32
13485,-18.00099999999925,3351.25,24,9,22,33
13486,3.59825000000077,2076.3333333333335,51,14,19,65
13487,-37.01249999999999,2343.0,16,17,19,33
13488,1.1067500000012371,3163.6666666666665,44,13,26,57
13489,-17.589749999998745,4387.85,41,1,26,42
13490,-6.3664999999985,1528.25,27,15,19,42
13491,-10.263249999998902,4350.45,56,9,12,65
13492,-18.949999999998987,3164.2105263157896,37,17,11,54
13493,5.58700000000078,3590.3684210526317,62,7,25,69
13494,-33.951249999999405,2060.4444444444443,17,15,23,32
13495,-13.59224999999986,2064.0,39,16,18,55
13496,-17.515749999999212,2179.5,28,11,25,39
13497,-19.226499999998982,3200.157894736842,40,7,22,47
13498,-29.824249999998802,2178.315789473684,23,17,16,40
13499,-11.642749999998511,3490.157894736842,40,6,23,46
13500,23.454750000000594,3611.6111111111113,75,8,19,83
13501,-29.082999999999185,1701.875,19,8,23,27
13502,-16.728999999999143,3820.842105263158,41,20,25,61
13503,-28.936499999998397,3114.157894736842,32,7,26,39
13504,-13.066749999999425,2631.8333333333335,35,12,19,47
13505,21.819500000000208,4199.263157894737,72,17,13,89
13506,1.2800000000003595,3801.7368421052633,49,18,10,67
13507,-36.20274999999977,2695.6315789473683,26,14,21,40
13508,9.05400000000127,4338.65,52,13,14,65
13509,19.923750000001725,3307.6470588235293,75,9,23,84
13510,9.703000000001857,3622.3529411764707,87,11,19,98
13511,28.82325000000187,5742.65,83,11,18,94
13512,-7.116499999998988,2664.5789473684213,35,5,22,40
13513,-0.43674999999913605,2600.1111111111113,43,12,21,55
13514,1.7767500000014622,2892.9444444444443,41,9,20,50
13515,-2.311749999998823,4459.3,52,6,26,58
13516,-1.2919999999982574,1850.1176470588234,42,8,19,50
13517,-10.171749999997731,3033.294117647059,51,22,13,73
13518,-22.26274999999884,2523.3333333333335,42,21,28,63
13519,-23.025499999999646,2531.0,25,16,28,41
13520,-19.785249999998733,3044.2,30,14,17,44
13521,-35.16774999999923,1581.235294117647,6,11,29,17
13522,-4.653999999999571,3121.684210526316,47,9,21,56
13523,-15.55749999999899,2232.6875,40,15,15,55
13524,-13.738999999998658,3346.277777777778,59,14,18,73
13525,-13.297499999999065,2814.3888888888887,34,8,22,42
13526,-23.93799999999876,1505.4375,15,12,29,27
13527,-0.8174999999984326,3065.9411764705883,63,16,23,79
13528,-15.906999999999504,2726.4736842105262,34,6,23,40
13529,-25.743249999999552,2686.15,18,8,22,26
13530,-19.550249999999327,1533.8,25,24,14,49
13531,0.9097500000014296,3741.5263157894738,57,10,17,67
13532,-23.1382499999996,4026.7,33,12,24,45
13533,-29.49075000000044,2397.4444444444443,25,13,47,38
13534,-8.003249999999486,2014.5,42,7,25,49
13535,5.9922500000016115,2619.5,44,13,15,57
13536,-36.25424999999948,2751.2,17,8,25,25
13537,3.0402500000028287,3570.1666666666665,63,6,20,69
13538,2.4912500000018984,4763.95,54,8,25,62
13539,-18.660749999999176,3820.8947368421054,67,8,26,75
13540,-6.182749999998389,4282.25,44,13,14,57
13541,3.754750000000425,2273.235294117647,54,6,20,60
13542,-12.959999999998342,4107.6,47,11,17,58
13543,-1.4732499999987063,3119.0588235294117,50,10,18,60
13544,-16.558499999998286,3365.6666666666665,50,13,19,63
13545,-15.261249999998947,2315.1176470588234,46,7,26,53
13546,-20.176750000000013,1438.5333333333333,38,29,15,67
13547,5.192750000000965,3388.157894736842,50,15,17,65
13548,-15.252250000000135,1527.25,20,16,26,36
13549,3.4244999999999957,2825.8333333333335,53,6,22,59
13550,5.184750000001886,2795.0,64,5,29,69
13551,10.91750000000265,3185.722222222222,57,10,20,67
13552,-4.6309999999986164,3589.5263157894738,48,22,11,70
13553,-24.495499999999744,2054.0625,32,7,20,39
13554,5.209750000000904,4021.4210526315787,52,9,20,61
13555,-35.12024999999973,2185.2105263157896,16,14,21,30
13556,1.8207500000011287,2605.5882352941176,51,14,22,65
13557,-42.75149999999989,1429.0,1,12,22,13
13558,-17.151499999999736,3295.3684210526317,39,19,20,58
13559,-9.845749999998526,4640.15,48,10,23,58
13560,-19.400249999998458,2460.777777777778,36,15,21,51
13561,-44.707999999999316,2231.5555555555557,12,18,18,30
13562,-26.71849999999921,1799.764705882353,21,8,18,29
13563,-18.341999999998475,1900.5882352941176,28,18,21,46
13564,-23.239749999999912,2030.3529411764705,47,20,22,67
13565,-34.21449999999994,1429.0,16,13,22,29
13566,-10.594999999999374,2846.1666666666665,32,18,16,50
13567,-19.826499999999605,2982.25,29,10,15,39
13568,-21.14974999999858,2139.6470588235293,43,4,23,47
13569,-7.0414999999984245,2413.235294117647,41,8,21,49
13570,-23.156249999999694,1799.764705882353,15,13,19,28
13571,-5.920749999999375,3983.15,46,10,18,56
13572,-2.15599999999947,2270.3529411764707,41,11,24,52
13573,-2.686749999998969,3050.9411764705883,55,12,19,67
13574,-10.384249999998694,3264.4736842105262,55,12,16,67
13575,-14.48524999999897,4180.7,39,11,15,50
13576,-11.943999999999235,4037.75,44,12,13,56
13577,-30.56099999999941,2934.6,23,6,26,29
13578,11.798749999999966,2937.0555555555557,63,14,19,77
13579,-16.896499999998785,2910.5,36,11,17,47
13580,-2.0084999999977406,2771.277777777778,48,11,14,59
13581,-12.822499999999021,2773.5882352941176,64,17,17,81
13582,-3.52499999999833,4054.0,55,12,15,67
13583,-9.17749999999853,2419.3333333333335,35,14,21,49
13584,-7.311249999999477,3944.5789473684213,54,9,16,63
13585,-13.43349999999863,2429.0625,58,23,16,81
13586,-3.7814999999991152,2805.3529411764707,53,13,16,66
13587,-11.980249999999003,3027.157894736842,32,11,41,43
13588,-43.61374999999938,3935.4,29,13,21,42
13589,-10.215249999999019,3590.15,39,5,21,44
13590,-1.6344999999994634,2613.9411764705883,52,17,16,69
13591,5.558000000002115,3433.5,54,4,33,58
13592,-25.74249999999999,1429.0,32,10,42,42
13593,5.42500000000112,4067.3684210526317,65,16,14,81
13594,-19.13924999999916,2807.235294117647,37,17,20,54
13595,-12.711749999998805,2783.5555555555557,53,3,20,56
13596,-21.18224999999893,3643.4,44,9,15,53
13597,-36.63024999999937,1429.0,13,8,34,21
13598,-6.689749999998673,3937.75,44,12,14,56
13599,-10.767249999998993,3191.0,38,19,12,57
13600,-5.838499999999526,2407.25,51,9,18,60
13601,-9.405499999999517,3210.2631578947367,41,16,15,57
13602,-15.26399999999953,1612.5625,30,7,26,37
13603,-33.14274999999911,1539.0666666666666,33,3,22,36
13604,-5.007749999999561,2089.6875,52,11,27,63
13605,3.226750000001494,3051.6111111111113,66,12,19,78
13606,-19.435749999997913,2323.6470588235293,40,10,27,50
13607,-3.6499999999987054,2786.1666666666665,49,21,11,70
13608,-26.07699999999924,2203.3333333333335,23,10,22,33
13609,4.400250000002021,2880.0588235294117,47,8,18,55
13610,-5.827749999998817,3666.315789473684,57,5,21,62
13611,-14.326499999999388,2052.5,25,19,14,44
13612,0.8990000000017757,3735.1111111111113,69,14,16,83
13613,-6.827499999998729,3860.65,45,7,29,52
13614,-30.758249999999514,2244.95,11,9,27,20
13615,12.995750000001376,3187.5,67,11,19,78
13616,-15.398499999999975,1692.9375,28,11,21,39
13617,5.736500000001007,3910.2105263157896,62,14,17,76
13618,24.667500000001116,4397.333333333333,99,10,23,109
13619,-26.09499999999995,2094.777777777778,18,7,29,25
13620,-19.494999999998164,3470.8947368421054,37,11,23,48
13621,6.234500000000829,2232.0588235294117,39,5,22,44
13622,-24.393749999999887,2170.1875,34,9,23,43
13623,2.2192500000017406,4664.1,52,17,14,69
13624,-16.316999999999545,3445.75,31,15,17,46
13625,-15.554249999998117,1710.8125,50,9,19,59
13626,-7.992749999999782,2111.6111111111113,49,12,18,61
13627,-20.95049999999913,3372.315789473684,43,9,23,52
13628,-35.40424999999957,1528.25,8,20,16,28
13629,-21.088999999998528,2141.470588235294,35,10,20,45
13630,-22.8452499999995,3335.5263157894738,28,3,34,31
13631,-4.460249999998958,2870.0555555555557,53,7,23,60
13632,-25.02874999999939,2198.4117647058824,28,8,22,36
13633,-12.028499999999335,2445.823529411765,31,37,9,68
13634,-13.089999999999048,2072.8333333333335,27,14,15,41
13635,3.286750000002988,2346.0,60,9,18,69
13636,-12.662749999998407,3057.8333333333335,45,9,14,54
13637,-9.814499999998825,3796.6,34,11,24,45
13638,-9.033749999997651,2866.157894736842,31,9,30,40
13639,-19.204500000000134,2718.8947368421054,32,1,29,33
13640,-35.32000000000003,1429.0,5,8,25,13
13641,-12.2735000000001,2479.529411764706,54,13,11,67
13642,-22.722249999999036,2962.35,28,9,22,37
13643,-19.037999999998693,3496.0,49,9,27,58
13644,-19.73874999999793,2072.8333333333335,38,13,18,51
13645,-23.67799999999968,3362.315789473684,51,11,20,62
13646,-7.9867499999981275,2512.375,75,19,17,94
13647,-23.473749999999164,2708.4,22,11,17,33
13648,0.6195000000014679,2035.1176470588234,34,14,21,48
13649,-8.439499999998727,4782.3,49,3,22,52
13650,3.2147500000018283,3202.235294117647,62,21,14,83
13651,-15.234749999999817,2314.4444444444443,36,15,18,51
13652,-7.079249999998862,3690.9444444444443,67,6,40,73
13653,-0.9317499999988804,3247.0,42,5,20,47
13654,-5.9024999999975485,5853.8,58,12,31,70
13655,-4.864999999998929,2481.1111111111113,42,6,27,48
13656,-7.788749999998599,2240.4117647058824,40,13,20,53
13657,-10.53549999999937,2925.315789473684,42,14,19,56
13658,-2.4224999999977284,3280.8888888888887,55,13,19,68
13659,-14.740999999999005,1849.625,25,8,29,33
13660,-26.43474999999919,2172.684210526316,22,11,18,33
13661,-14.531499999998019,3058.2105263157896,40,13,18,53
13662,-26.52999999999944,2399.1111111111113,20,17,13,37
13663,-7.509999999998746,2769.9411764705883,39,11,22,50
13664,-3.13124999999877,3565.2105263157896,46,13,17,59
13665,-24.521000000000008,2745.7894736842104,24,8,14,32
13666,-9.283749999998953,3008.55,33,5,20,38
13667,-20.05999999999866,2635.4444444444443,33,12,19,45
13668,0.3005000000004522,4147.526315789473,57,14,10,71
13669,-4.292999999999179,4584.6,41,14,19,55
13670,-4.100749999999034,3155.722222222222,46,14,22,60
13671,-38.24824999999949,3340.9,32,24,16,56
13672,-9.50024999999905,2724.235294117647,35,12,19,47
13673,8.501500000000691,3465.222222222222,53,9,24,62
13674,-49.23199999999986,1429.0,7,10,18,17
13675,8.426000000001464,3370.294117647059,64,12,19,76
13676,-3.28574999999896,2335.705882352941,34,9,20,43
13677,-11.038999999999696,2160.0588235294117,27,8,25,35
13678,-2.8009999999999726,2290.823529411765,47,8,26,55
13679,-11.169999999999801,2639.777777777778,46,10,14,56
13680,-26.15624999999931,2332.25,16,19,18,35
13681,4.00650000000062,2450.6470588235293,36,17,11,53
13682,-4.645499999998429,3097.705882352941,44,15,19,59
13683,-4.723499999999558,2272.235294117647,39,8,22,47
13684,-29.423500000000253,2884.315789473684,28,19,21,47
13685,-28.738499999999114,2866.35,29,9,18,38
13686,-13.00424999999891,1898.3125,34,12,15,46
13687,-44.0834999999998,2072.3684210526317,6,16,20,22
13688,-27.367499999999172,2077.9411764705883,25,21,20,46
13689,17.6160000000011,2625.5,68,20,14,88
13690,0.519250000001261,2078.8823529411766,50,13,17,63
13691,-21.498999999998883,3315.65,28,15,15,43
13692,-5.177499999997906,2129.4117647058824,39,16,15,55
13693,-15.831249999999432,2724.3888888888887,44,15,16,59
13694,-5.669999999998794,3600.3684210526317,48,14,10,62
13695,-7.3107499999981815,2529.0588235294117,44,8,20,52
13696,-23.798249999999058,2607.0,22,15,18,37
13697,-27.689249999999184,2136.823529411765,24,6,20,30
13698,7.726250000001519,4439.1578947368425,51,12,16,63
13699,-19.50499999999786,2640.235294117647,41,8,20,49
13700,-21.736249999998655,2008.8823529411766,32,8,23,40
13701,-10.845999999998387,2111.5882352941176,35,9,29,44
13702,-6.321249999998732,2341.294117647059,37,19,17,56
13703,-31.097999999999626,2241.9473684210525,11,12,22,23
13704,-13.896000000000015,2076.3888888888887,35,8,22,43
13705,7.331750000000339,4022.9473684210525,53,9,25,62
13706,25.240000000002873,4672.7,57,11,21,68
13707,-33.66649999999947,2475.823529411765,32,13,23,45
13708,21.046500000002094,3022.0,72,10,19,82
13709,-15.67649999999935,3175.157894736842,37,11,14,48
13710,8.064249999999442,3556.0,72,13,15,85
13711,-7.469249999998439,2795.1176470588234,63,11,21,74
13712,-21.546999999999056,2561.3333333333335,24,14,17,38
13713,-15.312499999998115,1840.75,38,14,13,52
13714,-16.70174999999931,3226.0,43,11,21,54
13715,-5.548499999999164,3270.3529411764707,47,6,18,53
13716,-21.239499999999897,1941.388888888889,27,8,23,35
13717,3.1387500000010897,4781.4,60,4,23,64
13718,-31.957249999999515,1589.6470588235295,7,9,25,16
13719,2.7472500000017073,4564.421052631579,59,9,17,68
13720,-24.16274999999947,3686.3,30,14,21,44
13721,-29.84249999999963,2768.2105263157896,12,17,15,29
13722,-10.179249999998515,2799.2105263157896,33,8,21,41
13723,-9.724749999999101,3374.230769230769,49,16,18,65
13724,17.097500000000927,4166.736842105263,52,8,17,60
13725,-15.364749999998583,2128.3888888888887,28,8,26,36
13726,-21.633000000000166,2605.470588235294,37,5,30,42
13727,-25.072499999999465,3155.0526315789475,21,8,26,29
13728,-25.89949999999958,1429.0,23,15,17,38
13729,0.48100000000294685,3279.5789473684213,50,4,25,54
13730,-6.520749999997868,3744.7894736842104,41,10,29,51
13731,-39.76074999999978,1429.0,29,17,22,46
13732,-24.681749999998882,3179.315789473684,33,12,23,45
13733,0.35350000000161474,5049.8421052631575,70,4,22,74
13734,-19.105249999999245,2902.6111111111113,31,14,20,45
13735,-8.209499999997997,4246.55,57,1,25,58
13736,4.79550000000151,3978.7894736842104,42,13,20,55
13737,-24.24024999999895,3079.85,29,10,21,39
13738,-13.906999999999968,2459.0,57,9,19,66
13739,-21.363249999999436,4024.25,32,16,17,48
13740,-4.803999999998534,2862.0555555555557,53,12,14,65
13741,-40.1889999999999,1429.0,0,13,25,13
13742,4.065750000001602,2705.4117647058824,43,10,14,53
13743,-7.921499999998153,2063.9411764705883,40,15,18,55
13744,-19.272499999998434,1858.5882352941176,29,14,15,43
13745,-23.603249999999203,2671.6111111111113,33,12,17,45
13746,-4.991249999998531,2103.625,44,8,25,52
13747,-25.28374999999929,2833.9,18,9,28,27
13748,-8.820999999997522,2269.3125,48,13,22,61
13749,10.289000000002027,4782.15,69,5,17,74
13750,-11.741249999998956,4072.315789473684,57,3,32,60
13751,-21.040249999999624,2608.8888888888887,24,14,18,38
13752,-2.2165000000003117,1429.0,55,9,20,64
13753,-21.05274999999899,3166.45,33,6,22,39
13754,-34.09574999999914,2370.0,23,17,21,40
13755,-34.39624999999955,2230.315789473684,18,14,19,32
13756,-11.118749999999128,3723.1052631578946,34,9,24,43
13757,-19.8209999999985,1626.5,28,18,15,46
13758,0.3750000000008903,4356.315789473684,61,6,20,67
13759,17.88375000000035,3888.5263157894738,66,10,13,76
13760,-12.773749999998723,2685.9411764705883,40,19,17,59
13761,-4.748999999999123,2407.8333333333335,32,8,18,40
13762,-2.2027499999992104,3179.315789473684,45,11,17,56
13763,-10.091499999999389,3346.1666666666665,53,14,18,67
13764,5.7092500000009325,4527.4,59,10,22,69
13765,8.014250000001173,2884.0555555555557,47,5,17,52
13766,-27.547499999999662,2921.0526315789475,18,12,23,30
13767,-27.303749999998793,2026.9444444444443,22,13,27,35
13768,-8.881249999998719,2244.777777777778,33,14,20,47
13769,-33.85424999999809,1599.6875,26,13,23,39
13770,-29.563499999999266,2536.35,21,9,22,30
13771,-15.577249999998463,3755.5789473684213,50,9,26,59
13772,-10.522749999999325,3251.2,33,6,16,39
13773,-41.01550000000011,1429.0,9,11,22,20
13774,-6.923499999997705,2203.294117647059,41,6,24,47
13775,-2.8552499999983625,4042.2631578947367,58,7,24,65
13776,24.079750000001308,3311.3529411764707,74,15,11,89
13777,-5.6524999999988115,1672.4,65,6,22,71
13778,-26.204749999999525,2654.0,28,17,16,45
13779,-26.139499999999195,1429.0,17,19,14,36
13780,-6.8939999999986465,2921.176470588235,43,8,25,51
13781,-11.50774999999987,1982.6875,51,16,13,67
13782,1.2747500000014464,3195.4444444444443,48,14,13,62
13783,-11.512999999999703,2370.8333333333335,47,9,22,56
13784,-43.54149999999919,1606.4705882352941,8,5,31,13
13785,-25.929249999999563,2914.5263157894738,29,15,14,44
13786,-14.690249999998699,4025.85,42,5,19,47
13787,-19.134999999998776,2500.6111111111113,29,12,22,41
13788,-33.51249999999932,1559.0,12,15,18,27
13789,-16.177249999998683,3285.45,30,14,18,44
13790,20.42900000000079,3663.6111111111113,68,6,11,74
13791,-26.21074999999947,3140.0,35,12,20,47
13792,-14.977499999999097,3756.5789473684213,50,5,20,55
13793,16.058500000002308,2581.294117647059,58,6,14,64
13794,-16.120999999999338,2679.6111111111113,30,3,21,33
13795,-12.806499999998541,2624.0,36,15,14,51
13796,-3.221249999998725,3649.6315789473683,55,17,16,72
13797,-10.70599999999963,1429.0,36,13,20,49
13798,-15.770249999999427,1951.0588235294117,17,6,25,23
13799,12.33200000000177,5840.15,70,11,13,81
13800,-13.714749999999464,2244.176470588235,35,8,33,43
13801,-2.787249999998779,2437.470588235294,32,14,25,46
13802,0.2115000000013482,2953.9444444444443,30,8,25,38
13803,-17.50574999999869,3338.7894736842104,48,20,23,68
13804,3.581250000001885,3220.0,58,9,13,67
13805,-32.05149999999922,1690.4705882352941,13,15,21,28
13806,0.1227500000016617,1534.8666666666666,40,10,22,50
13807,-17.043999999998952,2953.777777777778,34,17,22,51
13808,-8.421999999996796,2376.5,56,7,26,63
13809,2.7025000000017214,4348.9,46,4,34,50
13810,-32.944249999998696,2616.2631578947367,22,13,24,35
13811,5.578750000001707,3625.4210526315787,46,18,16,64
13812,-10.243999999998485,2280.8888888888887,39,18,11,57
13813,7.020250000000084,3325.9444444444443,52,10,16,62
13814,11.543500000001899,4837.05,64,11,20,75
13815,-28.34374999999893,2911.2105263157896,29,12,17,41
13816,-23.225750000000016,2601.8947368421054,28,8,34,36
13817,-12.90024999999907,3579.3684210526317,51,17,20,68
13818,-2.546749999999246,3336.2631578947367,48,14,14,62
13819,11.084000000001364,3766.8333333333335,68,21,15,89
13820,-40.29149999999886,2128.3888888888887,14,13,26,27
13821,-20.05825000000003,2034.0,29,17,22,46
13822,16.101500000000975,3180.3888888888887,58,3,23,61
13823,-14.090249999998301,2178.823529411765,36,7,21,43
13824,-23.7414999999992,1922.0,19,13,16,32
13825,-29.11874999999924,1937.8333333333333,12,11,26,23
13826,6.982500000001653,2925.125,57,14,21,71
13827,1.8330000000014195,4000.55,42,17,17,59
13828,-3.716749999997849,2566.294117647059,54,6,16,60
13829,-32.97774999999902,2009.2777777777778,21,7,22,28
13830,-25.124499999998857,4092.55,37,18,13,55
13831,-12.292749999999316,3457.4736842105262,45,16,18,61
13832,-25.86124999999874,1984.6470588235295,20,12,23,32
13833,-23.469999999997714,2802.9444444444443,38,11,21,49
13834,-23.703249999999446,1996.9444444444443,22,9,13,31
13835,-18.91424999999831,3131.684210526316,32,15,23,47
13836,-17.763499999999453,2261.0,31,13,24,44
13837,3.2432500000016744,4008.7894736842104,49,11,15,60
13838,-17.571499999999215,2324.0555555555557,29,7,24,36
13839,-6.816999999998842,1539.0666666666666,51,9,26,60
13840,-23.52524999999876,2861.0,22,15,24,37
13841,-5.1309999999981635,2456.1176470588234,38,14,23,52
13842,-18.314499999999846,2241.3529411764707,43,7,16,50
13843,-2.0697499999970637,3033.277777777778,58,19,22,77
13844,-21.358499999999008,2760.684210526316,25,8,25,33
13845,-17.79149999999909,4123.5,38,18,16,56
13846,-13.330499999998889,3058.5,28,6,25,34
13847,-11.23874999999894,2688.9473684210525,33,18,11,51
13848,-5.8784999999992635,3636.315789473684,57,6,25,63
13849,-16.311249999998868,2240.4117647058824,33,16,14,49
13850,-36.715499999999224,1559.0,10,11,32,21
13851,14.148500000001604,3635.3888888888887,74,15,8,89
13852,3.639250000002126,2727.823529411765,68,10,21,78
13853,3.024250000002352,2769.8823529411766,64,8,22,72
13854,4.855500000001359,2993.3333333333335,51,11,9,62
13855,-2.400749999998483,2300.0,68,8,19,76
13856,-2.5927499999989134,3404.842105263158,45,9,17,54
13857,-13.938249999999035,3786.5789473684213,38,10,13,48
13858,-39.657749999999304,1648.4705882352941,14,4,23,18
13859,-12.208749999999231,2543.0588235294117,30,7,22,37
13860,-12.26349999999937,3884.3684210526317,51,8,23,59
13861,10.243000000001565,3172.125,62,4,17,66
13862,10.44950000000211,2373.5,48,10,21,58
13863,-10.048749999998643,3202.95,39,6,20,45
13864,-24.779000000000035,2252.5882352941176,50,8,31,58
13865,-39.132499999999915,2500.5555555555557,26,9,25,35
13866,7.011250000000646,2551.4117647058824,59,7,24,66
13867,-17.041249999999103,2438.0625,50,16,17,66
13868,-51.28174999999948,1691.8333333333333,0,20,23,20
13869,-0.7962499999982262,3192.722222222222,53,4,19,57
13870,-2.248249999998734,2758.6470588235293,40,16,13,56
13871,5.254750000000555,2421.529411764706,42,4,29,46
13872,-16.04574999999875,3108.0555555555557,32,18,16,50
13873,-18.115999999999822,2190.0588235294117,34,10,19,44
13874,-22.64624999999962,1626.5,14,15,15,29
13875,-0.10399999999845874,4438.65,54,12,13,66
13876,-26.191749999999683,2674.684210526316,38,11,20,49
13877,-15.449249999999527,2224.4444444444443,28,17,31,45
13878,-3.0460000000000553,3306.315789473684,54,13,19,67
13879,-4.082249999999216,4413.894736842105,52,7,22,59
13880,-27.17174999999994,1457.6,23,5,30,28
13881,2.5550000000008923,3176.9411764705883,62,15,23,77
13882,-22.124249999999567,2834.6666666666665,57,9,26,66
13883,5.857750000000906,3994.6315789473683,71,9,20,80
13884,-25.170999999999218,2068.6470588235293,22,7,23,29
13885,2.1497500000009717,2353.75,47,20,14,67
13886,-36.10224999999944,2052.15,15,22,15,37
13887,-22.1609999999989,2854.1666666666665,41,20,21,61
13888,-9.498749999999859,1481.9333333333334,46,8,28,54
13889,-30.82299999999943,1528.25,11,9,24,20
13890,-20.342999999998906,1898.25,38,13,21,51
13891,-25.15949999999949,4354.45,45,8,17,53
13892,-22.799749999999687,2899.4210526315787,27,11,24,38
13893,8.444000000000603,4123.315789473684,53,5,25,58
13894,-15.433749999998742,4261.6,43,12,16,55
13895,2.581250000000879,2697.9411764705883,62,16,12,78
13896,-27.16749999999858,3798.95,38,10,20,48
13897,-19.523249999999535,2064.0,29,16,16,45
13898,-23.680749999999094,2373.4444444444443,23,21,14,44
13899,-16.105999999999092,2749.0,28,13,14,41
13900,13.5952500000013,3809.157894736842,59,12,18,71
13901,5.113750000001493,3559.5,59,5,17,64
13902,-31.663999999999703,1884.375,26,17,12,43
13903,0.005750000001179067,2736.294117647059,52,10,27,62
13904,-8.46149999999933,2361.764705882353,39,16,25,55
13905,15.047750000001226,3282.777777777778,67,10,21,77
13906,-19.015749999998985,3260.2631578947367,45,5,23,50
13907,-12.374749999999212,3568.5789473684213,39,11,14,50
13908,-19.916999999999145,2876.9473684210525,52,13,23,65
13909,-1.504249999999486,4806.05,52,13,14,65
13910,-10.188249999998913,3865.1052631578946,51,13,22,64
13911,-23.92899999999897,2627.5555555555557,39,10,25,49
13912,17.13200000000034,3045.5555555555557,64,17,15,81
13913,-16.171749999999644,3808.2631578947367,52,4,20,56
13914,-48.326499999999676,1917.4117647058824,9,12,22,21
13915,-2.0119999999990874,2023.3125,55,8,22,63
13916,0.4210000000011124,2644.277777777778,34,10,17,44
13917,-31.67599999999954,2417.6666666666665,29,5,29,34
13918,-20.24499999999886,2635.4117647058824,41,10,26,51
13919,-11.818749999999332,1954.7058823529412,36,15,16,51
13920,-8.299249999998867,3088.65,35,12,15,47
13921,-17.123249999999878,2493.4210526315787,25,11,19,36
13922,-2.181249999998836,2828.764705882353,60,7,22,67
13923,-17.12549999999917,1505.2,29,29,19,58
13924,-2.1989999999986045,2467.4117647058824,48,12,28,60
13925,-34.21999999999914,2092.222222222222,15,14,25,29
13926,2.419750000003681,5687.0,64,8,23,72
13927,-29.376999999999022,2679.7368421052633,31,13,14,44
13928,-17.320499999999782,2810.0555555555557,44,19,11,63
13929,-4.604499999999574,3016.3333333333335,52,21,25,73
13930,-11.951999999999064,3843.3,45,10,21,55
13931,-31.576749999999265,1581.8125,12,12,22,24
13932,5.677000000002039,4623.736842105263,60,14,18,74
13933,-23.842749999999775,1687.9375,31,21,21,52
13934,-7.631499999999138,2300.277777777778,35,9,20,44
13935,-32.98299999999906,1594.75,18,20,18,38
13936,4.197500000001805,3536.6666666666665,70,10,23,80
13937,-28.594749999999806,2905.222222222222,42,12,27,54
13938,-39.34299999999977,1914.421052631579,10,9,22,19
13939,-29.49374999999908,2922.7,20,16,17,36
13940,-19.119249999999234,2618.75,19,10,21,29
13941,-44.803999999999604,1626.5,7,8,26,15
13942,-33.084999999998686,2481.9444444444443,28,9,21,37
13943,-35.20474999999867,2223.5789473684213,21,15,19,36
13944,-24.51774999999906,2560.0,23,10,19,33
13945,13.754500000002091,2795.0588235294117,59,13,17,72
13946,3.8202500000011184,2969.6875,57,6,18,63
13947,-6.97824999999907,4481.35,43,20,15,63
13948,-11.29299999999705,3732.3684210526317,52,16,15,68
13949,-2.237499999998582,2677.470588235294,46,15,23,61
13950,-19.137749999999382,3184.315789473684,20,19,17,39
13951,-11.49074999999983,2282.4117647058824,41,8,25,49
13952,-21.237499999999233,2306.4444444444443,19,24,28,43
13953,-14.96899999999896,3429.8947368421054,52,9,20,61
13954,-33.091749999999834,1429.0,26,11,23,37
13955,-19.516999999999136,2493.4444444444443,44,16,19,60
13956,-27.76749999999973,1429.0,24,9,22,33
13957,-29.315249999999754,1496.5,11,8,25,19
13958,-7.196749999998642,4483.8,52,13,24,65
13959,-10.851249999998323,4086.3,52,9,12,61
13960,-12.923499999999006,2699.7368421052633,28,11,21,39
13961,-19.904249999999298,2501.0,42,18,13,60
13962,-15.422249999999499,3166.842105263158,47,14,20,61
13963,-2.472999999999468,1937.8823529411766,44,16,21,60
13964,-22.253249999998435,2936.315789473684,31,12,29,43
13965,-16.059999999999274,3052.1,39,12,10,51
13966,-22.762999999999224,1617.5625,20,14,13,34
13967,-6.821999999997447,2683.0555555555557,54,16,13,70
13968,-15.879249999999905,3354.684210526316,50,12,31,62
13969,-0.7292499999974759,1630.1333333333334,49,12,14,61
13970,-20.68624999999911,4744.75,44,13,24,57
13971,-14.744249999998667,3714.8333333333335,52,21,24,73
13972,-12.712249999998617,2369.235294117647,43,15,29,58
13973,5.969750000001085,2833.3529411764707,58,14,17,72
13974,-13.708999999999373,3001.3684210526317,29,10,24,39
13975,-15.561999999998918,3361.315789473684,29,15,14,44
13976,-28.72099999999932,2257.294117647059,23,16,20,39
13977,-18.325249999999105,3916.157894736842,60,4,33,64
13978,-38.32349999999943,2265.65,19,13,11,32
13979,0.7492500000013937,3693.0,57,23,15,80
13980,-7.159749999998643,3261.0,50,9,26,59
13981,10.71225000000243,2463.5882352941176,51,10,23,61
13982,-40.58224999999974,1429.0,5,8,27,13
13983,1.869750000001066,2421.6470588235293,52,7,24,59
13984,1.1635000000013562,3631.9444444444443,51,18,6,69
13985,-10.67224999999882,3180.7,28,10,18,38
13986,-30.093999999999273,2076.277777777778,25,11,21,36
13987,-6.994749999998739,2353.625,56,6,23,62
13988,7.622250000001917,2887.470588235294,56,16,13,72
13989,-18.238500000000293,1429.0,32,9,32,41
13990,2.036000000000891,2274.0588235294117,51,15,10,66
13991,-8.598749999999614,2362.0,34,21,15,55
13992,-10.156249999999158,2696.4736842105262,28,5,25,33
13993,3.1200000000015145,3127.5,48,11,24,59
13994,-1.204749999996781,2463.5882352941176,61,10,20,71
13995,-23.902499999999307,2190.0,41,9,21,50
13996,-27.28474999999982,2778.3333333333335,29,21,11,50
13997,-3.370249999999141,2702.6470588235293,37,17,22,54
13998,-32.60474999999854,2662.1052631578946,25,13,22,38
13999,-19.63099999999892,2576.5882352941176,34,16,14,50
14000,-5.470249999999005,3952.8333333333335,79,12,28,91
14001,-7.491999999996156,1534.8666666666666,58,14,18,72
14002,-6.311999999999616,1942.875,27,20,12,47
14003,-30.12149999999975,2192.6315789473683,28,10,26,38
14004,-14.595749999997901,2630.1111111111113,36,15,23,51
14005,-9.411999999999976,2428.1176470588234,48,26,9,74
14006,7.770750000000838,3425.7368421052633,37,6,33,43
14007,-3.6012499999993373,2669.0588235294117,62,9,26,71
14008,-12.54649999999938,2754.4444444444443,40,8,17,48
14009,-1.084000000000203,3151.277777777778,56,7,24,63
14010,-14.631999999998333,4148.0,46,20,17,66
14011,-1.950749999999784,3775.0,53,12,19,65
14012,22.134500000002312,4583.631578947368,90,12,21,102
14013,-23.739249999999693,1683.9444444444443,14,17,15,31
14014,-11.05099999999796,2620.4444444444443,49,10,17,59
14015,-42.553999999999675,2120.4444444444443,16,11,20,27
14016,-28.016499999999485,2103.6666666666665,20,12,17,32
14017,-8.355250000000392,2076.1176470588234,47,22,20,69
14018,3.9595000000003786,2925.5555555555557,49,6,16,55
14019,-24.705499999999823,2470.0,26,19,9,45
14020,-17.064249999998548,3300.5789473684213,40,20,11,60
14021,-6.61924999999791,5337.0,64,7,23,71
14022,1.0402500000014268,2526.294117647059,35,19,17,54
14023,-18.945999999998477,2372.5,33,24,9,57
14024,-26.904249999998978,2264.5,34,8,36,42
14025,13.969250000000915,2228.6875,51,25,10,76
14026,-25.76849999999964,1880.4375,26,14,20,40
14027,-21.288749999999297,1429.0,27,13,19,40
14028,-3.8684999999987495,3022.777777777778,49,16,13,65
14029,-12.580500000000109,1495.6666666666667,50,11,35,61
14030,-29.32424999999962,2228.5263157894738,13,12,23,25
14031,-4.969749999999182,2801.222222222222,45,17,18,62
14032,-17.501749999998825,2677.4117647058824,48,17,19,65
14033,13.944000000002035,3519.8888888888887,58,14,24,72
14034,-11.722749999998694,2926.3888888888887,49,5,19,54
14035,-47.74299999999978,1429.0,1,11,21,12
14036,2.6417500000007004,2274.9411764705883,43,16,16,59
14037,20.208250000001833,3378.777777777778,60,16,14,76
14038,-19.501499999999147,2636.157894736842,24,9,21,33
14039,-24.314749999999496,2121.6315789473683,14,9,26,23
14040,-22.696749999998467,3401.35,32,10,18,42
14041,3.6215000000007804,2173.235294117647,55,13,21,68
14042,-22.328999999999088,1824.875,23,8,24,31
14043,-2.1142499999990276,3835.4,46,9,18,55
14044,-1.318249999998491,3113.470588235294,51,13,17,64
14045,-26.187999999998908,2773.9444444444443,41,6,23,47
14046,-16.574999999999385,2338.277777777778,41,17,14,58
14047,17.29625000000111,5230.7,67,8,9,75
14048,11.000500000001512,4299.05,55,9,11,64
14049,-0.9922500000002735,2230.6111111111113,57,13,25,70
14050,4.175500000001624,4374.35,51,13,16,64
14051,-1.8992499999991175,3628.7368421052633,43,12,27,55
14052,-0.5267499999982587,3018.3125,73,15,14,88
14053,-22.65624999999836,3487.9411764705883,57,18,14,75
14054,-9.569999999998839,2013.3125,37,13,23,50
14055,-17.764999999998192,2696.3333333333335,42,21,12,63
14056,11.327750000000753,3576.1052631578946,45,13,17,58
14057,3.482250000003025,5250.6,73,11,23,84
14058,10.705250000002156,3674.6470588235293,75,10,6,85
14059,-33.77499999999934,1567.9375,22,9,23,31
14060,-15.102499999998193,2046.3529411764705,37,19,15,56
14061,-13.679249999999687,1429.0,41,9,32,50
14062,14.009750000002231,2023.3125,73,15,12,88
14063,14.238750000000831,3227.1111111111113,64,15,21,79
14064,-4.388249999999124,2341.294117647059,51,16,21,67
14065,11.459500000003114,2211.470588235294,62,9,23,71
14066,-24.8454999999993,2028.6666666666667,20,14,19,34
14067,-7.1467499999985025,2295.5882352941176,36,8,15,44
14068,-13.057999999997984,3027.157894736842,38,11,21,49
14069,-27.716250000000297,1429.0,15,9,27,24
14070,-37.29424999999993,2539.3684210526317,24,15,18,39
14071,-15.71624999999914,3155.8947368421054,38,6,29,44
14072,-19.961749999999498,2022.0,24,17,25,41
14073,-6.5214999999995555,2348.6875,54,8,25,62
14074,-10.695999999999708,2970.3888888888887,33,15,13,48
14075,-4.789999999998637,2326.9375,45,14,17,59
14076,-2.9262499999993374,3298.6666666666665,58,10,17,68
14077,-25.39274999999863,3052.95,29,19,15,48
14078,-27.467999999999183,2763.15,30,11,18,41
14079,-19.673499999998835,2518.705882352941,37,9,27,46
14080,-0.4772499999989742,2777.294117647059,46,15,21,61
14081,-2.63549999999666,3482.8888888888887,74,4,17,78
14082,-26.1542499999992,1969.75,34,11,14,45
14083,-0.8974999999998385,2311.4117647058824,40,9,20,49
14084,-5.269999999998477,3269.4444444444443,51,12,13,63
14085,13.077250000000802,4220.0,65,5,16,70
14086,-11.667499999999933,3230.6666666666665,60,19,12,79
14087,-23.6829999999993,2531.842105263158,20,19,15,39
14088,-7.677499999999467,2473.1111111111113,47,14,14,61
14089,-16.129749999999397,2695.75,23,13,20,36
14090,-17.904249999999127,3779.0526315789475,38,11,18,49
14091,-29.78799999999988,2666.4210526315787,23,9,29,32
14092,-8.850749999999014,2997.157894736842,40,7,13,47
14093,-4.788999999999126,2981.1111111111113,40,8,17,48
14094,-8.843749999998842,2030.2941176470588,35,19,14,54
14095,-42.25250000000029,1429.0,11,7,21,18
14096,0.03550000000173146,4895.0,70,15,17,85
14097,-10.007999999998312,2093.6875,44,15,17,59
14098,3.480500000001834,2414.9444444444443,46,14,11,60
14099,-9.672499999999228,3198.9444444444443,40,11,15,51
14100,-16.75699999999944,1809.0,41,18,18,59
14101,6.7685000000012066,2103.777777777778,32,14,18,46
14102,-20.55624999999808,2890.277777777778,42,13,19,55
14103,-11.974749999998988,2639.8333333333335,32,4,27,36
14104,5.016000000002473,4131.944444444444,74,18,10,92
14105,-7.109249999998619,3764.0,58,14,24,72
14106,-10.567749999999588,2625.3684210526317,39,9,22,48
14107,-7.085499999999722,2663.6111111111113,56,2,26,58
14108,-6.941499999998845,2884.0555555555557,36,11,15,47
14109,-35.473249999999275,2099.2105263157896,11,9,25,20
14110,-0.6922500000002124,1943.0,39,11,18,50
14111,-7.440249999998495,2670.0625,65,16,24,81
14112,-16.461750000000073,2125.4375,36,14,27,50
14113,-10.29799999999879,1614.8823529411766,29,13,16,42
14114,12.015000000002058,3047.125,71,20,18,91
14115,-2.9789999999984804,2337.6470588235293,33,6,27,39
14116,-11.208749999997606,2619.5,48,12,19,60
14117,-23.769249999998685,3508.45,34,11,18,45
14118,-34.823499999999186,1429.0,11,10,25,21
14119,5.86075000000075,4245.368421052632,55,6,20,61
14120,-36.31549999999893,2959.25,25,19,16,44
14121,-20.705499999999894,2343.4444444444443,45,20,18,65
14122,-8.831499999999561,3270.3333333333335,39,12,13,51
14123,-21.530749999998438,2939.4736842105262,35,6,25,41
14124,-14.894999999998532,3800.5,48,5,21,53
14125,10.558500000000961,3876.842105263158,55,11,23,66
14126,21.31775000000113,3592.277777777778,81,13,13,94
14127,-2.53674999999974,3093.0,63,14,13,77
14128,-22.78224999999877,2508.5,25,9,17,34
14129,-3.136249999998161,2129.4117647058824,44,6,21,50
14130,-24.201499999999594,1925.7058823529412,17,11,21,28
14131,-38.55950000000027,1589.75,25,11,28,36
14132,18.259750000000984,2384.375,86,15,20,101
14133,-11.923249999998983,3948.9,42,9,13,51
14134,-14.965749999998703,2416.9411764705883,35,16,18,51
14135,-10.552749999998662,3177.684210526316,40,10,24,50
14136,-19.962999999999084,3508.4,32,11,18,43
14137,-24.05424999999951,2370.1176470588234,38,15,18,53
14138,-23.909499999999042,2743.2105263157896,27,14,20,41
14139,-22.380249999998057,2686.3684210526317,37,12,15,49
14140,-29.145749999998998,2545.157894736842,28,19,11,47
14141,-6.813999999998535,2114.4117647058824,70,7,29,77
14142,-29.867499999999346,2447.4210526315787,28,20,10,48
14143,-26.04574999999851,3290.95,32,20,18,52
14144,-21.654749999999357,2738.6,21,12,16,33
14145,6.741500000002214,3332.2631578947367,53,8,17,61
14146,-18.123249999999125,2641.8823529411766,37,2,28,39
14147,-30.58674999999966,1673.6470588235295,9,18,12,27
14148,0.3897500000025477,3475.157894736842,52,10,16,62
14149,-23.284749999998777,2239.4444444444443,29,10,17,39
14150,-13.507999999999413,3159.222222222222,48,19,22,67
14151,0.4977500000004465,3154.2105263157896,55,9,19,64
14152,-23.06674999999927,3837.0,34,9,22,43
14153,-10.662499999999357,2219.8823529411766,29,17,13,46
14154,-23.47424999999894,2382.5,36,7,19,43
14155,-11.949499999998025,1835.75,32,9,30,41
14156,-1.6009999999994982,3385.8333333333335,39,7,22,46
14157,41.68550000000302,6508.45,80,5,17,85
14158,-26.275249999999566,1599.6875,14,12,17,26
14159,0.2647500000012325,3629.5789473684213,42,10,12,52
14160,-16.603499999998157,2866.4444444444443,44,10,16,54
14161,-0.5734999999994741,3232.7368421052633,47,18,14,65
14162,-48.43274999999926,2302.0,15,13,21,28
14163,-0.5064999999983962,4559.15,50,11,23,61
14164,-29.454249999999313,1809.0,35,10,25,45
14165,7.746250000002279,3873.5263157894738,53,15,21,68
14166,-14.312249999999628,2232.5625,37,12,18,49
14167,-23.87674999999854,2936.0,40,23,16,63
14168,-23.953249999998988,2306.4444444444443,23,13,20,36
14169,2.3500000000009535,2765.235294117647,51,17,18,68
14170,-10.26024999999848,2273.25,44,12,11,56
14171,-8.395250000000278,2691.0,41,15,28,56
14172,-0.8447499999983454,3830.3888888888887,64,7,20,71
14173,-12.011749999998788,3861.55,49,10,20,59
14174,-25.584749999999126,2719.65,23,16,14,39
14175,-2.996999999998928,3788.8333333333335,52,15,21,67
14176,-13.191749999999146,2622.294117647059,47,14,24,61
14177,-18.827749999999334,3503.65,28,18,18,46
14178,13.559500000002084,2683.1111111111113,50,12,17,62
14179,-35.10674999999965,2133.0,10,17,18,27
14180,-13.574749999999762,3405.1666666666665,49,18,10,67
14181,-5.899499999999764,2881.4444444444443,50,11,32,61
14182,-48.67425000000003,1429.0,0,13,17,13
14183,-22.071999999998933,3079.8947368421054,33,11,33,44
14184,-9.225999999998297,2902.7894736842104,38,14,20,52
14185,39.4550000000024,3652.235294117647,73,10,21,83
14186,-13.671499999999218,3475.842105263158,43,15,20,58
14187,-23.191499999999145,1598.0588235294117,23,5,21,28
14188,-4.1647499999993824,2118.1176470588234,47,13,36,60
14189,11.189250000001437,4343.0526315789475,72,14,16,86
14190,-0.47099999999797293,4395.578947368421,71,13,20,84
14191,2.9530000000007903,2778.3333333333335,55,14,15,69
14192,-7.613749999998741,4464.1578947368425,56,14,15,70
14193,-11.286249999999072,2663.0526315789475,32,8,12,40
14194,-9.890999999998574,3118.3684210526317,37,13,16,50
14195,-4.391999999999968,3576.1052631578946,45,13,18,58
14196,-11.498750000000125,2504.6470588235293,59,17,23,76
14197,-9.349499999999713,2348.6875,50,11,26,61
14198,-39.311249999999085,1749.3529411764705,11,17,18,28
14199,-11.535499999998367,4896.5,60,5,23,65
14200,-5.545999999999799,2716.5,44,9,25,53
14201,-0.1922499999986229,4215.6,41,10,15,51
14202,10.94175000000279,2500.4375,82,20,10,102
14203,-1.7474999999987204,3279.15,45,13,10,58
14204,-1.2319999999991214,4652.9473684210525,57,14,15,71
14205,-5.963749999998996,3076.3333333333335,51,12,17,63
14206,-26.90399999999902,2335.5555555555557,21,8,22,29
14207,-27.0377499999998,2433.4444444444443,27,5,22,32
14208,-5.6364999999988425,2489.764705882353,64,10,21,74
14209,-6.757749999998614,3276.157894736842,41,12,23,53
14210,-21.163749999999034,3256.0,37,10,16,47
14211,-6.008249999999275,2152.1875,41,8,23,49
14212,-27.971749999999048,2064.1176470588234,28,17,14,45
14213,-0.8252499999991457,2743.0,52,8,20,60
14214,-32.76949999999944,3327.9473684210525,46,20,18,66
14215,-24.074249999999296,1429.0,17,18,16,35
14216,-19.884499999998795,2348.6875,43,14,17,57
14217,-15.480499999998907,2401.0588235294117,21,12,28,33
14218,-12.620250000000272,2508.4444444444443,43,16,16,59
14219,-15.20949999999923,3267.842105263158,50,9,19,59
14220,-14.756999999998612,2909.777777777778,41,12,17,53
14221,-22.26599999999806,3299.5263157894738,36,17,18,53
14222,-9.433249999998623,3523.5263157894738,49,12,13,61
14223,-12.988249999999303,2080.705882352941,36,14,21,50
14224,-23.166249999998808,2929.4210526315787,31,16,19,47
14225,-17.42974999999999,2636.2105263157896,24,12,20,36
14226,-18.22124999999928,3782.25,31,6,25,37
14227,-11.36949999999929,5162.45,55,15,13,70
14228,-11.516749999999288,3332.8947368421054,46,8,21,54
14229,-10.359499999998713,2438.470588235294,37,9,16,46
14230,-16.48925000000072,1429.0,41,8,22,49
14231,14.66925000000148,2517.764705882353,67,10,17,77
14232,-17.509749999999123,3461.6315789473683,35,11,22,46
14233,-4.945749999998959,3971.1,45,15,16,60
14234,-8.912249999998881,2552.6666666666665,57,13,16,70
14235,-42.0599999999994,2318.7,11,11,22,22
14236,-3.455249999998972,2147.9411764705883,57,12,29,69
14237,-0.7269999999992611,2103.625,53,11,21,64
14238,-41.17499999999974,2060.6315789473683,11,13,19,24
14239,-35.765749999999784,3156.7368421052633,25,13,20,38
14240,5.41375000000123,4375.578947368421,69,17,16,86
14241,-1.7682499999960115,3504.8333333333335,70,16,17,86
14242,-27.673999999999467,1528.25,18,11,20,29
14243,-16.14074999999922,3541.0,44,22,20,66
14244,-47.58299999999935,1528.25,11,13,16,24
14245,-10.752249999998117,2597.4444444444443,41,6,24,47
14246,-52.29774999999908,1429.0,0,17,29,17
14247,-19.730250000000073,1429.0,32,12,32,44
14248,10.677500000000235,2967.0,77,13,21,90
14249,-27.65549999999867,3828.3,39,7,21,46
14250,-18.606749999998755,3152.1,33,15,16,48
14251,-15.746999999998119,2416.9411764705883,47,13,13,60
14252,-42.796249999999716,1941.157894736842,11,6,21,17
14253,-19.639499999998698,2424.529411764706,37,12,14,49
14254,-21.070749999998778,2043.5294117647059,24,11,22,35
14255,8.82250000000106,3454.9473684210525,51,7,18,58
14256,-16.795749999998936,2112.75,34,21,17,55
14257,-18.35249999999962,2616.0,43,6,23,49
14258,4.722500000000603,2309.5882352941176,39,16,14,55
14259,-8.968999999998625,3251.0555555555557,42,16,14,58
14260,-1.4089999999985432,3338.222222222222,54,9,35,63
14261,-18.76124999999967,2697.222222222222,30,9,27,39
14262,13.001250000000804,3403.157894736842,55,10,21,65
14263,5.505500000000981,4765.6,54,14,11,68
14264,-17.654999999998406,1429.0,19,10,30,29
14265,-5.180499999999285,2416.8823529411766,43,9,16,52
14266,-7.994999999998821,4442.421052631579,63,11,24,74
14267,4.757000000000865,3726.4736842105262,47,7,19,54
14268,-16.837249999999017,3884.6,41,6,18,47
14269,-21.869249999998704,3891.8,35,12,20,47
14270,-17.728999999998745,3535.2631578947367,41,8,29,49
14271,-19.255999999999453,2079.764705882353,22,12,21,34
14272,-17.29474999999776,1875.4117647058824,39,20,12,59
14273,0.8812500000007978,1660.111111111111,28,19,10,47
14274,-32.645499999999515,2080.684210526316,11,17,18,28
14275,-14.197749999999914,1429.0,24,20,27,44
14276,30.19150000000157,4654.578947368421,89,7,17,96
14277,-24.10999999999987,2533.0555555555557,40,19,14,59
14278,-19.13799999999918,3990.2,47,16,15,63
14279,-7.160749999998869,3460.0,34,13,21,47
14280,-25.222749999999618,2386.4210526315787,18,18,17,36
14281,-13.836750000000006,1496.5,28,16,13,44
14282,-28.404249999999024,3943.684210526316,34,15,22,49
14283,-27.099499999999203,1623.235294117647,22,9,24,31
14284,-24.608499999999815,1957.5294117647059,36,9,23,45
14285,-9.333499999998736,3725.05,37,15,16,52
14286,10.625250000001698,2474.75,52,5,13,57
14287,-34.81624999999966,2154.9473684210525,13,11,22,24
14288,4.21275000000162,1963.1176470588234,65,19,16,84
14289,2.5645000000000637,3476.5555555555557,52,9,20,61
14290,-7.429999999998801,3576.1052631578946,50,13,15,63
14291,-19.62100000000004,2627.8947368421054,22,8,29,30
14292,1.0325000000003732,2921.1111111111113,53,16,17,69
14293,-2.0412499999993776,2412.235294117647,38,13,19,51
14294,-24.894499999999024,3108.0555555555557,46,8,34,54
14295,-3.475499999998506,4883.8,47,5,24,52
14296,6.769500000001445,4058.5,48,4,17,52
14297,-12.154749999999666,2736.294117647059,36,5,21,41
14298,-17.46624999999902,2205.0,29,17,20,46
14299,-7.487999999997254,4687.05,47,13,20,60
14300,-11.38349999999873,2084.277777777778,40,20,19,60
14301,-1.7619999999982745,2392.3125,47,10,33,57
14302,-2.561249999999646,2560.5,45,19,17,64
14303,-6.212499999997596,2026.7058823529412,38,6,29,44
14304,-16.944749999999694,3482.5789473684213,30,11,20,41
14305,-19.660499999999633,2333.777777777778,32,13,14,45
14306,-8.586499999997915,3809.2105263157896,53,21,15,74
14307,-12.463749999998889,4245.75,46,16,17,62
14308,-29.33974999999963,1933.6315789473683,12,13,20,25
14309,-11.283249999997405,3228.0555555555557,50,8,23,58
14310,-14.717999999999313,2001.3529411764705,35,6,30,41
14311,-9.561999999998122,2110.705882352941,34,7,26,41
14312,-11.070999999999243,2862.0555555555557,38,11,20,49
14313,-23.204249999999348,3147.25,20,13,22,33
14314,15.441000000002589,5229.05,75,8,18,83
14315,-24.33749999999881,3863.5263157894738,37,8,27,45
14316,-19.55699999999849,3187.6315789473683,34,15,20,49
14317,-23.591999999999185,2703.6,25,8,22,33
14318,5.568250000001127,4448.263157894737,61,2,24,63
14319,2.8162500000020043,2450.529411764706,41,14,19,55
14320,-33.25749999999862,1481.9333333333334,42,18,22,60
14321,3.850000000000352,3125.0,53,11,23,64
14322,-13.570249999998751,3190.95,33,12,16,45
14323,-16.96674999999898,3321.4444444444443,36,8,22,44
14324,-52.65499999999906,1429.0,6,10,37,16
14325,-19.19449999999835,3601.95,44,10,15,54
14326,-3.550999999999185,3064.7894736842104,35,18,17,53
14327,4.182750000001875,3350.6111111111113,48,19,12,67
14328,-14.568249999999093,2565.6,28,13,13,41
14329,-12.627249999998941,4425.85,40,4,22,44
14330,-25.91299999999809,3282.842105263158,39,14,18,53
14331,-4.790749999999098,3028.722222222222,30,20,20,50
14332,8.092750000003557,3769.4444444444443,70,7,22,77
14333,-17.552999999999038,2383.294117647059,42,14,14,56
14334,-15.955999999999596,3418.05,34,14,12,48
14335,-8.545499999999535,3779.0555555555557,55,12,16,67
14336,-17.340499999998094,2408.8333333333335,37,17,17,54
14337,-7.360249999997217,2938.0,45,15,20,60
14338,0.6440000000027928,3574.3684210526317,58,10,21,68
14339,-11.498249999999532,3000.470588235294,50,12,19,62
14340,-42.39149999999968,2613.684210526316,20,11,29,31
14341,-5.412999999998239,2215.9375,40,10,20,50
14342,-1.5024999999974757,4033.0526315789475,64,12,18,76
14343,-10.883249999998295,1528.25,29,13,27,42
14344,-10.788999999999112,3131.8333333333335,28,20,20,48
14345,-24.456249999999184,2350.6111111111113,28,12,17,40
14346,-19.75299999999948,2813.4210526315787,27,14,21,41
14347,-7.268499999999184,3245.3684210526317,45,9,18,54
14348,-29.57249999999986,2436.8888888888887,18,8,31,26
14349,-5.241249999999821,2072.0,44,10,20,54
14350,-4.699249999997148,3339.684210526316,45,17,20,62
14351,-15.731249999998855,2845.1052631578946,26,14,20,40
14352,-18.257999999998223,3526.842105263158,44,10,28,54
14353,-16.401999999998814,2604.4736842105262,34,9,16,43
14354,-9.797499999999264,2080.764705882353,36,12,29,48
14355,-12.442499999998935,2512.8333333333335,41,13,18,54
14356,-28.744499999999118,3012.2631578947367,32,11,21,43
14357,-2.3529999999983398,5045.75,47,18,14,65
14358,-48.06374999999955,2098.2105263157896,12,14,21,26
14359,-14.278749999999297,2339.3529411764707,31,15,15,46
14360,-24.813499999999035,2706.470588235294,40,13,29,53
14361,-15.694499999999644,2691.0555555555557,41,9,25,50
14362,-17.997749999998863,3056.1666666666665,36,14,10,50
14363,-22.887499999999154,2908.5789473684213,26,14,16,40
14364,10.195750000000926,2350.6470588235293,42,15,12,57
14365,-19.12199999999814,2986.3888888888887,37,12,23,49
14366,-23.703499999999245,1904.2941176470588,26,15,32,41
14367,-39.72149999999958,1429.0,13,18,16,31
14368,-4.716249999998398,4410.736842105263,66,6,21,72
14369,-30.381999999999586,1429.0,12,16,22,28
14370,-18.714749999999633,2190.0588235294117,30,9,20,39
14371,8.754250000000267,2598.6875,65,15,18,80
14372,-9.853000000000403,2116.5,61,20,16,81
14373,-27.951249999999668,2665.5263157894738,18,4,38,22
14374,-11.767249999998928,3117.5789473684213,39,8,26,47
14375,-12.98899999999997,2505.5882352941176,42,12,31,54
14376,5.183000000000597,2202.8125,54,14,16,68
14377,20.512250000000908,4214.85,54,6,20,60
14378,-37.40049999999784,2186.294117647059,33,6,34,39
14379,-10.078499999997277,2312.3529411764707,53,11,21,64
14380,-13.99224999999915,1657.1875,39,9,28,48
14381,-5.125999999999864,4343.3,46,19,23,65
14382,-5.133249999997415,2322.875,53,6,18,59
14383,-29.27299999999937,2820.8947368421054,19,6,40,25
14384,-35.460249999999384,2441.3888888888887,23,21,19,44
14385,-1.8277499999974538,3723.2631578947367,52,4,30,56
14386,-35.30149999999948,2540.3,20,6,18,26
14387,-39.29299999999971,2997.777777777778,28,11,33,39
14388,-27.391999999999513,2591.8,18,6,22,24
14389,-9.66724999999881,2451.875,49,4,25,53
14390,1.1255000000015385,2909.777777777778,49,13,21,62
14391,1.3207500000016599,2817.9375,58,2,19,60
14392,-3.849999999999246,3359.25,35,19,9,54
14393,-4.957749999999234,2441.3888888888887,27,18,14,45
14394,-18.59599999999897,2979.9,28,8,17,36
14395,-14.380499999999179,2127.5,21,8,22,29
14396,-2.9489999999977234,2853.823529411765,56,9,24,65
14397,-17.74625000000011,1438.5333333333333,29,18,28,47
14398,-6.898249999998694,3458.45,32,10,20,42
14399,-27.4722499999993,2190.0,37,17,15,54
14400,-11.930249999997338,3358.0526315789475,52,9,21,61
14401,-19.080249999999612,2063.9411764705883,38,8,26,46
14402,-25.188999999999318,2072.777777777778,15,9,26,24
14403,8.318000000001788,3571.9411764705883,57,25,17,82
14404,-0.06299999999839656,5144.15,51,8,19,59
14405,-4.944749999999594,3703.9473684210525,50,11,11,61
14406,3.734000000001237,3636.315789473684,48,16,15,64
14407,-20.585999999998428,4192.578947368421,69,18,9,87
14408,-35.18199999999917,2906.05,17,4,30,21
14409,4.451250000002242,3021.722222222222,56,7,20,63
14410,-9.166499999997862,1534.8666666666666,42,19,12,61
14411,-20.273249999999305,2156.4117647058824,32,14,15,46
14412,-35.12524999999927,2876.842105263158,20,14,23,34
14413,-33.49649999999933,1429.0,31,22,17,53
14414,-29.347499999998075,3849.75,49,11,17,60
14415,-15.078749999999776,1912.7058823529412,32,19,24,51
14416,-1.4079999999990007,3455.7368421052633,56,8,21,64
14417,-18.977249999999238,1892.1764705882354,19,10,22,29
14418,-6.084499999997794,3289.722222222222,47,13,23,60
14419,-22.62099999999954,2306.5,33,14,22,47
14420,2.3452500000010548,4422.368421052632,53,11,20,64
14421,22.595500000002495,2455.235294117647,61,6,18,67
14422,-2.2387499999989475,3786.1666666666665,53,10,17,63
14423,-11.10699999999839,1533.8,49,17,22,66
14424,-17.470249999998824,2348.625,38,10,23,48
14425,-24.202749999998936,2103.625,30,7,25,37
14426,7.772250000001298,5068.210526315789,84,5,28,89
14427,-21.76549999999868,2255.3333333333335,27,10,22,37
14428,-19.268749999999642,2595.777777777778,28,9,32,37
14429,14.78600000000269,2997.705882352941,65,6,18,71
14430,-37.19775000000011,1429.0,6,16,19,22
14431,-33.9597499999996,2662.1052631578946,22,14,21,36
14432,-6.495999999998408,3249.4736842105262,36,16,15,52
14433,-14.278249999998735,2748.9473684210525,34,9,19,43
14434,0.5482500000005496,2195.3333333333335,41,15,19,56
14435,-13.981749999998579,2104.6666666666665,30,19,13,49
14436,-26.3582499999994,2703.9473684210525,27,11,17,38
14437,-7.753999999997854,2890.3333333333335,41,5,29,46
14438,2.6447500000006765,3876.8947368421054,51,7,19,58
14439,-1.4004999999990484,2544.5,37,9,18,46
14440,-29.9134999999989,1614.8823529411766,11,20,21,31
14441,6.065000000002788,2938.1176470588234,69,12,16,81
14442,-5.396499999998211,2514.5,49,16,17,65
14443,13.071250000001791,2994.0,69,15,16,84
14444,-11.801999999999552,2322.4444444444443,36,15,15,51
14445,-5.654499999998878,3092.1111111111113,35,16,14,51
14446,-8.173999999999726,3349.722222222222,52,14,18,66
14447,-14.199499999998457,3000.3529411764707,60,22,13,82
14448,14.067500000001843,2460.8125,59,7,19,66
14449,-9.513749999998254,4748.95,54,9,16,63
14450,0.6282499999998828,2294.6470588235293,55,18,16,73
14451,-16.477999999999522,1871.5,32,6,23,38
14452,-13.738499999999215,2191.8888888888887,29,16,15,45
14453,6.0295000000007635,3351.5,50,10,26,60
14454,-17.71624999999886,4444.15,42,8,17,50
14455,-16.205249999999374,1694.235294117647,32,13,18,45
14456,-34.19849999999876,2773.8888888888887,30,6,28,36
14457,4.359750000001171,3508.4444444444443,61,28,14,89
14458,-14.561250000000197,2930.777777777778,42,4,35,46
14459,7.402000000002401,2442.222222222222,49,21,21,70
14460,7.471250000001275,3095.722222222222,50,7,24,57
14461,-13.943999999999463,1429.0,12,10,29,22
14462,15.605500000001385,4325.9,65,7,16,72
14463,-9.798249999998758,3040.2,28,11,22,39
14464,-20.842999999999268,3228.3,31,17,14,48
14465,-23.774249999999547,2838.222222222222,28,9,32,37
14466,-8.772249999998191,4793.35,45,9,26,54
14467,1.450750000002617,3795.0,62,10,18,72
14468,4.446250000001079,3128.4117647058824,51,10,32,61
14469,-4.951249999999506,2585.0,49,9,23,58
14470,-2.5849999999986464,3863.25,46,12,21,58
14471,-18.6947499999988,3191.0,32,9,23,41
14472,-15.328249999999503,2393.722222222222,46,8,22,54
14473,-13.529999999998916,3185.842105263158,35,7,19,42
14474,12.654750000000291,3106.6315789473683,48,17,16,65
14475,-18.431499999999666,2764.0555555555557,42,10,23,52
14476,-19.731250000000248,2464.9473684210525,42,8,29,50
14477,-20.33549999999877,2170.125,47,23,21,70
14478,-22.805749999999176,3245.75,32,10,19,42
14479,-15.250749999998837,2103.6111111111113,32,7,17,39
14480,-36.12724999999955,1429.0,8,14,25,22
14481,-30.19674999999906,2191.8888888888887,19,4,26,23
14482,-18.68599999999982,2361.823529411765,42,21,29,63
14483,0.21725000000217848,2707.3529411764707,46,3,25,49
14484,-7.9997499999992,2646.0,45,15,21,60
14485,-37.24799999999995,1429.0,15,10,28,25
14486,-16.94849999999918,2966.4,28,8,22,36
14487,-3.590499999998953,3099.1052631578946,32,10,21,42
14488,-20.686749999999783,2062.9375,26,7,32,33
14489,-18.127749999999473,2197.222222222222,22,13,21,35
14490,-32.414749999998904,3481.6,31,6,25,37
14491,-18.04399999999825,2433.705882352941,43,11,26,54
14492,-11.245749999999926,3048.0555555555557,42,14,19,56
14493,-5.436499999999277,2374.8823529411766,52,8,20,60
14494,-1.8799999999984724,3624.5789473684213,46,12,18,58
14495,-7.332499999999186,2719.277777777778,46,13,12,59
14496,1.8145000000026645,2150.3125,50,11,29,61
14497,-5.211499999999236,1907.3125,46,10,18,56
14498,2.9937500000020187,4584.6,45,10,23,55
14499,9.690500000001128,5056.0,70,11,22,81
14500,-10.08099999999938,3422.4210526315787,31,14,27,45
14501,-10.115749999999961,1884.375,46,16,21,62
14502,0.7017500000016785,2171.3529411764707,39,17,17,56
14503,-39.062249999999366,2219.1111111111113,19,12,23,31
14504,-8.712499999998899,4593.35,55,16,11,71
14505,6.115000000001411,4185.210526315789,72,1,21,73
14506,-20.947499999999618,2423.8888888888887,25,16,14,41
14507,-16.392249999999727,1866.0588235294117,34,24,23,58
14508,-12.184999999999095,3381.5789473684213,43,18,20,61
14509,32.02800000000367,2480.470588235294,69,17,12,86
14510,-6.411249999998818,2527.25,50,12,26,62
14511,-2.335749999998557,3686.2631578947367,54,14,15,68
14512,4.275000000001474,5315.55,57,4,22,61
14513,-26.18874999999959,2635.315789473684,27,10,12,37
14514,-19.22774999999917,2729.95,24,11,18,35
14515,2.294500000003044,5403.65,69,10,24,79
14516,-31.59124999999881,3213.4736842105262,37,13,24,50
14517,-6.374999999996871,2266.5882352941176,52,8,22,60
14518,-12.448999999999163,3060.5,39,10,35,49
14519,-5.023249999998283,2574.823529411765,39,18,14,57
14520,-13.053999999998988,1904.2941176470588,24,11,24,35
14521,-12.040000000000132,2786.222222222222,38,20,17,58
14522,5.0405000000009625,4991.315789473684,69,15,14,84
14523,15.851500000003318,1528.25,57,13,23,70
14524,-17.28499999999947,1429.0,31,8,30,39
14525,-4.144999999999039,2686.764705882353,42,8,27,50
14526,-18.860499999998908,1943.0,34,17,16,51
14527,-32.16024999999811,2329.235294117647,24,7,37,31
14528,-33.144499999999454,2269.5,17,18,17,35
14529,4.361000000001712,3911.1052631578946,48,8,20,56
14530,1.226000000000135,3515.9473684210525,45,11,12,56
14531,-27.980499999999086,2276.157894736842,19,16,19,35
14532,-25.254500000000128,1429.0,28,7,23,35
14533,-15.640249999999629,3500.0526315789475,40,21,11,61
14534,-24.071499999999894,2381.4444444444443,52,13,19,65
14535,18.325500000001604,4522.7,49,15,14,64
14536,-2.128749999999682,3468.777777777778,44,14,19,58
14537,22.840250000003312,5251.35,64,16,11,80
14538,-21.54599999999851,3698.15,52,6,17,58
14539,-28.48799999999938,2508.5,18,12,13,30
14540,-11.895499999998105,2648.6111111111113,38,10,20,48
14541,-12.411749999999516,3087.4210526315787,45,10,14,55
14542,-10.227749999999595,2370.235294117647,46,22,20,68
14543,-45.52399999999971,2331.2631578947367,9,9,31,18
14544,7.724750000001604,3313.235294117647,60,9,19,69
14545,-15.281249999999229,2520.722222222222,31,6,20,37
14546,-30.38049999999951,1429.0,9,12,27,21
14547,-41.448249999999504,2342.55,9,6,30,15
14548,-16.97224999999836,2461.75,40,27,12,67
14549,-10.986999999998329,3301.35,29,15,22,44
14550,-26.082499999998408,3387.6111111111113,46,19,20,65
14551,-14.203499999999426,2989.5789473684213,29,9,22,38
14552,-12.733249999999014,3441.7,39,16,16,55
14553,-13.58749999999857,2206.0,29,8,21,37
14554,-27.722499999999002,2171.6111111111113,18,13,25,31
14555,-7.571999999999025,2281.3125,54,10,17,64
14556,-17.112999999998767,2104.5555555555557,33,11,14,44
14557,-20.092500000000094,1908.0588235294117,33,20,10,53
14558,-0.6987499999994145,3312.8947368421054,41,12,14,53
14559,2.8810000000006806,2882.823529411765,51,16,24,67
14560,-4.008749999998649,2500.5625,55,9,15,64
14561,-29.773999999999536,2185.35,13,23,12,36
14562,-17.45450000000007,2906.8947368421054,43,11,26,54
14563,-2.8082499999989543,3467.5263157894738,45,15,27,60
14564,1.846750000001777,3663.7368421052633,53,12,15,65
14565,-10.719749999997596,2278.4375,39,16,20,55
14566,2.393750000000611,2703.5882352941176,41,7,24,48
14567,8.754250000001893,2568.0,59,16,19,75
14568,-15.593749999999932,2076.1176470588234,30,11,21,41
14569,-21.68199999999839,1675.0625,38,23,17,61
14570,-3.068749999999465,2765.176470588235,48,18,19,66
14571,-13.14199999999789,1929.0,48,21,17,69
14572,-4.131499999998678,2469.75,42,17,24,59
14573,-8.124249999999048,4168.7,44,10,17,54
14574,-16.19149999999866,2704.45,26,18,20,44
14575,3.0605000000000033,2882.823529411765,66,18,18,84
14576,-10.013499999998896,3250.55,39,11,17,50
14577,6.161249999999904,2235.764705882353,49,16,19,65
14578,-22.626749999998687,2434.0,35,10,22,45
14579,-18.469499999998643,1534.8666666666666,21,20,19,41
14580,25.727250000002016,4129.222222222223,59,14,19,73
14581,-13.486249999999004,2763.2105263157896,38,19,20,57
14582,2.4965000000011095,3252.1,36,7,20,43
14583,-19.832499999999122,1603.625,44,18,22,62
14584,-29.798999999999346,2937.0,26,15,9,41
14585,-12.842749999998137,3014.6315789473683,45,18,17,63
14586,3.9982500000012267,1520.0666666666666,53,17,17,70
14587,-15.438499999998793,3582.684210526316,50,18,18,68
14588,-34.78624999999888,2070.1666666666665,23,9,19,32
14589,-18.917499999998363,3448.2105263157896,49,12,43,61
14590,-25.50399999999931,3217.95,33,7,19,40
14591,-30.624499999998722,2732.3684210526317,29,18,18,47
14592,-16.123249999999977,1954.764705882353,41,10,17,51
14593,-13.435249999999206,2402.3125,44,15,21,59
14594,0.6362500000029889,2883.277777777778,69,11,11,80
14595,-39.621999999999154,1429.0,12,15,24,27
14596,1.6822500000022682,3007.6111111111113,49,13,21,62
14597,-18.068999999999626,3252.7894736842104,35,12,17,47
14598,-24.93800000000006,2100.277777777778,22,12,23,34
14599,2.2637500000018553,3370.0,55,14,16,69
14600,4.7622500000008365,3112.5,43,13,21,56
14601,0.9637500000014171,2945.8333333333335,44,8,19,52
14602,-15.116999999999834,2545.5,19,21,15,40
14603,-23.529500000000112,2713.9473684210525,27,25,14,52
14604,-11.953249999999098,3444.8888888888887,50,13,19,63
14605,1.1950000000016092,5394.2,76,12,12,88
14606,-17.39725000000004,3207.684210526316,41,10,38,51
14607,-21.418999999999066,3722.0,47,4,13,51
14608,3.1915000000013563,4087.85,47,7,29,54
14609,-3.4742499999987215,2592.1666666666665,44,8,26,52
14610,-16.849749999999226,2121.684210526316,26,8,15,34
14611,-15.186249999999072,1821.1764705882354,27,8,25,35
14612,-27.97199999999908,2766.35,22,19,13,41
14613,-10.063499999998385,2768.5,47,11,31,58
14614,-15.32449999999904,2215.294117647059,39,9,27,48
14615,-29.27749999999911,1599.6875,9,17,26,26
14616,-12.892749999999504,2782.6111111111113,39,15,19,54
14617,-6.817249999998443,3134.8823529411766,63,19,18,82
14618,-17.441249999999492,3037.2631578947367,31,10,21,41
14619,-6.947999999999199,3101.25,27,13,17,40
14620,3.5480000000002505,3403.1052631578946,59,8,24,67
14621,-16.951999999999302,2076.9375,27,19,12,46
14622,-34.63824999999889,1962.8125,22,16,14,38
14623,-14.897999999998879,2778.2631578947367,28,16,21,44
14624,4.0670000000008,2895.9411764705883,67,8,15,75
14625,-11.582749999998716,2669.0588235294117,40,9,21,49
14626,-11.92774999999822,2019.4375,39,13,14,52
14627,-40.075249999999684,2086.25,11,16,15,27
14628,-7.948749999998857,4257.8421052631575,54,13,14,67
14629,-15.749249999998359,2672.5,30,13,29,43
14630,-23.217999999998863,2046.0625,19,5,34,24
14631,-28.497499999999853,1496.5,15,7,24,22
14632,-3.570749999999412,3438.55,33,9,20,42
14633,-32.54749999999957,2012.8333333333333,12,15,15,27
14634,-19.91424999999802,4183.05,48,17,19,65
14635,-6.795499999999443,2711.4210526315787,52,5,27,57
14636,-5.363749999998061,3519.3684210526317,42,15,20,57
14637,-14.639999999998858,2391.6470588235293,52,8,27,60
14638,-14.49499999999944,3156.6666666666665,30,16,19,46
14639,-18.71999999999928,2849.235294117647,63,20,18,83
14640,-16.1492499999992,2657.7,23,19,13,42
14641,-26.640749999998985,3365.6315789473683,30,9,22,39
14642,-7.548749999999802,3500.9473684210525,41,13,30,54
14643,-8.358249999998819,3950.5,35,11,19,46
14644,-14.930499999999475,2131.8333333333335,31,23,19,54
14645,0.9557500000017749,1925.764705882353,36,16,21,52
14646,-15.025749999998107,3172.3888888888887,60,18,15,78
14647,11.654750000001867,4779.9473684210525,58,6,18,64
14648,-12.485999999997958,2482.0,37,10,27,47
14649,-24.059249999999512,2859.25,19,21,22,40
14650,-10.217249999998753,3059.294117647059,48,13,19,61
14651,10.78550000000204,4136.684210526316,59,16,9,75
14652,11.281000000001836,3709.25,49,14,19,63
14653,13.272000000001366,5425.0,69,13,13,82
14654,23.24100000000113,2469.75,64,5,17,69
14655,6.796750000002416,5321.1,56,9,21,65
14656,-3.167749999999172,3397.315789473684,42,13,13,55
14657,-28.2659999999993,2165.5,13,13,23,26
14658,18.70700000000278,3808.1176470588234,77,8,24,85
14659,-37.3569999999989,2624.5789473684213,19,8,25,27
14660,-0.9437499999993108,3508.4210526315787,58,6,15,64
14661,-5.010749999999879,1737.5625,51,7,16,58
14662,-17.35424999999938,2683.9444444444443,28,8,29,36
14663,-32.722499999999634,2060.235294117647,21,8,16,29
14664,-6.29849999999926,4027.315789473684,53,15,15,68
14665,-17.3744999999996,2744.8333333333335,29,16,15,45
14666,-18.540249999999446,2817.8333333333335,40,12,18,52
14667,4.130250000001001,2834.777777777778,33,2,25,35
14668,-16.052750000000138,2429.0588235294117,39,16,18,55
14669,-17.022249999999016,3256.9,34,9,19,43
14670,-13.193999999999113,2472.4210526315787,32,11,17,43
14671,-17.16924999999913,3985.45,34,5,25,39
14672,-8.091749999999042,2201.875,49,12,20,61
14673,7.676250000001488,2576.5882352941176,65,20,16,85
14674,-21.63999999999922,2801.684210526316,32,15,20,47
14675,-7.681499999999529,2500.5,45,20,9,65
14676,-6.811249999998793,3092.3684210526317,35,8,18,43
14677,-11.874749999996833,1537.1875,50,14,21,64
14678,-21.93000000000003,2050.8823529411766,40,13,28,53
14679,-15.169249999999025,3198.85,31,6,20,37
14680,-5.197999999998155,4568.631578947368,56,13,19,69
14681,-28.35349999999977,1992.0588235294117,27,20,20,47
14682,-9.036749999999536,2028.7222222222222,27,6,20,33
14683,-17.79224999999857,2186.3529411764707,28,15,17,43
14684,-13.182749999999265,3104.5,42,7,27,49
14685,0.3092500000009384,4533.9,42,7,18,49
14686,5.104750000001839,2877.8888888888887,43,17,25,60
14687,-12.055249999999464,2378.5882352941176,53,22,13,75
14688,1.3617500000007394,2605.470588235294,65,18,18,83
14689,22.64450000000288,2850.235294117647,58,15,14,73
14690,-8.854749999998676,2540.9473684210525,39,9,12,48
14691,-13.255249999998892,3215.2631578947367,45,13,16,58
14692,-11.470499999999758,2421.9444444444443,35,9,24,44
14693,2.282000000000777,3139.8888888888887,57,10,19,67
14694,-1.1867499999991955,3824.1111111111113,67,11,24,78
14695,-11.775249999998849,2361.705882352941,45,15,20,60
14696,-40.50774999999897,2485.0,19,6,25,25
14697,-6.41474999999937,2464.8125,47,13,16,60
14698,-18.46900000000009,2767.6666666666665,25,9,25,34
14699,-0.9847499999998413,3127.5,68,21,20,89
14700,9.311750000001382,2845.6470588235293,58,8,25,66
14701,13.001250000000425,3611.6111111111113,60,18,16,78
14702,-23.263249999999054,2685.722222222222,34,6,15,40
14703,-1.3512499999985863,3921.9473684210525,59,20,15,79
14704,-17.217499999998942,3583.85,32,17,12,49
14705,-36.14624999999971,1429.0,20,12,32,32
14706,-16.488749999999705,2542.9411764705883,39,20,19,59
14707,2.3247500000004004,2496.294117647059,53,17,14,70
14708,-13.323749999998943,2272.235294117647,28,10,24,38
14709,-10.7159999999998,3008.3888888888887,48,20,16,68
14710,4.67425000000078,3030.5789473684213,51,12,15,63
14711,5.681250000001423,2722.176470588235,50,4,19,54
14712,15.942750000000501,2694.176470588235,56,18,15,74
14713,-7.109500000000179,2262.5,36,12,19,48
14714,-29.17499999999983,1429.0,23,12,38,35
14715,-16.82399999999956,2806.4444444444443,30,13,29,43
14716,2.1402500000009357,2909.6666666666665,52,13,22,65
14717,-9.01274999999771,1889.375,46,8,20,54
14718,-17.869249999997578,1572.875,39,10,23,49
14719,-2.6834999999983764,3623.8888888888887,48,6,26,54
14720,-21.655249999998308,2094.8125,35,6,35,41
14721,-14.807999999998989,4134.65,36,6,30,42
14722,-9.816249999998886,2939.6111111111113,35,22,11,57
14723,-13.69974999999963,2109.764705882353,23,24,19,47
14724,-13.04225000000019,1815.5294117647059,38,18,21,56
14725,16.366750000001353,4252.789473684211,70,12,18,82
14726,-15.65924999999911,2116.0555555555557,27,7,22,34
14727,-7.02749999999928,3167.5263157894738,59,7,17,66
14728,-4.3447499999992685,3052.5555555555557,49,12,24,61
14729,-23.658499999999908,1694.235294117647,22,11,16,33
14730,10.749500000000989,2077.75,49,23,10,72
14731,10.01625000000168,4098.9473684210525,63,16,12,79
14732,-15.462749999998783,1534.8666666666666,27,9,20,36
14733,-27.010999999999292,2295.315789473684,18,16,16,34
14734,10.679000000002365,4098.263157894737,74,7,11,81
14735,-29.870749999999465,1429.0,10,10,23,20
14736,-5.65999999999911,2687.5,43,8,22,51
14737,-24.262999999999835,2580.315789473684,34,7,18,41
14738,5.212500000002483,2986.470588235294,55,10,17,65
14739,-13.80499999999908,3164.9473684210525,32,17,18,49
14740,-29.65449999999886,2540.9473684210525,18,15,24,33
14741,-21.884499999998702,3165.157894736842,34,11,19,45
14742,5.345000000001936,5163.25,58,8,19,66
14743,1.1122500000009243,2173.176470588235,46,13,21,59
14744,-13.333999999998577,2390.3333333333335,34,14,12,48
14745,-10.477499999998445,2758.9444444444443,44,5,20,49
14746,-29.56150000000023,1429.0,11,18,19,29
14747,-5.119999999998499,3685.764705882353,54,19,18,73
14748,-27.862749999998726,2961.6666666666665,27,16,15,43
14749,-4.893999999998959,2982.2105263157896,26,22,18,48
14750,-17.653249999998813,2282.777777777778,27,16,15,43
14751,-3.773249999998736,3637.05,40,10,18,50
14752,-21.882999999999022,2765.65,20,14,16,34
14753,-7.819749999998526,2242.5625,38,7,18,45
14754,-4.944499999997755,5101.35,62,4,17,66
14755,-7.026499999999504,3105.684210526316,43,15,16,58
14756,-3.5714999999988306,3796.45,41,11,20,52
14757,-13.606499999998894,2056.9444444444443,27,5,25,32
14758,-42.28849999999987,1429.0,12,13,17,25
14759,-10.041999999998586,3597.842105263158,47,19,18,66
14760,-4.805749999998769,3301.3,26,23,12,49
14761,-14.183499999997858,2379.6470588235293,39,10,20,49
14762,9.877000000001901,2351.470588235294,52,7,15,59
14763,-7.689749999997817,3084.277777777778,46,13,16,59
14764,-25.494249999999237,2480.4117647058824,31,6,36,37
14765,-28.71224999999925,1514.375,22,12,30,34
14766,-23.889249999998356,1589.6470588235295,24,9,24,33
14767,-22.021499999998206,1666.125,35,15,28,50
14768,-10.860249999999562,2309.125,34,25,9,59
14769,-1.4779999999989506,2710.15,30,16,14,46
14770,5.835500000000939,6081.5,54,7,16,61
14771,1.397000000003183,2816.5882352941176,62,7,17,69
14772,15.728500000002848,2595.75,65,10,14,75
14773,-13.55374999999942,1580.8125,33,11,25,44
14774,-23.921999999999223,2206.823529411765,26,16,25,42
14775,-13.25624999999837,2451.9375,43,9,19,52
14776,-17.92624999999833,2068.3888888888887,37,14,34,51
14777,6.494500000001324,2610.176470588235,58,19,11,77
14778,-5.923499999999075,2442.1176470588234,41,13,19,54
14779,-23.861749999999013,2266.8333333333335,21,12,28,33
14780,-17.98399999999854,1887.5294117647059,36,17,16,53
14781,-17.515249999999277,1528.25,20,17,10,37
14782,-13.88749999999844,4072.315789473684,43,11,24,54
14783,1.3637500000014275,4400.45,57,14,19,71
14784,-37.52774999999891,2150.823529411765,22,11,31,33
14785,-28.086500000000047,2829.6470588235293,34,7,27,41
14786,-10.076499999999609,4933.05,50,13,23,63
14787,1.7492500000011764,4842.55,62,15,19,77
14788,-23.750499999999324,1946.3529411764705,37,12,27,49
14789,-21.401499999998467,3216.4,37,13,16,50
14790,-16.642499999998492,2055.0625,31,14,19,45
14791,-3.3524999999992717,2597.0588235294117,50,19,22,69
14792,-9.453249999999457,3623.7894736842104,30,17,17,47
14793,-15.937999999999013,3281.5,34,17,15,51
14794,-14.443499999999517,3056.4736842105262,36,12,21,48
14795,-3.1004999999985836,2155.722222222222,57,14,22,71
14796,-25.333499999999518,1528.25,16,12,16,28
14797,-5.769749999998582,2994.3333333333335,46,7,19,53
14798,-17.31624999999834,3108.1111111111113,49,7,31,56
14799,-10.967999999998995,3351.315789473684,46,14,16,60
14800,-10.392499999998659,1528.25,26,10,26,36
14801,4.617000000001247,3210.3333333333335,59,18,14,77
14802,4.021500000000968,3215.315789473684,53,8,27,61
14803,-28.399749999999607,3317.157894736842,36,15,19,51
14804,-15.076999999999611,2630.3684210526317,23,8,22,31
14805,-26.807249999999158,3239.35,21,10,27,31
14806,-4.716499999996146,4035.6315789473683,70,18,16,88
14807,-6.337499999998129,4373.210526315789,67,8,23,75
14808,1.1307500000004145,2194.3888888888887,29,12,20,41
14809,9.292750000000414,1514.7333333333333,50,13,19,63
14810,-0.703749999999099,2866.5625,69,17,21,86
14811,12.608250000001231,3546.1052631578946,52,12,22,64
14812,-13.508249999998796,2173.1875,35,13,15,48
14813,-37.95924999999904,1751.5,17,18,20,35
14814,-8.416749999998592,2891.294117647059,48,17,11,65
14815,-1.9559999999988378,3390.222222222222,45,17,21,62
14816,-10.880749999997999,4049.8947368421054,55,11,36,66
14817,-7.239499999999748,2639.235294117647,51,16,34,67
14818,-14.71649999999902,2777.375,47,9,15,56
14819,-27.833499999998935,4005.25,41,14,17,55
14820,-36.941999999999425,2033.111111111111,6,1,40,7
14821,-18.80574999999944,2076.3333333333335,31,18,26,49
14822,-15.961999999998465,2186.3529411764707,36,8,16,44
14823,-5.540749999998183,3631.8333333333335,53,9,20,62
14824,-1.7717499999990252,4324.25,56,9,21,65
14825,8.413500000003156,3291.4444444444443,69,14,11,83
14826,-20.897999999998706,3513.2,30,9,21,39
14827,-2.794499999999745,1550.0625,36,23,8,59
14828,2.5090000000015293,3501.3333333333335,66,8,17,74
14829,-19.878749999999805,2230.2105263157896,20,8,25,28
14830,-14.737749999998792,4293.4,44,10,20,54
14831,-25.757999999999008,2445.8333333333335,19,1,29,20
14832,7.665750000002303,4633.85,61,12,21,73
14833,-4.9097499999992875,2926.3888888888887,48,10,24,58
14834,-32.33899999999981,2076.5789473684213,9,9,22,18
14835,-2.2887499999981573,2389.4375,60,9,25,69
14836,-10.571249999999619,1921.1176470588234,55,9,30,64
14837,-28.66624999999895,2485.5,22,11,20,33
14838,-10.739749999999958,2643.842105263158,42,8,17,50
14839,-14.424749999999486,2655.4736842105262,21,8,17,29
14840,-34.846999999999305,2636.3,20,15,14,35
14841,23.364250000001157,3428.176470588235,64,16,11,80
14842,-11.518250000000016,2176.9411764705883,36,12,17,48
14843,-26.477249999999458,4664.1,42,13,18,55
14844,-43.759999999999806,3016.277777777778,31,7,34,38
14845,-24.574249999998877,2849.315789473684,26,9,32,35
14846,-6.462249999998209,4359.736842105263,59,8,17,67
14847,-14.746749999998803,2801.222222222222,40,10,22,50
14848,-15.122999999998928,2131.176470588235,27,14,19,41
14849,-8.197249999997897,3049.0555555555557,48,1,22,49
14850,0.27375000000095573,2061.9375,51,13,17,64
14851,-38.113749999999996,2108.1111111111113,8,11,45,19
14852,-9.514749999998878,3598.684210526316,58,19,14,77
14853,-3.1952499999977264,2456.3888888888887,34,17,22,51
14854,8.487750000000691,1893.3125,71,12,25,83
14855,0.49000000000108523,4119.388888888889,54,14,13,68
14856,-3.160749999998753,4169.210526315789,69,8,20,77
14857,4.248000000001722,3583.684210526316,62,15,16,77
14858,-23.777249999998908,2248.277777777778,28,9,18,37
14859,3.993500000002638,3760.7368421052633,55,5,22,60
14860,-3.2007499999981226,2481.235294117647,45,6,21,51
14861,-20.879249999999455,2673.8947368421054,24,9,22,33
14862,-30.106499999999187,2175.0625,44,3,33,47
14863,-26.913999999998502,2831.45,24,13,26,37
14864,-18.21274999999875,2753.0,38,14,14,52
14865,-19.507999999999488,2454.3529411764707,40,19,18,59
14866,-23.224499999999335,3221.1,24,7,24,31
14867,-5.859249999998323,2417.823529411765,47,13,19,60
14868,-3.848999999997961,5060.7,67,11,20,78
14869,-35.84949999999936,2874.3,18,19,13,37
14870,3.1875000000020557,4779.0,58,8,17,66
14871,-32.45649999999976,1429.0,25,15,24,40
14872,-16.5777499999974,3570.2105263157896,53,23,19,76
14873,-12.909249999998389,3597.0526315789475,40,5,29,45
14874,-2.957500000000398,2635.4444444444443,57,8,14,65
14875,5.300500000001515,4841.7,62,12,21,74
14876,-19.170749999999394,3049.7,28,11,23,39
14877,-14.058749999997833,4094.2,49,4,19,53
14878,-30.705999999999506,1834.7222222222222,15,11,25,26
14879,-3.595499999998721,3619.55,46,9,19,55
14880,-18.188999999998607,1429.0,23,15,25,38
14881,-30.584749999998802,2820.9473684210525,24,5,28,29
14882,-11.387749999999375,3622.842105263158,39,13,21,52
14883,-28.349249999999984,2659.1666666666665,37,7,39,44
14884,10.26500000000242,4952.9,61,8,18,69
14885,-19.093249999999294,2392.705882352941,36,13,18,49
14886,-18.469249999999267,3218.0,33,8,17,41
14887,-35.23324999999972,2207.684210526316,12,12,25,24
14888,-37.1832499999995,1690.5294117647059,9,17,20,26
14889,8.25475000000105,2547.705882352941,63,13,17,76
14890,-9.908999999998356,3774.35,39,6,23,45
14891,-7.9104999999996135,2487.823529411765,40,19,18,59
14892,-9.166749999999585,3311.3529411764707,57,11,30,68
14893,-2.612749999999032,2390.764705882353,42,13,19,55
14894,-18.3982499999995,2445.8333333333335,19,6,30,25
14895,-9.054499999999592,2106.0,29,18,14,47
14896,4.9750000000020815,4246.55,46,17,19,63
14897,-34.60374999999901,1429.0,15,5,26,20
14898,16.747000000001865,3072.470588235294,69,15,10,84
14899,-30.111999999999586,1867.0,18,7,23,25
14900,-11.483999999999195,2138.8888888888887,24,15,13,39
14901,-27.562999999999448,2365.6315789473683,18,16,22,34
14902,2.3422500000015467,2416.1875,48,10,28,58
14903,-27.204499999999076,1429.0,25,9,35,34
14904,-14.978499999999391,3292.0526315789475,54,9,22,63
14905,-27.83724999999858,2618.6111111111113,33,9,21,42
14906,-20.113749999999307,3762.4,47,16,14,63
14907,-13.195999999998843,3515.5,35,14,21,49
14908,9.784000000000848,4188.473684210527,50,21,11,71
14909,-7.1722499999984635,3229.8333333333335,47,13,19,60
14910,-9.79624999999876,4239.35,43,10,12,53
14911,15.514250000000809,3214.0,56,11,21,67
14912,-11.223749999999717,3019.7368421052633,31,14,19,45
14913,22.43550000000115,4382.210526315789,73,8,16,81
14914,11.883250000001661,3727.45,46,16,17,62
14915,13.617750000002214,4758.45,57,9,18,66
14916,-13.03924999999889,2436.529411764706,44,9,20,53
14917,-27.87874999999982,2267.842105263158,14,18,20,32
14918,-12.70174999999894,2933.5263157894738,31,16,17,47
14919,-1.841749999998718,2546.705882352941,49,23,25,72
14920,-33.64174999999974,2523.4210526315787,16,11,23,27
14921,-17.069499999998744,2628.4444444444443,32,4,22,36
14922,5.803500000001128,2434.0,60,9,21,69
14923,8.060000000001514,2134.5625,55,15,19,70
14924,-30.49549999999953,2348.0,13,17,16,30
14925,-32.57524999999939,2553.5789473684213,22,15,23,37
14926,-18.099749999998636,2601.8823529411766,42,10,25,52
14927,-10.494249999999493,2357.6111111111113,48,14,19,62
14928,-19.65699999999841,2116.8888888888887,17,13,30,30
14929,-3.3347499999968426,4229.95,60,5,15,65
14930,5.969000000001381,2765.0555555555557,50,9,14,59
14931,-26.066499999998825,2673.9473684210525,31,13,16,44
14932,-6.844999999999101,3906.0526315789475,58,13,39,71
14933,-17.293000000000028,2678.5555555555557,33,9,39,42
14934,-30.875749999998938,2098.75,35,21,35,56
14935,-23.516249999999538,2690.95,28,12,16,40
14936,-28.752249999999133,3127.4,29,7,24,36
14937,-33.12249999999961,2528.6666666666665,27,11,16,38
14938,11.613250000000418,2433.705882352941,55,9,20,64
14939,1.5432500000015579,3262.4444444444443,46,12,15,58
14940,-2.1364999999981595,2503.5,51,10,17,61
14941,1.5540000000016323,1592.0,46,8,23,54
14942,-10.828499999999902,2816.842105263158,37,10,25,47
14943,-5.151250000000152,2937.0,42,21,24,63
14944,-7.693999999999302,3014.5555555555557,34,8,25,42
14945,-29.90974999999911,2808.45,23,14,16,37
14946,-10.175999999999904,2299.5263157894738,18,15,26,33
14947,-18.529249999999983,2612.5,41,18,18,59
14948,-14.186999999998353,2369.0555555555557,37,6,20,43
14949,-6.39299999999853,3987.05,40,6,17,46
14950,-10.98749999999973,3109.8947368421054,46,7,28,53
14951,-17.027499999999893,2651.315789473684,32,10,19,42
14952,-28.285249999999603,1866.5625,22,21,21,43
14953,17.53225000000185,5501.35,69,12,23,81
14954,-2.2284999999982205,2131.176470588235,43,16,26,59
14955,11.220000000001532,6036.15,70,8,18,78
14956,1.725750000001406,6219.5,69,10,19,79
14957,4.5545000000024585,2416.1875,55,10,22,65
14958,-33.884249999998836,2009.2777777777778,12,15,26,27
14959,-25.00749999999946,1684.0,24,8,38,32
14960,-14.684249999998254,3190.8333333333335,49,20,15,69
14961,-33.99499999999968,2192.7894736842104,13,13,23,26
14962,-18.25899999999889,3206.05,33,12,16,45
14963,4.095250000002137,3343.176470588235,64,14,20,78
14964,-25.942249999999348,1840.8125,21,14,22,35
14965,0.02650000000115078,2230.625,56,6,19,62
14966,-4.1494999999994,3786.684210526316,53,7,17,60
14967,14.485500000001219,2938.0,75,6,23,81
14968,0.5062500000007633,2639.8333333333335,44,13,15,57
14969,-7.524749999999608,3558.5263157894738,34,11,20,45
14970,3.9205000000009234,3984.684210526316,58,9,24,67
14971,-14.024249999999077,2771.823529411765,52,13,17,65
14972,-28.608999999998694,3865.5,37,15,20,52
14973,-17.61449999999919,2138.8888888888887,23,9,19,32
14974,-12.47199999999888,3658.55,37,9,16,46
14975,-8.767499999998769,2059.0,46,9,14,55
14976,7.020000000000403,2994.0,53,15,20,68
14977,-9.754749999998928,3102.4210526315787,46,11,19,57
14978,-0.3357499999984553,4335.421052631579,63,15,14,78
14979,-11.329750000000054,2028.8333333333333,39,14,19,53
14980,-13.669249999999902,2032.25,45,7,22,52
14981,-16.866499999999313,1675.0625,30,14,20,44
14982,6.3900000000009625,2774.777777777778,50,6,24,56
14983,5.086250000002052,5722.75,78,8,17,86
14984,-7.043249999998809,3177.684210526316,43,14,15,57
14985,-21.684249999999203,1796.125,20,4,23,24
14986,-24.694249999999187,2728.157894736842,20,16,23,36
14987,-13.050749999998777,3064.1,34,21,11,55
14988,-7.2179999999992805,2449.3333333333335,42,28,9,70
14989,-11.953499999998808,4085.684210526316,60,14,20,74
14990,25.81275000000042,4048.1111111111113,75,15,14,90
14991,0.410500000001797,3026.9444444444443,47,13,20,60
14992,-23.91750000000005,2134.9411764705883,24,9,19,33
14993,-6.148749999999663,2123.9444444444443,34,12,21,46
14994,0.6017500000008811,2723.176470588235,51,14,18,65
14995,-4.02449999999922,3561.0526315789475,41,9,22,50
14996,-8.230499999997086,4001.315789473684,53,13,22,66
14997,-9.618999999998604,2821.4444444444443,31,10,34,41
14998,-27.729249999999524,3835.9473684210525,44,12,22,56
14999,-15.90524999999919,4212.35,42,16,17,58
15000,-1.1857499999976895,4448.9,54,12,18,66
