Episode,Average Lifespan,True Location Selections,False Location Selections,Explore Actions,Target Actions
1,0,10,40,0,50
2,0,12,39,0,51
3,0,14,39,0,53
4,0,10,45,0,55
5,0,24,39,0,63
6,0,19,36,0,55
7,0,9,41,0,50
8,0,16,43,0,59
9,0,18,44,0,62
10,0,22,37,0,59
11,0,15,36,0,51
12,0,21,42,0,63
13,0,15,40,0,55
