Episode,Average Lifespan,True Location Selections,False Location Selections,Explore Actions,Target Actions
1,2391.705882352941,30,32,0,62
2,2749.1666666666665,24,29,0,53
3,1814.4444444444443,8,32,5,40
4,2370.6315789473683,13,38,0,51
5,2421.0555555555557,11,35,0,46
6,2892.294117647059,30,39,0,69
7,2485.8947368421054,18,32,1,50
8,3082.764705882353,30,45,0,75
9,1933.5,15,40,9,55
10,2531.3333333333335,23,35,0,58
11,1500.4375,10,39,0,49
12,2441.5,25,38,0,63
13,3095.7894736842104,14,41,0,55
14,1905.2777777777778,13,39,0,52
15,3137.0,11,37,0,48
16,3153.3684210526317,29,34,0,63
17,2741.6315789473683,22,37,1,59
18,3044.0,15,45,0,60
19,2024.3,16,27,0,43
20,3841.1052631578946,31,46,0,77
21,2498.722222222222,23,32,0,55
22,2079.0,11,36,0,47
23,2617.823529411765,27,37,10,64
24,3772.8,31,36,0,67
25,2378.705882352941,18,34,0,52
26,3623.6,30,41,0,71
27,2679.5,25,38,5,63
28,2278.3333333333335,21,35,0,56
29,4279.9,37,27,0,64
30,3434.705882352941,38,37,0,75
31,3641.1,25,36,0,61
32,3091.85,22,29,0,51
33,2139.375,22,27,0,49
34,2632.8888888888887,18,33,0,51
35,2241.470588235294,17,38,0,55
36,3266.157894736842,29,30,0,59
37,1635.3529411764705,7,35,0,42
38,2473.153846153846,21,29,0,50
39,2967.2105263157896,34,30,0,64
40,3378.6470588235293,30,48,0,78
41,2860.157894736842,18,35,0,53
42,2531.4444444444443,21,37,0,58
43,2932.842105263158,32,27,0,59
44,1635.4117647058824,6,37,0,43
45,3009.684210526316,28,32,0,60
46,2181.3333333333335,18,36,0,54
47,2878.25,29,32,0,61
48,2787.85,17,35,0,52
49,3675.6315789473683,23,39,0,62
50,2961.777777777778,26,35,0,61
51,3989.35,26,35,0,61
52,1429.0,15,44,0,59
53,2759.8947368421054,20,33,0,53
54,2972.7,22,34,0,56
55,3207.684210526316,25,39,1,64
56,3906.95,29,37,0,66
57,2606.95,13,37,0,50
58,2897.3888888888887,28,48,0,76
59,2763.277777777778,24,44,0,68
60,3716.45,21,51,0,72
61,3340.9444444444443,28,41,0,69
62,3093.3684210526317,25,33,0,58
63,3636.315789473684,25,33,2,58
64,1706.3529411764705,13,32,0,45
65,2815.6470588235293,26,31,0,57
66,2398.1666666666665,11,41,0,52
67,4314.05,32,35,0,67
68,2860.529411764706,27,42,0,69
69,2539.3684210526317,13,36,0,49
70,2319.8823529411766,19,39,0,58
71,3583.05,22,37,0,59
72,2414.222222222222,21,33,0,54
73,2698.0,24,36,1,60
74,3812.45,25,44,0,69
75,2094.8333333333335,13,38,0,51
76,2416.9411764705883,22,39,1,61
77,2349.8125,22,34,0,56
78,3277.0526315789475,23,41,0,64
79,3608.55,21,44,0,65
80,1786.6470588235295,16,42,0,58
81,2535.2631578947367,21,29,0,50
82,3189.2631578947367,23,29,0,52
83,5258.45,33,52,0,85
84,3012.35,25,35,0,60
85,3034.1111111111113,25,39,4,64
86,1429.0,0,38,0,38
87,2672.2105263157896,22,39,0,61
88,2836.294117647059,30,28,0,58
89,2503.277777777778,20,33,0,53
90,2996.3684210526317,18,37,0,55
91,1640.0588235294117,5,25,0,30
92,3175.222222222222,21,36,0,57
93,2218.277777777778,13,30,0,43
94,3235.4,28,35,0,63
95,4373.210526315789,36,44,4,80
96,2796.8333333333335,24,41,0,65
97,2374.0588235294117,23,33,0,56
98,2108.0555555555557,20,35,0,55
99,2552.1,18,27,0,45
100,2357.5555555555557,20,35,0,55
101,3028.157894736842,20,34,0,54
102,2818.0555555555557,22,48,0,70
103,2357.75,19,37,0,56
104,2496.5625,26,38,0,64
105,1969.75,21,35,11,56
106,2791.6315789473683,10,40,0,50
107,2462.5789473684213,14,39,0,53
108,2453.722222222222,19,33,0,52
109,2393.777777777778,16,35,3,51
110,2756.0,14,41,0,55
111,1429.0,5,40,0,45
112,2561.8947368421054,13,42,0,55
113,2891.1052631578946,25,38,0,63
114,2690.9,24,27,0,51
115,2500.2105263157896,16,31,0,47
116,2457.6315789473683,17,38,0,55
117,2857.6666666666665,17,49,0,66
118,2328.0,18,32,13,50
119,3799.8,25,40,0,65
120,2099.75,14,25,0,39
121,2568.0,15,35,0,50
122,2423.125,20,29,0,49
123,2514.8,17,32,0,49
124,1909.7222222222222,11,29,0,40
125,1546.6470588235295,10,40,0,50
126,2548.2,16,33,0,49
127,2044.1,9,31,0,40
128,2960.85,15,36,0,51
129,2486.4444444444443,16,39,0,55
130,1900.5882352941176,18,33,0,51
131,2934.65,27,30,0,57
132,2492.5555555555557,19,40,0,59
133,3574.4,30,31,0,61
134,2295.8333333333335,17,37,0,54
135,1937.9411764705883,16,35,0,51
136,2004.888888888889,20,30,0,50
137,2487.75,12,38,0,50
138,1580.235294117647,9,40,0,49
139,2565.777777777778,24,36,0,60
140,2598.6875,25,41,0,66
141,1761.375,10,37,0,47
142,2739.1176470588234,25,32,0,57
143,2793.2631578947367,19,39,0,58
144,2859.4444444444443,19,46,0,65
145,2592.470588235294,23,37,0,60
146,4094.25,37,28,0,65
147,3286.157894736842,23,44,0,67
148,2436.222222222222,18,32,0,50
149,2871.1052631578946,28,39,0,67
150,2727.764705882353,22,50,0,72
151,2320.4210526315787,14,36,0,50
152,2314.230769230769,16,30,0,46
153,2989.684210526316,18,38,5,56
154,3366.4210526315787,28,38,0,66
155,2028.35,9,33,0,42
156,3822.95,27,37,0,64
157,2815.842105263158,27,29,0,56
158,2622.4117647058824,24,33,0,57
159,2361.277777777778,16,38,0,54
160,2823.5,19,36,0,55
161,2091.8,14,31,0,45
162,3622.9473684210525,33,29,0,62
163,2024.35,11,32,0,43
164,2727.9411764705883,23,37,3,60
165,3888.6,20,38,0,58
166,2642.0588235294117,19,29,0,48
167,4523.578947368421,37,32,8,69
168,3728.3,29,36,0,65
169,2393.3125,29,29,0,58
170,3533.8,21,34,0,55
171,2304.823529411765,16,31,0,47
172,3028.0,17,43,0,60
173,2516.8947368421054,26,24,0,50
174,3597.35,31,33,0,64
175,4191.85,35,42,0,77
176,3693.1052631578946,22,50,0,72
177,3125.9,32,27,0,59
178,2286.222222222222,13,38,0,51
179,3669.6315789473683,32,44,0,76
180,2647.470588235294,33,30,0,63
181,2336.315789473684,13,35,0,48
182,2953.722222222222,25,43,0,68
183,3272.0,24,38,0,62
184,2588.823529411765,20,40,0,60
185,2486.7368421052633,16,31,0,47
186,2109.764705882353,22,32,0,54
187,2440.294117647059,17,47,0,64
188,2735.1111111111113,27,38,0,65
189,2514.5555555555557,18,30,0,48
190,2549.3684210526317,25,23,0,48
191,3191.0,30,29,0,59
192,3015.684210526316,16,38,0,54
193,1429.0,7,40,0,47
194,2632.35,19,31,0,50
195,2883.3333333333335,27,34,0,61
196,2863.2,23,30,0,53
197,3017.294117647059,23,41,0,64
198,2371.8333333333335,22,40,0,62
199,3145.9473684210525,23,42,0,65
200,2549.4736842105262,21,33,0,54
201,3935.45,30,32,0,62
202,2684.8333333333335,27,37,0,64
203,2800.3333333333335,24,36,0,60
204,2749.0526315789475,19,31,0,50
205,2034.0588235294117,19,47,0,66
206,2478.5882352941176,19,42,0,61
207,3240.2631578947367,31,36,0,67
208,2935.4210526315787,25,31,0,56
209,1978.842105263158,10,34,0,44
210,2458.3684210526317,16,30,0,46
211,2206.8823529411766,20,33,0,53
212,3959.35,26,41,0,67
213,3374.7894736842104,36,38,0,74
214,1429.0,2,33,0,35
215,3163.5263157894738,23,34,0,57
216,1640.6666666666667,9,36,0,45
217,3302.1052631578946,35,35,0,70
218,2395.6666666666665,20,36,0,56
219,2664.5,19,34,0,53
220,1607.625,7,37,0,44
221,3081.684210526316,31,30,0,61
222,3421.15,30,33,0,63
223,2757.5,31,39,0,70
224,2318.0,9,37,0,46
225,2101.470588235294,15,35,0,50
226,1933.5,12,32,0,44
227,1929.0555555555557,14,36,0,50
228,2144.2631578947367,11,34,0,45
229,2312.3529411764707,19,35,0,54
230,3823.5,30,35,0,65
231,3924.3684210526317,31,34,0,65
232,1711.0588235294117,7,42,0,49
233,2220.823529411765,19,42,0,61
234,4635.35,32,36,0,68
235,2563.5789473684213,19,29,0,48
236,2959.4,22,35,0,57
237,4992.6,23,54,0,77
238,3196.5,16,37,0,53
239,1576.5882352941176,12,33,2,45
240,2551.842105263158,18,33,0,51
241,2736.15,16,36,0,52
242,3144.2105263157896,28,32,0,60
243,2774.8947368421054,22,35,0,57
244,3180.2631578947367,26,34,0,60
245,1898.5263157894738,10,35,0,45
246,2840.2105263157896,22,37,0,59
247,1933.388888888889,15,30,0,45
248,2893.6315789473683,24,39,0,63
249,2583.875,23,27,0,50
250,2548.2,15,34,0,49
251,3343.0526315789475,30,35,0,65
252,1936.888888888889,10,37,0,47
253,2552.15,16,36,0,52
254,2064.0,13,26,0,39
255,3935.4210526315787,26,54,0,80
256,3144.277777777778,21,46,0,67
257,3428.3,16,33,0,49
258,3925.6111111111113,33,34,0,67
259,3007.6111111111113,27,39,1,66
260,1429.0,5,33,0,38
261,2468.722222222222,20,32,0,52
262,2552.6666666666665,18,31,0,49
263,2728.0555555555557,25,39,3,64
264,1925.5555555555557,16,30,1,46
265,2644.6315789473683,24,34,0,58
266,2572.0,22,30,0,52
267,2528.8333333333335,24,32,8,56
268,2492.529411764706,21,34,0,55
269,4223.6,35,38,0,73
270,2084.529411764706,15,45,0,60
271,2118.1176470588234,12,51,0,63
272,1936.0,14,42,0,56
273,3112.55,24,27,0,51
274,3044.1,21,34,0,55
275,2774.722222222222,21,29,0,50
276,2907.7894736842104,19,34,0,53
277,2348.8125,22,34,0,56
278,2422.125,24,36,0,60
279,2032.25,6,37,0,43
280,2444.25,17,34,0,51
281,3836.3,35,33,0,68
282,2516.0588235294117,22,41,2,63
283,2556.05,16,29,0,45
284,2190.0588235294117,22,39,7,61
285,3322.0,26,34,0,60
286,5038.65,44,36,0,80
287,1790.4705882352941,13,43,12,56
288,3009.3,18,39,0,57
289,2502.5789473684213,21,33,0,54
290,5409.15,39,43,0,82
291,2639.8888888888887,18,40,0,58
292,2599.3333333333335,23,27,0,50
293,3027.2631578947367,25,35,0,60
294,2521.0526315789475,22,26,0,48
295,1926.1052631578948,11,30,0,41
296,2169.8888888888887,17,34,0,51
297,2035.9411764705883,18,35,0,53
298,2544.6666666666665,20,29,0,49
299,2873.6111111111113,27,35,7,62
300,2398.1666666666665,20,39,5,59
301,1997.157894736842,14,30,0,44
302,4356.526315789473,29,47,12,76
303,2171.2,11,32,0,43
304,2516.5555555555557,20,35,0,55
305,2990.5263157894738,24,40,0,64
306,1952.8333333333333,11,29,0,40
307,2814.2105263157896,17,41,0,58
308,2349.705882352941,20,33,10,53
309,3443.35,22,48,0,70
310,2500.5,26,32,0,58
311,2556.0,14,34,0,48
312,2699.9411764705883,26,31,0,57
313,2647.777777777778,20,40,0,60
314,4263.95,38,34,0,72
315,2281.722222222222,19,32,0,51
316,2501.5,16,33,0,49
317,2556.2,27,32,0,59
318,2402.6111111111113,16,38,0,54
319,2421.5263157894738,13,36,0,49
320,4092.55,25,47,0,72
321,2527.4375,21,43,0,64
322,2012.888888888889,20,31,0,51
323,2997.2105263157896,22,37,0,59
324,3808.45,29,39,0,68
325,2000.5294117647059,14,40,0,54
326,2004.9444444444443,16,33,0,49
327,3522.684210526316,25,37,0,62
328,3376.65,25,42,0,67
329,3627.5,24,48,0,72
330,4179.85,29,39,0,68
331,2003.8947368421052,15,34,0,49
332,2086.0555555555557,10,36,0,46
333,2019.7368421052631,15,33,0,48
334,2467.0555555555557,23,30,4,53
335,4448.15,39,30,0,69
336,1995.5263157894738,13,27,0,40
337,2012.2631578947369,12,32,0,44
338,3143.35,15,40,0,55
339,3980.7,28,40,0,68
340,2832.470588235294,25,40,0,65
341,2489.764705882353,21,27,0,48
342,2395.3125,36,35,0,71
343,2624.0,22,32,0,54
344,2298.5555555555557,14,42,12,56
345,2786.95,13,39,0,52
346,2560.4444444444443,20,35,0,55
347,2878.235294117647,32,41,2,73
348,3753.85,23,41,0,64
349,3876.7,23,38,0,61
350,2474.9444444444443,23,29,0,52
351,2975.4210526315787,21,45,0,66
352,2346.8823529411766,21,32,0,53
353,2779.2105263157896,19,33,0,52
354,3688.65,30,28,0,58
355,2198.470588235294,21,41,1,62
356,3516.45,15,46,0,61
357,1967.842105263158,10,35,0,45
358,2658.0526315789475,22,33,0,55
359,2938.1176470588234,31,30,0,61
360,2718.0,16,32,0,48
361,2375.5263157894738,16,35,0,51
362,1429.0,6,41,0,47
363,3370.684210526316,23,40,0,63
364,3754.8947368421054,31,41,0,72
365,2415.684210526316,9,40,0,49
366,2752.3684210526317,18,33,0,51
367,1978.7894736842106,12,29,0,41
368,3664.85,26,41,0,67
369,3668.05,27,31,0,58
370,3350.55,19,38,0,57
371,3233.277777777778,22,37,0,59
372,3622.1052631578946,22,44,0,66
373,3019.9444444444443,27,40,0,67
374,2036.3,7,37,0,44
375,2750.684210526316,13,35,0,48
376,3126.6666666666665,31,37,0,68
377,2281.9444444444443,17,33,0,50
378,2606.9,12,41,0,53
379,1429.0,3,38,0,41
380,2168.5882352941176,15,46,0,61
381,3482.5789473684213,34,31,0,65
382,3183.8,10,45,0,55
383,2214.75,26,27,0,53
384,2468.777777777778,19,43,0,62
385,4424.105263157895,22,50,0,72
386,4231.45,31,35,0,66
387,3663.0,23,38,0,61
388,3973.45,26,40,0,66
389,2763.2105263157896,21,36,0,57
390,4200.210526315789,32,46,0,78
391,2429.1176470588234,22,27,0,49
392,3698.95,26,34,0,60
393,3181.277777777778,16,45,0,61
394,1977.157894736842,8,42,0,50
395,2687.5,23,35,1,58
396,3269.7,23,41,0,64
397,3311.8333333333335,28,45,2,73
398,2077.5,14,28,0,42
399,2068.75,8,37,0,45
400,2243.684210526316,13,36,0,49
401,2646.222222222222,26,23,0,49
402,3287.9473684210525,27,29,0,56
403,2637.1666666666665,20,36,0,56
404,2024.4,10,29,0,39
405,4165.6,26,42,0,68
406,2465.9473684210525,17,34,0,51
407,2625.777777777778,26,34,0,60
408,2551.470588235294,24,29,0,53
409,3705.3,32,27,0,59
410,2246.0526315789475,15,37,0,52
411,4650.4,36,45,0,81
412,2148.0,19,33,0,52
413,2552.6111111111113,22,37,0,59
414,1990.235294117647,18,44,1,62
415,3351.4444444444443,32,37,0,69
416,2093.8823529411766,15,36,0,51
417,1882.8235294117646,18,37,0,55
418,3241.0,19,36,0,55
419,3347.4,19,40,0,59
420,2730.6666666666665,19,39,0,58
421,2865.6666666666665,25,42,0,67
422,2166.7368421052633,12,38,0,50
423,2134.5555555555557,14,31,0,45
424,2122.7,13,35,0,48
425,2402.9285714285716,24,36,0,60
426,3497.6315789473683,27,40,0,67
427,1988.1666666666667,11,36,0,47
428,2546.764705882353,19,33,0,52
429,2206.875,18,41,0,59
430,1655.8823529411766,12,37,0,49
431,1790.6666666666667,5,38,0,43
432,4026.4210526315787,35,44,0,79
433,2417.6666666666665,22,27,0,49
434,4132.631578947368,43,33,0,76
435,3364.0,25,39,0,64
436,1429.0,7,34,2,41
437,1429.0,4,36,1,40
438,2445.823529411765,28,37,0,65
439,5090.2,41,47,0,88
440,3484.7,29,32,0,61
441,2417.0588235294117,25,28,0,53
442,2984.764705882353,35,38,0,73
443,2579.3846153846152,20,33,0,53
444,2750.9444444444443,20,32,1,52
445,3388.5555555555557,29,43,1,72
446,3540.2,34,29,0,63
447,3695.8,28,40,0,68
448,2231.5555555555557,21,28,0,49
449,3942.8947368421054,26,44,0,70
450,2838.7,18,38,0,56
451,5360.85,36,47,0,83
452,2373.8947368421054,17,32,0,49
453,2842.764705882353,27,38,0,65
454,3134.7,19,34,0,53
455,2079.9473684210525,13,34,0,47
456,2535.157894736842,21,37,0,58
457,2536.8947368421054,22,30,0,52
458,2813.0625,29,39,0,68
459,3107.7,25,34,0,59
460,3175.1111111111113,28,31,0,59
461,2169.5882352941176,18,35,13,53
462,3409.6666666666665,33,35,0,68
463,1966.8823529411766,14,38,0,52
464,2007.5,24,37,0,61
465,2528.35,16,33,0,49
466,2282.9473684210525,16,36,0,52
467,1598.625,7,39,0,46
468,2622.7,18,37,0,55
469,1984.5882352941176,17,38,11,55
470,2694.6111111111113,21,35,0,56
471,2926.2105263157896,22,39,0,61
472,2230.2631578947367,11,35,0,46
473,2177.5789473684213,13,35,0,48
474,3387.777777777778,35,28,0,63
475,1957.3333333333333,15,32,0,47
476,3540.9,24,31,0,55
477,2254.3888888888887,9,46,0,55
478,3482.5789473684213,26,46,10,72
479,2087.3684210526317,16,32,0,48
480,3061.3888888888887,21,35,0,56
481,2433.1875,24,32,0,56
482,3525.1,24,43,0,67
483,3287.842105263158,18,43,0,61
484,2779.157894736842,17,41,0,58
485,2024.35,16,30,0,46
486,2548.1,22,28,0,50
487,1766.8333333333333,9,36,3,45
488,3026.3684210526317,19,36,0,55
489,1955.4444444444443,13,37,0,50
490,3742.6,26,36,0,62
491,2568.5789473684213,13,43,0,56
492,3554.55,29,36,0,65
493,3076.3888888888887,30,39,1,69
494,3083.15,21,30,0,51
495,2684.0588235294117,21,35,0,56
496,1733.9473684210527,5,35,0,40
497,2398.222222222222,20,34,0,54
498,3002.9473684210525,23,31,0,54
499,2387.1176470588234,22,45,0,67
500,2320.5555555555557,18,38,0,56
