Episode,Average Lifespan,True Location Selections,False Location Selections,Explore Actions,Target Actions
1,1989.0,9,42,0,51
2,1824.157894736842,9,36,2,45
3,3143.470588235294,30,34,0,64
4,2408.6470588235293,15,34,0,49
5,2311.722222222222,24,29,0,53
6,3783.85,27,41,0,68
7,2027.2105263157894,11,30,11,41
8,1979.8823529411766,18,32,0,50
9,2378.0,19,33,19,52
10,3020.8333333333335,28,38,6,66
11,2608.1666666666665,27,34,6,61
12,2910.2631578947367,15,41,0,56
13,2139.8888888888887,12,42,1,54
14,1865.611111111111,14,33,0,47
15,2333.8947368421054,16,27,0,43
16,2496.7368421052633,17,40,0,57
17,2755.823529411765,22,35,0,57
18,2285.277777777778,15,39,0,54
19,3544.4210526315787,21,47,0,68
20,2979.5789473684213,18,40,0,58
21,3288.6,24,39,0,63
22,2418.2631578947367,15,30,0,45
23,2876.9473684210525,20,33,0,53
24,1752.8666666666666,16,48,0,64
25,2471.1176470588234,11,51,0,62
26,2009.5,12,48,0,60
27,3066.5789473684213,24,39,0,63
28,2485.9473684210525,26,29,0,55
29,2597.0,15,45,0,60
30,2770.3888888888887,24,36,0,60
31,1714.75,9,47,0,56
32,1429.0,0,32,0,32
33,1822.3333333333333,9,35,0,44
34,3130.0526315789475,22,42,0,64
35,2084.277777777778,12,39,2,51
36,2088.6666666666665,12,31,0,43
37,3200.157894736842,23,43,2,66
38,1801.6842105263158,2,44,1,46
39,1429.0,0,39,0,39
40,2023.9473684210527,10,34,0,44
41,2100.1111111111113,15,30,13,45
42,2115.842105263158,10,32,0,42
43,1689.5882352941176,5,40,0,45
44,2040.111111111111,9,38,0,47
45,2563.529411764706,19,43,0,62
46,2047.35,8,34,0,42
47,1429.0,4,39,0,43
48,1936.0588235294117,15,39,0,54
49,2459.1666666666665,16,36,0,52
50,3277.35,21,33,0,54
51,2134.5555555555557,11,39,0,50
52,2317.2,16,32,0,48
53,2110.7368421052633,16,28,0,44
54,3089.1052631578946,23,37,0,60
55,2086.0555555555557,16,42,0,58
56,1944.4736842105262,12,32,0,44
57,1974.6842105263158,10,39,0,49
58,2032.3,9,31,0,40
59,2463.5,17,38,0,55
60,2667.277777777778,26,28,0,54
61,3268.75,26,37,0,63
62,2698.9473684210525,23,36,0,59
63,1618.5882352941176,5,39,0,44
64,2116.1111111111113,15,30,0,45
65,1929.0,13,55,0,68
66,2110.722222222222,15,36,0,51
67,3020.8571428571427,27,42,0,69
68,2573.5789473684213,23,25,0,48
69,2533.1666666666665,15,35,0,50
70,2902.1,17,32,0,49
71,2636.2631578947367,13,41,0,54
72,2627.0526315789475,18,35,0,53
73,2028.35,10,30,0,40
74,3035.55,15,35,0,50
75,4548.85,23,42,0,65
76,3038.65,16,37,0,53
77,2225.15,16,27,0,43
78,1941.4444444444443,17,36,10,53
79,3716.25,27,37,1,64
80,3271.2105263157896,25,42,0,67
81,2012.2105263157894,8,37,2,45
82,1828.5,9,40,0,49
83,4258.45,36,41,0,77
84,2134.5,19,32,0,51
85,1986.3157894736842,12,31,0,43
86,2650.4444444444443,16,42,0,58
87,3291.05,19,42,0,61
88,2664.470588235294,18,41,0,59
89,1988.3529411764705,19,33,9,52
90,2290.823529411765,23,33,6,56
91,2183.0555555555557,18,36,0,54
92,2292.1052631578946,12,32,0,44
93,1563.4705882352941,4,36,5,40
94,2804.125,33,28,0,61
95,2066.6111111111113,11,40,0,51
96,2669.8888888888887,16,32,0,48
97,3266.315789473684,25,31,0,56
98,2028.3,13,25,0,38
99,2333.0,16,28,0,44
100,1943.6842105263158,8,35,0,43
101,2757.705882352941,23,42,0,65
102,2681.4210526315787,15,40,2,55
103,2139.4,6,34,0,40
104,2197.222222222222,14,37,0,51
105,1509.375,9,42,0,51
106,2848.9,15,37,0,52
107,3668.842105263158,29,46,0,75
108,1973.111111111111,16,27,2,43
109,2228.0,15,41,0,56
110,2162.125,23,36,0,59
111,2862.6315789473683,18,33,0,51
112,2062.2631578947367,5,38,0,43
113,1982.6875,15,42,0,57
114,2089.5555555555557,11,34,0,45
115,2274.777777777778,19,40,10,59
116,3302.1052631578946,23,41,0,64
117,2129.95,9,35,0,44
118,2736.3,20,32,0,52
119,1810.888888888889,10,34,0,44
120,1429.0,1,37,0,38
121,2566.3,14,34,0,48
122,2669.0,26,29,0,55
123,2326.75,17,31,0,48
124,2741.8,14,35,0,49
125,2347.3684210526317,17,38,1,55
126,2044.15,9,28,0,37
127,3135.8947368421054,28,32,0,60
128,3414.05,23,39,0,62
129,1514.375,12,40,5,52
130,2054.0,13,33,0,46
131,4465.6,25,49,0,74
132,3072.4210526315787,18,41,1,59
133,2941.05,16,36,0,52
134,3307.0526315789475,21,45,0,66
135,3214.777777777778,31,38,0,69
136,2458.315789473684,12,46,0,58
137,2520.4,19,27,0,46
138,2353.222222222222,16,37,0,53
139,2587.0526315789475,15,31,0,46
140,2863.25,9,38,0,47
141,2186.294117647059,14,43,0,57
142,2652.05,18,32,0,50
143,2590.2631578947367,11,38,0,49
144,4146.55,23,45,0,68
145,2366.5,18,30,0,48
146,3269.5,19,39,0,58
147,3171.95,22,41,0,63
148,2805.0,26,35,0,61
149,2678.35,18,35,0,53
150,2459.0,23,41,9,64
151,2824.1666666666665,22,35,0,57
152,2087.3529411764707,16,38,0,54
153,2576.3888888888887,20,33,0,53
154,3603.722222222222,31,35,0,66
155,2480.0,14,46,0,60
156,5477.55,40,55,0,95
157,1753.157894736842,4,32,0,36
158,2361.8823529411766,19,37,0,56
159,2295.7,13,32,0,45
160,3250.4210526315787,27,40,0,67
161,2290.5555555555557,13,44,4,57
162,1551.3529411764705,4,39,5,43
163,2555.315789473684,19,36,0,55
164,2501.4444444444443,18,44,0,62
165,2133.375,14,44,0,58
166,2754.842105263158,25,31,0,56
167,2228.5263157894738,8,37,0,45
168,1993.7894736842106,15,26,0,41
169,1429.0,1,33,0,34
170,2937.8888888888887,24,37,0,61
171,2294.705882352941,18,31,0,49
172,2194.15,14,32,0,46
173,1926.157894736842,9,37,0,46
174,2288.65,13,36,0,49
175,2537.7368421052633,14,38,0,52
176,2514.1176470588234,22,38,0,60
177,1429.0,2,43,0,45
178,3505.157894736842,31,44,0,75
179,1747.4444444444443,6,34,0,40
180,2948.5,31,31,0,62
181,1891.1666666666667,6,47,2,53
182,2321.5,16,36,0,52
183,3099.9473684210525,23,30,0,53
184,1429.0,1,36,0,37
185,3325.4736842105262,24,43,0,67
186,4589.473684210527,41,40,0,81
187,3358.1052631578946,24,40,4,64
188,2645.9444444444443,20,37,0,57
189,2521.8947368421054,26,26,0,52
190,2599.5789473684213,13,41,0,54
191,2087.8,11,32,0,43
192,3057.9444444444443,25,41,0,66
193,2020.35,10,35,0,45
194,3706.95,26,43,0,69
195,2520.2631578947367,19,30,0,49
196,2088.65,12,30,0,42
197,4479.2,21,51,0,72
198,2060.3888888888887,13,27,0,40
199,2900.2631578947367,22,42,0,64
200,1720.0555555555557,3,33,0,36
201,3886.0526315789475,27,52,0,79
202,2680.3529411764707,22,32,0,54
203,1973.1666666666667,12,44,4,56
204,2996.4210526315787,27,41,0,68
205,2506.7368421052633,18,37,0,55
206,1691.888888888889,5,41,0,46
207,1429.0,3,46,2,49
208,1992.611111111111,12,59,0,71
209,2419.842105263158,6,44,0,50
210,2160.176470588235,10,44,0,54
211,2589.4736842105262,13,35,0,48
212,2306.5555555555557,12,33,0,45
213,3969.6,20,48,0,68
214,1859.2105263157894,6,35,0,41
215,3918.7,23,45,0,68
216,3360.5789473684213,26,42,0,68
217,2586.9473684210525,14,48,6,62
218,2657.9473684210525,21,39,0,60
219,2687.6111111111113,27,31,0,58
220,1581.235294117647,7,34,0,41
221,4290.421052631579,28,43,0,71
222,2026.888888888889,17,31,0,48
223,2121.2,11,27,0,38
224,3314.7368421052633,32,31,2,63
225,2667.277777777778,20,51,0,71
226,2637.4117647058824,18,44,7,62
227,2801.1666666666665,24,35,0,59
228,2142.4736842105262,10,39,0,49
229,2440.7894736842104,21,33,0,54
230,2370.176470588235,21,43,0,64
231,2897.277777777778,25,31,0,56
232,2703.3888888888887,26,29,9,55
233,3510.8,22,36,0,58
234,2231.235294117647,17,36,0,53
235,1657.25,12,32,0,44
236,2408.9473684210525,14,43,0,57
237,1429.0,0,33,0,33
238,2234.0,13,46,0,59
239,1795.0625,14,51,3,65
240,2243.0,11,32,5,43
241,1505.4375,10,38,4,48
242,2263.8823529411766,21,41,0,62
243,2499.4210526315787,17,30,0,47
244,1818.8333333333333,7,31,0,38
245,3169.2105263157896,31,33,0,64
246,2672.05,18,28,0,46
247,2335.6666666666665,15,35,0,50
248,2929.15,15,36,0,51
249,2534.0,23,26,0,49
250,2400.6315789473683,18,31,0,49
251,2020.3,15,33,0,48
252,2493.5625,25,37,0,62
253,2785.4,17,38,0,55
254,2313.235294117647,21,40,0,61
255,1887.5882352941176,10,40,0,50
256,2500.625,21,40,0,61
257,2524.3529411764707,19,51,0,70
258,1916.5294117647059,14,43,0,57
259,5141.85,29,45,0,74
260,1952.0526315789473,7,39,0,46
261,1858.5555555555557,5,32,0,37
262,2028.5294117647059,14,42,0,56
263,2079.8947368421054,8,38,1,46
264,2147.5789473684213,12,37,0,49
265,2467.25,18,35,0,53
266,2137.1111111111113,13,32,0,45
267,2759.0555555555557,24,31,0,55
268,1786.6470588235295,17,41,10,58
269,2531.45,16,31,0,47
270,2131.8333333333335,10,35,0,45
271,1429.0,1,37,0,38
272,2885.8888888888887,21,52,0,73
273,2013.5882352941176,13,39,4,52
274,2938.8823529411766,23,38,1,61
275,4348.85,23,41,0,64
276,3112.4736842105262,21,36,0,57
277,3868.0,39,37,0,76
278,2472.222222222222,18,40,0,58
279,2211.1052631578946,14,31,11,45
280,2331.315789473684,13,39,0,52
281,3032.315789473684,30,35,0,65
282,2814.5555555555557,22,38,3,60
283,3008.45,18,37,0,55
284,2349.75,21,39,0,60
285,1429.0,2,36,0,38
286,3132.3,22,33,0,55
287,3109.0555555555557,28,37,0,65
288,1833.2941176470588,10,41,0,51
289,2109.705882352941,14,41,0,55
290,2896.6,16,43,0,59
291,2835.6666666666665,24,37,0,61
292,2071.9,8,35,0,43
293,2578.7368421052633,21,38,0,59
294,3049.1111111111113,18,61,0,79
295,2972.157894736842,25,33,0,58
296,3087.4210526315787,17,38,0,55
297,2419.6,27,34,1,61
298,2022.5,9,30,0,39
299,2636.470588235294,19,32,0,51
300,2317.2631578947367,15,29,0,44
301,2750.7894736842104,20,42,6,62
302,1580.8125,11,47,0,58
303,2260.2631578947367,12,34,0,46
304,2562.764705882353,22,34,0,56
305,3745.7368421052633,35,50,0,85
306,2173.3684210526317,13,38,0,51
307,2953.777777777778,22,39,0,61
308,2206.8823529411766,23,36,1,59
309,2587.85,16,35,0,51
310,2008.5,11,30,0,41
311,3220.157894736842,29,32,0,61
312,2017.3333333333333,13,33,0,46
313,3017.2631578947367,23,40,0,63
314,2084.0526315789475,7,37,1,44
315,2248.1,8,34,0,42
316,1845.4705882352941,10,37,11,47
317,2376.5263157894738,19,31,0,50
318,2595.294117647059,24,25,0,49
319,2825.0,30,35,0,65
320,2780.65,20,33,0,53
321,1429.0,7,36,0,43
322,3761.6315789473683,27,36,0,63
323,3073.2631578947367,27,34,0,61
324,2799.157894736842,18,35,0,53
325,2425.5555555555557,17,34,0,51
326,1812.611111111111,10,36,0,46
327,3431.4,26,34,0,60
328,3412.4736842105262,34,32,0,66
329,2119.176470588235,14,39,0,53
330,2953.8888888888887,24,41,0,65
331,2625.315789473684,15,33,0,48
332,2207.7368421052633,12,40,0,52
333,2749.157894736842,17,39,6,56
334,3575.9,28,35,0,63
335,3012.2631578947367,27,36,12,63
336,3293.222222222222,26,43,0,69
337,3562.45,22,42,0,64
338,1429.0,1,36,0,37
339,2064.842105263158,11,34,0,45
340,2904.5263157894738,22,27,0,49
341,3759.25,21,50,0,71
342,2448.823529411765,20,33,0,53
343,2368.842105263158,13,36,0,49
344,2739.8947368421054,23,36,0,59
345,4400.5,29,48,0,77
346,2020.8333333333333,14,35,0,49
347,2119.0588235294117,14,37,0,51
348,2032.3,12,32,0,44
349,3571.15,26,34,0,60
350,4122.75,29,37,0,66
351,2474.157894736842,16,40,0,56
352,2996.705882352941,25,45,1,70
353,2160.1111111111113,12,34,0,46
354,2428.3684210526317,16,30,0,46
355,3317.2105263157896,25,37,0,62
356,2049.7894736842104,9,38,2,47
357,3871.9473684210525,37,36,0,73
358,2332.9411764705883,17,34,0,51
359,2700.6666666666665,23,42,0,65
360,2896.0,30,34,0,64
361,2245.722222222222,15,37,4,52
362,1889.3333333333333,11,42,0,53
363,2405.3125,19,37,0,56
364,3056.4736842105262,21,45,0,66
365,2541.176470588235,25,41,8,66
366,4109.25,23,42,0,65
367,3496.6,22,32,0,54
368,3133.4210526315787,34,18,0,52
369,2597.7894736842104,15,38,0,53
370,1961.7222222222222,12,40,5,52
371,2669.0588235294117,23,29,0,52
372,2513.4736842105262,15,36,0,51
373,2066.6111111111113,14,31,0,45
374,2084.8947368421054,8,40,0,48
375,3529.9,24,33,0,57
376,2179.5555555555557,17,32,0,49
377,2455.8125,21,33,0,54
378,2499.2105263157896,16,33,0,49
379,2226.470588235294,19,38,0,57
380,1957.2777777777778,9,33,0,42
381,2087.05,6,31,0,37
382,2108.5,14,29,0,43
383,2366.529411764706,20,29,0,49
384,2133.6666666666665,17,34,6,51
385,2727.1666666666665,25,30,0,55
386,2514.6111111111113,13,36,0,49
387,2371.625,22,40,2,62
388,2395.7894736842104,15,28,0,43
389,2549.923076923077,24,32,0,56
390,3769.5,25,39,0,64
391,1869.3157894736842,9,35,0,44
392,2866.0588235294117,25,35,0,60
393,3066.0,36,37,0,73
394,2155.722222222222,14,41,0,55
395,2108.1111111111113,10,37,5,47
396,2395.6111111111113,11,37,1,48
397,3354.5,16,45,0,61
398,1743.0,8,30,0,38
399,3436.5789473684213,27,37,0,64
400,2340.3333333333335,19,30,0,49
401,2540.95,10,39,0,49
402,3269.5789473684213,31,38,0,69
403,3320.4,26,35,0,61
404,3902.9,14,45,0,59
405,1955.611111111111,8,36,0,44
406,2622.294117647059,20,48,0,68
407,4190.95,18,51,0,69
408,2069.842105263158,8,36,0,44
409,1813.4444444444443,6,35,0,41
410,2505.157894736842,23,31,0,54
411,1907.9411764705883,11,37,0,48
412,3080.7,21,39,0,60
413,2552.4444444444443,21,33,2,54
414,3251.0555555555557,24,35,1,59
415,2865.6111111111113,23,34,0,57
416,2160.1111111111113,16,32,0,48
417,2474.823529411765,19,40,6,59
418,2157.3125,22,43,2,65
419,1491.5,5,37,0,42
420,2036.2,10,38,0,48
421,2078.3,15,28,0,43
422,2027.0,11,31,0,42
423,2629.277777777778,16,36,0,52
424,2541.8947368421054,13,38,0,51
425,3248.684210526316,16,45,0,61
426,3324.684210526316,25,44,0,69
427,1978.7894736842106,12,30,0,42
428,2171.25,10,33,0,43
429,2032.3,9,35,0,44
430,1966.8823529411766,20,51,0,71
431,2069.1052631578946,8,39,0,47
432,2250.9444444444443,12,38,0,50
433,3617.0,33,44,4,77
434,2818.8888888888887,18,33,0,51
435,2416.5,13,36,0,49
436,2572.0714285714284,23,31,0,54
437,2217.7894736842104,5,43,0,48
438,2028.8947368421052,14,29,0,43
439,2500.45,16,39,0,55
440,1635.4117647058824,4,39,2,43
441,2100.7368421052633,16,32,0,48
442,3064.0,27,33,0,60
443,2163.6666666666665,12,40,5,52
444,2395.6666666666665,21,28,0,49
445,1590.75,6,32,0,38
446,3087.8333333333335,27,46,0,73
447,2960.0555555555557,29,33,0,62
448,4148.95,24,50,0,74
449,2495.7,14,30,0,44
450,2162.3125,15,46,0,61
451,2152.5263157894738,13,29,0,42
452,2329.176470588235,11,41,0,52
453,2953.0,18,42,0,60
454,2595.2631578947367,15,38,0,53
455,1604.5,6,31,0,37
456,2646.55,12,36,0,48
457,1618.5882352941176,7,38,1,45
458,2146.6,14,35,0,49
459,3166.5,18,39,0,57
460,1638.5333333333333,16,45,0,61
461,2708.2105263157896,17,35,0,52
462,2201.3,17,26,0,43
463,2888.5,36,32,0,68
464,2664.75,18,28,0,46
465,2250.8333333333335,13,35,0,48
466,2417.0588235294117,22,31,0,53
467,2117.4210526315787,11,34,5,45
468,1429.0,3,38,0,41
469,2520.2105263157896,14,31,0,45
470,3092.6,17,46,0,63
471,2877.0555555555557,25,33,0,58
472,2771.6315789473683,12,35,6,47
473,2060.4444444444443,17,36,3,53
474,1429.0,5,39,0,44
475,2138.3684210526317,15,31,0,46
476,1748.3529411764705,7,35,0,42
477,1933.388888888889,16,24,0,40
478,2222.777777777778,11,39,0,50
479,2482.3529411764707,24,35,0,59
480,1429.0,1,37,0,38
481,2133.6666666666665,8,45,8,53
482,2399.9444444444443,13,37,0,50
483,2389.842105263158,15,38,13,53
484,2949.3888888888887,24,36,3,60
485,2409.842105263158,12,37,0,49
486,2107.6,14,27,0,41
487,2084.5882352941176,15,40,0,55
488,2875.9473684210525,21,45,0,66
489,3267.7894736842104,24,43,1,67
490,2296.55,9,35,0,44
491,4470.35,20,42,0,62
492,2019.7894736842106,17,22,0,39
493,2599.5789473684213,21,35,0,56
494,2464.157894736842,18,36,24,54
495,2301.222222222222,10,44,0,54
496,1429.0,0,38,0,38
497,1429.0,2,35,0,37
498,2048.15,12,34,0,46
499,2748.3888888888887,21,39,0,60
500,3092.45,19,39,0,58
