Episode,Average Reward,Average Lifespan,True Location Count,False Location Count,Explore Actions,Target Actions
1,-16.803749999999646,2579.8333333333335,29,10,20,39
2,-16.194749999996326,2940.5555555555557,39,9,21,48
3,-49.923249999997424,3647.25,25,17,24,42
4,-21.44524999999601,1951.875,33,4,32,37
5,-31.906249999997208,2942.277777777778,28,12,24,40
6,-9.982999999998116,1608.625,22,7,14,29
7,-29.236999999999238,2553.4736842105262,38,6,20,44
8,-33.86899999999755,3460.777777777778,49,14,31,63
9,-39.69724999999762,2131.0,15,13,18,28
10,-37.90099999999861,1701.8125,11,20,10,31
11,-47.067999999996196,3329.3888888888887,36,11,34,47
12,-27.189249999998232,2561.0526315789475,15,10,20,25
13,-32.23374999999656,3682.25,27,16,20,43
14,-37.16074999999592,2199.8333333333335,35,6,25,41
15,-38.09974999999777,3597.4,21,8,30,29
16,-29.164749999997184,1609.625,16,10,18,26
17,-23.02549999999659,3343.5555555555557,38,12,26,50
18,-44.96924999999745,3413.2,25,17,23,42
19,-27.879499999997556,2659.684210526316,23,12,22,35
20,-37.42750000000009,1589.6875,27,12,25,39
21,-31.76574999999777,2543.9444444444443,26,9,20,35
22,-36.653999999997,4006.05,34,13,28,47
23,-29.966249999996286,3608.4,39,11,22,50
24,-19.65849999999714,2610.3684210526317,20,8,19,28
25,-21.97474999999956,2230.6111111111113,21,2,29,23
26,-44.34924999999671,2662.470588235294,25,23,22,48
27,-17.798749999998783,3137.05,17,6,20,23
28,-25.056749999999973,1429.0,17,15,24,32
29,-17.03299999999734,2087.3529411764707,26,11,20,37
30,-9.329999999996133,1715.8125,38,12,25,50
31,-13.661499999995447,2926.2105263157896,36,5,28,41
32,-26.019749999997664,1429.0,24,12,15,36
33,-24.064499999999065,2758.2631578947367,23,17,22,40
34,-28.416249999998104,2545.3888888888887,17,15,26,32
35,-14.377249999997767,3167.1666666666665,34,20,20,54
36,-23.52724999999805,2921.157894736842,27,13,17,40
37,-33.575749999998834,3128.2631578947367,28,14,19,42
38,-22.043999999999983,1671.5555555555557,10,13,23,23
39,-56.99399999999887,2516.3888888888887,8,11,40,19
40,-52.61724999999586,2843.6111111111113,24,24,21,48
41,-18.49724999999793,1871.5,40,6,25,46
42,-34.58124999999808,3131.8888888888887,43,17,33,60
43,-29.42249999999745,3557.7368421052633,36,14,31,50
44,-41.18624999999727,2406.1111111111113,20,11,24,31
45,-35.112249999998404,2147.0588235294117,13,11,17,24
46,-26.918249999999016,2193.764705882353,41,17,24,58
47,-32.669999999996826,2907.0,32,6,31,38
48,-23.804499999997386,2474.0555555555557,32,9,20,41
49,-39.54049999999732,2863.777777777778,26,10,25,36
50,-34.886749999997654,3179.85,21,19,13,40
51,-22.12549999999954,2211.222222222222,21,9,25,30
52,-27.013249999999573,2028.7222222222222,24,9,22,33
53,-28.530499999997602,3663.9,35,16,12,51
54,-29.63199999999781,1929.5882352941176,24,7,20,31
55,-31.969999999999185,2421.1666666666665,22,10,28,32
56,-34.582499999998234,3087.3684210526317,33,11,34,44
57,-29.062499999998447,1635.375,12,9,15,21
58,-24.435499999998946,2441.4444444444443,26,16,21,42
59,-27.963249999996787,2692.722222222222,19,9,37,28
60,-39.935749999994734,2217.1176470588234,39,17,30,56
61,-36.42349999999816,3295.7,22,22,14,44
62,-27.932749999997903,2467.0,26,10,14,36
63,-22.979749999999406,2017.2941176470588,40,16,23,56
64,-22.907749999998074,1429.0,16,12,16,28
65,-33.967999999998014,2818.8888888888887,23,13,27,36
66,-31.593999999996544,3493.4210526315787,37,12,21,49
67,-20.47450000000038,1429.0,8,6,15,14
68,-27.0374999999981,2417.6666666666665,43,5,28,48
69,-13.25574999999687,4015.5,37,14,23,51
70,-16.28099999999835,1732.5294117647059,18,7,18,25
71,-27.05399999999659,3816.684210526316,46,13,19,59
72,-32.96500000000015,2357.6111111111113,30,25,27,55
73,-25.53124999999756,3046.4210526315787,37,13,22,50
74,-29.866999999999468,2140.0,7,14,12,21
75,-30.26649999999798,1644.3125,13,5,21,18
76,-31.13649999999737,3137.5263157894738,17,10,32,27
77,-30.608999999995454,3552.5555555555557,53,15,28,68
78,-40.67599999999853,2377.8333333333335,35,18,12,53
79,-16.19699999999825,3634.5789473684213,53,17,28,70
80,-21.50424999999898,1855.764705882353,32,8,22,40
81,-11.192749999998188,3505.1052631578946,40,8,32,48
82,-53.27624999999612,3294.5789473684213,23,9,39,32
83,-40.286249999997544,1671.125,21,11,20,32
84,-49.15774999999763,3739.0,37,18,37,55
85,-26.20149999999911,2613.15,14,8,15,22
86,-52.889999999996974,3521.6666666666665,37,19,31,56
87,-22.150249999999318,2202.235294117647,37,9,32,46
88,-33.57724999999887,2403.2105263157896,22,11,16,33
89,-24.09999999999723,1724.6875,24,11,23,35
90,-24.90149999999837,2276.5,31,13,11,44
91,-49.06999999999694,2258.9444444444443,34,9,46,43
92,-9.219999999998954,2492.5555555555557,31,9,14,40
93,-28.14224999999608,1662.1875,37,13,15,50
94,-25.007249999997743,2435.277777777778,28,2,21,30
95,-20.18674999999802,3089.842105263158,34,7,21,41
96,-35.770499999997796,2559.8823529411766,44,5,33,49
97,-18.61225000000014,1429.0,3,7,10,10
98,-16.361249999998087,2869.6,13,6,18,19
99,-31.079499999999037,2306.5,16,8,28,24
100,-28.021499999998372,2673.7894736842104,14,13,18,27
101,-37.458249999998664,2808.5,14,21,13,35
102,-34.119249999999155,2523.4444444444443,14,22,14,36
103,-27.75349999999952,2685.6315789473683,20,4,37,24
104,-30.95649999999705,1623.235294117647,15,13,21,28
105,-19.28074999999875,2306.5,19,5,20,24
106,-14.835000000000111,1761.4705882352941,26,8,20,34
107,-31.958249999997083,3432.25,23,11,23,34
108,-55.66774999999859,3167.5789473684213,29,13,41,42
109,-33.8082499999984,1514.375,9,21,16,30
110,-32.171249999998444,2851.3,19,14,19,33
111,-25.95874999999928,1476.6666666666667,38,16,25,54
112,-38.39849999999766,3107.1666666666665,28,16,31,44
113,-29.377499999997337,2758.9444444444443,36,4,35,40
114,-30.937750000000346,1429.0,26,11,13,37
115,-46.18974999999813,3373.5555555555557,35,29,21,64
116,-28.448000000000285,1955.8125,37,21,40,58
117,-41.862499999999955,2050.9411764705883,25,23,21,48
118,-61.65099999999853,3170.0,30,10,38,40
119,-26.300249999998414,1532.1875,24,13,21,37
120,-46.29274999999866,2513.1176470588234,32,14,19,46
121,-43.84374999999669,3606.2105263157896,36,14,29,50
122,-43.970749999996336,1898.3125,20,8,32,28
123,-25.438999999999034,2353.4117647058824,46,16,25,62
124,-21.12974999999677,3490.1052631578946,36,10,28,46
125,-35.69824999999851,2756.85,14,19,14,33
126,-32.9242499999986,2500.9473684210525,14,12,21,26
127,-20.04749999999847,1945.3529411764705,19,5,21,24
128,-24.07749999999792,2219.315789473684,17,10,14,27
129,-26.43699999999951,1634.375,21,22,14,43
130,-32.534749999998176,2944.5263157894738,29,10,28,39
131,-34.360999999998036,1732.5294117647059,7,15,19,22
132,-45.29499999999616,2887.5882352941176,25,17,44,42
133,-48.99574999999817,2534.5882352941176,37,16,27,53
134,-19.706499999997703,2208.6666666666665,25,10,22,35
135,-31.17549999999735,2302.842105263158,21,12,21,33
136,-21.197999999998455,2683.0,20,10,22,30
137,-20.59499999999574,2593.0555555555557,38,11,28,49
138,-25.471249999998996,2109.764705882353,19,14,25,33
139,-18.209250000000146,1714.75,25,18,13,43
140,-29.935249999998018,4254.473684210527,51,16,29,67
141,-39.98249999999733,3648.85,23,24,16,47
142,-40.8764999999983,1853.6875,13,13,20,26
143,-27.013749999997138,1959.4117647058824,20,10,23,30
144,-31.472999999997825,1652.235294117647,20,11,16,31
145,-48.30524999999717,3632.2,32,10,21,42
146,-20.223499999999206,2138.9444444444443,21,11,26,32
147,-32.934499999998124,2479.3333333333335,17,19,23,36
148,-14.308249999998713,2076.277777777778,38,7,26,45
149,-33.78199999999713,3094.8947368421054,28,13,32,41
150,-35.79474999999824,2893.35,15,16,17,31
151,-36.62049999999603,2849.315789473684,29,18,21,47
152,-31.326249999997987,2794.1,16,14,17,30
153,-29.051999999997314,1841.764705882353,15,12,27,27
154,-15.066499999996344,2985.5,44,3,24,47
155,-22.378999999999824,1798.5555555555557,22,3,31,25
156,-24.012749999998015,3489.157894736842,40,17,14,57
157,-29.681749999998424,2377.9444444444443,25,15,29,40
158,-43.36049999999815,2007.9411764705883,14,11,21,25
159,-25.00649999999806,2097.5882352941176,16,19,16,35
160,-23.366249999997734,1617.5625,20,8,15,28
161,-56.025999999997964,3385.8888888888887,55,22,19,77
162,-28.312249999998045,3185.157894736842,32,14,30,46
163,-41.90824999999883,2643.277777777778,28,18,12,46
164,-15.695249999999584,2067.6470588235293,33,4,46,37
165,-27.496249999997865,2869.55,25,13,12,38
166,-24.763999999998006,4565.6,43,20,23,63
167,-37.70024999999775,3531.7368421052633,31,20,20,51
168,-31.398249999998303,3263.15,23,10,15,33
169,-28.12224999999649,2839.823529411765,49,19,35,68
170,-36.27774999999748,1692.9375,26,12,21,38
171,-33.72149999999867,2159.2631578947367,8,9,20,17
172,-12.441750000001097,1429.0,19,19,15,38
173,-32.18274999999779,2008.9411764705883,22,20,28,42
174,-26.94874999999895,2197.0555555555557,31,13,22,44
175,-10.37149999999898,1429.0,8,6,10,14
176,-28.85524999999984,1705.75,42,17,18,59
177,-37.40474999999704,3898.15,38,13,26,51
178,-23.72324999999713,2417.0,33,6,28,39
179,-40.36099999999898,2310.0555555555557,20,7,23,27
180,-26.860249999997045,2381.4444444444443,22,13,23,35
181,-29.04499999999723,3829.85,22,27,19,49
182,-24.90324999999827,2457.277777777778,15,6,21,21
183,-22.67049999999939,1811.8235294117646,20,5,15,25
184,-14.097750000000186,1429.0,13,4,14,17
185,-16.933999999997596,2646.0,25,11,22,36
186,-37.84374999999856,1429.0,39,20,23,59
187,-16.08149999999841,1761.4705882352941,31,11,19,42
188,-19.639999999998032,2290.6111111111113,23,6,29,29
189,-19.1139999999984,1800.0625,17,6,17,23
190,-32.36324999999852,2681.3684210526317,18,16,17,34
191,-32.51799999999741,4020.4736842105262,29,11,45,40
192,-25.188249999998384,2779.1,14,14,16,28
193,-27.15299999999877,1879.1176470588234,14,7,18,21
194,-21.367999999999263,1429.0,7,8,10,15
195,-46.58800000000029,2071.8888888888887,22,7,42,29
196,-19.885999999998507,2966.4,22,16,11,38
197,-28.021999999998666,2790.15,15,11,13,26
198,-18.237249999997346,2047.1764705882354,29,9,23,38
199,-13.764249999998267,2188.277777777778,22,4,13,26
200,-27.012499999996464,3775.95,30,16,32,46
201,-11.876999999999223,1576.875,33,8,21,41
202,-37.71799999999745,3606.85,25,9,23,34
203,-53.983999999998915,3079.8333333333335,49,27,21,76
204,-27.843499999996357,4424.3,41,11,28,52
205,-20.986249999998144,3602.95,26,10,18,36
206,-68.50749999999532,2844.875,49,21,38,70
207,-34.649749999998576,2310.5263157894738,9,10,15,19
208,-42.44149999999718,2941.4444444444443,35,13,31,48
209,-20.700999999995616,1528.25,36,10,25,46
210,-17.937999999998333,2030.3529411764705,30,10,20,40
211,-29.88224999999819,1870.764705882353,19,12,19,31
212,-40.397250000000156,2179.4444444444443,24,16,17,40
213,-38.95249999999908,2791.6315789473683,17,15,23,32
214,-18.524749999998118,3159.25,27,7,13,34
215,-25.459249999998036,2064.0,37,10,25,47
216,-26.04224999999647,2560.764705882353,35,7,35,42
217,-19.934499999998593,2067.705882352941,26,14,33,40
218,-11.66175000000047,1429.0,22,11,22,33
219,-36.86899999999737,3426.8,24,13,21,37
220,-17.01499999999546,2522.470588235294,48,9,33,57
221,-25.449749999998023,2512.6315789473683,26,12,16,38
222,-25.78149999999864,1825.0,13,8,18,21
223,-45.56849999999612,2228.625,35,26,21,61
224,-29.03324999999856,3030.65,17,12,14,29
225,-19.064999999999067,1612.5625,18,8,16,26
226,-22.696750000000115,1429.0,12,10,16,22
227,-43.56474999999516,2568.3888888888887,37,10,31,47
228,-27.44099999999409,3598.5,46,7,39,53
229,-44.330999999998696,2962.7894736842104,25,20,16,45
230,-25.49949999999867,2718.0,19,14,14,33
231,-16.235999999995663,2189.0588235294117,43,9,23,52
232,-38.358499999994145,2480.4117647058824,50,13,23,63
233,-21.003999999997884,2997.1052631578946,26,7,29,33
234,-26.04499999999956,2062.222222222222,24,13,23,37
235,-34.83974999999792,3281.5,25,16,16,41
236,-31.51549999999733,1960.75,27,10,38,37
237,-19.786249999999065,1707.7222222222222,9,5,16,14
238,-29.59174999999857,2496.9444444444443,36,16,23,52
239,-23.301249999997296,2088.722222222222,28,6,21,34
240,-37.22574999999817,3486.25,22,15,22,37
241,-39.574499999999546,2394.0,8,20,13,28
242,-28.35799999999739,2355.294117647059,57,15,27,72
243,-31.208499999998054,2159.176470588235,23,15,19,38
244,-38.00199999999775,1589.6470588235295,7,9,27,16
245,-38.41749999999818,1759.4375,22,16,17,38
246,-19.10799999999731,2798.4210526315787,31,9,19,40
247,-38.79624999999784,3068.0,28,13,17,41
248,-33.892499999996616,1932.9375,24,15,22,39
249,-44.82299999999785,2950.5,19,18,17,37
250,-17.851249999999624,2516.3888888888887,33,14,26,47
251,-26.30799999999842,3227.5,23,7,18,30
252,-35.681749999996846,2999.7368421052633,37,13,19,50
253,-22.079749999997993,3180.6,22,8,12,30
254,-37.7374999999977,3467.15,32,10,19,42
255,-26.15099999999817,3159.25,16,12,30,28
256,-47.92249999999543,3308.7368421052633,33,13,21,46
257,-40.20099999999507,2875.4117647058824,44,7,28,51
258,-40.271499999999094,2256.05,7,16,17,23
259,-18.58724999999724,2753.5,32,17,25,49
260,-28.40874999999877,2236.0526315789475,15,10,21,25
261,-27.157249999996118,2303.9411764705883,33,9,36,42
262,-16.937249999999963,1790.3529411764705,20,10,18,30
263,-26.916249999997984,3004.9444444444443,54,7,25,61
264,-44.88299999999821,2950.222222222222,30,15,33,45
265,-35.118249999996536,2992.5,32,16,18,48
266,-37.635749999997884,2898.2,17,17,14,34
267,-47.96599999999755,3209.15,16,14,24,30
268,-39.777999999995515,2938.0588235294117,57,13,28,70
269,-33.917749999997326,3458.4,22,7,28,29
270,-15.107749999998626,3118.75,23,10,12,33
271,-37.08949999999886,2009.4444444444443,10,15,15,25
272,-29.505249999996238,2769.823529411765,48,6,40,54
273,-37.66224999999889,2716.4,15,13,21,28
274,-34.179749999997654,2341.235294117647,44,14,26,58
275,-38.16924999999779,2622.1111111111113,24,21,21,45
276,-30.562249999996265,4200.55,48,8,16,56
277,-17.3247499999975,2406.1666666666665,29,16,14,45
278,-22.05249999999815,2639.0588235294117,38,5,35,43
279,-39.16574999999966,1735.235294117647,18,14,17,32
280,-27.019499999999635,2277.0,10,13,8,23
281,-30.13024999999944,2267.842105263158,22,12,27,34
282,-31.213499999998692,3329.05,19,14,19,33
283,-42.139249999998476,1988.3529411764705,14,14,16,28
284,-41.09074999999649,3443.2105263157896,34,15,24,49
285,-25.013749999997565,3538.4736842105262,47,12,34,59
286,-27.355749999994533,1808.0625,52,7,23,59
287,-24.306249999996773,2901.6666666666665,41,11,25,52
288,-18.020499999998414,2887.1,18,3,19,21
289,-40.112499999997745,2494.2631578947367,19,13,15,32
290,-27.964249999997627,3907.7894736842104,46,12,34,58
291,-15.90199999999854,2372.65,12,10,19,22
292,-38.84224999999776,1769.8823529411766,17,16,23,33
293,-17.155749999999216,2409.2,13,13,6,26
294,-49.67574999999557,2261.8823529411766,44,10,24,54
295,-26.798749999997778,2774.722222222222,33,14,23,47
296,-16.46224999999881,2257.294117647059,34,14,12,48
297,-23.650749999997338,2596.6666666666665,28,14,10,42
298,-28.47224999999974,1429.0,24,13,25,37
299,-21.97549999999798,2131.235294117647,22,13,15,35
300,-25.811999999996818,1635.375,21,14,19,35
301,-34.108749999997336,4014.6315789473683,55,16,23,71
302,-7.711249999999184,2222.6666666666665,13,7,15,20
303,-14.779999999997997,2982.157894736842,28,14,20,42
304,-48.18299999999594,3744.8947368421054,37,15,27,52
305,-31.554250000000195,1429.0,20,18,21,38
306,-35.96049999999738,3741.8,32,20,22,52
307,-36.3069999999978,2957.277777777778,47,15,28,62
308,-24.749249999994554,3903.6315789473683,56,5,32,61
309,-30.741499999999224,1997.7058823529412,35,20,17,55
310,-13.820499999999123,2282.7894736842104,18,8,21,26
311,-29.772499999998082,2913.222222222222,33,21,26,54
312,-26.663749999998327,2608.1111111111113,40,17,24,57
313,-45.68649999999821,1694.1764705882354,19,17,15,36
314,-24.267249999998075,2139.5882352941176,24,12,21,36
315,-18.995499999999353,2227.1111111111113,21,14,20,35
316,-18.498750000000445,1679.0625,29,24,18,53
317,-41.76274999999665,2265.705882352941,28,9,23,37
318,-26.066999999998966,2160.176470588235,45,17,23,62
319,-23.868999999997477,3206.1,33,6,14,39
320,-27.267999999997464,2316.0588235294117,34,14,16,48
321,-41.961999999997616,3497.35,26,19,26,45
322,-14.220249999999101,2209.75,45,10,23,55
323,-47.07624999999947,2651.3333333333335,48,24,24,72
324,-28.280249999998563,3402.315789473684,46,18,18,64
325,-17.988499999997934,1612.5625,16,10,24,26
326,-38.437249999997434,2366.470588235294,23,14,29,37
327,-26.610249999997695,2272.842105263158,23,18,13,41
328,-24.6757499999991,2120.7894736842104,7,10,21,17
329,-13.907749999999396,2297.8947368421054,21,8,13,29
330,-28.985749999998585,3072.8,20,11,16,31
331,-37.913749999998416,2508.4,15,12,16,27
332,-33.71274999999745,2144.294117647059,19,10,15,29
333,-31.489999999997263,2432.764705882353,34,22,14,56
334,-41.8507499999986,2732.25,25,14,9,39
335,-19.433749999998078,2264.5263157894738,23,6,15,29
336,-27.738749999997793,2277.375,37,16,32,53
337,-32.775249999992795,2028.25,64,5,30,69
338,-30.203249999997972,3246.5,41,14,24,55
339,-30.007249999997555,3092.222222222222,38,16,14,54
340,-37.01199999999757,1429.0,14,15,12,29
341,-36.46999999999666,2904.4210526315787,30,15,19,45
342,-27.63924999999703,2457.277777777778,28,20,18,48
343,-17.985499999999664,2354.684210526316,24,7,30,31
344,-46.97624999999657,4307.894736842105,44,22,22,66
345,-32.478249999997956,3460.842105263158,43,7,23,50
346,-14.128999999998005,2455.7894736842104,21,14,9,35
347,-30.56974999999908,1550.0625,18,15,18,33
348,-22.10124999999703,2122.222222222222,29,7,22,36
349,-40.9502499999982,1791.3529411764705,12,17,23,29
350,-17.58674999999625,2023.3125,36,13,27,49
351,-29.58499999999766,3190.1052631578946,23,15,21,38
352,-26.629749999999326,1429.0,37,20,13,57
353,-30.005249999998334,1711.0588235294117,18,13,17,31
354,-28.74474999999773,2239.4444444444443,27,18,12,45
355,-26.338749999998537,2674.684210526316,23,17,10,40
356,-28.955249999998397,3040.1666666666665,27,16,20,43
357,-42.044499999995736,2969.722222222222,29,9,33,38
358,-24.72874999999662,4191.0,45,13,16,58
359,-10.946499999998457,2884.4210526315787,17,8,22,25
360,-27.020499999999117,2871.0,44,23,14,67
361,-39.23424999999902,2820.842105263158,28,18,19,46
362,-32.49274999999918,2834.2631578947367,33,19,31,52
363,-30.867249999998716,3245.315789473684,51,14,23,65
364,-34.63274999999774,3362.0555555555557,49,16,26,65
365,-42.065499999998686,1904.3529411764705,31,14,25,45
366,-30.86850000000025,1713.0526315789473,16,13,25,29
367,-23.140749999999635,1639.3125,7,14,12,21
368,-16.26825000000078,1429.0,12,10,16,22
369,-39.740249999997594,3409.6666666666665,47,14,21,61
370,-22.84424999999704,3094.0,51,19,22,70
371,-30.28349999999715,3135.4444444444443,38,20,13,58
372,-30.643499999993804,1662.25,51,15,32,66
373,-32.69599999999857,2639.6315789473683,21,16,14,37
374,-27.575499999996275,2191.8888888888887,38,10,18,48
375,-31.88349999999903,2133.315789473684,14,16,5,30
376,-33.33324999999545,1608.625,36,16,23,52
377,-22.720999999998654,2377.2105263157896,13,12,17,25
378,-31.265749999999542,2147.722222222222,19,9,22,28
379,-32.769999999996365,3395.684210526316,41,20,16,61
380,-33.18299999999633,3623.9444444444443,50,9,51,59
381,-21.73949999999856,2687.0,18,13,13,31
382,-26.38224999999713,2028.5294117647059,40,6,19,46
383,-39.521999999998506,1429.0,0,12,30,12
384,-23.319249999998483,1735.625,25,16,21,41
385,-9.34524999999635,2911.4444444444443,43,15,19,58
386,-17.972000000000087,2119.5,35,28,17,63
387,-21.218749999998078,2810.0555555555557,46,18,14,64
388,-38.023499999998606,2608.9444444444443,21,27,10,48
389,-36.72474999999726,1778.1875,27,18,14,45
390,-25.132249999997764,3478.3684210526317,61,17,14,78
391,-35.121999999995815,2287.235294117647,27,12,34,39
392,-19.66424999999801,1707.2941176470588,12,17,13,29
393,-19.160000000000586,1429.0,16,13,22,29
394,-31.721499999999025,2623.684210526316,15,21,9,36
395,-36.16399999999565,2051.823529411765,28,16,32,44
396,-34.63724999999762,3116.0555555555557,59,12,25,71
397,-14.603249999998283,3611.6,32,22,12,54
398,-25.597499999999254,1621.5625,13,10,17,23
399,-28.38924999999921,2771.6315789473683,31,10,19,41
400,-21.637749999999656,2247.4444444444443,36,20,21,56
401,-20.57124999999927,1796.1875,13,11,5,24
402,-24.97499999999739,3191.0,27,17,17,44
403,-26.37674999999887,2644.9,19,25,7,44
404,-34.09724999999692,2968.684210526316,38,10,17,48
405,-36.18899999999672,2207.6666666666665,28,13,21,41
406,-30.56874999999699,3437.85,31,15,18,46
407,-27.209249999997404,3243.1111111111113,57,15,20,72
408,-22.061999999997646,3060.5,52,6,27,58
409,-19.575249999998924,3121.85,16,20,8,36
410,-25.07699999999792,3048.9444444444443,38,18,7,56
411,-14.0067499999993,1862.625,29,7,20,36
412,-27.516999999997857,2861.7894736842104,27,26,4,53
413,-36.61449999999685,3815.6,41,23,12,64
414,-42.719249999997366,2826.7894736842104,23,18,17,41
415,-15.792999999998107,2080.823529411765,31,10,11,41
416,-25.94724999999832,3049.8947368421054,44,14,12,58
417,-28.579999999997284,3163.6666666666665,54,18,18,72
418,-28.153249999996667,3883.85,48,13,17,61
419,-1.172499999997626,3676.8,46,8,8,54
420,-19.866749999999218,1429.0,7,18,10,25
421,-29.22449999999943,2576.157894736842,26,8,25,34
422,-33.619499999997394,3060.5,45,13,22,58
423,-34.95149999999982,1429.0,10,18,10,28
424,-21.70649999999842,1701.8125,35,19,10,54
425,-33.56024999999859,1719.75,20,21,10,41
426,-17.52249999999673,2245.176470588235,38,13,22,51
427,-14.533249999997338,2343.842105263158,26,10,14,36
428,-16.4344999999981,2558.5789473684213,32,15,7,47
429,-30.328499999993817,2232.0588235294117,59,12,23,71
430,-43.13649999999684,1898.3125,39,26,13,65
431,-45.75074999999803,3657.1052631578946,42,32,10,74
432,-31.883999999996085,3328.842105263158,52,12,9,64
433,-21.90199999999704,3123.8888888888887,45,13,19,58
434,-17.6559999999984,2937.0,44,15,11,59
435,-29.690249999998834,2319.705882352941,40,24,12,64
436,-29.42549999999911,2571.8888888888887,23,22,13,45
437,-41.367249999998435,2432.5,32,21,6,53
438,-6.259999999996659,2001.5625,38,6,18,44
439,-24.413500000000706,1429.0,9,12,17,21
440,-29.72824999999805,3207.684210526316,49,17,14,66
441,-39.196249999999466,2374.7894736842104,14,22,12,36
442,-28.881999999998754,1690.4705882352941,11,18,9,29
443,-29.746499999994274,3085.470588235294,63,18,21,81
444,-23.920749999999213,2308.45,13,14,9,27
445,-43.423249999997736,4773.5,38,30,10,68
446,-3.960499999998511,3328.0526315789475,67,13,15,80
447,-10.53674999999965,2084.470588235294,46,13,14,59
448,-26.857999999995428,2110.6470588235293,50,13,16,63
449,-27.35525000000006,1429.0,12,22,9,34
450,-25.12474999999881,2666.315789473684,22,15,15,37
451,-28.23899999999881,2038.4444444444443,21,20,13,41
452,-13.840999999997928,2090.5,29,11,8,40
453,-38.01449999999815,3290.3684210526317,46,27,26,73
454,-44.51624999999758,3595.75,29,8,17,37
455,-3.2634999999991123,2508.45,30,10,6,40
456,-9.506249999997282,3846.7894736842104,50,9,18,59
457,-26.510249999997303,2857.5263157894738,31,11,15,42
458,-21.265249999998385,3020.5263157894738,33,13,10,46
459,-32.54974999999889,3040.222222222222,44,23,25,67
460,-35.29549999999942,2413.1052631578946,21,19,6,40
461,-17.118999999997484,3200.2631578947367,40,9,21,49
462,-16.589749999994584,2510.3529411764707,60,17,15,77
463,-18.05774999999861,2266.8888888888887,39,12,10,51
464,-49.0109999999966,1875.4117647058824,26,9,33,35
465,-15.448999999998353,3407.6,25,18,11,43
466,-27.81549999999944,2094.15,17,13,8,30
467,-35.028499999998886,2297.9473684210525,14,20,8,34
468,-18.643749999999446,2354.7368421052633,31,15,10,46
469,-36.8054999999971,2369.9444444444443,22,10,25,32
470,-20.7634999999993,2125.842105263158,13,13,8,26
471,-26.172499999996944,3377.315789473684,35,14,21,49
472,-14.462249999997036,2759.777777777778,41,17,14,58
473,-19.662749999999598,2519.2105263157896,11,21,1,32
474,-27.932999999995474,2874.3888888888887,46,21,20,67
475,-53.18749999999784,3617.0,41,23,15,64
476,-19.375499999998294,2114.1052631578946,25,10,12,35
477,-25.639999999997322,2240.4117647058824,29,18,20,47
478,-40.37824999999789,2777.2631578947367,26,17,12,43
479,-25.611499999998067,2740.2,26,16,10,42
480,-16.041749999999848,2210.529411764706,40,20,14,60
481,-34.74674999999989,1514.375,19,15,24,34
482,-7.837499999997175,1583.8125,34,11,10,45
483,-14.010499999998563,2734.0,22,19,9,41
484,-28.341749999998996,2059.294117647059,37,28,15,65
485,-19.140749999998476,3544.15,40,25,5,65
486,-42.65924999999847,2930.3684210526317,36,20,7,56
487,-32.506749999999776,2254.5,26,30,13,56
488,-4.924249999998497,3587.722222222222,64,28,11,92
489,-13.700249999998096,1769.8823529411766,38,13,24,51
490,-18.520249999998295,1790.125,33,17,7,50
491,-15.890249999997184,2072.8888888888887,27,10,29,37
492,-30.23499999999808,3312.35,36,14,8,50
493,-22.104999999994472,3384.842105263158,41,7,30,48
494,-15.900249999998703,1520.0666666666666,48,15,17,63
495,-8.48174999999903,2651.222222222222,37,16,10,53
496,-19.047499999997047,3676.315789473684,45,12,16,57
497,-29.15474999999775,2164.9411764705883,52,25,5,77
498,-19.303499999999282,1992.0588235294117,15,16,2,31
499,-23.15249999999899,2683.1111111111113,33,12,20,45
500,-10.169249999994914,2741.0,63,5,17,68
501,-31.112249999998415,3293.6315789473683,55,17,16,72
502,-29.897249999997207,3213.5263157894738,31,23,11,54
503,-20.472249999997562,2076.9375,47,14,19,61
504,-22.077499999996846,3490.0526315789475,43,14,23,57
505,-12.085749999998399,1817.875,34,19,21,53
506,-24.402749999999656,2230.6666666666665,39,23,7,62
507,-24.236749999998036,2656.2631578947367,26,27,6,53
508,-31.652999999996858,1652.235294117647,27,16,14,43
509,-16.254499999997893,2893.25,33,11,11,44
510,-29.254249999999967,2032.1666666666667,11,24,27,35
511,-26.734749999998268,2623.55,22,15,11,37
512,-7.78549999999737,2139.375,41,2,19,43
513,-25.512499999998994,2089.3529411764707,42,15,26,57
514,-19.287000000000386,1429.0,5,11,10,16
515,-31.312499999999716,1750.4375,29,15,35,44
516,-28.27374999999766,2978.0,32,12,9,44
517,-26.986749999998686,3360.5263157894738,52,23,7,75
518,-34.65124999999926,2746.4736842105262,29,13,32,42
519,-29.994249999997457,1898.25,29,15,24,44
520,-36.23649999999894,2072.3529411764707,30,20,26,50
521,-32.04224999999856,3992.55,35,22,7,57
522,-14.523249999999043,3170.157894736842,41,7,23,48
523,-48.09899999999798,3246.157894736842,35,22,20,57
524,-32.89774999999817,2889.3888888888887,40,20,10,60
525,-42.016249999996774,4066.5263157894738,49,25,12,74
526,-25.197749999997868,1853.625,35,18,17,53
527,-38.306749999995574,3111.6111111111113,44,19,12,63
528,-23.92899999999704,2112.529411764706,33,20,9,53
529,-39.33849999999761,3780.65,34,26,8,60
530,-29.966499999998053,2064.0,29,20,12,49
531,-34.645249999996224,2610.3529411764707,44,19,22,63
532,-21.497999999997482,3291.65,37,12,8,49
533,-18.01450000000051,1714.75,33,15,10,48
534,-20.13924999999634,5152.9,66,15,24,81
535,-30.267749999999428,2307.1052631578946,20,21,11,41
536,-12.704249999995266,2318.777777777778,47,9,28,56
537,-23.421499999998225,3587.722222222222,55,25,10,80
538,-29.446249999998514,2568.05,31,12,8,43
539,-31.847249999996848,3005.5789473684213,48,16,13,64
540,-18.301249999996838,4124.45,56,17,6,73
541,-24.72574999999883,2433.5555555555557,31,21,20,52
542,-26.130249999997936,1765.1764705882354,20,22,9,42
543,-36.973999999996764,2487.625,57,18,8,75
544,-8.086499999998566,2160.1111111111113,21,3,14,24
545,-34.55899999999711,3121.5789473684213,40,13,10,53
546,-17.932749999998347,2828.5,44,12,13,56
547,-42.75874999999524,2755.5625,73,22,25,95
548,-11.448749999996823,1429.0,39,18,15,57
549,-19.148249999997738,3537.1,44,17,13,61
550,-25.24724999999683,2333.823529411765,36,20,19,56
551,-28.18374999999625,2202.3888888888887,38,20,19,58
552,-22.283750000000044,1702.6470588235295,22,13,20,35
553,-25.845500000000037,1660.5882352941176,28,19,10,47
554,-39.7692499999963,2791.5555555555557,43,16,23,59
555,-9.704749999998656,1676.0,22,10,6,32
556,-16.773749999999332,1926.157894736842,11,10,8,21
557,-35.130750000000106,1723.1764705882354,19,22,17,41
558,-30.49174999999891,2339.75,44,20,21,64
559,-10.755749999997574,3144.2631578947367,32,13,15,45
560,-31.223999999996817,3054.0,39,17,16,56
561,-20.758999999998746,2738.5555555555557,32,18,10,50
562,-29.265999999998268,2857.5263157894738,50,14,11,64
563,-18.246499999996225,2661.8333333333335,47,15,14,62
564,-19.556499999997623,2190.0588235294117,37,16,12,53
565,5.414000000004966,3398.222222222222,82,4,18,86
566,-30.555499999997142,1937.9444444444443,28,14,22,42
567,-15.029000000000377,1429.0,27,20,19,47
568,-0.863999999994828,1983.625,62,5,20,67
569,-32.26799999999824,2036.25,33,28,10,61
570,-20.397749999997757,3170.1052631578946,23,10,20,33
571,-7.9534999999983595,1528.25,19,13,10,32
572,-29.069499999999078,1429.0,9,14,8,23
573,-22.35849999999819,3561.0526315789475,50,19,8,69
574,-13.95724999999778,2747.315789473684,20,15,19,35
575,-30.03499999999737,2194.6470588235293,38,21,6,59
576,-39.656499999996676,1644.375,31,13,21,44
577,-11.954499999999879,1711.0588235294117,35,10,10,45
578,-26.126999999998986,3024.684210526316,48,18,19,66
579,-15.730749999997638,2143.4117647058824,31,21,6,52
580,-27.318499999997794,1559.0,21,14,10,35
581,-18.507749999997962,2232.0,45,15,14,60
582,-8.803749999998397,1707.3529411764705,21,12,7,33
583,-31.275249999998294,2952.1052631578946,36,10,24,46
584,-16.17474999999795,3576.1052631578946,55,16,24,71
585,-34.02474999999887,1988.5294117647059,28,21,15,49
586,-22.50199999999939,2168.529411764706,32,11,24,43
587,-32.117499999995964,4914.8,67,20,7,87
588,-32.87399999999804,2763.2631578947367,37,18,4,55
589,-23.946249999998738,2336.764705882353,23,20,12,43
590,-31.14074999999726,2050.125,59,15,28,74
591,-44.23824999999767,2952.1052631578946,35,20,9,55
592,-10.237499999998327,3259.4736842105262,50,14,14,64
593,-23.136499999997632,3401.6315789473683,48,16,15,64
594,-18.44250000000014,2290.4210526315787,27,9,18,36
595,-32.3064999999974,2811.7368421052633,32,21,7,53
596,-8.628999999998552,2393.157894736842,30,16,5,46
597,-23.61899999999385,1938.0,68,4,27,72
598,-21.48549999999696,4049.7368421052633,57,23,17,80
599,-16.170999999999957,1429.0,0,18,1,18
600,-37.719499999995584,2891.1666666666665,65,15,4,80
601,-22.363749999998138,2566.9473684210525,25,17,10,42
602,-8.575749999996708,2340.294117647059,45,14,25,59
603,-19.770999999997713,3444.15,34,22,9,56
604,-24.70099999999758,2442.176470588235,44,11,20,55
605,-17.98949999999738,2112.5,31,17,9,48
606,-23.37324999999796,1510.5333333333333,37,21,4,58
607,-30.860249999999535,1429.0,9,18,2,27
608,-37.30424999999608,2753.2105263157896,39,14,13,53
609,-39.27999999999824,2744.8333333333335,44,24,9,68
610,-18.920749999998506,2159.2105263157896,21,20,4,41
611,-26.35474999999886,2101.1111111111113,17,14,18,31
612,-32.358249999997305,2295.529411764706,36,11,16,47
613,-25.528749999997718,3231.1052631578946,35,22,7,57
614,-20.993249999997428,3154.157894736842,45,10,12,55
615,7.732250000002942,2802.8888888888887,49,11,13,60
616,-20.49849999999868,1481.9333333333334,46,21,14,67
617,-37.36974999999714,4034.7368421052633,68,18,17,86
618,-33.44074999999815,3888.5789473684213,49,28,9,77
619,-27.67374999999845,1429.0,16,19,7,35
620,-25.722249999996222,3033.1111111111113,48,12,18,60
621,-32.24374999999503,4665.473684210527,75,16,8,91
622,-39.41949999999797,3817.9444444444443,59,31,16,90
623,-13.44074999999653,2959.1666666666665,60,16,9,76
624,-26.560749999998205,3186.0,50,19,14,69
625,-24.91774999999836,2537.6315789473683,24,17,5,41
626,-15.975249999999042,2143.3529411764707,38,15,8,53
627,-30.396499999997825,2509.3529411764707,55,18,23,73
628,-5.939999999993878,5664.8,88,9,16,97
629,-12.376999999998889,2987.222222222222,50,15,12,65
630,-18.704749999999358,1528.25,13,12,10,25
631,-25.06599999999848,2647.6470588235293,49,30,5,79
632,-18.65424999999764,2708.5555555555557,48,16,11,64
633,-23.45174999999725,2846.1666666666665,37,29,8,66
634,-27.769749999999583,1675.125,21,19,7,40
635,-10.115749999999982,1429.0,0,17,0,17
636,-24.295999999998916,2129.2105263157896,16,25,3,41
637,-35.42974999999955,2060.4444444444443,35,20,17,55
638,-24.845499999998008,2383.8947368421054,26,26,9,52
639,-21.775499999998544,3064.7894736842104,50,17,14,67
640,-26.55749999999794,3192.5789473684213,43,13,10,56
641,-12.345249999994158,2060.235294117647,63,12,26,75
642,-7.9799999999975295,1954.7058823529412,37,10,15,47
643,-14.531749999999581,1846.1666666666667,11,19,3,30
644,-14.547999999996268,3903.7,60,15,7,75
645,-45.36099999999631,3890.2631578947367,50,25,1,75
646,-24.56124999999719,2318.9411764705883,34,23,13,57
647,-17.077999999998035,3764.4666666666667,40,13,7,53
648,-37.44299999999679,4108.4,43,21,12,64
649,-20.575749999998404,1528.25,17,12,13,29
650,-15.286499999996057,3104.5555555555557,47,15,23,62
651,-14.783249999997775,3108.6,39,19,7,58
652,-20.884499999998866,2928.222222222222,58,15,17,73
653,-35.563999999996874,4236.25,52,21,6,73
654,-22.933749999997975,3148.25,39,16,11,55
655,-6.358999999995616,2605.3888888888887,59,15,14,74
656,-7.700499999998721,2201.5,42,11,18,53
657,-25.034249999999748,1765.1176470588234,29,30,7,59
658,-23.47149999999902,2523.5263157894738,29,15,7,44
659,-13.072749999997038,2786.705882352941,61,16,15,77
660,-14.32574999999938,2557.7368421052633,39,12,11,51
661,-34.85849999999754,3388.157894736842,60,17,11,77
662,-18.89799999999829,2112.625,39,14,13,53
663,-44.9832499999968,3972.0,46,24,6,70
664,-25.720749999995427,1572.9375,55,16,9,71
665,-36.70999999999928,1623.2941176470588,9,16,6,25
666,-8.616499999996602,3382.5,76,19,11,95
667,-17.37349999999618,3687.05,47,14,12,61
668,-23.006999999998932,1438.5333333333333,13,19,10,32
669,-25.964999999998394,2915.9444444444443,36,19,14,55
670,-14.39024999999676,3734.0,56,15,16,71
671,-27.099749999998636,2764.1052631578946,58,16,9,74
672,-19.315499999998764,2365.55,16,18,13,34
673,-27.997749999998213,2507.6315789473683,29,20,6,49
674,-27.21924999999856,3032.222222222222,47,23,15,70
675,-43.19124999999836,2433.3888888888887,30,12,46,42
676,-29.715249999999337,1806.4444444444443,12,15,12,27
677,-16.0824999999999,2143.294117647059,49,17,15,66
678,-5.477499999996378,3572.7894736842104,57,14,9,71
679,-4.6197499999987155,2422.7,22,16,6,38
680,-15.189249999996317,3884.3684210526317,55,20,14,75
681,-16.700999999996284,2715.75,65,11,15,76
682,-16.192749999998135,1751.4375,35,18,9,53
683,-8.809499999999286,2552.85,14,12,0,26
684,-20.88999999999882,2276.6111111111113,31,17,10,48
685,-32.10174999999877,1691.888888888889,12,16,9,28
686,-19.630749999999203,2630.705882352941,70,31,5,101
687,-29.87924999999719,3483.3684210526317,46,27,8,73
688,-9.211249999998651,2796.45,29,14,3,43
689,-10.260499999999878,1429.0,24,13,6,37
690,-40.246999999998,1481.9333333333334,25,24,14,49
691,-22.529499999998656,1621.5,23,22,8,45
692,-21.900999999997016,3374.5,45,26,17,71
693,-10.36974999999712,3795.7894736842104,58,20,11,78
694,-23.030999999998453,3683.0,65,26,10,91
695,-25.195249999999582,2317.9444444444443,48,23,6,71
696,-24.685249999999815,2057.2631578947367,14,15,20,29
697,-14.214499999998347,2316.176470588235,40,18,6,58
698,-37.924249999999574,1429.0,5,25,4,30
699,-25.81199999999876,2485.842105263158,23,17,11,40
700,-39.098999999999705,1545.0625,24,28,5,52
701,-31.23049999999926,1429.0,19,24,4,43
702,-22.789499999997417,3861.8947368421054,60,14,8,74
703,-27.781249999999083,1429.0,41,23,7,64
704,-17.267249999999414,2129.85,16,16,7,32
705,-16.052749999998362,3310.0555555555557,65,24,9,89
706,-22.80474999999816,3137.7,43,15,2,58
707,-32.41999999999756,2602.722222222222,44,24,4,68
708,-23.812999999997665,2821.0625,61,16,12,77
709,-14.847499999999389,2038.9473684210527,16,16,7,32
710,-15.869749999997442,3293.6315789473683,44,22,7,66
711,-21.968499999998727,2840.0526315789475,48,18,10,66
712,-19.19849999999871,2227.1111111111113,43,21,15,64
713,-7.143999999998909,1795.0625,55,17,10,72
714,-5.271499999995976,1706.8125,53,15,9,68
715,-22.038249999998904,2235.764705882353,46,29,17,75
716,-32.40774999999831,3714.7368421052633,52,32,9,84
717,-23.983749999998576,3040.1666666666665,46,25,4,71
718,-30.243999999998728,2997.1052631578946,29,36,2,65
719,-19.44949999999792,3244.3,42,6,12,48
720,-18.994499999997707,3348.15,49,12,9,61
721,-22.718249999998935,2651.2631578947367,35,24,8,59
722,-38.177249999998516,2768.75,16,22,1,38
723,-15.895249999998398,2884.4210526315787,33,18,10,51
724,-23.50674999999905,2166.7368421052633,9,22,8,31
725,-24.469999999998887,2384.7894736842104,16,16,5,32
726,-17.81224999999862,2393.9444444444443,29,14,9,43
727,-25.54324999999909,1621.5,13,19,6,32
728,-23.4579999999981,2338.277777777778,35,19,5,54
729,-13.587749999996063,2481.1111111111113,54,12,17,66
730,-22.525499999997763,3008.0,41,11,14,52
731,-21.784749999999963,1429.0,1,20,5,21
732,-6.698499999997961,2593.470588235294,53,11,21,64
733,-34.10574999999704,3040.1666666666665,48,15,12,63
734,-19.80624999999714,3902.9,48,21,4,69
735,-29.303499999996397,2777.3529411764707,45,23,7,68
736,-27.101749999998923,2210.529411764706,26,24,6,50
737,-20.459749999997634,3455.7368421052633,47,14,16,61
738,-19.57049999999718,3520.9473684210525,53,14,8,67
739,-30.159749999998162,2825.8888888888887,42,23,10,65
740,-28.86474999999727,3376.1666666666665,45,32,8,77
741,-21.7829999999963,2971.6470588235293,71,22,16,93
742,-11.58324999999919,1688.0,44,16,15,60
743,-29.291499999999644,1652.1764705882354,16,17,23,33
744,-17.06649999999752,4612.4,55,23,7,78
745,-0.4487499999996169,2311.3529411764707,65,28,11,93
746,-18.575749999998408,2588.764705882353,43,18,10,61
747,-20.431749999998896,2042.4705882352941,32,22,9,54
748,-31.87824999999699,2652.1176470588234,56,18,12,74
749,-18.92374999999779,2240.4117647058824,45,20,14,65
750,-16.66849999999905,2749.7,24,9,12,33
751,-23.254249999996674,2825.0588235294117,50,11,17,61
752,-16.328249999997155,2117.625,52,14,6,66
753,-18.777999999996183,3926.2105263157896,58,28,3,86
754,-14.99049999999941,2092.222222222222,34,20,11,54
755,-21.559249999997412,2087.3529411764707,28,12,19,40
756,-5.203749999997159,1528.25,28,5,20,33
757,-33.09074999999858,2825.85,29,19,0,48
758,-21.614999999997554,3794.1111111111113,62,36,7,98
759,-29.45699999999647,3094.842105263158,34,22,29,56
760,-5.3679999999955275,2799.764705882353,67,14,13,81
761,-7.341499999997683,2756.4375,77,20,12,97
762,-6.205749999995918,2706.4117647058824,67,14,17,81
763,-50.03399999999899,2219.1666666666665,26,18,32,44
764,-44.8432499999955,5185.5,72,16,18,88
765,-24.795749999998115,2677.8333333333335,32,13,21,45
766,-10.106999999998251,3689.45,47,19,3,66
767,-15.407999999999188,2536.0526315789475,29,9,7,38
768,-17.85974999999928,3054.0,23,19,12,42
769,-15.785999999996784,2152.705882352941,50,12,11,62
770,-14.154499999996997,4140.0,80,23,11,103
771,-12.875249999998044,2450.222222222222,41,18,5,59
772,-21.7647499999988,2251.0555555555557,23,16,13,39
773,-11.398999999998772,1753.9411764705883,18,20,3,38
774,-23.100749999996058,2466.1111111111113,52,18,21,70
775,-15.685499999997086,2600.1111111111113,44,14,11,58
776,-24.87274999999688,3982.1052631578946,69,29,19,98
777,-19.6399999999979,2996.9444444444443,58,18,7,76
778,-16.79149999999853,2593.6315789473683,33,17,7,50
779,-14.540999999999608,2044.5555555555557,43,27,7,70
780,-19.10424999999945,1934.1764705882354,10,22,6,32
781,-25.676249999998483,2290.6111111111113,35,17,6,52
782,-19.666499999997516,2603.6666666666665,38,16,8,54
783,-22.63649999999714,3289.5789473684213,41,17,19,58
784,0.43775000000001985,3024.3888888888887,68,31,13,99
785,-10.698749999998844,2433.5,45,12,18,57
786,-43.97874999999751,2799.2105263157896,32,16,14,48
787,-5.926749999998106,3676.4210526315787,58,17,6,75
788,-0.15524999999631017,5484.65,82,22,6,104
789,-19.209249999998995,2210.529411764706,35,22,4,57
790,-22.340499999998663,3185.157894736842,35,24,9,59
791,-6.041999999999482,2293.684210526316,15,12,5,27
792,-30.755999999999922,1429.0,0,17,12,17
793,-21.054499999997763,3540.15,39,18,15,57
794,-38.19374999999825,3242.7894736842104,34,19,5,53
795,-5.900499999997419,2593.4117647058824,59,9,20,68
796,-20.630499999997912,3901.0,52,20,6,72
797,-14.199499999999688,1429.0,33,12,23,45
798,-14.456749999996546,2278.764705882353,36,16,22,52
799,-10.268749999997318,2895.9411764705883,76,19,11,95
800,-9.327249999999392,3003.8947368421054,43,20,11,63
801,-19.76349999999772,3656.1,44,23,5,67
802,-15.18374999999808,2957.3333333333335,48,15,8,63
803,-4.740499999996905,2875.3333333333335,59,11,16,70
804,-25.947499999998378,2901.722222222222,47,14,9,61
805,-11.08724999999898,2673.842105263158,40,16,8,56
806,-1.9797499999969452,4056.15,71,16,4,87
807,-13.403499999999203,3210.9473684210525,43,16,18,59
808,-19.39624999999681,3846.7894736842104,63,22,14,85
809,-7.754749999999733,2125.0,30,16,7,46
810,-10.300749999997098,4213.15,52,24,17,76
811,1.0750000000029458,4707.6,67,27,7,94
812,-33.12599999999838,2657.2631578947367,25,22,6,47
813,-36.90024999999991,2167.0555555555557,26,33,4,59
814,-33.65400000000009,2382.3684210526317,29,15,18,44
815,-18.37624999999779,2542.7368421052633,32,15,10,47
816,-21.31749999999854,3733.157894736842,52,29,19,81
817,-19.730749999998757,2315.6,22,19,2,41
818,-23.08849999999905,1929.0625,38,28,1,66
819,-11.310499999999339,2907.0,38,19,12,57
820,-25.165249999998917,2264.4736842105262,22,16,11,38
821,-6.929749999999002,2631.9444444444443,47,20,22,67
822,-9.511249999998583,2867.7368421052633,35,20,3,55
823,-17.569249999998952,2786.222222222222,34,18,7,52
824,-23.118999999996664,2274.1176470588234,59,13,10,72
825,-12.63524999999999,1429.0,0,11,2,11
826,-11.704249999999657,2598.6315789473683,45,7,13,52
827,-27.50624999999902,1684.0,36,20,20,56
828,-21.771749999998462,3393.4,39,17,8,56
829,-34.50449999999946,2361.6,9,21,11,30
830,-6.149499999998683,2580.3529411764707,50,12,9,62
831,-21.6717499999964,3279.1666666666665,61,13,7,74
832,-22.587499999995945,2367.6875,57,13,17,70
833,-27.96399999999967,1500.4375,52,21,9,73
834,-23.184999999998677,1496.5,30,13,11,43
835,-24.360249999997972,2193.823529411765,32,19,7,51
836,2.956250000001409,3425.684210526316,63,22,11,85
837,-9.953499999995994,2456.3888888888887,70,18,7,88
838,-1.5074999999985543,2538.294117647059,59,17,4,76
839,-33.05574999999644,2514.0588235294117,58,11,13,69
840,-13.868749999998439,2671.6111111111113,48,10,15,58
841,-24.408749999996957,1800.125,54,17,10,71
842,-18.303499999999097,1429.0,12,9,6,21
843,-21.014249999999418,2331.5,12,12,11,24
844,-33.02049999999735,2660.6470588235293,60,29,10,89
845,-26.50224999999971,2358.0526315789475,27,12,19,39
846,-12.840999999998644,2158.235294117647,35,17,7,52
847,-15.36174999999805,3445.7,43,10,7,53
848,-17.72524999999898,2437.8888888888887,27,26,7,53
849,-35.007249999998365,1626.5,19,25,11,44
850,-19.17249999999869,2339.9444444444443,34,21,10,55
851,-19.969749999999085,2030.4117647058824,29,13,18,42
852,-17.346749999997137,4151.3,58,10,7,68
853,-29.168499999998822,1746.5,48,11,17,59
854,-19.163999999999213,2306.823529411765,39,18,13,57
855,-13.809749999998393,3023.1052631578946,42,8,13,50
856,-19.983499999998475,1476.6,29,16,12,45
857,-10.718499999998375,2644.2,37,15,4,52
858,1.3667500000020225,3968.7894736842104,64,12,21,76
859,-32.804249999998234,3335.5263157894738,45,24,16,69
860,-6.0764999999983775,2460.75,74,19,10,93
861,-37.043249999996625,2477.6666666666665,29,17,25,46
862,-21.20749999999719,2593.9444444444443,40,19,13,59
863,-16.08325,1429.0,0,22,0,22
864,-31.969749999997457,2085.6875,46,22,15,68
865,-26.452249999995463,2169.5882352941176,63,14,16,77
866,-12.117999999999313,2297.8947368421054,20,16,7,36
867,-18.521999999997366,3456.5263157894738,50,15,9,65
868,-16.51949999999893,2063.0555555555557,26,20,3,46
869,-10.115749999998668,1612.625,55,16,5,71
870,-15.785749999996899,2501.4444444444443,35,18,16,53
871,-45.3134999999963,2557.7368421052633,25,18,31,43
872,-28.22649999999907,1828.7058823529412,24,25,6,49
873,-8.577499999998352,3780.55,36,23,6,59
874,-18.0759999999987,2967.1052631578946,48,21,16,69
875,-16.279749999998085,2890.2631578947367,46,12,4,58
876,-2.714999999998212,3425.7894736842104,70,16,10,86
877,-13.342749999996494,1599.6875,60,12,4,72
878,-28.22124999999864,3226.8947368421054,58,17,10,75
879,-29.87899999999969,2466.6315789473683,41,19,19,60
880,-22.213749999997624,3470.842105263158,54,19,13,73
881,-14.794249999998078,3040.25,43,15,6,58
882,-20.555999999998534,3072.0,59,17,4,76
883,2.074250000001549,2143.4117647058824,36,13,6,49
884,-19.960499999999396,2771.6315789473683,40,15,13,55
885,-31.44924999999812,2866.5,41,18,15,59
886,-27.618249999996358,1581.8125,44,15,13,59
887,-30.479499999997994,3522.75,40,15,2,55
888,-11.656499999998795,2681.176470588235,50,25,4,75
889,-7.716749999998325,2429.8947368421054,29,10,15,39
890,-5.246749999996631,2889.3888888888887,65,13,17,78
891,-9.006249999996346,1892.3125,55,21,11,76
892,-12.855749999996362,2429.125,61,13,9,74
893,-5.091749999998202,3139.8333333333335,66,7,24,73
894,2.1132500000019876,4376.473684210527,82,19,11,101
895,-11.639999999997805,1481.9333333333334,50,15,3,65
896,10.912500000001318,3300.4736842105262,56,17,6,73
897,-27.538499999999072,2582.4,29,21,5,50
898,-13.962749999998076,2263.222222222222,32,13,12,45
899,-11.282749999998073,2876.0526315789475,39,13,12,52
900,-11.952999999996672,2755.4375,84,12,12,96
901,-45.10899999999511,5079.0,63,26,6,89
902,-21.491249999998523,2516.35,32,18,6,50
903,-8.263999999997866,3169.3684210526317,50,11,10,61
904,-31.131999999997333,3176.9411764705883,78,39,4,117
905,-28.203999999996455,2309.5789473684213,13,19,32,32
906,3.354250000001725,1583.8125,32,7,7,39
907,-30.380749999998407,3111.75,39,12,11,51
908,-23.987499999997542,1481.9333333333334,34,25,15,59
909,-23.298999999997562,2018.235294117647,20,15,24,35
910,-10.855749999996767,3347.2631578947367,48,19,19,67
911,-22.224249999998356,2094.6875,52,17,15,69
912,-10.422499999998218,3571.1,47,19,5,66
913,-12.194749999997239,4388.6,66,18,9,84
914,-5.207749999999001,3202.85,35,15,7,50
915,-10.760499999997728,4303.55,60,21,13,81
916,-34.00424999999811,2592.0,27,22,9,49
917,-12.150499999997834,3911.6,56,20,4,76
918,-13.421999999998201,2757.3684210526317,31,15,18,46
919,-8.552999999997883,3040.222222222222,55,11,4,66
920,-12.200249999996585,4509.2,67,12,7,79
921,-19.020999999999567,1778.235294117647,38,19,9,57
922,-28.45374999999958,2711.4210526315787,35,17,15,52
923,-17.138749999996868,3328.0,56,16,9,72
924,-8.403499999998948,2401.722222222222,36,7,11,43
925,-4.041249999998292,3166.7894736842104,49,13,10,62
926,4.717000000001534,3177.6315789473683,56,8,12,64
927,-22.634249999999337,2106.6315789473683,12,26,3,38
928,-11.24299999999667,2380.470588235294,49,10,15,59
929,-16.526749999997953,3598.684210526316,51,19,9,70
930,-6.975999999998083,2080.75,54,14,4,68
931,-20.453499999996644,2630.705882352941,51,12,22,63
932,-30.349249999996783,1599.6875,34,19,23,53
933,-20.48074999999859,2226.842105263158,28,11,8,39
934,-15.0327499999979,2175.9444444444443,39,8,14,47
935,-26.469499999998277,3177.9444444444443,45,18,19,63
936,-2.5482499999971013,2430.0,50,17,13,67
937,-11.273749999994932,1534.8666666666666,80,17,11,97
938,-26.244249999998022,2088.6666666666665,16,19,20,35
939,-23.159999999996124,2758.8333333333335,57,13,20,70
940,-16.51899999999723,2862.294117647059,60,15,26,75
941,-21.37324999999903,3000.5555555555557,42,16,24,58
942,-13.96524999999846,3177.5789473684213,57,23,19,80
943,-13.706749999998227,2622.1052631578946,35,14,6,49
944,4.691250000002471,2103.625,78,4,15,82
945,-10.15149999999797,2369.230769230769,55,16,8,71
946,-28.359749999996705,3013.6470588235293,60,21,21,81
947,-9.010749999998986,2497.5789473684213,33,10,13,43
948,-19.142999999998636,2984.684210526316,32,20,14,52
949,-26.85999999999777,3054.1052631578946,37,11,23,48
950,-8.361999999999242,2713.8947368421054,39,26,6,65
951,-5.851749999996056,3441.5789473684213,60,15,11,75
952,-13.358999999996408,2116.8888888888887,52,18,12,70
953,-16.853499999997997,2996.9444444444443,58,15,9,73
954,-12.823249999997007,2887.529411764706,53,10,18,63
955,-6.109499999998336,2863.0,71,14,11,85
956,-22.55299999999773,2981.222222222222,40,28,6,68
957,-18.814499999995018,3926.157894736842,73,9,11,82
958,-9.007249999999768,1916.4117647058824,40,17,4,57
959,-14.02349999999897,2540.222222222222,37,8,21,45
960,-19.275499999999937,1559.764705882353,2,15,4,17
961,-13.95674999999826,3191.75,37,15,4,52
962,-16.01849999999904,2242.9444444444443,39,19,11,58
963,-17.187499999997016,1534.8666666666666,43,15,9,58
964,-29.750249999997987,2679.5555555555557,41,21,14,62
965,-18.05874999999951,2779.1052631578946,35,22,5,57
966,-16.670999999998877,3012.9473684210525,31,24,4,55
967,-10.79524999999889,1979.8823529411766,43,5,13,48
968,-5.9599999999974305,3476.7894736842104,59,12,15,71
969,-1.1467499999956547,3564.5263157894738,85,12,6,97
970,-15.035749999997543,2995.277777777778,43,16,18,59
971,-8.025999999996618,1689.0,66,14,5,80
972,-13.594499999997709,2546.6470588235293,58,18,13,76
973,-24.81874999999843,2672.8,26,14,11,40
974,-23.36974999999988,2499.2105263157896,16,16,12,32
975,-20.93274999999799,2619.5882352941176,49,30,13,79
976,-21.91774999999888,2088.235294117647,38,26,7,64
977,6.321500000003878,6063.15,93,23,10,116
978,4.6135000000049455,2232.75,89,9,9,98
979,0.8917500000018126,3684.65,49,17,8,66
980,-19.169999999997135,2658.157894736842,31,13,22,44
981,-30.84449999999895,2965.6,28,22,5,50
982,-8.773499999998283,2552.294117647059,51,17,12,68
983,-8.936499999998643,3271.15,42,15,5,57
984,-14.99599999999682,2541.1111111111113,55,15,11,70
985,-21.294249999997085,4025.1,67,16,6,83
986,6.6067500000033395,3196.529411764706,71,13,7,84
987,-11.72549999999912,2325.8333333333335,27,17,7,44
988,-41.694749999995665,3209.4444444444443,59,24,18,83
989,-8.102999999999415,1621.5,30,13,5,43
990,-14.060999999998506,4062.45,52,17,11,69
991,-28.97124999999601,2474.9375,61,9,22,70
992,-24.316499999999586,1429.0,12,30,4,42
993,-20.444499999998037,3380.684210526316,55,14,9,69
994,-24.12799999999872,2722.2631578947367,30,6,18,36
995,-10.506749999997496,2593.4117647058824,67,19,7,86
996,-12.773499999997416,3145.0,41,21,8,62
997,-35.212750000001236,1429.0,39,27,9,66
998,-9.196999999998026,2748.3529411764707,60,12,12,72
999,-17.543999999998576,2671.6111111111113,67,18,15,85
1000,-15.803249999999561,2801.9444444444443,44,18,5,62
1001,-13.242999999998773,2559.3684210526317,28,14,7,42
1002,-17.976749999999015,3224.3,33,11,10,44
1003,-26.315999999998525,1576.8125,23,24,1,47
1004,-25.158749999998527,2546.842105263158,28,17,17,45
1005,-19.308999999998186,2906.1111111111113,44,24,7,68
1006,-22.57649999999913,2801.6315789473683,39,21,16,60
1007,-14.463499999998314,3866.3,39,16,19,55
1008,-21.098749999995842,2196.875,51,18,24,69
1009,-17.10174999999962,2381.3888888888887,35,28,5,63
1010,-18.818749999998797,2080.722222222222,17,15,10,32
1011,-28.71474999999531,4159.210526315789,70,15,22,85
1012,2.214750000004596,2037.1875,78,10,8,88
1013,-18.424499999999387,2160.1111111111113,43,22,7,65
1014,1.8875000000010058,3082.3684210526317,45,20,15,65
1015,-11.834499999998473,3413.2,41,20,7,61
1016,-23.908249999996197,4568.7,73,25,2,98
1017,-12.673749999999373,1711.0,38,16,16,54
1018,-27.321999999998713,2597.4444444444443,43,18,8,61
1019,-29.544000000000153,1429.0,0,18,3,18
1020,-18.55674999999603,3618.5882352941176,71,20,23,91
1021,5.68300000000248,3152.222222222222,56,11,12,67
1022,-16.766499999999404,2597.1052631578946,27,16,1,43
1023,-29.024999999998663,2968.6666666666665,55,18,20,73
1024,-25.129749999998417,2131.8888888888887,37,12,21,49
1025,-24.05824999999779,3465.842105263158,49,13,13,62
1026,-10.381249999998417,3193.35,44,11,8,55
1027,-41.40874999999919,2059.0,35,17,25,52
1028,-27.95499999999758,3028.722222222222,58,16,17,74
1029,-20.927749999997694,3305.3684210526317,52,25,7,77
1030,-2.771249999997489,3028.9473684210525,47,10,13,57
1031,-7.12724999999798,3476.65,46,14,1,60
1032,-8.550499999997045,4407.421052631579,78,10,18,88
1033,-16.373999999997167,2858.4444444444443,54,21,16,75
1034,-3.6509999999999154,2094.842105263158,16,8,5,24
1035,-12.49299999999849,1590.75,23,14,11,37
1036,-3.6417499999975504,3771.6315789473683,63,12,16,75
1037,-26.064249999999,2876.842105263158,32,5,32,37
1038,-20.796499999999348,2819.157894736842,43,19,17,62
1039,-40.067249999997664,3459.9473684210525,47,20,20,67
1040,-24.29674999999872,2548.4736842105262,29,20,8,49
1041,-20.46574999999843,1769.8235294117646,34,21,11,55
1042,-14.130749999999406,1429.0,12,10,11,22
1043,-33.899249999999356,2012.888888888889,24,31,7,55
1044,2.059750000002306,4361.7,63,17,13,80
1045,-25.61224999999903,3244.3684210526317,44,14,8,58
1046,-15.322499999998977,2799.2631578947367,35,9,17,44
1047,-15.97699999999956,1889.3333333333333,27,25,8,52
1048,-11.430999999997358,3238.5384615384614,57,18,3,75
1049,-24.87324999999831,2584.5789473684213,28,18,9,46
1050,-16.742249999999196,2619.5555555555557,32,10,24,42
1051,-12.07649999999882,2764.157894736842,36,11,13,47
1052,-17.2784999999977,3947.3,58,23,8,81
1053,-27.849999999998467,2568.176470588235,41,18,19,59
1054,-8.99274999999935,1429.0,12,12,3,24
1055,-17.340749999998646,2694.2,30,13,8,43
1056,-20.854499999998474,1429.0,28,14,6,42
1057,-13.126249999996613,1528.25,32,8,17,40
1058,-33.805249999998274,2863.4210526315787,35,18,10,53
1059,-12.014999999997588,3777.5263157894738,69,20,6,89
1060,-29.051999999999357,2371.1,21,12,10,33
1061,-17.8644999999969,1983.6875,41,10,19,51
1062,-20.915749999997807,2946.4117647058824,57,24,9,81
1063,-26.91799999999767,2143.3333333333335,22,14,12,36
1064,-30.755499999997646,2719.1666666666665,34,25,21,59
1065,4.373750000001236,2601.3,32,3,4,35
1066,-24.511499999998794,2223.6470588235293,32,23,4,55
1067,9.72025000000279,2640.375,85,15,9,100
1068,-15.753249999999998,1429.0,0,12,5,12
1069,-23.253499999999498,1937.0,15,21,1,36
1070,-11.411999999998343,4177.45,58,11,3,69
1071,12.543750000000312,2876.8947368421054,36,14,11,50
1072,2.5807500000030426,2224.6875,40,23,27,63
1073,-8.95749999999918,2781.45,22,21,6,43
1074,-28.346249999999877,2079.0526315789475,14,16,13,30
1075,-2.045999999998736,2967.0526315789475,66,14,10,80
1076,-21.617999999996627,3368.8947368421054,48,12,24,60
1077,-10.693749999997653,3136.684210526316,43,15,10,58
1078,-10.068249999997638,2257.294117647059,56,16,10,72
1079,-19.214499999996963,2148.0588235294117,62,11,23,73
1080,-17.162749999996457,2110.764705882353,61,13,17,74
1081,-16.049999999997922,3052.1,48,14,13,62
1082,-15.969999999998198,3264.4736842105262,47,19,14,66
1083,-24.230249999996616,2969.6875,77,17,15,94
1084,-11.745249999998904,1528.25,16,15,3,31
1085,-11.070499999995363,3266.722222222222,67,12,18,79
1086,-0.6137499999981365,2398.277777777778,48,14,6,62
1087,-26.06599999999841,3376.6,40,18,7,58
1088,-20.262749999998228,3561.0526315789475,50,21,5,71
1089,-26.894499999996174,3312.777777777778,64,15,18,79
1090,-16.38199999999881,1547.6470588235295,15,21,6,36
1091,-19.428499999999403,1926.157894736842,14,15,10,29
1092,-8.455749999999412,2001.388888888889,12,14,13,26
1093,-29.11399999999665,1948.6842105263158,18,13,33,31
1094,-15.344999999998555,2770.684210526316,30,14,14,44
1095,-18.31224999999868,2631.5,31,7,16,38
1096,-16.014249999999713,2595.722222222222,47,29,4,76
1097,-16.511499999998808,2861.842105263158,45,16,7,61
1098,-12.721499999999143,2971.2631578947367,42,24,22,66
1099,-14.450249999996387,2280.3125,59,12,18,71
1100,-5.826249999998799,2854.2631578947367,34,28,1,62
1101,-20.337749999996817,2873.5789473684213,52,16,10,68
1102,-10.543499999997698,4159.25,62,17,5,79
1103,12.427250000001331,3703.842105263158,72,17,6,89
1104,-1.2057499999981993,3841.722222222222,73,29,7,102
1105,-5.282999999998582,3324.277777777778,58,22,16,80
1106,-8.363999999998923,2756.823529411765,70,25,5,95
1107,-31.44749999999801,2377.2105263157896,25,16,17,41
1108,-14.88249999999827,3056.05,32,13,8,45
1109,-22.58924999999921,2029.4705882352941,26,17,7,43
1110,-9.429499999997596,2601.8823529411766,64,24,9,88
1111,-3.1429999999980547,3848.2,53,21,10,74
1112,-42.62474999999731,2635.4117647058824,48,11,32,59
1113,-21.954749999997848,3418.2105263157896,39,25,12,64
1114,-16.910999999998253,1567.9375,32,14,12,46
1115,-18.126749999998324,2037.1875,31,16,9,47
1116,-18.592500000000207,1429.0,40,29,27,69
1117,-23.52674999999746,2122.823529411765,41,15,24,56
1118,0.7737500000022074,2681.222222222222,40,14,16,54
1119,1.2530000000042523,2438.4117647058824,74,13,10,87
1120,-11.566749999997347,1831.875,47,20,12,67
1121,-9.20149999999923,2008.9411764705883,28,4,18,32
1122,0.2050000000026433,2896.176470588235,54,10,27,64
1123,-15.461749999996119,3153.8888888888887,61,10,14,71
1124,-26.878999999998296,2517.5263157894738,24,22,11,46
1125,-23.656999999994774,1715.75,63,22,16,85
1126,0.9160000000025971,3092.222222222222,69,10,18,79
1127,-30.050749999996572,1822.9375,26,19,23,45
1128,-27.629999999998894,1594.6875,40,25,15,65
1129,-25.844249999997338,2215.6666666666665,27,20,9,47
1130,-6.838499999998946,2370.0,44,22,6,66
1131,-27.73374999999635,2803.0555555555557,47,15,15,62
1132,-30.119999999995883,3249.5263157894738,45,11,29,56
1133,-0.5502499999981534,3351.4210526315787,50,26,11,76
1134,-21.4422499999954,1649.1333333333334,56,19,23,75
1135,4.558000000003603,1799.764705882353,56,18,6,74
1136,-12.81224999999967,2455.7368421052633,47,9,15,56
1137,-13.36049999999888,3076.4210526315787,53,15,9,68
1138,-3.6917499999982986,3387.315789473684,46,18,13,64
1139,-19.21449999999938,2042.4705882352941,27,20,8,47
1140,-11.343499999998766,2999.6315789473683,52,12,3,64
1141,-2.877499999994788,2064.0,83,15,15,98
1142,-35.19649999999699,4358.1578947368425,69,14,26,83
1143,-23.693249999999214,2576.1052631578946,30,23,3,53
1144,-8.34199999999722,2866.0526315789475,45,11,17,56
1145,-15.51199999999829,2770.3333333333335,35,21,5,56
1146,-18.471499999998144,2822.65,25,11,12,36
1147,-18.388499999998793,3045.5263157894738,34,16,16,50
1148,-17.761999999999865,2155.1052631578946,26,14,27,40
1149,4.912750000001089,2504.8888888888887,56,16,10,72
1150,-29.40325000000026,2034.1764705882354,33,13,28,46
1151,-25.671249999997684,2808.2631578947367,32,24,18,56
1152,-7.334749999996781,3914.4210526315787,75,14,2,89
1153,-18.338749999999127,1429.0,12,19,6,31
1154,-6.301749999999955,2036.6666666666667,43,14,13,57
1155,-12.018249999998988,2017.1764705882354,45,14,13,59
1156,-7.091499999997732,2484.1176470588234,64,13,12,77
1157,-4.501499999999161,2286.1052631578946,17,11,5,28
1158,-21.141499999997084,4413.25,70,18,6,88
1159,-10.132749999997653,2727.8823529411766,57,26,9,83
1160,-9.893249999997014,4044.6666666666665,80,14,24,94
1161,-11.117499999999415,2831.7368421052633,24,7,27,31
1162,-20.903999999996515,4692.5,69,20,6,89
1163,-10.807250000000089,1429.0,0,10,5,10
1164,-17.39924999999717,3044.722222222222,45,11,30,56
1165,-13.319999999998425,3105.684210526316,45,13,12,58
1166,-9.37774999999691,4051.3,67,10,6,77
1167,-29.34224999999851,2891.9473684210525,33,15,9,48
1168,-19.69399999999835,3478.25,42,12,8,54
1169,-13.884499999997349,2559.823529411765,57,16,12,73
1170,-11.189499999998471,3291.75,45,12,1,57
1171,-21.22249999999937,2849.6666666666665,45,22,18,67
1172,-13.530999999998988,2806.8,32,15,2,47
1173,0.46075000000197563,2353.75,63,9,34,72
1174,-21.396250000000933,1429.0,17,16,22,33
1175,-7.310749999998667,2640.6666666666665,42,8,14,50
1176,-8.352499999998974,3200.2631578947367,59,17,12,76
1177,1.868250000002981,2483.176470588235,51,14,11,65
1178,-18.23649999999645,1581.235294117647,50,14,2,64
1179,-22.42799999999773,2121.5,48,25,12,73
1180,12.731500000000763,2620.3333333333335,52,11,11,63
1181,1.328750000003539,5172.7,79,24,7,103
1182,-28.152249999998777,2693.4,23,19,8,42
1183,-21.136249999999002,2667.2105263157896,33,17,16,50
1184,-3.630999999999575,2215.5555555555557,35,16,7,51
1185,-14.621249999997218,2081.8125,56,7,10,63
1186,-11.13199999999887,2497.0,56,25,7,81
1187,-17.249749999997455,2543.0,68,19,11,87
1188,-28.039499999997037,2148.0,44,16,14,60
1189,-1.3417500000001121,1429.0,43,20,17,63
1190,-5.378999999997871,3086.7368421052633,46,12,10,58
1191,-10.633999999999482,1567.9375,16,13,4,29
1192,4.58900000000194,3236.15,43,5,4,48
1193,-17.47724999999826,2393.3125,58,24,11,82
1194,-3.148249999997465,4547.35,67,17,13,84
1195,-9.083249999998817,3678.3,43,23,9,66
1196,-0.5929999999963153,2510.375,66,13,7,79
1197,12.024000000003353,5096.5,84,9,12,93
1198,-16.40324999999926,1541.125,29,19,6,48
1199,-9.311499999997277,1917.3529411764705,46,9,13,55
1200,-16.1554999999995,1567.9375,36,19,10,55
1201,-5.587249999997363,4422.315789473684,81,23,5,104
1202,-17.959249999998658,3219.55,42,11,5,53
1203,-30.479749999999523,2008.5,16,20,3,36
1204,-9.276999999997726,3884.4210526315787,74,17,9,91
1205,-20.190999999997377,1909.0,37,25,12,62
1206,-25.093499999998215,2156.470588235294,54,8,16,62
1207,-18.709249999998757,1496.5,26,21,7,47
1208,-11.487499999998306,3726.5263157894738,59,18,11,77
1209,-23.619999999997752,3113.2105263157896,37,7,19,44
1210,-7.7237499999994155,1581.8125,12,11,9,23
1211,-25.736999999998318,2790.7368421052633,23,21,14,44
1212,-14.666749999997942,2648.25,75,14,15,89
1213,-6.894499999998809,2349.705882352941,41,10,9,51
1214,-3.1842499999989298,2417.722222222222,66,8,13,74
1215,-23.61849999999857,3094.8947368421054,38,24,13,62
1216,-19.37424999999697,2409.470588235294,54,17,10,71
1217,-19.388249999999488,1429.0,39,23,11,62
1218,-3.5107499999966634,2619.5882352941176,65,7,16,72
1219,-15.923749999998597,2984.6111111111113,68,21,3,89
1220,-1.6437499999991552,2561.0,31,10,13,41
1221,-16.59349999999925,2962.0526315789475,38,21,9,59
1222,-4.343999999999239,3056.0555555555557,76,14,7,90
1223,-12.185499999996692,3781.6315789473683,64,17,10,81
1224,-12.390749999999086,2624.7368421052633,25,7,6,32
1225,-1.7194999999986167,2881.5,36,11,3,47
1226,-17.679499999998164,3272.7,41,21,4,62
1227,-11.472249999998265,3202.235294117647,80,21,3,101
1228,-5.458499999999529,2027.1875,61,17,15,78
1229,-12.659249999998746,2512.8333333333335,32,13,8,45
1230,-15.59324999999962,2627.4444444444443,53,29,5,82
1231,4.617000000002463,4154.5,66,17,6,83
1232,-0.711999999997315,4488.7,70,16,11,86
1233,-27.95074999999892,2688.7894736842104,29,17,4,46
1234,-26.59924999999722,3536.6666666666665,72,30,11,102
1235,-13.052249999999642,2279.9444444444443,30,17,14,47
1236,8.991750000000929,2286.176470588235,71,20,1,91
1237,-5.0949999999979445,2576.705882352941,63,14,11,77
1238,-21.92624999999796,2814.5555555555557,59,12,11,71
1239,-8.225000000000104,1626.9411764705883,37,14,8,51
1240,-8.027499999998147,2481.0555555555557,36,18,8,54
1241,3.077750000002549,2210.75,65,14,10,79
1242,-10.010749999996968,2414.1111111111113,51,10,11,61
1243,-5.706999999998705,3470.8947368421054,62,20,9,82
1244,-16.076999999998854,3905.2631578947367,63,19,24,82
1245,-20.620249999998567,2537.4117647058824,55,15,13,70
1246,-9.536249999999107,2412.294117647059,61,19,11,80
1247,-16.436749999998263,3064.05,48,11,8,59
1248,-11.744999999998006,4139.105263157895,71,24,3,95
1249,-12.82349999999749,3600.5,57,8,8,65
1250,-7.159999999997074,4008.55,58,11,14,69
1251,-23.131749999997766,3211.1666666666665,48,13,28,61
1252,-21.172999999999032,2587.7,31,15,3,46
1253,-20.351999999997748,3749.0526315789475,48,18,11,66
1254,3.4297500000017522,3741.6315789473683,66,19,2,85
1255,-7.957999999999053,2806.9,30,11,6,41
1256,-8.447250000000475,1429.0,27,10,13,37
1257,-12.528249999997046,3302.0526315789475,41,16,21,57
1258,-10.606249999998523,2226.8947368421054,23,19,8,42
1259,-12.292499999996608,2928.1111111111113,63,24,10,87
1260,-20.01599999999607,2979.9411764705883,76,11,24,87
1261,-36.83949999999607,3445.0,55,12,23,67
1262,3.169500000003249,4609.9,83,19,7,102
1263,-14.631499999998244,2982.2631578947367,51,9,8,60
1264,-18.92349999999824,3008.45,35,15,7,50
1265,-21.74324999999808,1563.4666666666667,37,15,4,52
1266,1.0480000000026648,4049.842105263158,79,12,18,91
1267,-25.589249999996113,2430.125,72,19,14,91
1268,-9.976749999996846,5421.2,91,14,10,105
1269,-13.930499999999066,3627.4,49,11,4,60
1270,-5.776999999998322,3243.5,44,16,8,60
1271,-26.590499999998304,2678.1052631578946,31,15,12,46
1272,5.333500000004162,2388.0588235294117,74,8,15,82
1273,-19.23224999999811,2257.235294117647,44,20,11,64
1274,-12.418749999999113,2235.705882352941,64,17,15,81
1275,-13.377999999997305,4290.473684210527,79,15,19,94
1276,-19.659999999998238,3157.6,49,15,2,64
1277,-17.402999999998837,3275.3684210526317,43,5,36,48
1278,-4.296749999998967,3222.7368421052633,46,17,4,63
1279,-17.9847499999992,2768.85,28,22,4,50
1280,-12.66424999999774,3717.95,44,10,12,54
1281,5.595000000004118,4364.684210526316,90,14,6,104
1282,-11.661249999996908,3347.2105263157896,49,15,10,64
1283,-20.529249999998747,3292.45,43,18,2,61
1284,-12.98999999999864,2508.45,24,13,11,37
1285,-9.796749999997502,4075.15,60,14,6,74
1286,-28.771749999999106,1429.0,31,17,6,48
1287,1.2887500000006011,3037.2631578947367,58,16,10,74
1288,-10.471249999998914,2594.15,26,10,7,36
1289,-29.884249999998435,3337.05,42,18,4,60
1290,-6.246999999999377,2041.25,29,15,4,44
1291,-11.661999999998073,3787.85,47,22,12,69
1292,-22.077749999998332,2087.722222222222,15,15,15,30
1293,-4.619749999998577,3231.6666666666665,84,6,11,90
1294,-3.993749999999605,2179.5,39,20,12,59
1295,-16.212499999997426,4840.0526315789475,94,14,10,108
1296,-16.317749999997893,3288.65,40,9,10,49
1297,-11.050499999999184,2625.3684210526317,25,8,12,33
1298,-15.068249999997533,2813.4210526315787,38,11,13,49
1299,-3.7472499999984166,4255.95,62,15,5,77
1300,-14.343999999997454,2660.6470588235293,54,10,10,64
1301,-14.204499999996779,4065.65,62,12,5,74
1302,-11.250999999997493,2754.9411764705883,46,9,19,55
1303,-18.644749999999235,2723.45,29,22,2,51
1304,-10.716499999999078,2063.9411764705883,50,23,11,73
1305,-1.941249999998633,2313.0625,67,16,13,83
1306,-20.79824999999738,2872.6666666666665,41,13,19,54
1307,-7.244999999996092,3398.277777777778,73,3,18,76
1308,-17.416249999995408,2480.625,87,19,7,106
1309,-7.872999999998186,2392.3684210526317,25,8,15,33
1310,-19.032499999998098,2655.5263157894738,39,16,10,55
1311,-11.300500000000046,1429.0,0,8,4,8
1312,-10.421999999999079,2536.6111111111113,40,14,22,54
1313,-18.230249999997497,2856.8333333333335,47,9,15,56
1314,-13.75499999999902,1635.4375,26,7,5,33
1315,-17.395499999997615,4243.3,61,9,8,70
1316,-11.336499999997354,4298.9,61,8,9,69
1317,-10.175499999998456,1429.0,41,18,10,59
1318,3.6680000000032273,4364.7,63,21,8,84
1319,-34.27624999999751,3914.3684210526317,66,11,18,77
1320,-15.159999999997614,2736.176470588235,68,13,12,81
1321,-18.34299999999734,2608.75,57,12,14,69
1322,-14.963749999998779,2783.1,27,19,7,46
1323,-12.059749999999086,2537.4444444444443,37,8,8,45
1324,-11.448999999999618,2229.4210526315787,19,10,4,29
1325,-22.01849999999814,2110.6470588235293,38,8,21,46
1326,-8.351499999998799,2731.35,31,11,6,42
1327,-13.83549999999661,1724.6875,63,10,10,73
1328,-13.36949999999824,2390.3333333333335,38,15,4,53
1329,-14.022499999997866,2678.0,45,9,10,54
1330,-10.807249999998836,2849.176470588235,74,15,15,89
1331,-16.285249999997127,2019.4375,53,5,20,58
1332,-14.062499999996103,3490.9444444444443,57,10,22,67
1333,-18.428750000000072,1429.0,28,19,8,47
1334,5.853500000004395,2547.5882352941176,73,12,18,85
1335,-7.4749999999987695,1572.875,26,15,10,41
1336,-49.26924999999791,2542.9411764705883,54,30,23,84
1337,6.798000000002131,4996.5,88,12,6,100
1338,-13.828249999997647,3676.7,52,16,10,68
1339,-25.86299999999857,2755.95,24,9,18,33
1340,-5.920499999998917,1481.9333333333334,53,14,15,67
1341,-27.572749999998116,2777.4117647058824,53,27,13,80
1342,-14.12649999999817,3190.0,39,3,16,42
1343,-18.679749999997085,2584.9411764705883,70,22,13,92
1344,-25.087749999998074,3551.8947368421054,44,18,21,62
1345,-17.16424999999879,2717.9,25,18,6,43
1346,-8.011749999995503,4272.0526315789475,90,10,11,100
1347,-13.393749999997274,3612.9473684210525,49,18,14,67
1348,-21.83524999999802,2993.4444444444443,57,10,18,67
1349,-4.809999999996447,6123.45,106,16,11,122
1350,-18.830749999998716,2156.3529411764707,53,9,24,62
1351,-23.08199999999951,1997.2105263157894,17,13,15,30
1352,-14.602749999998181,2668.0,56,19,10,75
1353,-2.3919999999958708,2887.5882352941176,76,10,15,86
1354,-17.163249999998463,2723.6111111111113,45,12,16,57
1355,-16.67400000000046,1429.0,13,19,32,32
1356,-11.333749999997984,2589.5263157894738,26,6,26,32
1357,-17.501249999999267,2475.8947368421054,16,18,4,34
1358,-1.7644999999986504,3019.684210526316,49,3,9,52
1359,-10.116249999997407,1617.5625,49,8,7,57
1360,-0.11849999999721739,1544.4,53,10,5,63
1361,-10.602749999998917,1954.7058823529412,21,13,19,34
1362,-19.78624999999886,3161.6315789473683,37,19,18,56
1363,-13.62399999999821,3716.45,49,14,7,63
1364,3.0470000000035222,5075.9,76,14,13,90
1365,-1.7742499999980286,4876.75,70,16,5,86
1366,-8.669249999997856,2856.8823529411766,70,13,12,83
1367,1.6175000000014716,3120.7894736842104,44,8,12,52
1368,-12.302999999998141,2640.5789473684213,36,20,11,56
1369,-19.775249999999183,1631.6470588235295,11,21,10,32
1370,-18.886499999999938,2111.6111111111113,27,13,27,40
1371,-6.602499999997425,3342.2105263157896,43,10,15,53
1372,-14.12274999999924,2366.4444444444443,23,19,11,42
1373,12.996000000002539,4822.8,81,17,12,98
1374,-17.9067499999986,3179.05,41,15,8,56
1375,6.323250000001918,3921.85,58,8,12,66
1376,-11.20299999999887,2610.8333333333335,58,9,20,67
1377,-0.0909999999971279,3536.1052631578946,72,16,3,88
1378,-29.608499999998685,2672.75,29,12,13,41
1379,-7.424999999999085,3113.2631578947367,41,4,21,45
1380,-7.63174999999787,1429.0,30,9,7,39
1381,-4.513249999997941,3160.176470588235,54,15,21,69
1382,-24.48799999999905,1580.75,44,23,10,67
1383,-20.426499999997112,2655.4210526315787,41,23,12,64
1384,1.4380000000022872,3895.8,56,9,10,65
1385,-18.366500000000052,1630.4375,13,10,16,23
1386,-24.22799999999635,2094.9444444444443,27,13,35,40
1387,-25.698999999997874,3628.8947368421054,53,20,17,73
1388,-25.609999999999282,2323.1666666666665,25,26,2,51
1389,-5.060749999997976,4060.05,54,13,12,67
1390,-15.93274999999793,4719.55,59,15,22,74
1391,-14.689749999997549,3819.65,49,10,10,59
1392,-19.094499999998682,3197.3,43,9,8,52
1393,-1.5097499999979742,2676.0625,72,12,7,84
1394,-27.49474999999857,2520.2105263157896,31,21,10,52
1395,-25.92224999999907,1948.6842105263158,13,3,19,16
1396,-16.70199999999675,4705.3,71,12,16,83
1397,-20.752499999998204,2750.9444444444443,46,14,17,60
1398,-11.21024999999727,4232.9,63,11,13,74
1399,-25.461249999998188,2286.176470588235,56,20,16,76
1400,-15.075999999998325,3361.3684210526317,58,7,6,65
1401,-1.9657499999977468,2855.0,62,25,0,87
1402,-7.614499999996634,4188.6,61,11,15,72
1403,1.1610000000019292,3759.95,58,18,7,76
1404,-24.876499999997808,1572.8235294117646,16,20,17,36
1405,4.926250000001974,3258.8333333333335,59,6,9,65
1406,-12.433249999997932,3562.7368421052633,59,16,16,75
1407,-25.95024999999975,2222.7894736842104,21,13,23,34
1408,-23.612249999999804,2005.0588235294117,35,6,32,41
1409,-15.141249999999307,2788.315789473684,36,7,13,43
1410,-22.737249999997655,2580.315789473684,30,11,21,41
1411,-12.866249999998299,3657.9473684210525,58,13,10,71
1412,-13.480749999996817,2795.0,57,8,16,65
1413,10.26825000000357,2870.705882352941,86,14,10,100
1414,-8.058999999997646,3298.6111111111113,58,16,14,74
1415,-10.737249999998378,2462.4210526315787,40,12,9,52
1416,-17.609249999997992,3929.05,45,10,16,55
1417,-5.468999999997431,2019.3125,49,22,2,71
1418,-19.38299999999748,4146.45,53,24,5,77
1419,-15.827249999997969,4586.9,63,16,12,79
1420,7.255750000002675,4049.7368421052633,81,13,10,94
1421,-19.685999999999357,2581.9473684210525,40,12,6,52
1422,-1.8029999999999524,2683.0,49,12,11,61
1423,-13.873249999996967,4154.315789473684,64,30,7,94
1424,-20.10299999999926,2617.0526315789475,35,8,14,43
1425,-22.838749999995038,2018.2941176470588,28,8,52,36
1426,-4.981749999997502,2196.875,50,12,16,62
1427,-1.8284999999966054,5033.85,78,16,11,94
1428,-1.7719999999981215,3711.4210526315787,62,1,23,63
1429,-12.989499999999776,1429.0,31,16,4,47
1430,-2.569249999997588,2719.8125,81,10,19,91
1431,-19.856749999997678,2614.764705882353,48,9,19,57
1432,-28.879749999996875,2253.529411764706,57,14,14,71
1433,-9.041750000000473,1429.0,26,15,16,41
1434,-29.455499999997734,2357.625,45,16,26,61
1435,-11.986499999997745,2300.25,71,14,6,85
1436,-18.60624999999925,2546.6470588235293,63,22,10,85
1437,-21.054249999996635,3341.4736842105262,46,17,16,63
1438,-23.275499999998242,2955.3,27,11,16,38
1439,-7.394249999998586,3378.9473684210525,55,12,10,67
1440,-9.051249999998648,2805.842105263158,31,9,4,40
1441,-10.816499999997422,2461.6666666666665,47,19,12,66
1442,-11.071249999998184,2989.0,67,15,16,82
1443,-8.901749999998513,2651.2631578947367,29,18,7,47
1444,-5.225499999998243,3087.777777777778,61,10,22,71
1445,-2.5799999999987917,3368.75,43,14,12,57
1446,-6.694999999999998,1429.0,0,4,3,4
1447,-17.701499999997814,2400.0,48,16,7,64
1448,-10.379249999999388,1564.4117647058824,15,16,2,31
1449,1.3395000000018906,3963.2,55,13,13,68
1450,-8.081249999998153,2975.4210526315787,41,11,14,52
1451,-19.09524999999798,3298.5555555555557,70,18,5,88
1452,-12.943999999998212,3819.5,48,22,13,70
1453,-6.822249999996882,3596.6111111111113,80,22,9,102
1454,-15.337999999999132,2579.4736842105262,30,21,6,51
1455,-7.723749999998953,1429.0,23,19,6,42
1456,-21.84399999999804,1564.0,17,15,16,32
1457,-1.8684999999959455,2737.625,105,18,8,123
1458,-1.3109999999998299,2301.157894736842,15,13,1,28
1459,-12.433499999998855,2874.4117647058824,89,21,14,110
1460,-14.810249999999751,1949.9411764705883,39,20,11,59
1461,-21.52949999999788,3068.4444444444443,61,19,17,80
1462,-31.575999999998192,2265.0,25,19,18,44
1463,-27.612749999996993,4034.7368421052633,67,17,15,84
1464,-1.3687499999964317,3572.7368421052633,72,4,8,76
1465,1.8855000000020776,3564.3684210526317,50,13,16,63
1466,-16.79499999999701,3071.8888888888887,48,19,13,67
1467,-27.95749999999836,2325.1111111111113,36,15,12,51
1468,-22.17749999999928,2696.4736842105262,40,19,13,59
1469,-14.031749999999263,2148.1,17,22,1,39
1470,-10.591499999998796,2520.8333333333335,41,7,15,48
1471,-10.660249999997436,2408.2631578947367,38,8,17,46
1472,-21.228999999999026,1514.375,32,19,18,51
1473,-13.127999999998679,3025.9444444444443,69,26,12,95
1474,4.957750000002351,4109.25,69,13,4,82
1475,-22.918499999998307,2726.1111111111113,55,10,14,65
1476,-29.30324999999629,2349.6875,61,14,12,75
1477,6.532000000001783,3905.3684210526317,63,19,9,82
1478,-21.76724999999896,2354.1111111111113,46,22,7,68
1479,-6.768749999997736,3139.2105263157896,46,15,12,61
1480,-11.98274999999705,3027.777777777778,60,14,6,74
1481,-9.922749999997226,2467.4117647058824,62,19,11,81
1482,-23.40524999999643,4748.05,72,16,15,88
1483,-2.5142499999981336,3329.95,51,9,4,60
1484,-17.37499999999954,1429.0,13,17,2,30
1485,-10.19324999999665,3482.5263157894738,64,7,23,71
1486,-8.313249999997968,2092.0,38,15,4,53
1487,-18.223749999997505,2546.3333333333335,55,16,7,71
1488,-11.978499999998622,2611.1052631578946,32,7,8,39
1489,-15.717999999997266,3045.4444444444443,82,12,10,94
1490,-16.338749999998534,3056.4736842105262,40,26,12,66
1491,-4.5704999999985185,2694.25,28,1,15,29
1492,-13.809249999998277,1978.625,43,16,8,59
1493,-21.860249999999034,2193.823529411765,58,20,24,78
1494,-7.439749999997136,3261.1052631578946,58,20,8,78
1495,-20.72499999999912,3307.1052631578946,41,19,18,60
1496,-1.8927499999981023,3630.65,56,16,7,72
1497,-24.283249999998485,3590.315789473684,47,20,12,67
1498,-14.318749999998213,3303.05,43,12,11,55
1499,3.0385000000008873,2501.7368421052633,26,8,7,34
1500,-3.407499999998349,2774.777777777778,59,14,22,73
1501,-3.2564999999975783,4322.75,68,8,11,76
1502,-25.442999999998218,2788.2631578947367,31,14,9,45
1503,-8.39124999999901,3162.5263157894738,49,6,19,55
1504,-4.777749999998145,3028.157894736842,54,13,7,67
1505,-36.478749999998215,2112.5,13,16,21,29
1506,-11.13199999999734,3667.95,51,22,5,73
1507,7.839500000001482,3294.1666666666665,77,9,6,86
1508,-4.362749999997535,3224.4736842105262,54,4,12,58
1509,-8.856250000000163,1554.0,45,23,10,68
1510,9.497750000001577,2415.0555555555557,47,12,8,59
1511,-24.961999999997897,2354.9444444444443,31,14,10,45
1512,5.875000000002686,4603.65,80,19,3,99
1513,-9.894249999996566,2636.3888888888887,64,10,16,74
1514,-18.097249999998848,2252.5882352941176,64,10,4,74
1515,-24.12874999999915,1997.111111111111,23,14,31,37
1516,-23.225749999997284,3362.2631578947367,43,13,17,56
1517,-25.10599999999659,2627.0,43,21,26,64
1518,-12.081999999997578,2010.764705882353,47,29,6,76
1519,-31.14574999999863,2794.1111111111113,41,11,16,52
1520,-31.23499999999776,2450.529411764706,38,14,38,52
1521,-0.6969999999988166,3016.4736842105262,42,18,18,60
1522,-2.385999999997252,2971.2631578947367,54,5,12,59
1523,-16.752499999997003,3384.7894736842104,54,21,10,75
1524,-13.817249999997898,1572.875,21,16,15,37
1525,-9.43024999999767,2030.5294117647059,45,6,16,51
1526,-2.384249999996897,5768.7,108,14,12,122
1527,-19.745749999998917,1572.8235294117646,11,13,12,24
1528,-17.775999999998625,3586.2,36,17,6,53
1529,-17.212499999996975,2639.4375,63,16,17,79
1530,-11.873249999997363,3147.777777777778,71,18,21,89
1531,-38.23399999999842,3562.7368421052633,52,9,18,61
1532,-14.434249999998134,3964.75,57,20,7,77
1533,-17.607999999998828,2929.5263157894738,40,6,17,46
1534,-29.528999999998433,2856.7894736842104,31,16,12,47
1535,-2.2179999999978626,3783.05,64,6,7,70
1536,-17.06024999999807,3374.7894736842104,60,12,8,72
1537,-7.515249999999274,2290.4210526315787,31,9,9,40
1538,-19.094749999997287,2694.294117647059,64,12,10,76
1539,-25.713499999998703,2719.529411764706,57,15,24,72
1540,-12.550999999997362,2177.8333333333335,30,4,22,34
1541,-4.628749999999429,1576.875,19,8,13,27
1542,-7.439999999997745,3262.3333333333335,59,11,11,70
1543,-15.583749999996744,2982.8888888888887,52,10,19,62
1544,-10.05249999999739,2291.1875,63,8,12,71
1545,-32.325749999997626,3286.315789473684,44,14,16,58
1546,-5.203999999998841,2183.0,54,6,22,60
1547,1.9397500000039414,5171.95,89,16,9,105
1548,-15.525749999998022,3115.1111111111113,69,13,11,82
1549,-18.839249999998753,3079.0526315789475,39,16,16,55
1550,-16.685999999997744,2035.1176470588234,36,10,18,46
1551,-6.800999999997993,2868.222222222222,50,12,7,62
1552,-21.637999999997668,2628.5,40,16,15,56
1553,-9.132999999997432,2530.2105263157896,30,14,25,44
1554,-14.624249999997167,3056.4210526315787,48,7,14,55
1555,-19.126749999998303,2492.6666666666665,37,20,8,57
1556,-12.484999999998953,2097.6470588235293,54,10,11,64
1557,-3.24274999999777,3572.7894736842104,55,16,8,71
1558,-26.091999999999054,2748.1052631578946,48,15,9,63
1559,-14.567999999999154,2293.45,19,10,12,29
1560,-13.037249999997787,3636.2105263157896,61,24,10,85
1561,-20.544749999997464,2795.125,83,13,8,96
1562,9.880000000001825,3653.0526315789475,68,8,14,76
1563,-13.427499999999025,2017.2941176470588,51,24,5,75
1564,-0.3524999999992327,2646.315789473684,40,10,8,50
1565,-3.5649999999955755,2425.0,83,11,11,94
1566,-19.468999999998836,2295.25,73,23,12,96
1567,-2.7304999999965025,4257.789473684211,81,13,7,94
1568,10.148250000001445,2596.235294117647,76,17,4,93
1569,-1.873499999997971,2528.6111111111113,51,11,10,62
1570,-17.97174999999704,2555.1176470588234,56,21,10,77
1571,-2.4834999999979575,2704.0,50,16,10,66
1572,-9.520249999998125,2148.0,29,6,15,35
1573,-9.59074999999807,3270.3,44,17,5,61
1574,-9.394249999997495,3195.157894736842,40,14,16,54
1575,-1.633749999995516,1939.0,73,18,13,91
1576,-21.323249999997707,2194.705882352941,37,18,12,55
1577,-7.823249999999597,1429.0,59,11,16,70
1578,-16.229999999996643,2278.25,57,13,20,70
1579,4.030750000002993,3523.4736842105262,56,4,19,60
1580,-8.02574999999906,2421.85,18,6,14,24
1581,-2.545999999997826,2166.6470588235293,51,10,5,61
1582,-12.213999999998245,2685.8823529411766,49,7,11,56
1583,-23.667999999996947,3112.5555555555557,54,13,14,67
1584,-9.294999999998494,3634.6,43,17,11,60
1585,-7.438749999996745,3120.5,63,23,8,86
1586,-3.049749999999343,2759.842105263158,31,13,6,44
1587,-24.020249999997063,2453.8333333333335,35,16,24,51
1588,-9.281749999998896,2684.6666666666665,40,15,8,55
1589,-20.549499999998865,2711.4736842105262,36,16,18,52
1590,-22.90199999999995,2222.6666666666665,28,21,18,49
1591,-3.2244999999981103,3767.2,54,14,8,68
1592,-10.631499999998145,3873.5,60,13,11,73
1593,-11.18549999999788,3800.842105263158,68,21,5,89
1594,-8.534499999997903,2643.7894736842104,33,17,18,50
1595,-7.63849999999938,2627.45,28,6,3,34
1596,-21.174999999997915,2035.1176470588234,40,10,15,50
1597,-10.545249999998067,2005.888888888889,39,21,5,60
1598,-5.5794999999965995,4415.65,69,5,15,74
1599,-11.501249999996679,4214.8,68,19,12,87
1600,-12.172249999997453,3770.3,62,12,8,74
1601,-8.480749999998375,2518.9444444444443,41,12,8,53
1602,-6.004999999997605,3565.6,44,8,14,52
1603,-27.71999999999851,2531.823529411765,47,21,8,68
1604,-7.544999999996923,3615.2631578947367,59,9,17,68
1605,-11.431249999995146,2322.705882352941,70,15,22,85
1606,-5.5279999999973715,2583.1176470588234,47,7,24,54
1607,-4.071499999996656,3647.777777777778,84,16,2,100
1608,-24.246249999996387,2595.6666666666665,37,20,23,57
1609,-20.52374999999856,1559.0,27,25,5,52
1610,-11.292499999998132,2632.777777777778,43,14,6,57
1611,2.824000000002905,4169.4,72,14,4,86
1612,-21.676999999997896,2798.5555555555557,64,21,11,85
1613,-22.66799999999699,1976.6875,60,12,10,72
1614,-19.43599999999717,3014.842105263158,46,14,21,60
1615,-16.99699999999647,3615.315789473684,65,26,9,91
1616,-13.650499999997274,2311.8333333333335,55,8,7,63
1617,-15.58174999999795,2877.9444444444443,54,12,24,66
1618,-8.781999999998199,1528.25,32,14,11,46
1619,-8.440249999999029,2905.2105263157896,42,9,19,51
1620,-15.916499999996281,3794.1052631578946,62,8,26,70
1621,0.6040000000019929,1757.4375,82,24,9,106
1622,-18.649499999999218,2134.9411764705883,23,13,17,36
1623,-30.236499999998735,2173.235294117647,51,17,8,68
1624,3.701000000002259,2559.5,50,13,8,63
1625,-31.51474999999717,2347.8823529411766,54,11,15,65
1626,-17.886499999999593,1657.1875,27,15,16,42
1627,-17.452499999997862,2068.9375,49,21,6,70
1628,-14.09524999999888,2887.05,36,5,5,41
1629,-6.30700000000039,1429.0,11,8,15,19
1630,-28.646499999998134,2310.9444444444443,26,18,8,44
1631,11.624250000002931,2143.4117647058824,68,16,3,84
1632,5.326000000002045,4938.55,73,10,9,83
1633,-16.68024999999965,2048.0,18,17,2,35
1634,-28.517749999998422,2866.1052631578946,32,16,9,48
1635,-11.210249999998542,3245.6111111111113,55,9,21,64
1636,-0.43749999999737443,4412.45,69,14,5,83
1637,-15.682999999995758,2406.1111111111113,64,11,18,75
1638,-23.230499999995484,1822.9375,64,17,20,81
1639,-19.074499999998913,3087.3684210526317,32,10,25,42
1640,-4.767999999999428,2634.5789473684213,40,11,9,51
1641,-19.252499999998633,1680.0625,11,27,10,38
1642,-20.311499999997608,3155.777777777778,66,9,20,75
1643,-12.595999999996494,4649.631578947368,89,17,11,106
1644,-11.673499999997134,4177.45,65,12,9,77
1645,-13.58074999999776,4102.1,56,21,10,77
1646,-18.075249999999365,3118.2105263157896,41,21,16,62
1647,5.3322500000021265,3841.9444444444443,84,21,12,105
1648,-25.136499999997124,2167.1666666666665,51,15,12,66
1649,2.8167500000025933,5377.45,90,22,7,112
1650,-18.679499999997848,3583.684210526316,63,18,7,81
1651,-2.256499999996243,5519.65,86,11,16,97
1652,-24.093749999997836,2353.8125,49,12,15,61
1653,-9.760999999997505,4291.0,72,10,6,82
1654,3.2342500000021204,3516.277777777778,71,13,6,84
1655,-12.985749999999367,2200.2631578947367,32,14,11,46
1656,-8.193749999997976,4554.45,70,17,8,87
1657,-22.524999999998236,2840.842105263158,40,15,11,55
1658,-29.971249999996097,2730.7368421052633,43,20,26,63
1659,-4.518749999999317,2269.4117647058824,42,16,10,58
1660,-2.1124999999981866,2689.5882352941176,45,17,16,62
1661,-36.35875000000047,1741.5,22,14,24,36
1662,3.190250000004542,3001.4117647058824,89,12,15,101
1663,-19.13274999999731,2456.4444444444443,43,18,13,61
1664,-13.672999999998265,2190.0588235294117,48,18,5,66
1665,6.719250000003418,5851.4,104,17,5,121
1666,-19.32924999999794,1491.4666666666667,29,22,7,51
1667,5.719500000001781,3694.7894736842104,58,11,13,69
1668,-16.428499999998387,2492.5263157894738,32,16,14,48
1669,-12.54249999999919,2824.2631578947367,39,18,25,57
1670,-11.504749999998875,2476.684210526316,32,16,7,48
1671,-24.239999999998286,3060.15,39,15,10,54
1672,8.484250000002394,2228.625,84,10,10,94
1673,-28.957749999995407,2253.5,78,21,18,99
1674,-4.3322499999982504,3713.9473684210525,78,12,6,90
1675,-22.207999999999075,2631.1111111111113,56,15,9,71
1676,-19.777749999999717,2235.705882352941,35,17,23,52
1677,-24.261999999998523,2264.4736842105262,31,16,4,47
1678,-6.8207499999972665,3500.55,48,6,12,54
1679,0.41175000000203327,3546.0526315789475,66,5,10,71
1680,-10.657249999997182,2564.8888888888887,53,14,11,67
1681,-6.602749999999041,3452.8333333333335,83,28,9,111
1682,-7.387249999997849,2318.0,56,8,10,64
1683,-13.967749999999521,1723.611111111111,12,12,7,24
1684,-11.68849999999919,2846.8947368421054,45,8,32,53
1685,-11.615999999999449,2490.1052631578946,27,15,9,42
1686,-9.90024999999729,2003.2941176470588,52,17,9,69
1687,-4.4849999999985934,2250.5,56,21,13,77
1688,-13.90899999999913,2929.0,68,20,5,88
1689,-6.760749999997958,3075.4444444444443,66,14,6,80
1690,-9.624999999996705,2487.625,90,24,14,114
1691,-9.545999999998713,2608.5,34,19,5,53
1692,11.17175000000245,2592.4117647058824,84,11,13,95
1693,-17.395999999999056,3266.1052631578946,57,21,14,78
1694,-14.486749999997665,2535.6666666666665,49,17,9,66
1695,-10.689499999997674,2596.2105263157896,38,14,6,52
1696,-20.04674999999909,2072.8333333333335,17,17,8,34
1697,15.54525000000055,3024.3888888888887,78,29,9,107
1698,-5.611749999997994,4183.15,65,16,5,81
1699,-4.7502499999972,3654.777777777778,94,21,9,115
1700,-13.142999999997878,4084.8947368421054,71,25,7,96
1701,20.157750000002068,2909.6111111111113,92,15,1,107
1702,-15.618249999998202,3460.7368421052633,54,21,13,75
1703,2.7937500000022153,3092.3684210526317,58,7,5,65
1704,-4.61824999999865,2775.6111111111113,72,17,2,89
1705,-20.800749999999486,2421.1111111111113,42,18,15,60
1706,-36.096750000000114,1612.5625,20,19,24,39
1707,-11.81399999999697,4803.7,72,14,14,86
1708,-23.14424999999951,1800.0625,41,29,14,70
1709,-24.417499999999254,2403.764705882353,43,19,19,62
1710,3.7712500000002853,2378.705882352941,63,27,5,90
1711,-8.732749999999342,2325.9444444444443,33,16,6,49
1712,-17.6457499999981,2329.176470588235,38,11,13,49
1713,-17.736749999998146,3200.4,45,21,4,66
1714,-29.56574999999848,2873.5,42,12,30,54
1715,-1.4194999999973437,4510.1,69,5,15,74
1716,-19.961499999997322,3488.9444444444443,69,19,32,88
1717,-8.97824999999784,2927.705882352941,53,15,22,68
1718,-12.143249999999208,2816.7368421052633,38,9,10,47
1719,-6.199999999999925,2027.2631578947369,25,11,10,36
1720,-14.128999999997808,3187.5,53,6,13,59
1721,-17.535749999998686,2662.722222222222,52,17,14,69
1722,-2.557749999999225,3175.9473684210525,64,15,5,79
1723,-31.488499999998066,2054.6470588235293,30,17,18,47
1724,-16.76149999999737,3008.9473684210525,49,12,13,61
1725,-10.15074999999889,3148.15,37,19,3,56
1726,-1.793499999998334,2589.75,68,11,16,79
1727,-5.912249999996961,2823.277777777778,57,15,10,72
1728,-8.590999999996756,4087.8,64,15,16,79
1729,-2.0094999999986936,2248.8823529411766,53,16,16,69
1730,-19.37424999999874,2314.3888888888887,47,16,20,63
1731,-16.046749999997363,4200.1578947368425,73,14,14,87
1732,-15.788249999997413,2153.25,54,16,10,70
1733,-14.389499999999183,2008.9411764705883,42,29,6,71
1734,-33.77824999999832,2764.0526315789475,31,20,11,51
1735,-28.159999999999496,2064.7894736842104,19,21,14,40
1736,6.7602500000010695,2623.8888888888887,57,13,15,70
1737,-15.281249999999261,2647.842105263158,28,11,15,39
1738,-1.2804999999981965,2504.705882352941,51,21,8,72
1739,-18.78149999999846,2664.6111111111113,33,6,15,39
1740,-2.9914999999987737,3074.0,43,8,20,51
1741,-8.672499999998688,3391.3684210526317,56,22,3,78
1742,-7.175249999995695,2549.0,55,6,23,61
1743,-16.987499999999176,2976.722222222222,51,21,14,72
1744,0.019750000002851386,2847.3529411764707,68,9,10,77
1745,-30.932999999998447,2851.842105263158,41,14,14,55
1746,-39.03299999999854,2901.722222222222,43,16,33,59
1747,-10.311999999997393,2826.8823529411766,67,16,5,83
1748,-19.151999999997702,2168.8333333333335,34,13,14,47
1749,-18.119249999999404,1532.1875,15,16,9,31
1750,-3.333749999997937,2610.5625,56,5,15,61
1751,-18.49824999999753,3755.7368421052633,50,10,20,60
1752,-2.214749999999042,2951.9473684210525,40,12,20,52
1753,-12.874999999999227,1429.0,18,14,7,32
1754,5.465500000001356,3123.9444444444443,66,17,12,83
1755,-11.065999999998379,3181.0,49,21,9,70
1756,-1.469749999996796,2409.470588235294,66,11,10,77
1757,-3.35024999999879,3071.4736842105262,44,17,11,61
1758,-5.893249999998531,3102.9,47,12,7,59
1759,-27.469749999998463,2705.8125,69,13,22,82
1760,-13.303249999996776,4594.2,69,12,8,81
1761,6.836250000002548,5013.15,84,14,10,98
1762,-28.567249999997994,2592.1666666666665,57,21,22,78
1763,-16.621749999999736,2589.4210526315787,18,12,2,30
1764,-10.762249999999025,2632.0,29,8,6,37
1765,-17.37124999999641,2589.764705882353,60,14,13,74
1766,-19.963499999998305,1429.0,28,18,4,46
1767,8.55425000000319,4478.263157894737,97,10,11,107
1768,-38.161749999999536,2794.1111111111113,40,16,27,56
1769,-9.229749999996915,4668.0,72,18,9,90
1770,-14.685999999998026,2134.6666666666665,46,4,8,50
1771,-8.9244999999996,1714.6875,31,18,4,49
1772,-23.734499999999336,1528.25,15,17,6,32
1773,5.044250000005408,6065.6,112,8,8,120
1774,-22.17799999999899,2298.684210526316,26,16,7,42
1775,-26.21549999999737,2452.0,72,15,10,87
1776,6.485250000002024,4347.263157894737,88,21,11,109
1777,-12.584749999996962,2711.9411764705883,52,15,14,67
1778,-15.688249999997359,4248.1,70,8,9,78
1779,2.180000000001526,3184.55,47,15,3,62
1780,-9.644749999999082,2644.15,26,13,5,39
1781,-0.7719999999984097,3083.85,39,10,5,49
1782,-12.186499999996652,2923.722222222222,68,9,16,77
1783,-12.687249999998292,1555.0625,36,19,7,55
1784,-22.68299999999993,1429.0,14,18,13,32
1785,-30.08524999999772,3063.157894736842,52,15,6,67
1786,-2.383749999999323,2565.722222222222,54,18,12,72
1787,-29.237749999998584,2090.5,19,13,12,32
1788,-21.22249999999918,2012.7777777777778,30,10,8,40
1789,-18.20849999999965,1857.611111111111,15,19,2,34
1790,0.48150000000291737,4831.5,80,8,8,88
1791,7.5852500000017855,4217.15,56,14,5,70
1792,-12.105999999998868,3185.6666666666665,69,12,11,81
1793,-16.651749999998444,3168.85,41,12,9,53
1794,-6.639999999997225,3453.315789473684,66,18,9,84
1795,-6.74224999999763,4257.6,64,19,11,83
1796,6.430500000003692,5238.65,93,11,9,104
1797,-13.9562499999966,2408.470588235294,74,18,11,92
1798,-5.816749999996946,2472.0588235294117,61,9,8,70
1799,-19.11674999999918,1737.5625,33,13,12,46
1800,-25.960499999997886,4002.8,54,13,14,67
1801,-30.881749999998824,2806.6315789473683,36,10,19,46
1802,-7.068249999999535,1874.4117647058824,32,21,5,53
1803,-6.60199999999764,4225.05,64,11,9,75
1804,-8.399499999997134,3470.0526315789475,56,7,18,63
1805,-11.070749999998332,1982.75,46,21,9,67
1806,6.080750000002696,3775.15,60,10,12,70
1807,7.267000000002551,3572.777777777778,68,8,9,76
1808,-0.2544999999967031,1528.25,63,12,5,75
1809,-18.932499999999674,1429.0,18,17,6,35
1810,-6.56224999999734,3817.0555555555557,76,14,10,90
1811,0.4075000000013228,2577.277777777778,38,18,16,56
1812,-2.1737499999982277,3274.3,43,11,10,54
1813,-8.832249999999522,1714.7058823529412,15,14,6,29
1814,-20.43274999999769,3784.65,61,13,12,74
1815,-1.4997499999963673,3198.9444444444443,69,12,17,81
1816,-3.7734999999989647,2723.6111111111113,56,13,9,69
1817,-21.378999999995763,4844.2,73,8,16,81
1818,-12.968499999997505,2907.176470588235,49,17,18,66
1819,-9.86699999999694,2960.3529411764707,78,13,9,91
1820,-40.58750000000014,1989.111111111111,22,17,25,39
1821,-10.037999999999508,2143.294117647059,25,21,8,46
1822,-17.33349999999863,3297.35,45,19,9,64
1823,-16.289249999997917,2452.5263157894738,25,17,20,42
1824,0.8685000000024716,2803.470588235294,93,14,7,107
1825,-20.838749999999237,2611.6111111111113,39,12,16,51
1826,-8.865499999999441,2100.277777777778,45,6,15,51
1827,-21.477999999999344,1585.75,19,19,7,38
1828,-8.986499999998617,1985.611111111111,27,8,16,35
1829,-6.755999999997196,2282.470588235294,70,23,12,93
1830,-13.666249999998456,2766.684210526316,36,14,6,50
1831,-37.626750000000825,1429.0,14,31,23,45
1832,-11.454249999998638,2691.05,31,8,6,39
1833,-28.092999999999016,2563.470588235294,52,24,16,76
1834,-15.059750000000003,2446.684210526316,29,15,29,44
1835,-6.621249999999245,2531.0526315789475,28,12,24,40
1836,1.209750000002061,2758.9444444444443,64,9,12,73
1837,-16.815749999997916,2446.9411764705883,51,12,9,63
1838,-10.637749999998658,1921.1764705882354,55,15,13,70
1839,-13.842999999997218,3206.0526315789475,55,17,12,72
1840,-17.229999999998874,3276.7,39,13,8,52
1841,-24.491499999998176,1673.7058823529412,28,13,11,41
1842,3.6735000000010074,2766.8333333333335,67,7,4,74
1843,-29.51874999999642,3908.5789473684213,62,11,17,73
1844,-25.815499999999524,1429.0,19,16,5,35
1845,-27.335999999997682,2843.4210526315787,49,13,7,62
1846,-23.526499999997903,2790.6111111111113,21,10,22,31
1847,-12.230499999998885,3019.7894736842104,39,10,30,49
1848,-23.28799999999766,3395.0,40,20,9,60
1849,-29.52124999999892,2745.842105263158,27,19,10,46
1850,-13.648499999998526,2475.8823529411766,51,17,19,68
1851,-16.26074999999879,2776.75,26,10,11,36
1852,-21.232499999996694,4399.0526315789475,72,22,17,94
1853,11.141000000003077,4343.1578947368425,88,14,7,102
1854,-20.478499999999137,2298.5555555555557,26,16,16,42
1855,4.49375000000356,2502.764705882353,76,11,8,87
1856,-16.970499999999554,2472.65,16,16,3,32
1857,3.4017500000031524,2631.705882352941,63,17,13,80
1858,-10.507499999998235,3658.0526315789475,70,24,3,94
1859,1.5080000000014273,2379.5882352941176,70,21,13,91
1860,-8.490499999997793,2477.6111111111113,44,9,6,53
1861,-17.110749999998287,1528.25,15,19,15,34
1862,-6.664749999996916,1697.9375,60,19,4,79
1863,-14.748249999998283,3237.85,44,20,6,64
1864,-21.192999999999152,2974.5789473684213,57,22,6,79
1865,-19.11624999999764,3672.7,48,12,14,60
1866,8.528500000003291,3377.315789473684,66,16,6,82
1867,-7.964749999998479,3757.6,50,12,4,62
1868,-13.505499999997946,2450.222222222222,33,5,13,38
1869,-16.18474999999733,5091.0,81,16,11,97
1870,-3.6972499999980064,2384.235294117647,49,11,3,60
1871,-12.427499999996142,2044.0,81,15,17,96
1872,6.177500000001535,3302.05,46,6,10,52
1873,7.526250000001683,3807.5789473684213,75,11,10,86
1874,-0.8512499999992287,2966.8823529411766,92,19,13,111
1875,-10.035249999999763,1429.0,21,14,9,35
1876,-22.18549999999717,2979.3333333333335,59,10,12,69
1877,-10.677999999997292,3838.3888888888887,96,20,12,116
1878,-15.559999999999638,2246.8947368421054,24,10,9,34
1879,-14.188999999997268,2715.722222222222,51,19,6,70
1880,-19.66524999999846,2595.2631578947367,27,5,19,32
1881,-17.10649999999806,2663.6111111111113,43,10,29,53
1882,-17.551499999998548,1648.3125,36,13,11,49
1883,-14.13374999999796,2601.0,65,17,10,82
1884,-13.5739999999991,2619.5263157894738,26,11,7,37
1885,-16.241749999996564,3333.0,66,13,15,79
1886,-4.164749999997684,4303.75,74,14,3,88
1887,2.5495000000015002,2293.705882352941,68,17,10,85
1888,-1.3812499999974355,3603.7,58,14,7,72
1889,-2.7064999999986057,1429.0,73,15,7,88
1890,7.683250000001918,4555.25,76,8,3,84
1891,-4.383249999996987,4273.6,70,9,9,79
1892,-20.18874999999848,2952.8888888888887,56,13,9,69
1893,6.231500000004755,5008.55,94,12,10,106
1894,-16.112499999995887,3326.8333333333335,74,12,8,86
1895,-1.9472499999979376,2853.9411764705883,66,3,10,69
1896,11.298500000002214,4301.3,64,8,7,72
1897,-32.015999999997035,2601.823529411765,69,16,20,85
1898,-3.9209999999979415,2013.5294117647059,68,18,8,86
1899,-13.869249999997843,3337.0,39,10,15,49
1900,-10.759999999998984,3119.4444444444443,61,18,13,79
1901,-5.016249999998431,4583.75,63,22,8,85
1902,-2.6342499999977504,1534.8666666666666,44,18,9,62
1903,-15.589749999999082,2084.222222222222,24,13,11,37
1904,-12.312249999997546,4402.368421052632,82,23,4,105
1905,-19.063749999998954,1992.0588235294117,22,16,8,38
1906,2.3130000000025133,3136.7368421052633,54,8,4,62
1907,-17.821749999998037,3229.9,33,19,10,52
1908,-1.7764999999974456,4091.85,76,6,6,82
1909,-13.612249999999099,3254.4444444444443,71,27,7,98
1910,-11.549499999998124,2700.7368421052633,37,2,12,39
1911,-14.97374999999808,3080.8888888888887,49,22,10,71
1912,-0.3352499999973597,4230.65,76,18,0,94
1913,-0.3352499999963676,4373.0,81,13,7,94
1914,-18.094999999997356,2239.4444444444443,39,13,14,52
1915,-16.363999999998022,3359.3,43,18,9,61
1916,-29.122499999998677,2602.0,34,11,10,45
1917,-27.785249999998747,1532.1875,25,17,13,42
1918,-32.641749999996534,2264.375,45,13,39,58
1919,-9.317499999997677,2295.529411764706,47,9,11,56
1920,-7.368749999998057,2360.222222222222,28,9,19,37
1921,-2.1192499999966365,5186.25,86,16,6,102
1922,-13.425249999995666,1481.9333333333334,71,21,14,92
1923,-14.699749999998796,2430.1052631578946,27,20,9,47
1924,-9.49549999999893,3471.6315789473683,52,20,5,72
1925,-14.49874999999823,1765.3125,55,14,16,69
1926,-11.0319999999975,2078.9411764705883,61,18,14,79
1927,-27.835249999996375,2625.4210526315787,28,6,30,34
1928,-6.538749999997276,4144.15,65,4,8,69
1929,-17.17199999999901,3539.315789473684,46,17,5,63
1930,-32.34799999999908,2699.823529411765,40,20,18,60
1931,-4.880999999999028,1844.6875,53,11,9,64
1932,-12.569499999998948,1853.6875,60,11,12,71
1933,-6.948249999997694,5071.1,66,10,20,76
1934,-6.949749999998363,3825.8333333333335,84,21,5,105
1935,-11.556249999998496,3556.0555555555557,80,21,13,101
1936,-27.5547499999975,4935.5,86,21,3,107
1937,-5.71399999999692,5100.55,78,17,9,95
1938,-1.5837499999978626,4123.55,61,5,11,66
1939,-14.58799999999834,1429.0,30,19,13,49
1940,-13.909999999998268,2017.2941176470588,39,9,11,48
1941,-18.85899999999842,2972.3333333333335,41,12,13,53
1942,-20.75099999999877,3529.85,49,17,10,66
1943,-25.060499999999156,1963.1764705882354,20,19,12,39
1944,-8.328999999996237,1796.125,74,9,8,83
1945,-24.85449999999775,2131.294117647059,44,12,31,56
1946,-16.096499999999747,2749.0526315789475,44,6,17,50
1947,11.470250000003166,5418.05,104,17,6,121
1948,-18.92824999999876,1429.0,27,18,6,45
1949,-4.785749999996685,2755.5625,78,13,13,91
1950,-4.81574999999813,2309.125,81,19,6,100
1951,-7.505999999996748,3843.5263157894738,55,8,25,63
1952,-1.910499999998083,3548.25,57,13,2,70
1953,-9.1187499999979,3644.5789473684213,70,11,11,81
1954,-18.669999999999128,1710.8125,48,13,20,61
1955,-15.85424999999733,1997.8333333333333,36,16,13,52
1956,-13.440499999998684,2624.0,58,19,11,77
1957,-18.770749999998586,3471.1,41,11,9,52
1958,-26.932249999997907,3329.9,38,10,11,48
1959,-19.026249999998655,3471.684210526316,66,13,14,79
1960,-12.184249999998908,2681.5,27,15,11,42
1961,-16.793999999999066,2573.6315789473683,38,20,5,58
1962,-14.381499999998912,3267.8947368421054,57,16,8,73
1963,1.707000000002953,4326.7,70,19,12,89
1964,5.201250000002074,3060.3888888888887,68,20,16,88
1965,-14.207749999999304,1930.0,14,9,6,23
1966,-12.899249999999011,2291.5,30,14,8,44
1967,-10.961249999998868,1539.0666666666666,31,16,7,47
1968,18.19550000000458,5651.3,108,7,6,115
1969,-3.344249999998369,3253.65,44,14,7,58
1970,-30.020999999997155,4407.55,62,11,17,73
1971,-18.354749999999203,1652.1666666666667,14,21,7,35
1972,-8.32299999999801,3008.45,43,5,11,48
1973,-22.943249999997697,3222.8,45,6,11,51
1974,-4.53349999999862,2874.4117647058824,66,19,16,85
1975,-17.847999999998336,3952.8,60,13,5,73
1976,-0.9859999999989355,2583.5789473684213,23,3,7,26
1977,-12.22874999999873,3352.9,38,15,11,53
1978,-16.651499999996645,2322.277777777778,51,14,17,65
1979,-1.2362499999975087,3116.294117647059,52,8,16,60
1980,2.2092500000029065,2064.0,89,6,5,95
1981,-8.221249999998786,2633.6666666666665,41,11,4,52
1982,-7.042249999998875,2815.5,29,3,14,32
1983,-18.50849999999831,2220.625,59,24,5,83
1984,4.1145000000017244,2677.470588235294,68,7,14,75
1985,-23.468499999998905,3319.5789473684213,41,16,20,57
1986,13.296500000003789,5044.2,83,1,10,84
1987,0.8875000000017055,3851.7368421052633,83,22,4,105
1988,-7.229749999998132,4311.210526315789,69,12,21,81
1989,-1.01049999999672,4208.526315789473,84,13,9,97
1990,-24.083249999998404,2600.1666666666665,41,20,5,61
1991,-7.284499999997889,3512.684210526316,63,18,4,81
1992,-23.024999999996744,4698.15,84,15,8,99
1993,-0.37174999999980846,1554.0625,37,29,7,66
1994,3.9992500000021125,2996.8888888888887,67,2,15,69
1995,0.6035000000007059,2690.9444444444443,46,20,13,66
1996,-9.065749999998191,2309.0625,66,17,9,83
1997,-21.515749999998462,2391.705882352941,49,24,4,73
1998,-9.635249999998612,3114.8947368421054,55,10,8,65
1999,-9.33174999999904,3601.25,35,19,13,54
2000,-28.691749999998798,3286.95,35,16,9,51
2001,-27.963249999997743,4067.15,54,13,5,67
2002,-17.559499999997623,2103.75,61,16,17,77
2003,-22.894250000000078,1429.0,12,13,31,25
2004,9.29125000000182,1719.75,78,15,6,93
2005,-3.6952499999961654,3881.0,74,7,14,81
2006,-24.847749999998427,2866.0,64,14,9,78
2007,13.847750000002623,4132.368421052632,80,18,6,98
2008,-4.498999999995087,4563.578947368421,84,15,20,99
2009,-2.7865000000000526,1438.5333333333333,6,4,1,10
2010,-14.838749999999283,2479.6470588235293,56,12,8,68
2011,-10.42424999999748,2103.777777777778,51,9,7,60
2012,-21.502499999997916,2354.1666666666665,64,19,15,83
2013,-14.657999999998754,3096.6315789473683,48,14,11,62
2014,-7.112499999999285,1941.6470588235295,47,12,10,59
2015,1.442000000003162,1626.5,61,16,4,77
2016,-16.538999999997873,3622.7,49,9,9,58
2017,-23.61399999999821,2552.4444444444443,41,20,17,61
2018,-19.28774999999782,2927.7894736842104,48,9,9,57
2019,-2.337999999998588,2357.625,55,20,10,75
2020,8.952250000004344,3284.4444444444443,79,9,17,88
2021,-7.409249999997788,2452.0625,69,11,20,80
2022,-1.2422499999983294,1539.0666666666666,37,8,10,45
2023,-14.722749999997735,3612.842105263158,62,10,8,72
2024,-25.737749999998886,1481.9333333333334,23,19,19,42
2025,-15.66099999999897,2258.1176470588234,48,20,11,68
2026,-17.589999999998458,2559.6666666666665,45,12,13,57
2027,-12.86499999999722,4832.25,76,15,8,91
2028,7.763000000001137,2576.5882352941176,51,11,4,62
2029,-0.9844999999970507,2219.9411764705883,49,3,18,52
2030,-11.479999999997915,3395.684210526316,53,14,19,67
2031,-24.38874999999805,3840.95,49,9,17,58
2032,-2.8837499999985217,3095.7,52,14,1,66
2033,1.8057500000034619,3693.842105263158,70,12,11,82
2034,-2.146999999999266,2575.5882352941176,44,17,7,61
2035,-8.25499999999966,1657.1875,10,9,5,19
2036,-20.931749999996935,2805.9473684210525,49,14,18,63
2037,-9.060999999998625,2719.1666666666665,65,15,8,80
2038,-18.383499999997262,2019.3125,22,14,31,36
2039,-9.335749999997656,3307.3888888888887,63,18,19,81
2040,-10.688749999997594,2768.5555555555557,53,13,11,66
2041,2.59400000000087,2592.277777777778,62,19,13,81
2042,1.1510000000041156,3316.9411764705883,88,13,10,101
2043,-33.06574999999834,3202.1,36,18,11,54
2044,-20.099499999998162,3510.157894736842,47,16,10,63
2045,-9.92174999999807,3538.4736842105262,73,15,5,88
2046,-13.653749999998416,2678.0526315789475,29,12,15,41
2047,3.6745000000016907,1837.1176470588234,58,17,8,75
2048,-9.533499999997987,3340.8333333333335,77,24,10,101
2049,-3.628749999999845,2109.842105263158,14,9,6,23
2050,-16.734249999998653,2198.1111111111113,25,14,6,39
2051,-11.42624999999679,2959.529411764706,65,8,11,73
2052,-4.1719999999985244,2346.1666666666665,55,10,3,65
2053,-20.282499999998045,1608.625,25,13,17,38
2054,-5.364749999998102,2497.5789473684213,42,15,8,57
2055,-29.392499999996737,3716.5555555555557,66,16,13,82
2056,-3.6287499999985933,4026.7,58,10,7,68
2057,-8.908249999995531,4835.9473684210525,88,20,14,108
2058,-16.432499999996026,2009.8235294117646,65,16,11,81
2059,-6.413499999997617,2255.3888888888887,44,11,12,55
2060,-15.15824999999883,3527.55,48,19,7,67
2061,-7.099249999999292,2135.3125,30,16,6,46
2062,5.759750000002284,3635.45,59,8,9,67
2063,4.373000000002233,1916.125,58,6,4,64
2064,-4.584749999997724,2904.4210526315787,34,8,17,42
2065,-0.4657499999974357,2731.5882352941176,74,14,5,88
2066,6.313000000001682,3675.0,52,8,9,60
2067,-10.231499999998391,2202.3888888888887,32,16,8,48
2068,3.701500000001468,2183.470588235294,37,6,2,43
2069,-12.575749999997587,3931.45,59,16,11,75
2070,-24.82249999999855,2974.684210526316,46,12,14,58
2071,-16.64200000000013,1429.0,3,11,6,14
2072,-15.807999999998563,1996.764705882353,30,13,15,43
2073,-10.73249999999817,2420.6470588235293,54,9,17,63
2074,8.25650000000093,3485.842105263158,63,7,6,70
2075,-7.868499999997129,3091.5789473684213,39,14,21,53
2076,-10.117249999998714,2176.0,41,9,13,50
2077,-11.479249999996771,2938.9411764705883,65,12,12,77
2078,-19.364999999997984,2357.625,63,24,12,87
2079,-0.29574999999718016,3076.5789473684213,54,7,11,61
2080,-13.986499999998562,2849.235294117647,60,15,16,75
2081,2.408750000005258,2816.5882352941176,90,15,15,105
2082,-8.042749999997627,2222.6666666666665,50,16,5,66
2083,-8.929249999999557,2133.6111111111113,38,15,6,53
2084,-27.003499999997484,2092.9411764705883,25,16,39,41
2085,-27.929749999997266,3583.5789473684213,52,5,17,57
2086,-3.1369999999988805,2843.4444444444443,56,18,15,74
2087,-29.51974999999781,3052.315789473684,31,19,11,50
2088,-9.626749999998125,3320.5789473684213,63,13,9,76
2089,-21.89274999999748,3460.0,47,13,17,60
2090,-7.1142499999967175,3268.6111111111113,66,18,9,84
2091,-4.58399999999855,3467.15,36,19,12,55
2092,-1.5129999999986923,1621.5,58,12,10,70
2093,-9.628999999999783,2413.1666666666665,48,21,9,69
2094,-11.157499999997187,2625.4210526315787,44,8,14,52
2095,15.23200000000071,2825.8888888888887,71,11,3,82
2096,1.6457500000018144,2660.1666666666665,45,11,7,56
2097,-32.40674999999898,2859.315789473684,33,20,13,53
2098,-16.993999999998284,3894.05,57,13,12,70
2099,1.5275000000027559,3908.55,61,15,3,76
2100,-11.011249999997734,3659.2,41,17,11,58
2101,-7.378499999998406,3698.1,44,14,10,58
2102,-9.854750000000042,1429.0,0,7,3,7
2103,2.740750000002607,5029.1,87,12,10,99
2104,-13.758749999996397,2304.722222222222,63,18,8,81
2105,-12.546249999998185,3957.7,54,11,7,65
2106,20.757500000001862,3482.8888888888887,82,19,4,101
2107,-19.252499999997,3989.6315789473683,71,17,14,88
2108,-16.84824999999691,2117.5625,55,6,14,61
2109,-11.064749999998726,2298.7894736842104,19,11,17,30
2110,-1.4684999999984498,2505.777777777778,40,5,6,45
2111,-10.808999999997672,2565.9473684210525,34,24,19,58
2112,17.86400000000175,2778.3529411764707,86,13,4,99
2113,-1.9667499999992288,3106.6315789473683,56,21,19,77
2114,-14.602749999996902,3841.842105263158,68,11,10,79
2115,-6.010749999995558,2434.0625,91,7,19,98
2116,-19.151249999998264,2818.8333333333335,61,18,8,79
2117,-0.729749999996937,2500.375,93,18,8,111
2118,-22.093749999999513,2937.0555555555557,55,27,12,82
2119,-21.32124999999834,2460.1052631578946,24,19,16,43
2120,2.4070000000016423,2066.764705882353,38,14,8,52
2121,-7.091999999997533,3750.9444444444443,73,16,12,89
2122,-15.327499999996771,4777.4,76,14,18,90
2123,5.415750000003533,4695.75,79,20,11,99
2124,-27.422249999999053,2207.65,17,16,7,33
2125,-15.827249999999262,2008.4,19,10,5,29
2126,-0.8987499999961619,2886.722222222222,72,13,15,85
2127,-12.73999999999805,2610.722222222222,43,9,10,52
2128,-30.435749999998308,1429.0,6,27,22,33
2129,-7.594999999999106,3094.842105263158,46,19,20,65
2130,-22.276499999997,2134.176470588235,59,11,11,70
2131,19.321500000002324,4211.6,70,11,11,81
2132,-18.08499999999727,4390.25,62,15,14,77
2133,-1.6197499999956413,2374.3333333333335,81,7,14,88
2134,-12.832249999998675,2384.375,72,23,5,95
2135,-5.8332499999983245,2208.823529411765,57,12,13,69
2136,-10.392249999998832,1653.25,25,14,2,39
2137,13.557000000001239,3897.3333333333335,93,18,5,111
2138,-5.581749999999717,2295.0555555555557,15,5,7,20
2139,-21.110999999998658,2850.1052631578946,31,13,16,44
2140,-28.322499999998325,2062.2631578947367,26,14,13,40
2141,-18.68799999999724,3191.8888888888887,52,11,22,63
2142,-5.147499999997641,3711.4210526315787,56,9,8,65
2143,-9.210499999998676,3111.55,43,11,5,54
2144,-2.422249999996235,3530.3888888888887,75,9,12,84
2145,-9.940749999997314,2664.5,50,14,13,64
2146,-17.696249999997654,2778.235294117647,54,10,14,64
2147,-9.844499999998778,1481.9333333333334,57,22,5,79
2148,-14.74049999999744,4192.736842105263,64,4,21,68
2149,-13.842749999998418,3249.4210526315787,47,12,12,59
2150,4.593500000003749,4421.421052631579,86,9,10,95
2151,3.856000000001349,3244.15,37,11,7,48
2152,-5.579249999999362,1527.1875,17,6,7,23
2153,-7.005499999996099,2891.1666666666665,50,20,34,70
2154,-7.921749999997767,3768.85,50,9,11,59
2155,-20.030749999998243,3137.0,32,19,9,51
2156,6.015750000003356,3564.8333333333335,75,13,14,88
2157,-30.919249999997636,3181.277777777778,48,18,14,66
2158,-13.489249999997194,4155.3,57,24,9,81
2159,16.43400000000313,2937.0,69,7,10,76
2160,-16.43949999999848,2913.1666666666665,41,18,22,59
2161,-14.156249999998673,3223.5,44,13,5,57
2162,-1.7007499999987394,2494.470588235294,50,20,9,70
2163,-12.529749999998483,3287.1,45,8,16,53
2164,-16.480999999998488,3209.3684210526317,49,14,6,63
2165,-15.690749999998971,2621.2105263157896,37,10,14,47
2166,-9.089999999998826,2756.4736842105262,33,14,8,47
2167,-26.583499999996388,2826.777777777778,42,8,29,50
2168,-13.869249999997972,2870.0555555555557,52,13,13,65
2169,8.368500000003067,2475.705882352941,72,14,7,86
2170,-12.42674999999885,2178.6666666666665,29,12,7,41
2171,-0.4767499999972923,4397.2,61,10,17,71
2172,-8.40649999999732,2482.5263157894738,42,17,17,59
2173,-0.4424999999979965,2581.1052631578946,43,4,6,47
2174,-15.645749999999193,2734.7368421052633,30,10,20,40
2175,-6.396999999998621,2922.8888888888887,62,4,8,66
2176,6.1957500000029135,5504.45,94,11,15,105
2177,-16.640749999997876,3034.684210526316,48,12,14,60
2178,-0.055499999998620805,3933.05,56,6,8,62
2179,2.0390000000026585,4040.95,63,14,7,77
2180,-6.499499999999125,2365.4444444444443,57,3,11,60
2181,-16.849249999998793,2672.7,29,13,13,42
2182,-12.814249999996292,2650.6111111111113,73,12,8,85
2183,-8.863249999998114,3822.8,60,10,10,70
2184,-23.850999999998024,2960.5263157894738,45,16,9,61
2185,1.0445000000019256,3330.3888888888887,90,21,4,111
2186,-18.42949999999825,3860.75,57,9,7,66
2187,-0.9015000000011415,1429.0,29,3,25,32
2188,-21.22099999999594,3279.222222222222,78,17,15,95
2189,-11.146749999999262,1782.25,47,12,7,59
2190,1.011000000003051,3369.842105263158,64,7,9,71
2191,-20.56599999999998,1505.4375,17,25,16,42
2192,-5.791249999998244,2781.6315789473683,40,9,8,49
2193,-12.641999999999033,3146.7368421052633,43,17,6,60
2194,-10.629499999997705,4278.25,67,6,13,73
2195,-14.417749999999533,2030.3529411764705,33,11,26,44
2196,-5.412999999999005,2627.45,27,11,11,38
2197,-22.40449999999849,2594.3684210526317,29,12,10,41
2198,-25.133999999998117,3393.777777777778,57,14,21,71
2199,-11.754249999998116,2906.1111111111113,37,14,9,51
2200,2.934250000000109,1438.5333333333333,37,7,6,44
2201,-21.741249999998356,2452.4736842105262,29,9,20,38
2202,-0.48024999999910795,3135.3888888888887,71,14,12,85
2203,-19.481499999997187,4012.315789473684,81,15,12,96
2204,-11.614749999998088,2935.277777777778,56,14,12,70
2205,-4.89324999999863,2459.0588235294117,67,2,17,69
2206,-26.73299999999919,2084.1052631578946,14,22,7,36
2207,19.65425000000267,4497.526315789473,96,17,8,113
2208,-6.006499999997786,3140.0,55,14,6,69
2209,-26.91224999999895,3032.222222222222,50,14,27,64
2210,-1.7834999999970165,5005.15,87,15,8,102
2211,-0.27224999999822164,3086.1111111111113,74,17,9,91
2212,-13.794249999999007,2802.0555555555557,48,17,12,65
2213,-6.451249999996621,4678.35,71,12,13,83
2214,-13.986749999999015,1429.0,22,8,8,30
2215,-4.725999999997567,3221.823529411765,83,9,16,92
2216,-13.292999999999491,1684.0,22,13,9,35
2217,-21.734499999998626,3124.9473684210525,40,10,14,50
2218,-7.870499999997925,3148.722222222222,61,18,3,79
2219,-8.090999999997404,4194.368421052632,81,12,13,93
2220,-19.640249999995817,2169.5882352941176,37,23,27,60
2221,-22.9117499999981,2614.8823529411766,51,19,16,70
2222,11.554000000001647,3338.684210526316,53,9,5,62
2223,-7.8932500000001315,2246.5,45,14,8,59
2224,-7.668249999996766,4214.473684210527,91,22,4,113
2225,-10.889999999999393,1429.0,13,12,3,25
2226,-1.4912499999988267,2520.8888888888887,69,9,15,78
2227,-3.524749999998883,2064.8888888888887,26,2,16,28
2228,9.107250000001645,3476.6666666666665,82,16,12,98
2229,-18.590499999998165,3090.15,43,16,8,59
2230,-8.850499999999014,2952.8333333333335,62,19,12,81
2231,-4.8629999999990705,2452.0,56,11,15,67
2232,-18.03499999999807,2145.176470588235,37,13,8,50
2233,-4.993499999997234,4892.55,81,10,10,91
2234,-3.816999999998287,2164.8823529411766,40,7,21,47
2235,3.7545000000029445,5318.85,93,14,15,107
2236,-10.981749999997719,3526.0526315789475,55,6,8,61
2237,-6.300999999998801,2853.3888888888887,66,18,11,84
2238,-15.700499999999016,2163.6111111111113,33,8,32,41
2239,3.335250000001447,2572.7368421052633,32,11,8,43
2240,-9.041249999995838,5860.75,97,18,14,115
2241,-10.405749999998127,3152.2,42,7,13,49
2242,-13.567999999998483,3008.4,40,9,6,49
2243,-12.251249999999246,2545.5,52,18,16,70
2244,-13.779499999998567,2758.3684210526317,43,14,15,57
2245,-14.428500000000085,2072.4210526315787,34,13,26,47
2246,-2.076999999997782,3402.5555555555557,59,15,13,74
2247,-12.47149999999829,2382.294117647059,52,12,4,64
2248,-12.51299999999667,4448.1,69,12,7,81
2249,-0.8279999999977556,4202.8,75,12,9,87
2250,1.1140000000026062,3046.3684210526317,56,14,6,70
2251,20.425250000002716,2705.0,78,15,8,93
2252,15.863750000003417,2619.529411764706,73,6,16,79
2253,-23.99099999999735,3585.4,49,12,11,61
2254,-23.828499999997025,3345.3888888888887,51,17,17,68
2255,-3.054749999997222,4703.6,69,11,12,80
2256,-9.961749999998672,2513.1176470588234,56,19,13,75
2257,-5.789999999998811,3488.3684210526317,61,14,9,75
2258,-7.084499999996121,2840.75,101,14,9,115
2259,8.798750000004118,3136.277777777778,82,7,14,89
2260,1.8737500000026053,2247.5,79,14,7,93
2261,-9.615999999996014,2851.4444444444443,64,25,12,89
2262,-13.428749999996535,2282.25,63,10,28,73
2263,3.965000000001767,2625.5625,102,7,20,109
2264,-28.882999999996866,2192.6666666666665,41,16,21,57
2265,-8.21024999999845,3170.1052631578946,56,19,14,75
2266,-4.8307499999985195,1505.4375,59,16,11,75
2267,-8.845249999997304,2978.9473684210525,43,7,18,50
2268,4.435000000002214,5579.85,98,18,6,116
2269,-1.0789999999985482,3169.55,43,17,5,60
2270,-18.54624999999625,3008.1176470588234,74,15,9,89
2271,-7.061999999998679,2627.157894736842,35,14,17,49
2272,12.296250000002496,5394.15,80,30,5,110
2273,-15.767999999999319,2221.842105263158,17,12,5,29
2274,-2.825499999998074,3617.25,54,12,6,66
2275,-15.40974999999734,2586.0555555555557,52,6,11,58
2276,-10.58224999999765,2594.8125,74,18,15,92
2277,-2.2832499999985503,3087.75,41,6,14,47
2278,-22.69924999999916,2237.1,19,5,10,24
2279,-11.699749999998362,2708.4,30,8,21,38
2280,-8.247999999998166,2501.4444444444443,36,5,11,41
2281,-2.5699999999989176,3363.2,44,19,5,63
2282,-4.584249999996002,2770.764705882353,59,9,20,68
2283,-28.331499999998265,3354.4,36,14,17,50
2284,0.5762500000015608,4114.9473684210525,86,12,4,98
2285,-16.773999999999468,1438.5333333333333,45,26,4,71
2286,-11.900249999998191,3287.0,40,16,7,56
2287,-9.767249999998823,2489.1666666666665,32,7,33,39
2288,-5.147749999997844,3094.25,38,10,8,48
2289,5.009500000001596,4479.1,77,18,4,95
2290,-38.88049999999801,2091.9411764705883,30,6,34,36
2291,-15.279499999996796,3756.5263157894738,69,9,12,78
2292,-9.70049999999831,1987.5625,57,22,6,79
2293,-7.79625000000032,2016.3333333333333,46,25,14,71
2294,-9.432249999999236,2967.0526315789475,62,22,5,84
2295,-15.394249999997744,3345.277777777778,51,20,20,71
2296,9.642000000002685,4722.8,83,2,9,85
2297,6.127750000001433,2765.1176470588234,61,6,27,67
2298,-17.573249999998758,2822.0,30,14,10,44
2299,10.878250000003122,4952.210526315789,101,16,9,117
2300,-8.127749999997707,4444.2,67,10,9,77
2301,-3.5124999999975315,2371.625,53,2,16,55
2302,-19.912499999999348,2215.315789473684,14,11,9,25
2303,12.379250000002383,3854.315789473684,88,9,7,97
2304,-20.193499999998487,3178.3684210526317,33,6,16,39
2305,-6.451999999997524,3883.85,54,14,12,68
2306,-36.4162499999979,2818.4736842105262,37,6,18,43
2307,-1.3209999999984827,1933.9375,57,19,12,76
2308,-3.813499999997629,4218.8,59,15,17,74
2309,-8.460249999998817,2138.764705882353,31,15,8,46
2310,-35.18649999999538,2010.4375,46,11,35,57
2311,4.305000000001345,3064.7894736842104,48,16,8,64
2312,-14.833249999997992,3204.277777777778,53,15,15,68
2313,-5.911999999997947,2023.3125,61,14,10,75
2314,-5.606499999997661,2353.3529411764707,76,18,15,94
2315,8.749500000001825,2139.5882352941176,54,14,21,68
2316,-7.855499999997832,3876.842105263158,85,15,8,100
2317,-0.30024999999710916,3168.9444444444443,69,15,4,84
2318,-3.797999999995832,2623.3529411764707,82,12,13,94
2319,7.180500000002556,3005.0,78,6,9,84
2320,-23.6367499999992,2598.7368421052633,31,3,25,34
2321,-20.440750000000765,1429.0,0,11,29,11
2322,-17.926749999999842,1429.0,0,10,5,10
2323,2.2830000000023922,2839.1111111111113,56,4,11,60
2324,-7.8097499999995295,2774.9473684210525,37,6,17,43
2325,-19.03049999999885,2975.4736842105262,32,11,17,43
2326,-5.070999999998557,3223.5,37,10,6,47
2327,-25.617499999998792,2628.842105263158,31,12,19,43
2328,-16.757999999999647,2640.3684210526317,28,16,27,44
2329,-3.169749999999045,1907.25,50,16,4,66
2330,-12.526249999996718,3435.222222222222,54,9,18,63
2331,-5.923499999999538,2986.315789473684,58,12,20,70
2332,-6.717499999998348,3227.4,49,7,1,56
2333,-2.252249999998594,2366.625,62,7,17,69
2334,-17.608749999998093,2580.8333333333335,34,17,11,51
2335,-32.53924999999754,2148.0588235294117,32,19,24,51
2336,-10.63849999999679,3137.1111111111113,54,13,22,67
2337,0.3710000000011848,3167.1666666666665,74,15,15,89
2338,-7.676249999996555,2948.1176470588234,53,10,30,63
2339,-6.2494999999985605,2332.8823529411766,66,9,13,75
2340,-13.316249999996426,2579.470588235294,65,21,10,86
2341,8.437500000002009,3437.4117647058824,85,12,8,97
2342,2.6112500000022063,4750.55,81,10,8,91
2343,-2.6669999999980485,2484.176470588235,69,15,7,84
2344,-19.86099999999997,1429.0,12,22,7,34
2345,3.8912500000027017,2627.0588235294117,82,14,18,96
2346,-7.2044999999984585,1576.875,28,5,9,33
2347,4.565750000003912,4518.421052631579,88,9,21,97
2348,-10.483749999996274,4328.789473684211,84,21,12,105
2349,-20.600999999998475,2099.157894736842,19,23,14,42
2350,-40.10874999999918,1612.5625,18,28,12,46
2351,-2.030749999998012,3818.8333333333335,84,13,8,97
2352,5.790000000003522,4599.8,85,18,12,103
2353,-10.985249999998555,2745.85,36,11,10,47
2354,3.5652500000034912,4348.8421052631575,77,6,10,83
2355,10.114250000002453,3385.9444444444443,95,9,6,104
2356,-22.344249999997963,2377.9444444444443,28,11,27,39
2357,-11.039749999998415,2000.4375,59,15,9,74
2358,-5.050249999995344,4171.555555555556,100,10,15,110
2359,-3.342499999998367,3116.35,47,9,9,56
2360,-8.426999999997111,2318.0625,57,13,23,70
2361,-12.385249999997916,2953.7368421052633,49,15,10,64
2362,-9.34699999999925,1576.875,13,5,11,18
2363,-2.5597499999974085,2367.4117647058824,55,13,16,68
2364,-22.091999999998954,2697.3,27,12,14,39
2365,-12.645499999999199,2054.125,41,15,20,56
2366,-24.61299999999732,1429.0,24,14,21,38
2367,-0.664499999998797,2063.9411764705883,36,6,13,42
2368,-25.347999999998727,2147.722222222222,17,12,17,29
2369,4.849000000002493,2705.8125,90,11,10,101
2370,-10.63349999999805,2835.1052631578946,39,15,7,54
2371,-6.081249999999009,2072.8888888888887,22,9,10,31
2372,-21.38474999999839,2263.277777777778,28,16,12,44
2373,-4.828249999997464,2572.9411764705883,52,6,8,58
2374,-12.0707499999977,2780.0,53,10,11,63
2375,-12.992249999997295,3122.8823529411766,75,6,18,81
2376,-14.234249999998994,3437.0,88,20,9,108
2377,-19.54049999999898,1997.0,29,23,8,52
2378,-14.417999999997164,2607.4117647058824,56,20,3,76
2379,-11.659749999999269,1481.9333333333334,45,20,10,65
2380,-11.968999999997472,2382.3333333333335,34,13,20,47
2381,2.314250000001638,3344.842105263158,67,13,11,80
2382,-20.425999999998616,1689.0,33,21,2,54
2383,-12.894749999997847,2585.176470588235,56,20,13,76
2384,-16.695499999997626,2409.6666666666665,47,12,12,59
2385,14.425750000002129,3092.0,84,16,12,100
2386,-7.525999999997734,2786.705882352941,60,19,9,79
2387,-9.09399999999775,3613.7894736842104,83,11,11,94
2388,-1.046499999996709,2882.4444444444443,64,10,9,74
2389,-6.759749999998492,2711.222222222222,47,12,16,59
2390,-6.1382499999990525,2897.4444444444443,59,19,12,78
2391,-4.13174999999747,2517.764705882353,81,12,13,93
2392,-13.533499999998435,2425.5555555555557,61,13,13,74
2393,-28.001249999998635,2723.55,29,17,9,46
2394,-4.054749999997468,2308.6470588235293,53,16,5,69
2395,-13.03499999999664,3490.157894736842,57,18,11,75
2396,0.7445000000022868,2306.3888888888887,53,12,4,65
2397,-31.467749999997828,2414.0555555555557,42,14,8,56
2398,-16.920249999997445,4216.45,59,4,12,63
2399,-11.77849999999705,2469.8125,67,17,18,84
2400,8.79125000000406,3036.0588235294117,83,15,9,98
2401,-13.632749999997696,4219.6,51,12,14,63
2402,-4.864000000000115,2048.1111111111113,39,13,10,52
2403,-8.6872499999979,3044.6111111111113,58,15,13,73
2404,-20.456749999998216,2617.842105263158,37,17,7,54
2405,-19.15449999999906,1850.5555555555557,16,9,11,25
2406,-15.281999999999169,2735.45,30,11,6,41
2407,-10.017749999998802,2879.6666666666665,59,22,6,81
2408,8.390000000001184,2157.25,63,13,9,76
2409,-1.36174999999866,3921.157894736842,57,14,10,71
2410,-28.929499999999628,2566.0,31,16,36,47
2411,-12.199999999999596,2044.1,17,19,2,36
2412,-14.921749999998317,2670.5263157894738,31,15,14,46
2413,-13.382249999998795,2521.470588235294,70,17,13,87
2414,-6.239749999999013,2107.75,45,7,16,52
2415,-22.198999999999586,2562.7368421052633,30,12,20,42
2416,-23.927499999996805,1534.8666666666666,38,15,22,53
2417,-9.5142499999992,1576.875,31,15,8,46
2418,-4.5289999999989154,2481.5789473684213,25,12,5,37
2419,-1.2092499999971775,3518.3684210526317,67,3,12,70
2420,4.9225000000025805,4267.95,70,20,7,90
2421,0.7225000000026334,4168.75,65,13,11,78
2422,-1.1834999999991176,1532.1875,37,16,9,53
2423,-4.9609999999973775,4245.368421052632,72,10,25,82
2424,-22.936999999998097,3112.4,41,16,11,57
2425,-18.910499999997473,2768.2631578947367,27,13,18,40
2426,-17.01324999999776,3337.05,40,11,11,51
2427,-20.38124999999834,3945.7,50,16,7,66
2428,-0.9682499999983418,3336.764705882353,76,15,6,91
2429,18.296000000003286,2278.3125,73,9,15,82
2430,-7.884749999997571,2561.0526315789475,45,11,11,56
2431,-8.282249999997331,2572.0,53,19,16,72
2432,-8.977999999996605,2962.722222222222,71,7,8,78
2433,8.999250000001135,2740.0,55,17,8,72
2434,-17.718999999997685,3663.842105263158,55,18,16,73
2435,-0.9862499999972186,2043.4705882352941,52,18,6,70
2436,-10.051749999996664,2019.375,59,12,7,71
2437,-3.637500000000357,1429.0,44,26,4,70
2438,-8.069249999999354,2235.2631578947367,15,8,5,23
2439,-18.228749999997543,2911.5,61,21,9,82
2440,-3.037999999997317,2861.9444444444443,55,11,5,66
2441,-5.8732499999977446,2143.25,71,10,17,81
2442,-23.78799999999967,2473.2631578947367,30,19,9,49
2443,5.307250000001822,2729.8333333333335,89,13,2,102
2444,-11.182249999998456,2967.1052631578946,50,21,5,71
2445,-11.945249999999197,2184.3684210526317,21,7,3,28
2446,-16.026499999998897,2473.1666666666665,42,11,23,53
2447,-17.417749999997373,2485.5,48,13,13,61
2448,-1.8722499999984432,2475.823529411765,73,18,15,91
2449,-4.2749999999977115,3684.65,48,13,3,61
2450,-9.280249999998023,3044.722222222222,55,15,9,70
2451,-0.9672499999972057,2631.705882352941,51,11,21,62
2452,-3.4367499999991273,2116.0555555555557,36,11,5,47
2453,-25.094999999997366,1875.3529411764705,30,21,23,51
2454,-5.781499999997811,3994.6315789473683,66,14,12,80
2455,-14.122999999998706,2203.277777777778,32,17,22,49
2456,-10.537249999998254,3463.2631578947367,71,19,9,90
2457,-3.69899999999719,3397.3333333333335,64,7,8,71
2458,-7.165749999999159,2718.9473684210525,34,16,5,50
2459,-17.436999999998402,3075.9,38,6,13,44
2460,-6.201499999999429,2519.2105263157896,25,25,2,50
2461,11.05725000000333,1934.0,92,8,14,100
2462,-14.390499999998477,3140.25,40,14,11,54
2463,-15.315749999999207,1616.5625,17,9,7,26
2464,-0.9699999999971693,3629.5789473684213,71,8,5,79
2465,-15.606499999998032,1429.0,27,21,6,48
2466,-4.447999999998456,2425.470588235294,46,9,12,55
2467,3.0730000000025184,4550.55,86,15,2,101
2468,-10.19349999999724,3279.6470588235293,83,15,6,98
2469,0.5385000000010786,2562.222222222222,66,17,3,83
2470,-9.500499999998933,1887.5294117647059,38,11,22,49
2471,-9.63949999999687,2485.6111111111113,49,4,22,53
2472,-6.861249999996348,2523.3125,89,13,13,102
2473,7.502750000003514,3315.3888888888887,74,12,15,86
2474,-0.37024999999727337,1909.0,52,17,6,69
2475,1.5005000000025253,1505.4375,84,16,7,100
2476,-17.417249999998383,2580.8333333333335,30,11,22,41
2477,-0.0037499999987423037,3057.2631578947367,64,12,9,76
2478,-4.484499999997029,2147.9411764705883,51,9,12,60
2479,-14.40674999999803,3829.1,62,12,7,74
2480,-4.963999999996341,1939.0,61,17,14,78
2481,1.1745000000030008,1799.7058823529412,47,9,24,56
2482,-4.531249999996761,3909.3684210526317,61,10,13,71
2483,-7.713999999998883,2997.25,28,13,5,41
2484,-1.7922499999990005,2406.8888888888887,46,13,10,59
2485,-13.501749999996028,1930.0625,62,12,17,74
2486,-41.31424999999922,1893.0588235294117,12,30,11,42
2487,-13.69524999999833,3180.75,48,12,3,60
2488,-6.24374999999903,1572.8235294117646,11,15,10,26
2489,-27.544499999996834,1626.5,50,16,9,66
2490,-20.393249999999256,2606.85,24,15,6,39
2491,-25.063249999996337,4665.6,73,11,15,84
2492,-28.20849999999741,3091.6315789473683,53,12,6,65
2493,-0.832499999997592,2559.705882352941,51,14,9,65
2494,-23.455999999999356,2730.6111111111113,64,24,14,88
2495,-12.39599999999921,2801.6315789473683,44,14,3,58
2496,-28.604499999999064,2122.764705882353,28,22,18,50
2497,-11.989499999998435,1834.6666666666667,16,17,17,33
2498,-17.6317499999994,2140.0526315789475,30,23,6,53
2499,-18.432749999998002,4089.4,48,14,17,62
2500,-6.37399999999848,2694.7368421052633,44,9,12,53
2501,-1.831749999998289,3854.2631578947367,76,14,8,90
2502,-3.245249999998488,3233.1,45,7,5,52
2503,1.8592500000019136,2357.6875,72,21,4,93
2504,-20.942499999998592,2758.8888888888887,43,21,30,64
2505,20.437750000005803,4783.315789473684,107,7,11,114
2506,3.8402500000023805,3537.05,57,9,7,66
2507,0.19875000000187892,2311.3529411764707,62,16,4,78
2508,-7.898249999997968,4437.1,70,11,8,81
2509,-8.475999999998816,2987.0526315789475,61,18,5,79
2510,-7.018249999998306,3678.0,75,20,8,95
2511,-13.13274999999744,2798.5,46,7,20,53
2512,-19.31574999999748,2082.4444444444443,45,12,5,57
2513,-16.765750000000185,2165.0526315789475,18,13,27,31
2514,-2.5409999999980797,2452.8125,84,10,5,94
2515,-16.40124999999772,4020.4,51,18,14,69
2516,8.272500000003939,2945.8333333333335,59,11,24,70
2517,0.8117500000024874,2843.5263157894738,49,12,8,61
2518,-3.676249999998619,2370.235294117647,58,25,5,83
2519,-5.8799999999977945,2316.0588235294117,31,9,16,40
2520,-5.84349999999788,1532.1875,49,16,5,65
2521,-20.389249999999357,2905.3333333333335,56,25,8,81
2522,0.6315000000011567,2353.4117647058824,72,19,5,91
2523,-5.3747499999984125,2698.0,31,5,18,36
2524,-2.028249999996931,4359.35,74,6,15,80
2525,-6.184499999999066,2587.777777777778,62,20,9,82
2526,-5.191499999999769,2147.8333333333335,38,13,23,51
2527,-12.223249999996487,2463.6470588235293,49,13,22,62
2528,-17.9409999999996,1539.235294117647,8,20,1,28
2529,-3.0252499999966354,2753.0,90,20,9,110
2530,-12.917499999998403,2192.875,43,21,2,64
2531,-9.550999999998833,2018.4375,57,17,9,74
2532,-8.080249999997287,3404.8947368421054,50,13,13,63
2533,-9.462999999998749,3080.7894736842104,41,19,8,60
2534,-0.605499999998593,3099.8,41,11,8,52
2535,-24.01549999999881,2409.6111111111113,39,20,11,59
2536,-23.006499999998546,2465.277777777778,55,19,10,74
2537,-24.732749999999456,2155.0526315789475,16,22,5,38
2538,-13.689999999996356,1742.5625,42,16,25,58
2539,17.64825000000277,4718.7,91,4,3,95
2540,-8.678999999996666,4493.368421052632,76,21,11,97
2541,-28.229999999999016,2052.3684210526317,16,21,2,37
2542,-6.711999999997749,2129.4117647058824,45,9,7,54
2543,-3.592499999998207,2779.1111111111113,50,21,11,71
2544,-20.87774999999695,1481.9333333333334,37,14,21,51
2545,12.639250000002223,4449.75,70,13,12,83
2546,-15.669249999997145,2941.2105263157896,43,12,18,55
2547,6.146750000003255,3287.1666666666665,69,10,13,79
2548,-7.460999999998917,3488.55,49,19,1,68
2549,-20.786749999997078,3049.0,65,18,15,83
2550,-20.89349999999754,3601.35,46,15,15,61
2551,-11.17549999999778,4004.7368421052633,75,7,7,82
2552,-11.25574999999844,2968.8333333333335,46,9,14,55
2553,-7.43099999999786,1880.4375,47,10,3,57
2554,-5.876999999997425,4117.526315789473,76,15,11,91
2555,-23.23799999999969,1555.0625,8,23,4,31
2556,-9.411999999998793,2220.764705882353,70,17,8,87
2557,-21.672249999998797,3145.7894736842104,32,21,6,53
2558,-15.538749999999391,2042.5294117647059,32,20,4,52
2559,-18.208999999999342,2047.1176470588234,24,7,41,31
2560,0.7540000000024509,2736.294117647059,92,16,8,108
2561,3.3512500000033847,4616.35,78,16,5,94
2562,3.550000000003803,2430.1176470588234,69,9,13,78
2563,8.985500000000176,2269.3529411764707,65,29,4,94
2564,-12.345749999998306,3091.5263157894738,37,16,7,53
2565,-5.480999999998803,2634.5555555555557,57,20,5,77
2566,-34.329999999998876,2055.5882352941176,48,20,17,68
2567,-10.398499999997679,2821.5,50,8,12,58
2568,-2.820749999998335,2785.5,54,15,5,69
2569,-11.397749999999592,1941.3333333333333,15,12,5,27
2570,-14.191499999996955,2828.705882352941,61,12,15,73
2571,-5.171999999998337,3655.3,55,21,3,76
2572,-17.07924999999881,3190.157894736842,59,13,10,72
2573,-16.52274999999906,2805.3,33,18,6,51
2574,-1.0309999999984343,2532.222222222222,43,15,7,58
2575,-20.71249999999886,2691.05,27,14,10,41
2576,-25.62249999999812,1996.4375,39,22,17,61
2577,4.3647500000019,2407.3125,81,12,14,93
2578,-13.603249999999647,2378.1052631578946,53,14,5,67
2579,-7.7664999999980395,3898.15,56,8,11,64
2580,-11.603999999998518,3540.15,57,9,3,66
2581,-8.193499999998277,3598.9,47,17,4,64
2582,-8.457249999998876,3012.8333333333335,58,15,15,73
2583,-15.69374999999954,1710.75,21,27,12,48
2584,2.9745000000022443,4167.684210526316,92,14,0,106
2585,-18.547999999996456,2517.3333333333335,54,15,13,69
2586,-15.537999999997428,2794.1111111111113,60,8,12,68
2587,-10.089749999998487,2886.2,36,15,7,51
2588,12.798750000002746,4328.789473684211,84,7,10,91
2589,-1.4744999999986104,3078.45,46,11,6,57
2590,-18.64999999999893,2444.2631578947367,29,13,5,42
2591,-3.157999999997247,3139.0,63,17,7,80
2592,-5.994249999998654,2148.0588235294117,63,15,13,78
2593,-11.138749999998861,2097.529411764706,45,21,4,66
2594,-11.733999999998613,2286.25,71,18,8,89
2595,-9.941249999997751,2473.1666666666665,58,17,9,75
2596,-24.731999999999093,2083.1052631578946,18,16,6,34
2597,9.272750000004033,2110.764705882353,70,21,10,91
2598,2.057500000001803,2484.1176470588234,49,16,7,65
2599,-8.53399999999831,3778.2631578947367,77,14,2,91
2600,-14.568999999997327,4508.5,65,17,10,82
2601,-22.508499999999625,2794.0555555555557,47,19,15,66
2602,-1.3774999999993265,2084.5882352941176,29,6,11,35
2603,-18.600249999998212,2257.4117647058824,41,11,9,52
2604,2.1432500000018786,2584.1176470588234,46,12,8,58
2605,-6.964499999998829,2089.75,57,20,4,77
2606,9.74175000000118,3460.8333333333335,82,28,3,110
2607,-28.083999999996944,2413.176470588235,50,11,17,61
2608,-18.98649999999869,2790.6666666666665,54,22,8,76
2609,-19.506499999997637,2714.764705882353,46,13,21,59
2610,-0.046749999999160075,3146.7368421052633,52,18,5,70
2611,-5.297249999995605,4247.789473684211,85,16,14,101
2612,-18.58099999999826,3851.8947368421054,68,24,9,92
2613,-8.74949999999958,2155.722222222222,32,8,10,40
2614,-3.5147499999990934,2974.3,32,11,8,43
2615,-1.9722499999958962,2741.0,75,3,19,78
2616,1.3395000000022503,2604.6470588235293,56,17,4,73
2617,-14.343499999999684,1429.0,27,21,8,48
2618,2.9837500000022574,1481.9333333333334,52,16,7,68
2619,-10.371999999998888,2883.85,32,15,5,47
2620,4.554000000002249,3745.05,62,18,3,80
2621,-0.6957499999977033,4464.8,79,9,10,88
2622,-16.221499999999004,1559.0,17,16,3,33
2623,-28.6274999999982,3629.8,39,27,8,66
2624,-6.1687499999972575,2371.5,69,14,12,83
2625,-15.496999999997811,3548.2,53,11,10,64
2626,-12.89649999999691,2978.5,51,19,15,70
2627,-21.17174999999888,1429.0,12,18,12,30
2628,-26.19524999999668,2395.5,54,18,10,72
2629,12.8755000000013,2983.6666666666665,65,12,10,77
2630,-13.451499999998186,2716.4736842105262,42,16,4,58
2631,-10.06174999999756,3581.9473684210525,67,14,5,81
2632,-14.335249999999068,2120.0,21,18,1,39
2633,-19.769499999998754,2654.8888888888887,45,8,19,53
2634,-21.145499999997945,2425.294117647059,50,29,18,79
2635,3.006250000002643,3589.4736842105262,63,10,10,73
2636,-12.491999999998754,2528.722222222222,68,20,9,88
2637,-17.338499999998277,2966.9473684210525,41,13,9,54
2638,7.865750000004051,1626.5,68,9,16,77
2639,-16.624999999998415,3241.8947368421054,46,20,6,66
2640,-11.61574999999701,4005.5789473684213,62,19,17,81
2641,-13.97249999999969,2493.315789473684,32,13,16,45
2642,-13.430749999998971,1621.5,28,11,16,39
2643,-12.501999999998983,2013.4705882352941,53,10,6,63
2644,-13.508249999997323,3901.35,48,15,16,63
2645,-8.18624999999923,3029.684210526316,46,19,4,65
2646,-15.531999999997637,1978.625,51,17,26,68
2647,1.7932500000038103,4106.578947368421,77,19,12,96
2648,-4.5649999999992374,2126.4117647058824,56,13,7,69
2649,1.0095000000004428,1893.4375,65,17,17,82
2650,-10.576249999998748,2295.4210526315787,24,13,7,37
2651,-9.622999999997877,3694.5,75,27,7,102
2652,-3.0594999999996633,2846.45,31,13,5,44
2653,-26.10999999999866,2959.684210526316,42,8,9,50
2654,-13.565999999998041,3236.2631578947367,45,13,11,58
2655,-22.889249999998007,2917.470588235294,52,17,20,69
2656,10.4810000000039,3527.0,79,17,12,96
2657,-17.988999999998935,2783.85,26,17,7,43
2658,-20.93849999999818,2761.6315789473683,38,17,6,55
2659,-4.261499999998149,3553.4736842105262,65,16,11,81
2660,-5.8354999999977855,4352.1,67,21,9,88
2661,-9.95074999999699,3965.6,39,7,25,46
2662,-7.803749999997907,2053.125,77,18,11,95
2663,-14.266749999996867,4899.7,79,6,15,85
2664,-16.276999999997766,3215.235294117647,71,9,23,80
2665,-3.882749999995989,1942.6470588235295,66,7,13,73
2666,-15.913749999997307,2103.75,67,23,7,90
2667,-18.2462499999977,2588.684210526316,30,12,20,42
2668,-16.52924999999832,2812.6666666666665,53,14,8,67
2669,-11.82224999999836,2489.0,56,19,18,75
2670,-9.96974999999951,2675.5263157894738,44,20,14,64
2671,-4.747999999999716,1429.0,16,5,2,21
2672,-24.822249999997638,3338.277777777778,72,13,16,85
2673,2.2700000000011946,2597.0588235294117,79,12,5,91
2674,4.934000000002936,4955.263157894737,108,27,6,135
2675,-3.291249999997201,1577.2,63,9,5,72
2676,-8.850249999996475,2177.8823529411766,55,11,13,66
2677,0.5662500000009839,3119.5,55,20,8,75
2678,-16.16474999999911,3021.4210526315787,66,16,9,82
2679,-11.600999999999468,2044.5555555555557,34,22,1,56
2680,-5.892999999996927,4833.05,73,14,16,87
2681,-23.711749999998528,2703.9473684210525,24,15,14,39
2682,-0.4584999999984259,2580.294117647059,70,20,9,90
2683,-4.080999999997369,1612.5625,49,11,7,60
2684,-18.39049999999854,2184.0,53,23,11,76
2685,-33.59074999999758,2341.294117647059,50,13,25,63
2686,-19.843249999999195,1523.25,28,20,6,48
2687,2.429250000001628,3433.2105263157896,73,13,5,86
2688,-19.67899999999937,1975.2941176470588,36,12,14,48
2689,-2.3882499999964404,4727.5,82,17,3,99
2690,-1.0507499999984766,3079.8,48,13,9,61
2691,-20.76549999999687,2555.0,42,6,22,48
2692,-12.819999999999135,2525.1052631578946,32,16,5,48
2693,-4.63774999999753,2112.4444444444443,47,11,6,58
2694,22.330750000003043,4561.9473684210525,79,13,15,92
2695,-2.683999999996773,1481.9333333333334,57,17,10,74
2696,-31.95499999999805,3636.2105263157896,53,19,16,72
2697,-15.266999999997074,2369.7894736842104,24,21,20,45
2698,2.9040000000019397,2276.8823529411766,68,9,9,77
2699,-26.118499999997038,3472.5263157894738,47,11,22,58
2700,8.180000000001359,3575.2105263157896,69,7,6,76
2701,-8.397249999997001,2324.4117647058824,64,21,4,85
2702,-9.533749999998289,2854.764705882353,78,13,19,91
2703,-13.902999999996783,2463.5882352941176,55,13,12,68
2704,-1.1072499999980323,3809.2105263157896,56,12,21,68
2705,-18.418999999996416,2162.25,66,16,13,82
2706,-32.88274999999781,3396.5263157894738,39,23,9,62
2707,0.21350000000137187,3102.3684210526317,59,9,6,68
2708,-21.561749999997673,3673.8947368421054,66,15,14,81
2709,3.53850000000242,4174.4,69,8,5,77
2710,-24.951999999998154,3823.5,53,12,12,65
2711,4.2552500000040885,5785.45,105,20,9,125
2712,-15.620249999997403,2264.3125,79,19,9,98
2713,-1.7137500000002586,1429.0,38,16,1,54
2714,-14.635499999999258,1885.888888888889,11,6,9,17
2715,-1.1542499999990805,2644.95,38,9,3,47
2716,-15.9567499999983,3241.75,49,11,5,60
2717,-3.7142499999971625,3550.4117647058824,83,16,14,99
2718,-22.01624999999972,2028.8333333333333,11,17,6,28
2719,-1.4877499999970893,1614.8823529411766,59,13,9,72
2720,-8.272499999996919,5340.25,93,11,11,104
2721,-3.9087499999991855,2808.222222222222,59,16,6,75
2722,1.024500000001807,3681.4210526315787,75,12,15,87
2723,-14.151999999998669,2424.6111111111113,36,16,3,52
2724,-15.652749999998928,2523.6315789473683,38,22,11,60
2725,-9.91974999999798,3084.277777777778,79,10,5,89
2726,-9.147249999997971,2097.6470588235293,37,11,15,48
2727,-17.784749999998077,1759.375,41,25,12,66
2728,-25.471249999999895,2040.1666666666667,20,23,13,43
2729,-4.309499999998422,2873.4444444444443,64,17,7,81
2730,-26.996249999998525,3079.9473684210525,39,25,11,64
2731,-20.703999999997585,2228.5625,68,7,16,75
2732,-13.200749999995512,1585.8823529411766,56,19,15,75
2733,-19.425249999999224,2139.777777777778,28,15,12,43
2734,-13.72674999999694,3131.9444444444443,44,14,30,58
2735,-2.4944999999981636,3994.1,51,14,13,65
2736,-0.6517499999958968,3769.9411764705883,99,11,16,110
2737,-6.930999999998571,3186.95,42,13,12,55
2738,-28.89374999999751,2698.0526315789475,28,5,19,33
2739,-17.992749999997624,2044.0,53,8,17,61
2740,-19.494499999999206,3135.4444444444443,59,14,22,73
2741,-7.429249999996541,3578.222222222222,86,19,9,105
2742,-6.854249999998119,3374.3888888888887,58,12,7,70
2743,-12.96874999999901,2134.8823529411766,31,11,13,42
2744,-21.37549999999732,1429.0,40,14,17,54
2745,-6.600999999998022,3761.6,57,13,3,70
2746,-15.487999999998218,1907.1875,33,11,10,44
2747,-24.424249999997322,3619.5263157894738,54,15,9,69
2748,-26.505999999997407,1528.25,30,16,14,46
2749,1.4107500000028235,2767.722222222222,66,13,4,79
2750,-8.39824999999892,3031.5,32,14,1,46
2751,13.933000000002803,4774.2,90,5,8,95
2752,-14.392249999998896,2632.0,45,20,9,65
2753,-8.322999999996828,4393.4,74,11,7,85
2754,5.090750000001486,3028.6666666666665,64,10,6,74
2755,-23.56174999999942,1979.9411764705883,26,16,8,42
2756,0.955000000003128,2736.5625,115,11,6,126
2757,-10.419249999999064,3064.842105263158,64,15,14,79
2758,-12.870999999995979,2387.9411764705883,66,17,14,83
2759,-9.228249999997747,2893.722222222222,54,15,12,69
2760,0.2850000000035271,3342.6666666666665,74,9,8,83
2761,-17.749999999995577,2487.625,87,15,17,102
2762,-2.6509999999987115,3340.4736842105262,59,20,8,79
2763,-13.892999999999088,2111.5,14,22,2,36
2764,3.922500000001359,3048.2,49,2,1,51
2765,-29.524499999999357,1523.25,51,19,10,70
2766,-18.68899999999857,4310.8,57,23,5,80
2767,1.9355000000030818,4679.1,68,16,9,84
2768,-11.895999999999153,2017.4117647058824,38,16,5,54
2769,-5.320499999997601,4228.888888888889,95,23,10,118
2770,-1.7137499999973667,3552.5,79,15,8,94
2771,-2.1962499999967733,2460.8125,92,17,14,109
2772,-12.914499999997977,4270.35,70,11,6,81
2773,-25.77499999999865,2622.3529411764707,74,21,12,95
2774,-15.482499999996369,2569.222222222222,53,12,18,65
2775,-20.283999999999196,2510.1666666666665,44,10,19,54
2776,-16.86199999999713,1684.0,51,15,8,66
2777,4.3777500000030205,3594.3684210526317,78,21,5,99
2778,-15.95674999999908,1912.7058823529412,35,10,14,45
2779,-25.69874999999787,3441.15,46,9,10,55
2780,-13.657249999997813,2315.1176470588234,51,16,8,67
2781,-19.967249999999353,2306.5,26,19,36,45
2782,2.87225000000294,4585.35,81,11,10,92
2783,0.6877500000036005,3302.1052631578946,52,16,23,68
2784,-10.589249999994497,2303.9411764705883,88,18,7,106
2785,-8.602499999999136,2619.45,30,15,3,45
2786,-20.406999999999524,2092.65,12,16,6,28
2787,-19.23574999999903,2083.5882352941176,30,13,12,43
2788,-10.559249999998531,2592.4117647058824,54,9,5,63
2789,-10.148749999998884,2469.6666666666665,42,21,9,63
2790,-1.3704999999982213,2304.0,81,27,5,108
2791,-16.726249999996774,3012.705882352941,67,21,11,88
2792,-19.310249999999748,2042.4705882352941,41,18,8,59
2793,-17.35724999999635,3549.0555555555557,66,9,24,75
2794,-3.9284999999955574,3320.8823529411766,86,17,10,103
2795,-12.021999999998517,2773.6470588235293,65,13,16,78
2796,-4.075999999998821,2244.1176470588234,53,12,11,65
2797,15.092000000002077,4796.55,78,14,2,92
2798,-27.539249999998013,2103.75,64,19,10,83
2799,-21.32699999999719,2557.0555555555557,55,13,12,68
2800,-22.239499999998124,3136.4,44,10,10,54
2801,-14.335499999998792,2914.4736842105262,58,19,7,77
2802,-14.786749999998829,2989.5789473684213,38,13,9,51
2803,-4.552749999996314,2590.5882352941176,62,17,22,79
2804,-28.668749999999637,2064.8888888888887,23,26,8,49
2805,-17.244749999998724,2362.1111111111113,76,19,8,95
2806,-29.301249999999264,2387.0,30,10,19,40
2807,-15.962499999999585,2109.1052631578946,16,15,2,31
2808,-18.921499999997657,2261.9411764705883,44,13,8,57
2809,1.6587500000015774,2489.0,53,14,6,67
2810,8.08225000000186,3459.9444444444443,89,12,6,101
2811,-34.619499999996414,1742.5625,42,11,23,53
2812,-21.829249999999753,2079.842105263158,14,18,12,32
2813,-33.78199999999807,1514.375,14,14,27,28
2814,10.611500000002144,3080.8823529411766,80,11,14,91
2815,22.750250000002513,2987.3529411764707,103,15,3,118
2816,3.8345000000016625,3344.25,40,7,8,47
2817,-30.95149999999805,2803.0555555555557,40,20,21,60
2818,-7.136999999997039,4675.95,73,12,11,85
2819,-8.994999999998756,3126.5789473684213,42,17,14,59
2820,-27.24274999999845,2903.65,27,14,13,41
2821,-16.318249999998237,2137.4736842105262,30,23,0,53
2822,-9.632749999999167,2817.85,35,15,8,50
2823,-8.992499999999477,2594.4210526315787,49,9,5,58
2824,-18.788499999998603,3768.05,51,15,8,66
2825,-27.33974999999789,3591.315789473684,53,15,17,68
2826,-3.376249999997089,4659.3,76,23,4,99
2827,7.374250000002846,3211.3333333333335,104,15,8,119
2828,2.1622500000020803,4379.15,73,7,2,80
2829,-11.672749999997347,2148.0,53,11,7,64
2830,-14.25349999999849,3102.05,45,8,6,53
2831,-7.739999999998555,2580.875,76,31,6,107
2832,-14.537999999998153,2485.5555555555557,42,24,5,66
2833,-14.262749999998709,2241.5,49,23,9,72
2834,1.3415000000011186,3188.3333333333335,76,16,11,92
2835,-18.0617499999968,4669.578947368421,93,24,15,117
2836,-4.716499999998854,2705.3,28,16,9,44
2837,-11.632749999999122,2478.4210526315787,49,17,9,66
2838,-9.054249999998166,3595.75,50,11,10,61
2839,-16.487749999999178,2576.1052631578946,22,15,21,37
2840,11.26800000000256,1438.5333333333333,92,13,8,105
2841,-13.834749999999332,2100.1111111111113,53,13,6,66
2842,-16.204499999999264,1429.0,44,21,4,65
2843,-14.22999999999936,2114.2105263157896,15,15,3,30
2844,-3.0529999999971027,4927.45,70,24,5,94
2845,-22.86474999999791,2250.0,34,22,8,56
2846,6.857000000003128,4083.157894736842,84,19,2,103
2847,-18.39049999999805,3634.6,40,11,11,51
2848,-20.2547499999985,3406.1,44,19,4,63
2849,-15.779249999998246,3158.55,52,10,9,62
2850,-34.08449999999959,1429.0,0,15,6,15
2851,-9.385999999999177,1835.8125,45,10,14,55
2852,-10.528749999996593,4661.315789473684,80,14,16,94
2853,-21.97449999999889,2527.25,63,17,18,80
2854,10.511000000004532,5151.35,101,4,5,105
2855,-11.335499999998579,1859.625,24,0,15,24
2856,-21.793999999998807,2677.2631578947367,28,15,5,43
2857,-18.699999999999452,2076.5263157894738,13,14,4,27
2858,-22.688249999998284,2841.0526315789475,33,13,10,46
2859,9.071750000001515,3822.5789473684213,75,12,10,87
2860,-22.449999999998845,3049.8333333333335,55,28,8,83
2861,-6.816249999995267,5022.7,94,13,9,107
2862,-6.677749999998459,2798.5,79,21,9,100
2863,0.20625000000341095,3794.0555555555557,88,12,18,100
2864,-9.465499999997967,2681.2631578947367,44,8,15,52
2865,-9.474999999998365,3565.6,48,19,8,67
2866,11.885250000002845,4056.4210526315787,81,17,4,98
2867,-12.937249999999796,2023.4444444444443,19,15,1,34
2868,-1.140249999994524,5775.9,95,11,20,106
2869,-20.057999999998792,2648.25,30,14,8,44
2870,-10.551749999997668,3563.9444444444443,88,27,1,115
2871,-19.621499999997443,3470.5555555555557,59,24,12,83
2872,-15.177999999999287,2046.4736842105262,18,18,1,36
2873,-19.38699999999925,2038.8947368421052,19,18,6,37
2874,-20.002749999998592,3394.1,42,18,3,60
2875,15.251500000000927,2670.125,95,23,2,118
2876,-25.127749999998088,1528.25,26,21,8,47
2877,-1.0167499999985878,2504.705882352941,85,22,5,107
2878,-1.5529999999977846,3889.4,53,12,12,65
2879,-10.8804999999986,1429.0,25,10,4,35
2880,-5.039999999998715,3049.9473684210525,53,15,10,68
2881,-0.0607500000004431,2365.5,57,26,7,83
2882,-8.628499999998654,3048.15,40,20,5,60
2883,-10.00899999999752,3015.4444444444443,70,9,6,79
2884,-8.969999999995254,3898.277777777778,81,11,18,92
2885,-12.383250000000029,2007.611111111111,33,12,3,45
2886,3.811500000002618,3689.529411764706,98,25,3,123
2887,-14.938750000000084,1429.0,16,13,15,29
2888,7.973000000004342,2569.235294117647,80,12,11,92
2889,-26.242999999997767,3064.0588235294117,64,18,12,82
2890,2.285750000001717,3646.2631578947367,75,28,6,103
2891,0.165250000002486,4306.0,73,7,4,80
2892,-9.03024999999835,3083.85,46,17,3,63
2893,-11.59099999999792,1665.2941176470588,40,16,3,56
2894,-10.776499999997638,2210.75,49,14,20,63
2895,-5.948249999997156,1528.25,40,15,15,55
2896,-19.790749999998813,2087.315789473684,28,18,4,46
2897,-15.567999999998454,1615.5,70,17,6,87
2898,-28.632499999999556,2184.2105263157896,18,25,0,43
2899,-11.506249999999117,2957.8947368421054,43,14,14,57
2900,-1.0947499999981978,3770.222222222222,110,30,2,140
2901,-7.66249999999941,2130.7,19,7,10,26
2902,-18.78749999999906,2009.8235294117646,22,16,3,38
2903,-35.17125000000021,1429.0,27,24,18,51
2904,-10.657249999999085,3135.5,67,28,10,95
2905,-20.216999999998816,2552.6111111111113,54,11,25,65
2906,-1.0027499999992548,2616.8888888888887,63,14,6,77
2907,-20.493249999998053,2574.764705882353,60,18,4,78
2908,-9.966249999997657,1942.9375,74,12,12,86
2909,-17.925999999999433,2798.15,26,17,4,43
2910,-11.43149999999836,3751.3,52,21,1,73
2911,-20.447749999998827,2709.0526315789475,28,17,8,45
2912,0.26975000000166993,3324.6315789473683,49,19,3,68
2913,-9.277749999997393,3937.842105263158,63,6,21,69
2914,12.021500000002225,5145.7,85,10,10,95
2915,-16.062249999999516,2129.9473684210525,13,18,2,31
2916,11.286500000001574,2956.3888888888887,89,17,7,106
2917,-16.86399999999869,2148.0,39,19,6,58
2918,-7.23949999999962,2044.611111111111,35,17,22,52
2919,-13.364499999999257,2399.0555555555557,60,24,8,84
2920,-25.5519999999988,2587.05,24,15,8,39
2921,-28.30824999999688,2122.9411764705883,47,18,8,65
2922,7.848750000001537,3056.1111111111113,98,11,1,109
2923,-19.811499999998556,3127.684210526316,58,10,12,68
2924,-6.76474999999698,4777.4,84,19,5,103
2925,-1.9019999999981128,2005.4375,82,14,10,96
2926,-3.4627499999988367,2067.6470588235293,46,21,0,67
2927,-20.40374999999789,4177.5,64,26,4,90
2928,-11.881749999998794,2265.6470588235293,45,17,6,62
2929,-3.1854999999970732,3528.5263157894738,66,17,8,83
2930,-7.7564999999964215,4998.85,84,14,5,98
2931,-3.3195000000000094,1719.6875,31,20,15,51
2932,-8.583499999998129,2266.8333333333335,47,13,13,60
2933,-9.219999999998233,2877.9444444444443,59,15,4,74
2934,-16.536499999998092,3251.4,47,8,7,55
2935,-11.107999999998206,3221.9,46,16,7,62
2936,-1.8372499999995031,2460.722222222222,51,17,3,68
2937,-9.040999999998025,4154.263157894737,80,17,8,97
2938,-25.976749999998326,2840.2,32,20,11,52
2939,-11.666749999995458,4159.263157894737,85,10,7,95
2940,-18.12799999999763,4361.55,69,16,6,85
2941,-17.758749999998265,3425.7368421052633,55,25,5,80
2942,-5.620749999997832,3703.7,55,17,2,72
2943,7.878000000003138,4794.2,81,11,5,92
2944,-7.542249999999046,2538.5263157894738,28,22,13,50
2945,-5.713999999998971,1576.875,58,20,1,78
2946,-17.369749999999478,2590.2105263157896,27,16,21,43
2947,0.11025000000267085,2248.8823529411766,75,12,3,87
2948,-26.58499999999874,2922.0,39,16,13,55
2949,-25.813249999999123,2758.45,20,20,9,40
2950,-21.874249999998078,2409.375,54,20,12,74
2951,-12.82374999999862,2853.65,30,19,5,49
2952,-26.441249999997233,3495.294117647059,80,35,11,115
2953,1.2062500000024343,2937.1176470588234,101,14,7,115
2954,11.789750000003163,4273.55,75,4,13,79
2955,7.873000000001388,3750.45,63,11,5,74
2956,-12.728499999998032,2901.0,39,18,4,57
2957,2.8525000000036176,5177.45,80,9,20,89
2958,-19.201249999999305,3121.6315789473683,60,17,11,77
2959,-6.227499999999343,2000.5625,52,20,4,72
2960,2.277250000000167,3191.0555555555557,85,24,6,109
2961,-11.42950000000043,1429.0,59,24,6,83
2962,-12.383749999999663,1751.235294117647,10,14,2,24
2963,-3.7804999999997113,2561.7894736842104,41,20,4,61
2964,-22.528999999998657,2290.6111111111113,33,17,10,50
2965,-8.81049999999695,4373.105263157895,88,17,4,105
2966,-19.147249999997587,4058.9473684210525,70,14,15,84
2967,-23.70249999999932,2109.8947368421054,18,16,9,34
2968,-16.230999999996914,3909.6111111111113,101,27,6,128
2969,-15.049999999998814,2010.1666666666667,29,19,3,48
2970,-12.99299999999892,1639.375,21,17,6,38
2971,-16.179749999999427,2680.3333333333335,30,7,20,37
2972,-10.64149999999834,3406.3684210526317,52,13,10,65
2973,-28.469749999999216,2481.1111111111113,26,22,10,48
2974,-10.45649999999727,1482.5625,53,15,1,68
2975,-12.28349999999842,2362.625,51,15,3,66
2976,-2.5144999999970574,4008.45,67,19,3,86
2977,-25.97099999999697,2755.3333333333335,47,15,19,62
2978,-21.161749999997372,2601.764705882353,55,12,17,67
2979,-1.0774999999970438,3497.0555555555557,70,14,14,84
2980,-7.532750000000503,1429.0,31,13,6,44
2981,19.075500000002904,5234.55,98,22,3,120
2982,-2.552249999997983,3836.6315789473683,68,17,5,85
2983,-10.60499999999791,2711.277777777778,46,5,12,51
2984,-8.883499999997687,4029.7368421052633,67,19,7,86
2985,-12.134499999997677,2610.235294117647,68,7,28,75
2986,-14.747999999999257,2176.0,60,20,9,80
2987,3.73000000000233,2438.0,79,18,10,97
2988,-1.7847499999992587,2311.470588235294,55,12,13,67
2989,-4.181999999998675,2374.3888888888887,31,10,14,41
2990,-28.289999999999196,3104.157894736842,36,10,25,46
2991,-0.43449999999589195,2611.176470588235,83,17,4,100
2992,-22.524249999998837,2683.0,29,15,10,44
2993,1.35300000000464,3835.6666666666665,99,12,7,111
2994,-10.274249999997656,2103.625,54,10,10,64
2995,-10.255249999999346,2069.0,19,18,1,37
2996,-8.312249999998645,2945.2631578947367,46,13,5,59
2997,-16.891249999999374,2862.5789473684213,50,20,7,70
2998,-1.148499999996655,2304.0,66,8,8,74
2999,-14.763249999998328,2426.5789473684213,28,18,12,46
3000,-6.829749999996855,4657.6,87,12,1,99
3001,-13.802749999998378,3536.0526315789475,78,17,12,95
3002,-11.24699999999821,2584.277777777778,60,20,11,80
3003,-0.5727499999969717,3241.157894736842,61,12,15,73
3004,-11.901999999998385,2862.8888888888887,58,21,0,79
3005,-20.165249999998515,2324.5882352941176,56,15,25,71
3006,0.9812500000021538,2957.3333333333335,88,21,3,109
3007,-11.447249999998208,2497.294117647059,73,15,5,88
3008,-22.882249999999477,2178.4210526315787,15,16,5,31
3009,-24.666499999996315,2154.6470588235293,62,22,9,84
3010,-19.397749999998098,3625.85,48,18,5,66
3011,-10.52324999999871,3825.1052631578946,87,25,6,112
3012,-7.461999999998572,1892.1764705882354,33,13,2,46
3013,-2.638749999996784,4008.45,70,15,1,85
3014,-9.159999999996186,3895.2631578947367,78,22,5,100
3015,-24.77574999999849,3190.1,39,25,6,64
3016,-7.14874999999777,3250.9444444444443,91,23,0,114
3017,13.714500000001314,2857.5882352941176,90,22,5,112
3018,-7.65874999999795,2687.3888888888887,55,11,2,66
3019,-12.715999999998488,2316.235294117647,38,12,16,50
3020,10.25325000000483,2099.6875,98,8,1,106
3021,-12.436249999998504,1698.9411764705883,14,8,12,22
3022,2.3530000000015465,2226.3333333333335,47,14,4,61
3023,-19.51199999999883,2523.5789473684213,32,6,21,38
3024,-19.459249999998114,1429.0,29,9,8,38
3025,-21.106249999997818,2585.315789473684,24,7,27,31
3026,4.630750000002959,3338.222222222222,77,18,1,95
3027,-20.67999999999821,2467.294117647059,56,22,22,78
3028,-17.22299999999899,2369.842105263158,28,25,1,53
3029,-3.5659999999986525,2726.5263157894738,48,11,2,59
3030,-27.04974999999866,2561.8947368421054,28,12,15,40
3031,-4.557749999997994,1996.5,61,19,2,80
3032,-11.223999999996733,3482.6315789473683,68,16,6,84
3033,-26.454499999996,2509.3333333333335,63,15,14,78
3034,-4.411249999998081,3028.6666666666665,49,15,6,64
3035,-3.3672499999976986,5145.0,74,23,1,97
3036,-26.563499999998378,3591.157894736842,72,19,12,91
3037,-5.706249999998517,2477.5263157894738,29,6,13,35
3038,-29.131499999996993,2822.3333333333335,60,17,8,77
3039,-23.59949999999907,2552.722222222222,41,22,7,63
3040,-12.157499999998475,1862.2941176470588,38,8,14,46
3041,-12.871499999998424,2730.5789473684213,33,9,14,42
3042,4.23125000000123,2387.0588235294117,35,16,23,51
3043,-18.664749999997195,3736.25,57,17,2,74
3044,1.7677500000035213,5255.3,89,17,6,106
3045,-36.92675000000064,1429.0,10,16,32,26
3046,-13.727999999998511,3335.4,42,22,6,64
3047,-19.716749999997166,2366.625,47,6,19,53
3048,-15.12499999999556,2640.0588235294117,48,19,31,67
3049,-34.129749999999675,2004.7894736842106,12,16,19,28
3050,-13.515499999999246,2028.7222222222222,23,18,3,41
3051,-1.899499999997781,2677.4117647058824,58,18,13,76
3052,0.9370000000019264,2861.7368421052633,40,11,14,51
3053,-0.12724999999601003,2312.6666666666665,77,10,2,87
3054,-8.690249999998459,3541.157894736842,55,17,12,72
3055,9.975000000002284,3382.3333333333335,74,16,5,90
3056,-15.745249999996602,2816.1666666666665,65,12,9,77
3057,-19.10599999999863,2422.4736842105262,26,20,9,46
3058,-28.82799999999626,3146.0555555555557,66,19,11,85
3059,-0.6647499999990536,3400.55,36,13,12,49
3060,-25.741749999998746,3064.1052631578946,42,19,13,61
3061,-10.894749999999753,2085.1111111111113,47,10,2,57
3062,-19.913249999997337,3298.0526315789475,41,11,27,52
3063,-11.9785000000002,1429.0,11,6,16,17
3064,-6.172749999997877,3893.777777777778,81,14,4,95
3065,-7.985249999997744,2804.125,83,25,9,108
3066,7.393000000001154,2532.1111111111113,55,6,6,61
3067,-16.885749999997568,3519.315789473684,51,19,13,70
3068,-16.17799999999758,4525.85,72,22,3,94
3069,-20.192749999997453,2568.5,49,7,21,56
3070,-23.412499999999476,1429.0,14,16,5,30
3071,-7.152749999996748,2896.823529411765,69,19,12,88
3072,-13.253999999998285,3060.6111111111113,69,20,14,89
3073,0.8887500000029952,3026.6470588235293,82,17,11,99
3074,-15.753749999998538,2096.764705882353,48,22,7,70
3075,-1.3844999999982417,3117.5263157894738,48,5,5,53
3076,2.4882500000015577,3279.9,42,16,4,58
3077,-15.033249999998276,2830.277777777778,48,8,4,56
3078,-0.6717499999975098,3394.7368421052633,69,9,7,78
3079,-17.978999999998784,3145.7,37,13,5,50
3080,-13.26774999999651,3968.7368421052633,71,22,7,93
3081,-9.189249999998083,2366.5555555555557,45,13,7,58
3082,-18.087249999998775,2479.5882352941176,60,19,13,79
3083,-13.205999999998758,3367.2105263157896,68,25,5,93
3084,-11.315999999999622,2734.842105263158,41,12,14,53
3085,3.4987500000013263,1902.25,46,21,18,67
3086,4.23050000000206,2935.222222222222,59,19,2,78
3087,-13.845249999998146,4290.473684210527,78,20,21,98
3088,-1.1099999999979235,4605.25,73,23,4,96
3089,0.17250000000279647,2152.705882352941,52,8,11,60
3090,-12.351749999997288,2463.6470588235293,62,23,7,85
3091,-13.96924999999833,3072.05,45,11,6,56
3092,-18.42824999999963,2867.2,29,16,6,45
3093,-8.585499999998762,2159.277777777778,31,16,5,47
3094,-1.8229999999987427,3084.529411764706,80,28,15,108
3095,-19.855999999995735,5750.45,79,13,10,92
3096,-9.12524999999834,3315.3529411764707,51,5,7,56
3097,-18.732749999998084,2663.6111111111113,52,16,19,68
3098,-19.556499999998703,2307.705882352941,51,12,26,63
3099,3.104000000003148,4998.0526315789475,93,19,13,112
3100,-24.492249999999707,2463.2631578947367,21,18,29,39
3101,-3.6849999999962675,4444.1,66,15,4,81
3102,-13.8584999999992,2968.777777777778,60,18,11,78
3103,6.246250000003038,2925.823529411765,68,10,9,78
3104,-13.020999999999479,2323.6470588235293,34,18,3,52
3105,-13.613499999999936,1429.0,20,7,13,27
3106,0.9355000000016856,4236.894736842105,65,22,13,87
3107,5.120000000003442,4235.263157894737,82,15,10,97
3108,-14.61724999999895,2231.6111111111113,16,13,7,29
3109,-14.076499999997091,3489.1111111111113,74,22,3,96
3110,-3.418499999997322,2208.75,61,24,3,85
3111,-11.259749999996114,2055.125,70,13,14,83
3112,-13.997999999997322,1910.1875,52,14,10,66
3113,8.289500000002521,4488.5,80,20,2,100
3114,-17.571999999998635,2316.0588235294117,60,21,14,81
3115,-22.049249999997972,1800.125,46,24,10,70
3116,-9.347499999998538,3294.3,45,6,14,51
3117,-13.002249999999794,2659.1666666666665,55,26,3,81
3118,-20.411499999997886,2103.722222222222,48,13,4,61
3119,-5.757999999997326,1534.8666666666666,52,8,6,60
3120,-17.999499999998232,2727.1666666666665,42,17,15,59
3121,-25.526999999998278,1648.4705882352941,29,19,10,48
3122,-18.209249999999038,2955.25,33,16,7,49
3123,-7.960499999998412,3384.65,41,20,10,61
3124,-4.070499999999088,2647.4,35,14,4,49
3125,-13.982249999998936,2837.0,30,7,8,37
3126,-7.8084999999946545,3223.6111111111113,66,8,34,74
3127,-22.782499999996805,4496.5,71,11,10,82
3128,-5.087249999996719,4655.25,78,17,2,95
3129,-20.22124999999734,2644.277777777778,42,22,17,64
3130,-4.40449999999841,3130.1666666666665,61,15,9,76
3131,-7.16799999999831,3151.25,47,12,5,59
3132,-4.847499999997844,2761.529411764706,78,21,7,99
3133,-2.206999999998159,3610.85,45,13,8,58
3134,-9.817249999997964,3305.4736842105262,68,15,16,83
3135,-19.035249999997536,2533.4736842105262,47,14,8,61
3136,-3.7257499999989654,3481.6315789473683,66,14,13,80
3137,-12.727749999997698,3243.0,56,21,9,77
3138,-12.832499999996752,3231.6111111111113,73,19,4,92
3139,-13.134249999998541,3099.7,41,13,8,54
3140,-8.953499999998414,2465.1666666666665,62,18,11,80
3141,-13.94399999999867,2608.1111111111113,59,11,20,70
3142,-0.7104999999972751,4505.2,74,12,4,86
3143,-11.181499999999382,2108.0555555555557,52,14,11,66
3144,-25.06124999999747,2064.125,40,14,19,54
3145,-15.186999999998154,2895.5555555555557,54,23,9,77
3146,-18.18074999999774,2993.8947368421054,51,12,6,63
3147,17.20875000000403,5137.85,96,4,10,100
3148,-15.34949999999949,2202.176470588235,41,20,12,61
3149,-11.103249999999274,2718.9473684210525,28,8,7,36
3150,-13.964999999999089,2076.3888888888887,44,17,10,61
3151,-18.78299999999827,1800.0625,68,26,10,94
3152,-8.211999999998174,2151.3333333333335,34,12,5,46
3153,1.2547500000029,4251.3,62,6,5,68
3154,-7.93999999999964,2264.75,15,15,1,30
3155,-6.893999999996536,2501.5,73,8,7,81
3156,-25.91624999999912,1594.6875,14,14,10,28
3157,-17.850249999999388,2028.6666666666667,28,19,5,47
3158,-9.69474999999617,2152.1666666666665,41,8,28,49
3159,0.47100000000221076,2185.235294117647,39,13,12,52
3160,-0.382249999997638,3658.7894736842104,77,12,4,89
3161,-15.24624999999945,1481.9333333333334,39,16,16,55
3162,-10.808249999997361,2965.0,77,19,6,96
3163,-16.762749999998448,3659.5789473684213,52,19,12,71
3164,-5.137749999997412,3790.6111111111113,99,15,9,114
3165,-2.8757499999983684,2081.705882352941,40,20,7,60
3166,-28.39699999999924,2591.2105263157896,33,16,18,49
3167,-21.725499999999023,2663.7368421052633,27,6,11,33
3168,-28.516999999998394,3339.45,43,22,3,65
3169,-4.139999999996357,1653.25,73,15,4,88
3170,-4.432749999998804,2541.7894736842104,40,12,5,52
3171,-12.950499999998314,3514.5,87,19,14,106
3172,-5.370749999999079,2820.8947368421054,58,16,11,74
3173,-2.7412499999961843,2378.777777777778,68,13,10,81
3174,-16.0799999999986,1954.7058823529412,60,24,7,84
3175,-8.246249999997355,2988.3529411764707,88,12,2,100
3176,-20.621749999998865,2539.315789473684,26,27,8,53
3177,-5.6119999999979004,3663.6111111111113,84,16,10,100
3178,-20.419499999997292,3897.222222222222,75,14,10,89
3179,5.306500000002119,2941.3888888888887,82,14,8,96
3180,-21.706499999997142,2761.4117647058824,46,9,27,55
3181,-2.651249999999064,3639.35,49,20,4,69
3182,-3.190999999998306,3219.3888888888887,70,15,19,85
3183,-13.21424999999761,3759.0526315789475,69,19,8,88
3184,-23.924499999997263,4416.4,46,10,26,56
3185,-24.040500000000115,1429.0,0,21,1,21
3186,-3.471249999998462,4326.263157894737,96,13,8,109
3187,-36.19524999999827,2395.4117647058824,34,28,15,62
3188,-11.246749999998181,2568.5789473684213,39,21,8,60
3189,-28.969499999997588,3183.4210526315787,40,15,18,55
3190,-9.719749999996775,4726.526315789473,96,19,7,115
3191,9.582000000002296,2869.9444444444443,60,8,8,68
3192,-13.26149999999871,2988.1111111111113,47,6,18,53
3193,-15.572749999998763,2844.1,31,17,8,48
3194,-6.5579999999987875,4158.315789473684,82,14,8,96
3195,-6.023499999996579,2499.625,71,12,7,83
3196,-1.2012499999985016,3145.842105263158,42,7,7,49
3197,11.138000000002172,4112.421052631579,81,10,2,91
3198,22.02850000000567,2233.625,103,8,13,111
3199,-9.268499999996385,4982.2,86,16,6,102
3200,2.943250000000858,3170.0526315789475,70,21,5,91
3201,-3.071499999996612,3324.470588235294,79,9,14,88
3202,-17.7989999999996,1870.7058823529412,36,20,21,56
3203,-3.7062499999982093,3869.315789473684,81,23,7,104
3204,19.291000000003642,1976.1764705882354,79,13,4,92
3205,-13.790749999998283,3080.65,41,19,2,60
3206,-13.097499999998012,2072.8333333333335,31,11,11,42
3207,-3.6987499999963966,2912.3125,79,10,12,89
3208,-4.969999999998594,2214.75,62,22,7,84
3209,-15.062499999999076,2054.0,66,22,9,88
3210,-9.6967499999987,3111.55,37,11,12,48
3211,-4.817749999995493,3295.0555555555557,88,11,10,99
3212,3.3055000000012718,3591.157894736842,83,10,9,93
3213,-5.871749999998945,3079.842105263158,67,14,11,81
3214,-6.293499999998746,2232.0588235294117,56,15,15,71
3215,0.10350000000165753,3833.4210526315787,73,8,6,81
3216,-0.4449999999985678,3210.05,40,10,3,50
3217,-11.373749999998774,1630.4375,20,17,10,37
3218,0.26700000000065155,2148.0,58,27,3,85
3219,-12.659999999998174,3560.0,46,12,8,58
3220,-16.91599999999644,3207.722222222222,71,9,11,80
3221,-12.922499999999133,2862.35,27,11,4,38
3222,2.471750000000994,1550.0625,62,15,3,77
3223,-21.641999999997285,2565.722222222222,38,12,17,50
3224,-4.11674999999954,2887.05,28,14,5,42
3225,-21.40324999999816,2730.9285714285716,38,11,13,49
3226,-4.582499999998288,3794.9473684210525,62,20,8,82
3227,-10.76974999999789,2893.9444444444443,74,13,10,87
3228,-24.928999999997174,2652.1666666666665,26,4,30,30
3229,-11.136749999998889,2116.9444444444443,32,10,7,42
3230,-30.663749999997997,2967.0588235294117,57,13,20,70
3231,-19.62049999999804,1978.625,48,8,25,56
3232,-24.10549999999843,2697.2105263157896,25,14,16,39
3233,-16.93049999999895,2185.470588235294,30,15,13,45
3234,-15.024749999998866,3567.15,43,18,8,61
3235,-10.243749999997792,3103.315789473684,54,7,9,61
3236,-6.213249999998252,3671.4736842105262,45,21,17,66
3237,-16.875249999996512,4297.894736842105,79,12,13,91
3238,-0.8704999999972841,4113.25,59,9,18,68
3239,-22.509749999999062,2198.8333333333335,13,15,16,28
3240,-14.400499999999392,1956.3157894736842,12,13,7,25
3241,-14.982249999998988,2565.2105263157896,25,18,4,43
3242,-9.277249999998045,1438.5333333333333,39,3,19,42
3243,4.863000000002345,4042.315789473684,87,7,16,94
3244,0.7745000000018935,2903.3529411764707,91,24,6,115
3245,-4.131499999999083,2677.55,39,15,3,54
3246,-15.390749999999002,2072.529411764706,25,7,17,32
3247,-14.19649999999775,3881.0526315789475,68,23,5,91
3248,1.821750000002283,4240.2,69,7,6,76
3249,-7.042749999998698,3391.4210526315787,51,20,11,71
3250,-7.059999999997983,2612.842105263158,30,16,18,46
3251,-1.3932499999984864,2482.6875,79,17,7,96
3252,1.0245000000017899,2492.529411764706,76,14,10,90
3253,-8.404999999998546,3358.45,43,8,9,51
3254,-3.121499999997444,3008.8823529411766,59,24,14,83
3255,-14.84424999999752,5023.5,78,16,8,94
3256,-8.00924999999846,2134.3125,61,11,10,72
3257,-19.290749999998376,3958.684210526316,64,18,12,82
3258,-12.34099999999775,3373.2105263157896,60,13,18,73
3259,-17.954999999998726,2027.0555555555557,21,24,10,45
3260,-22.131000000000235,2132.5263157894738,26,25,21,51
3261,-24.71974999999725,3829.85,50,10,17,60
3262,-20.119999999999756,2072.777777777778,23,16,10,39
3263,-7.968999999997003,4500.45,57,22,21,79
3264,-17.005999999997762,4206.75,62,19,3,81
3265,-5.664999999997179,4067.95,68,11,7,79
3266,2.8585000000021514,3724.3,56,5,6,61
3267,-25.418999999998643,1429.0,37,25,11,62
3268,-14.85674999999856,2179.3888888888887,32,18,6,50
3269,-8.036249999997663,2724.176470588235,53,13,16,66
3270,-9.488749999997642,2781.8333333333335,39,22,19,61
3271,-9.950749999998653,3410.9,46,14,8,60
3272,-1.979999999996362,3647.777777777778,88,16,20,104
3273,-29.157249999998346,3348.1,41,23,5,64
3274,-4.606749999999563,1951.9444444444443,35,12,9,47
3275,-21.864000000000832,1429.0,1,14,30,15
3276,1.2200000000027045,3143.4444444444443,61,6,9,67
3277,4.384500000003252,2110.705882352941,58,6,15,64
3278,-5.270999999996852,2558.0,84,21,9,105
3279,-6.102249999997792,2854.0588235294117,85,13,3,98
3280,-13.763749999999131,2097.705882352941,57,19,16,76
3281,-1.9979999999956193,2993.1176470588234,91,11,16,102
3282,-14.212249999997947,3353.842105263158,54,25,14,79
3283,-12.739249999999208,2690.5263157894738,31,16,4,47
3284,-4.375999999998733,2538.3529411764707,62,14,6,76
3285,-0.005499999997214467,3282.529411764706,79,16,7,95
3286,-19.424999999997887,2647.9473684210525,43,17,5,60
3287,-9.902999999998668,2512.8888888888887,37,12,10,49
3288,-14.875749999999561,2298.0,29,21,10,50
3289,-11.251749999995848,3775.7368421052633,73,13,23,86
3290,-12.646499999998852,2222.6111111111113,28,19,2,47
3291,-1.2152500000002013,2063.9444444444443,50,11,6,61
3292,-27.11074999999685,3490.157894736842,49,14,16,63
3293,-21.666749999999446,2266.777777777778,27,14,27,41
3294,-17.14424999999614,2675.529411764706,69,16,15,85
3295,-18.6629999999982,2010.0666666666666,61,9,23,70
3296,3.587000000002356,2907.0,50,15,8,65
3297,-9.757999999999264,1663.125,35,10,5,45
3298,-4.616249999999647,1429.0,27,11,3,38
3299,-25.716750000000065,2072.4736842105262,29,11,28,40
3300,-27.404749999999108,3015.5263157894738,53,23,10,76
3301,-0.11274999999913042,2568.4736842105262,51,8,21,59
3302,12.83100000000216,3634.5,83,20,1,103
3303,1.8672500000038006,3374.9411764705883,95,18,14,113
3304,-7.084499999998276,2850.176470588235,78,25,7,103
3305,-9.884999999999451,1719.4117647058824,45,22,5,67
3306,-0.5227499999982411,3063.95,48,9,4,57
3307,-5.280749999996234,5341.05,96,16,3,112
3308,-3.964999999999647,2683.0555555555557,63,19,4,82
3309,-14.87499999999874,2973.6,22,11,13,33
3310,-23.749250000000508,2071.8888888888887,14,17,38,31
3311,-5.43049999999867,3252.05,47,13,9,60
3312,-32.48024999999738,2790.6111111111113,47,19,14,66
3313,-1.326999999998869,2124.6470588235293,72,12,7,84
3314,-17.332749999997134,3154.2105263157896,52,11,15,63
3315,2.7457500000022352,4255.25,63,17,7,80
3316,13.897500000002058,3460.0555555555557,101,10,5,111
3317,5.978000000003131,2242.625,81,8,16,89
3318,-19.51624999999675,2731.5,60,9,10,69
3319,-4.315499999996144,2055.0,75,1,13,76
3320,-6.777499999998879,2044.611111111111,59,18,9,77
3321,-7.311749999999213,2080.684210526316,15,8,6,23
3322,0.08525000000372618,5833.75,107,3,7,110
3323,-14.109999999997054,3399.0,62,16,11,78
3324,-21.805249999998075,2575.529411764706,41,9,25,50
3325,-12.898749999998813,3487.85,45,19,4,64
3326,-22.712749999996422,4155.777777777777,82,13,23,95
3327,-8.476999999997904,4006.1,71,18,2,89
3328,-17.50724999999874,3012.2105263157896,66,22,6,88
3329,-11.16949999999729,1528.25,34,11,17,45
3330,-17.684750000000516,2188.3684210526317,29,14,23,43
3331,-17.281249999997947,2420.1666666666665,54,13,4,67
3332,-34.35699999999957,1429.0,13,12,35,25
3333,-5.229499999998238,3008.55,41,6,4,47
3334,-17.084499999999284,2346.1666666666665,40,15,7,55
3335,0.28425000000437406,2245.1176470588234,79,15,13,94
3336,1.3685000000034326,2404.823529411765,60,8,9,68
3337,-11.671249999998,1769.375,39,13,3,52
3338,-11.556249999997775,4507.6,76,15,5,91
3339,-17.765249999999913,2271.1052631578946,39,18,9,57
3340,-12.974499999999185,2637.0526315789475,31,7,5,38
3341,-11.795999999997424,2103.5625,62,1,16,63
3342,-18.50999999999807,2553.235294117647,52,13,5,65
3343,-22.52274999999805,3814.85,51,11,18,62
3344,-19.73149999999905,2200.4117647058824,27,16,10,43
3345,-23.49249999999847,3206.8888888888887,56,26,6,82
3346,-6.871499999995683,2165.764705882353,74,13,15,87
3347,-6.04299999999974,1429.0,48,21,6,69
3348,0.6362500000039992,2194.705882352941,63,5,17,68
3349,-24.759499999997754,3756.9,49,20,12,69
3350,-28.699499999998203,2482.777777777778,38,21,9,59
3351,-10.338249999998244,3362.0555555555557,56,8,20,64
3352,-28.54299999999983,1429.0,26,18,13,44
3353,0.6152500000016768,2554.125,79,28,5,107
3354,-29.75149999999899,3059.7894736842104,71,13,10,84
3355,-22.214249999998476,2574.6111111111113,66,22,5,88
3356,-4.387499999997555,4079.1052631578946,89,19,4,108
3357,2.1405000000028527,4782.2,86,17,10,103
3358,-1.1984999999971921,1740.5625,53,16,12,69
3359,-2.4062499999990536,2651.3,27,10,3,37
3360,-12.306999999997862,2259.1176470588234,68,18,4,86
3361,-17.050999999997003,4215.210526315789,91,9,3,100
3362,-8.479749999999166,1429.0,15,12,8,27
3363,-4.602499999998185,2460.0,38,11,6,49
3364,-10.345749999997546,3665.65,59,17,6,76
3365,-2.803249999998139,4367.9,58,20,1,78
3366,-7.8154999999975105,2326.3529411764707,53,18,14,71
3367,-8.86324999999761,1653.25,37,15,5,52
3368,-3.6839999999970923,2954.705882352941,76,12,17,88
3369,-2.788999999997523,4770.35,81,14,3,95
3370,-15.835499999999598,2179.6666666666665,35,8,10,43
3371,3.8735000000022444,3465.222222222222,84,20,9,104
3372,-24.811749999998085,4005.4736842105262,66,24,14,90
3373,-5.953249999998072,4290.2,59,20,6,79
3374,-29.47674999999747,1564.4117647058824,14,18,26,32
3375,-16.259499999998837,2607.277777777778,34,14,7,48
3376,-14.27974999999888,1429.0,22,17,1,39
3377,-29.030499999998955,2607.6,25,19,7,44
3378,-14.464249999997325,4341.0,67,14,8,81
3379,5.798500000002948,3520.8888888888887,79,11,9,90
3380,-12.999499999998932,3274.5263157894738,51,27,3,78
3381,-9.54674999999826,2479.4444444444443,40,17,10,57
3382,4.529000000002695,3485.842105263158,71,16,6,87
3383,-3.065999999997444,4995.75,82,24,3,106
3384,-20.90649999999909,2230.0,15,8,13,23
3385,-2.912999999997633,3639.9444444444443,85,13,10,98
3386,-13.393249999998364,2425.6111111111113,52,13,16,65
3387,-11.110499999996438,3727.315789473684,73,12,10,85
3388,-15.87450000000025,2022.9473684210527,34,24,9,58
3389,-7.985749999998579,3106.5789473684213,58,16,5,74
3390,-35.606499999996934,2830.529411764706,45,22,14,67
3391,-11.02349999999846,2095.8333333333335,29,19,4,48
3392,-18.620249999999107,2058.777777777778,26,19,10,45
3393,-10.669249999998533,3086.0555555555557,67,13,16,80
3394,-2.495499999996227,3295.1111111111113,83,11,3,94
3395,-3.0374999999978414,2775.6666666666665,43,6,4,49
3396,-12.67674999999868,2148.0,54,14,4,68
3397,-14.58324999999883,2489.0,53,21,7,74
3398,-12.583249999997454,3827.5,56,11,10,67
3399,1.234500000002622,2727.1666666666665,71,24,6,95
3400,-25.435999999998984,1991.5625,34,18,8,52
3401,-11.153499999997504,3513.777777777778,81,13,5,94
3402,10.85000000000247,4861.6,79,15,6,94
3403,-8.812749999996516,3937.8823529411766,104,18,10,122
3404,-4.187249999998049,2543.1176470588234,70,13,10,83
3405,-2.8814999999984736,3162.5263157894738,37,5,11,42
3406,2.479500000003937,2814.3333333333335,78,7,6,85
3407,-23.082749999998597,1969.75,27,20,15,47
3408,-2.1502499999994193,2467.777777777778,55,17,18,72
3409,-3.6497499999986003,3461.7,47,16,4,63
3410,-10.864249999998343,2444.0555555555557,41,17,6,58
3411,-7.846249999998777,2040.2222222222222,34,16,0,50
3412,-9.873999999996363,5205.105263157895,91,25,3,116
3413,-16.111749999999027,2749.0526315789475,35,16,7,51
3414,-3.850999999998396,2965.277777777778,59,16,6,75
3415,-22.948749999998572,1429.0,24,24,3,48
3416,-16.262999999998897,3385.4,38,23,9,61
3417,-10.807999999996742,2211.529411764706,60,10,5,70
3418,-20.675999999997806,2769.823529411765,78,13,9,91
3419,-6.423999999995347,4369.8421052631575,104,8,7,112
3420,-23.31274999999855,2481.1111111111113,28,19,20,47
3421,-1.7614999999982164,3867.684210526316,80,19,2,99
3422,-3.216999999998665,2084.3333333333335,28,5,14,33
3423,-4.660499999999152,2457.65,20,17,1,37
3424,-12.450499999998662,1698.8823529411766,25,19,4,44
3425,0.42375000000212826,2066.0,51,15,3,66
3426,-16.43524999999941,2621.2105263157896,39,20,5,59
3427,-16.55274999999913,2111.6875,63,25,4,88
3428,-12.120499999996305,3659.277777777778,74,16,17,90
3429,-7.6874999999972715,3216.0526315789475,56,17,6,73
3430,-15.924249999998784,2613.3333333333335,45,17,4,62
3431,-0.7477499999990631,2068.2631578947367,15,11,11,26
3432,-20.920999999997377,3501.35,43,14,13,57
3433,-10.923749999998902,1971.5294117647059,47,14,14,61
3434,-3.9044999999979852,3013.0526315789475,53,6,4,59
3435,-21.416749999997602,2707.315789473684,36,23,10,59
3436,-15.138249999999463,2009.4375,47,20,8,67
3437,-19.983749999997727,2970.4210526315787,40,19,15,59
3438,-9.336749999997746,3479.85,48,14,15,62
3439,-13.843749999998511,2425.294117647059,61,17,7,78
3440,-8.00774999999798,3752.1,65,13,0,78
3441,-14.665749999998619,2481.1111111111113,39,15,10,54
3442,-23.830999999998262,3253.0,44,22,6,66
3443,-4.804249999998137,2085.1111111111113,40,13,7,53
3444,-14.22724999999662,3285.2631578947367,49,15,22,64
3445,-5.232999999998617,2166.125,73,13,4,86
3446,-16.59124999999631,2130.5,65,15,5,80
3447,5.975250000001667,1496.5,62,7,3,69
3448,-8.673499999998247,3086.3,46,12,4,58
3449,-10.781999999997513,4437.8,69,8,2,77
3450,-16.408999999998464,3266.8333333333335,68,14,11,82
3451,-6.83899999999881,3026.3684210526317,48,11,17,59
3452,-8.873499999998094,2830.3333333333335,71,10,6,81
3453,-5.870999999998616,1639.375,61,19,13,80
3454,-8.222499999998531,2616.1111111111113,49,11,16,60
3455,-1.911499999996262,5119.7,88,9,11,97
3456,4.300750000003068,2550.25,103,13,8,116
3457,-10.29424999999738,2262.0588235294117,47,12,10,59
3458,-11.435499999998072,2997.8888888888887,47,13,8,60
3459,3.31775000000214,4841.75,80,8,6,88
3460,1.178000000001714,2790.6111111111113,64,11,4,75
3461,-12.948249999999225,2668.7,30,19,2,49
3462,-8.922500000000102,1429.0,0,12,2,12
3463,-10.531249999999089,2688.1052631578946,46,19,5,65
3464,-1.4237499999971577,4282.0,79,12,6,91
3465,-17.542749999997323,1698.9411764705883,24,17,14,41
3466,6.639500000004925,2815.0625,106,7,4,113
3467,-29.852499999998834,2099.0,15,22,15,37
3468,-18.888999999995193,3426.4117647058824,93,15,9,108
3469,-6.217749999999721,1481.9333333333334,49,17,9,66
3470,0.8890000000020963,2974.3529411764707,70,21,2,91
3471,-27.249999999999538,1429.0,13,19,10,32
3472,-17.310249999997875,3714.9,52,16,14,68
3473,-17.67649999999937,2200.2105263157896,31,17,7,48
3474,-25.44524999999814,2234.4210526315787,26,24,6,50
3475,-6.2827499999989485,2967.0526315789475,50,9,10,59
3476,-3.3084999999984297,2290.8823529411766,60,12,6,72
3477,-6.357999999996847,2147.9411764705883,68,13,10,81
3478,-16.48699999999831,2630.764705882353,65,21,16,86
3479,-6.953499999997487,3160.8947368421054,60,14,3,74
3480,-2.299749999997975,3274.722222222222,68,11,7,79
3481,-5.5139999999982665,3465.0,52,16,14,68
3482,-13.337249999998672,2912.4,31,11,10,42
3483,0.6722500000000411,2101.4117647058824,46,14,15,60
3484,-13.040749999999221,2173.176470588235,32,9,21,41
3485,-19.389499999997525,3956.2631578947367,72,21,12,93
3486,-2.4994999999985223,2684.1176470588234,77,12,6,89
3487,-3.569249999998493,2735.1111111111113,58,15,9,73
3488,-0.5302499999969363,3629.5263157894738,70,7,8,77
3489,-13.803749999998804,2052.5,29,17,7,46
3490,-0.17974999999687125,2121.5,73,9,12,82
3491,-8.599999999997696,3558.5789473684213,65,8,6,73
3492,7.997500000002198,4344.9,77,17,6,94
3493,-53.88100000000086,2373.5,27,24,52,51
3494,-4.738499999998518,3104.157894736842,47,3,0,50
3495,-12.088249999998968,2689.684210526316,36,8,8,44
3496,-15.473249999999808,2068.3888888888887,15,12,14,27
3497,-7.9927499999978595,1621.5,59,19,1,78
3498,-6.421999999998789,1429.0,47,13,7,60
3499,-11.561749999998373,1920.0,59,30,9,89
3500,-9.947249999997698,2307.705882352941,77,15,17,92
3501,-10.115749999998858,1429.0,41,19,0,60
3502,-7.030749999998051,3569.4210526315787,62,6,6,68
3503,-15.369499999999075,2052.5555555555557,32,17,11,49
3504,-12.237749999998133,2432.777777777778,37,14,9,51
3505,-21.167499999999134,2013.6470588235295,47,21,3,68
3506,-12.445249999998476,2014.375,50,19,11,69
3507,0.4147500000048847,2455.3529411764707,107,6,12,113
3508,-14.426499999997466,3648.1052631578946,58,17,8,75
3509,-4.518999999998553,4493.421052631579,104,22,8,126
3510,-16.472249999997928,3338.0,43,24,14,67
3511,-14.600999999997876,3008.842105263158,48,16,7,64
3512,-21.96274999999917,1675.0625,29,23,9,52
3513,-3.9322499999987968,3867.5789473684213,74,12,13,86
3514,-24.81399999999859,2504.8888888888887,41,9,33,50
3515,-1.918249999998865,2597.176470588235,66,21,17,87
3516,-11.767749999998113,3794.15,54,20,9,74
3517,-10.60524999999773,2557.0,66,17,10,83
3518,-20.716999999997803,4045.529411764706,61,15,4,76
3519,21.479250000002686,4801.3,82,24,1,106
3520,-2.2119999999983952,2481.1111111111113,71,13,9,84
3521,-30.107749999998873,2202.294117647059,27,16,13,43
3522,-16.53324999999746,4180.65,58,17,3,75
3523,-6.412999999999249,1429.0,13,9,4,22
3524,-33.02099999999863,2215.722222222222,33,16,9,49
3525,-14.53549999999826,2592.222222222222,53,17,6,70
3526,3.588750000002895,3114.277777777778,67,7,15,74
3527,18.519000000002652,5125.2,92,17,6,109
3528,-12.802999999998537,2802.5263157894738,40,11,6,51
3529,-18.044499999997193,2780.8888888888887,60,17,6,77
3530,-12.223249999997726,3461.684210526316,50,21,6,71
3531,-11.865999999999,2476.6666666666665,30,14,5,44
3532,-9.708749999996744,2433.764705882353,57,17,13,74
3533,1.793000000002181,2736.4117647058824,72,13,17,85
3534,-5.6937499999974035,3165.0526315789475,64,10,5,74
3535,-25.54324999999816,2196.842105263158,33,20,5,53
3536,-6.088499999997493,2130.4375,81,13,13,94
3537,-4.286999999998234,2971.875,93,12,7,105
3538,4.486250000001066,3193.4736842105262,54,13,11,67
3539,-26.403999999999165,2193.4736842105262,13,11,10,24
3540,-6.871999999998278,2581.0,40,14,5,54
3541,0.7492500000018654,3175.85,43,8,7,51
3542,-18.26799999999664,4460.8,73,24,8,97
3543,-11.04024999999837,3049.7894736842104,41,20,10,61
3544,-1.2002499999966243,3006.6666666666665,66,11,14,77
3545,-0.8297499999982966,3183.1111111111113,71,13,5,84
3546,0.698500000002548,4034.7368421052633,67,14,22,81
3547,0.7607500000029965,2973.3529411764707,68,14,2,82
3548,-10.229999999998261,1631.7058823529412,36,14,4,50
3549,-15.362749999998442,3354.7368421052633,58,19,11,77
3550,8.515500000000827,2548.15,33,1,3,34
3551,-18.076499999997942,1942.6470588235295,41,10,6,51
3552,-34.536249999997764,2663.6111111111113,37,18,14,55
3553,-16.82599999999747,1429.0,26,14,16,40
3554,-13.698749999998771,2033.9473684210527,17,7,16,24
3555,3.355750000001668,3768.2105263157896,69,13,6,82
3556,-19.79774999999828,2760.6666666666665,46,18,10,64
3557,-15.644249999999431,2643.7894736842104,48,19,3,67
3558,-1.2682499999976846,2443.0625,101,14,4,115
3559,13.787000000002251,4212.45,72,10,4,82
3560,-16.4820000000001,1429.0,15,18,12,33
3561,-10.006499999998894,1429.0,47,20,9,67
3562,2.5880000000000516,2889.3333333333335,69,24,1,93
3563,-18.19899999999928,2770.3888888888887,44,6,28,50
3564,-13.348249999998691,2450.470588235294,41,27,4,68
3565,-12.582249999999352,2921.1111111111113,58,9,9,67
3566,-13.007499999996176,4861.55,83,9,6,92
3567,-33.157749999998856,2137.1666666666665,42,25,20,67
3568,-2.9177499999972243,2420.1666666666665,51,17,11,68
3569,5.002500000001168,2509.4117647058824,73,11,6,84
3570,-11.141249999997884,2422.4210526315787,39,19,10,58
3571,-28.1937499999985,2481.842105263158,31,13,9,44
3572,-27.239499999999975,1944.6315789473683,16,19,23,35
3573,-3.6389999999968317,4742.6,68,27,11,95
3574,-5.063499999997733,3181.7894736842104,54,21,5,75
3575,-14.170249999999005,2325.8888888888887,41,12,15,53
3576,-10.389999999998688,2671.5,45,15,6,60
3577,1.2052500000032587,2858.5555555555557,61,13,13,74
3578,-17.756249999999067,2694.684210526316,25,20,4,45
3579,-12.478249999999402,3048.2105263157896,43,13,9,56
3580,-7.92574999999851,2523.4117647058824,68,22,14,90
3581,-5.403749999998302,2838.1666666666665,47,11,9,58
3582,-26.115749999998457,2764.8947368421054,33,19,10,52
3583,-16.833499999998665,2898.15,32,19,3,51
3584,-3.6017499999981544,3117.9,52,12,4,64
3585,4.23500000000101,2723.1176470588234,103,18,1,121
3586,11.504750000001007,1536.1875,53,5,10,58
3587,-22.383499999998612,2313.9375,64,16,20,80
3588,-4.5589999999998545,2341.722222222222,58,23,3,81
3589,-4.780249999998142,3790.25,61,18,7,79
3590,-6.416749999999031,2512.8888888888887,73,17,2,90
3591,-5.53574999999907,2548.1,35,9,3,44
3592,-18.934749999997898,2918.684210526316,51,16,6,67
3593,-19.883999999995716,2912.277777777778,62,23,12,85
3594,-23.36899999999825,2636.2631578947367,34,19,6,53
3595,7.344500000001264,2339.75,85,8,10,93
3596,-28.937749999997532,3613.684210526316,54,16,14,70
3597,-22.1857499999987,1532.1875,23,23,4,46
3598,-18.05699999999925,2156.529411764706,52,17,20,69
3599,-25.648249999999233,2729.85,30,21,3,51
3600,-10.091249999999212,2433.2105263157896,30,21,7,51
3601,-23.714749999997412,2122.823529411765,62,25,16,87
3602,4.312500000001956,3735.3,59,5,3,64
3603,-23.483249999998332,2753.2105263157896,26,9,20,35
3604,-19.628499999999388,2038.8947368421052,12,18,5,30
3605,-4.040749999997719,3202.235294117647,90,18,6,108
3606,-5.086749999999467,2294.1666666666665,46,8,6,54
3607,-11.06849999999945,2632.2,17,13,4,30
3608,-13.32224999999687,2907.1666666666665,71,19,8,90
3609,-22.886499999999252,2795.0526315789475,36,19,9,55
3610,3.8075000000013057,3380.5789473684213,64,13,17,77
3611,5.80425000000064,3403.157894736842,68,14,9,82
3612,3.1217500000016174,3109.9444444444443,74,13,5,87
3613,-22.917999999998308,2618.0,25,17,14,42
3614,-20.942000000000135,1429.0,35,12,16,47
3615,-3.6007499999975883,3697.3,60,10,9,70
3616,-14.278249999995714,3715.6111111111113,68,16,26,84
3617,-21.762999999997824,2495.1666666666665,53,16,8,69
3618,2.737000000001443,2950.277777777778,45,17,6,62
3619,-5.493999999998378,2638.8888888888887,76,26,0,102
3620,-14.789499999995948,3344.684210526316,67,17,6,84
3621,-13.818499999999005,2737.0,30,15,1,45
3622,-12.794499999998417,1481.9333333333334,60,18,8,78
3623,-10.517749999997424,2971.315789473684,52,10,12,62
3624,2.62950000000206,2890.277777777778,51,15,6,66
3625,-30.39099999999609,1858.5294117647059,36,17,23,53
3626,-0.18124999999785613,2768.3125,93,22,4,115
3627,-6.173999999998719,2445.8823529411766,51,8,6,59
3628,-6.573749999997548,3781.6,66,14,2,80
3629,-20.350749999997,3445.842105263158,50,14,16,64
3630,-9.711249999996825,4259.3,72,17,5,89
3631,-18.250249999996992,3045.470588235294,68,11,18,79
3632,-20.16024999999788,3290.3684210526317,49,25,5,74
3633,7.538250000001471,3587.777777777778,89,9,10,98
3634,-14.815749999998442,3409.842105263158,48,27,12,75
3635,-19.277749999998072,2611.8947368421054,39,19,5,58
3636,-0.7819999999995884,2785.0,55,11,8,66
3637,-8.23149999999833,4575.85,56,22,5,78
3638,-23.212499999997497,2874.5,48,13,4,61
3639,1.242250000001584,2298.4117647058824,49,15,6,64
3640,13.152500000003988,2893.8333333333335,79,22,7,101
3641,-6.522499999999522,2540.0555555555557,49,15,17,64
3642,-17.982749999997726,3176.7894736842104,39,11,13,50
3643,4.414250000003747,4836.95,90,11,6,101
3644,-1.3057499999981035,2610.176470588235,52,9,17,61
3645,-7.517999999998771,2765.6,32,14,4,46
3646,-10.927249999998441,2807.3529411764707,56,18,7,74
3647,-28.353749999999515,2645.3684210526317,24,25,19,49
3648,-17.48599999999771,2532.3333333333335,32,22,15,54
3649,7.218250000003147,4637.0,76,14,4,90
3650,-16.427499999998727,3186.95,34,16,7,50
3651,-31.5267499999995,2768.2631578947367,43,19,17,62
3652,-17.13174999999883,3473.55,40,24,4,64
3653,-5.953999999997221,3475.5882352941176,87,13,18,100
3654,-4.339499999996457,2711.0,74,7,10,81
3655,-17.461249999998657,2726.5263157894738,44,11,14,55
3656,-20.577249999998365,3338.55,46,18,11,64
3657,-15.59899999999755,2570.2631578947367,32,8,18,40
3658,-24.161499999998636,2693.6666666666665,41,11,23,52
3659,-9.636249999998029,2904.4736842105262,36,9,17,45
3660,-1.2254999999981466,3261.6,42,14,7,56
3661,-14.73849999999825,3729.9,56,15,8,71
3662,-15.359999999999397,1429.0,44,14,13,58
3663,-9.735499999997442,3822.75,58,9,6,67
3664,-3.9314999999996623,1448.0666666666666,65,18,6,83
3665,-12.097749999998651,3357.6111111111113,67,30,3,97
3666,-22.578249999999084,1429.0,10,23,19,33
3667,-26.042999999999928,2764.8947368421054,50,24,9,74
3668,-12.92349999999829,3425.7368421052633,69,13,6,82
3669,-23.391499999996437,2018.3529411764705,47,20,16,67
3670,-19.629749999997806,3431.45,40,19,18,59
3671,-19.17849999999952,2683.0,24,27,3,51
3672,-13.842249999997302,2945.1111111111113,61,8,7,69
3673,-20.062999999999462,2084.1052631578946,12,18,7,30
3674,-14.371999999999584,2075.85,14,11,5,25
3675,-23.921249999999663,1973.75,39,22,14,61
3676,-12.294249999999753,1429.0,12,22,2,34
3677,-10.553749999997567,2329.235294117647,43,13,13,56
3678,-14.804999999998177,2430.0,25,11,15,36
3679,-24.151249999998786,2828.5789473684213,46,16,23,62
3680,-10.2134999999978,2344.8125,69,14,7,83
3681,6.624250000001569,3120.35,42,18,3,60
3682,-0.4772499999981781,2451.875,77,13,11,90
3683,-7.177999999997738,2870.157894736842,46,10,10,56
3684,-14.490499999999178,1532.1875,21,19,12,40
3685,-2.1574999999977598,4281.45,66,6,3,72
3686,-14.23274999999779,2279.1666666666665,20,9,18,29
3687,-16.978999999997335,2261.8823529411766,53,20,15,73
3688,-18.164999999996454,3748.9473684210525,65,22,8,87
3689,-11.257499999995932,2089.176470588235,60,14,16,74
3690,-31.009249999999405,2084.3333333333335,34,16,17,50
3691,-5.67149999999929,2693.157894736842,48,11,7,59
3692,1.8557500000032334,2909.6111111111113,66,10,9,76
3693,-5.938749999996208,2599.6875,88,14,6,102
3694,-17.927499999996815,1912.1875,26,11,33,37
3695,-16.324499999999514,2598.684210526316,47,13,13,60
3696,-7.1254999999987705,2575.1,27,10,10,37
3697,8.377000000003193,3941.3888888888887,90,14,11,104
3698,-14.781249999997815,2759.0,55,14,13,69
3699,-1.024499999999044,4065.55,53,8,6,61
3700,-7.668999999997302,3560.6111111111113,91,20,26,111
3701,-30.138249999999385,2151.764705882353,64,46,0,110
3702,-10.528499999999065,2698.8,24,9,5,33
3703,-25.793499999997476,4098.388888888889,76,26,14,102
3704,-4.154749999999014,1429.0,52,15,1,67
3705,-1.6052499999979872,3105.684210526316,51,12,6,63
3706,-14.501499999998297,3131.8888888888887,71,21,16,92
3707,2.1150000000043265,3362.764705882353,88,15,9,103
3708,-0.9977499999982884,4110.1,57,19,12,76
3709,-29.0287499999979,2450.529411764706,68,26,15,94
3710,7.955250000002887,3543.5263157894738,65,9,14,74
3711,0.3532500000022039,4352.1,72,17,7,89
3712,-4.673499999998078,3084.7,52,4,7,56
3713,-2.4187499999965767,2990.176470588235,72,7,8,79
3714,-24.561999999999422,2583.684210526316,27,6,23,33
3715,-2.7424999999987802,2147.8333333333335,46,13,11,59
3716,13.52875000000309,4515.9473684210525,97,11,5,108
3717,-8.215249999998514,2050.0625,59,12,14,71
3718,2.6590000000018277,3019.8888888888887,73,25,9,98
3719,-8.439249999997713,3449.4444444444443,75,14,24,89
3720,16.304750000003246,2916.25,100,9,9,109
3721,-10.84449999999651,2582.235294117647,67,13,18,80
3722,-5.846499999996974,2783.0,64,16,7,80
3723,3.260750000003103,5139.4,71,18,19,89
3724,-7.182749999998046,2354.1111111111113,60,14,9,74
3725,-20.635499999996558,4537.05,73,5,13,78
3726,-7.472749999999851,1559.764705882353,17,18,1,35
3727,-4.74274999999935,3043.1052631578946,78,9,4,87
3728,6.829250000003083,2801.3888888888887,68,14,3,82
3729,10.849250000002073,4584.421052631579,89,27,6,116
3730,-3.096999999997632,3139.2105263157896,62,19,5,81
3731,4.739750000003139,3190.176470588235,85,12,14,97
3732,5.230000000002875,3974.6315789473683,89,11,3,100
3733,-8.464499999997551,2139.705882352941,50,13,12,63
3734,-8.778499999997674,2169.5882352941176,51,9,6,60
3735,-20.981499999997958,3559.25,40,14,11,54
3736,-14.331499999998925,3231.0526315789475,42,26,10,68
3737,-18.06599999999863,3046.4210526315787,42,16,11,58
3738,-19.83999999999879,2820.0,30,29,1,59
3739,-16.35549999999875,2223.6470588235293,58,22,11,80
3740,-25.82699999999811,2372.5625,54,24,21,78
3741,-16.631999999998833,3057.4210526315787,40,21,12,61
3742,-20.326749999999205,1627.0,27,7,19,34
3743,-1.2234999999974023,2988.294117647059,89,13,9,102
3744,-23.98724999999872,2622.0,33,11,9,44
3745,-20.94649999999844,2204.315789473684,32,16,6,48
3746,-0.23224999999957757,2378.705882352941,50,17,7,67
3747,-2.1449999999998552,2187.5555555555557,34,9,22,43
3748,-11.11099999999884,3413.157894736842,64,20,8,84
3749,-23.62824999999693,4225.1,66,24,5,90
3750,-11.738999999998976,2731.4736842105262,31,5,9,36
3751,-17.079499999998966,2454.235294117647,57,20,13,77
3752,-12.98524999999817,3627.842105263158,57,24,1,81
3753,-2.4107499999989965,2891.235294117647,81,20,4,101
3754,4.913750000003819,4571.0526315789475,85,17,21,102
3755,-25.24349999999699,2541.1176470588234,63,18,6,81
3756,3.660750000003977,4088.2631578947367,83,10,10,93
3757,-17.692499999998038,1586.6666666666667,67,23,8,90
3758,-8.722999999997876,2845.6470588235293,67,12,14,79
3759,-17.44124999999827,2755.8571428571427,40,17,17,57
3760,-15.398749999998316,2464.3333333333335,39,17,6,56
3761,-32.68049999999813,3237.7894736842104,43,13,20,56
3762,-7.198749999999199,3225.2105263157896,63,11,20,74
3763,-26.332750000000196,1429.0,14,22,25,36
3764,-15.738249999999036,2646.55,27,6,13,33
3765,-4.825999999997907,3848.1,53,9,12,62
3766,-17.67650000000033,1429.0,35,18,11,53
3767,-15.152999999998704,2005.1764705882354,44,15,12,59
3768,-12.34899999999886,2706.05,31,12,7,43
3769,-12.899249999999117,2738.5,42,16,8,58
3770,15.575750000003117,3745.7368421052633,81,5,5,86
3771,-10.544749999998043,2015.3333333333333,51,12,15,63
3772,-6.675499999998398,3591.05,41,12,12,53
3773,1.1802500000019946,4037.315789473684,69,16,10,85
3774,-13.139249999998517,3349.7368421052633,49,14,11,63
3775,-5.387249999998524,4540.9,62,23,15,85
3776,-12.859249999997953,3290.315789473684,53,15,11,68
3777,-30.381749999999748,2635.4210526315787,11,12,52,23
3778,-19.729499999999387,2284.4117647058824,29,18,32,47
3779,-1.8209999999975577,3339.7894736842104,53,13,13,66
3780,-6.008749999998605,2869.315789473684,37,8,13,45
3781,-14.553499999995756,2818.8888888888887,56,10,20,66
3782,-6.714999999998698,2348.8823529411766,40,12,6,52
3783,-3.032999999996842,4705.25,84,13,5,97
3784,-10.790499999997692,3508.5,52,18,6,70
3785,-7.243249999998838,3177.5789473684213,50,7,17,57
3786,-22.752499999996978,2732.529411764706,50,12,19,62
3787,-15.18199999999948,2261.55,15,22,4,37
3788,-14.585249999998757,3067.1,37,20,5,57
3789,6.926250000001538,2717.315789473684,47,8,8,55
3790,-6.952499999998041,3383.3529411764707,88,15,9,103
3791,-7.190499999999027,2450.7894736842104,30,11,10,41
3792,-23.14349999999788,4698.2,64,14,13,78
3793,-14.238499999999126,2929.05,28,13,13,41
3794,-23.19149999999937,2833.777777777778,38,12,19,50
3795,3.8265000000034193,3655.4210526315787,72,8,7,80
3796,1.7535000000024226,4314.0,67,18,10,85
3797,-24.4124999999996,2782.4210526315787,24,13,11,37
3798,11.74525000000396,5742.55,99,10,6,109
3799,2.0425000000018456,3412.35,35,7,17,42
3800,-9.980999999997834,2959.5789473684213,52,14,8,66
3801,-17.663999999998367,4299.0,65,14,13,79
3802,-16.58774999999897,2602.8888888888887,67,11,15,78
3803,-8.197999999998412,3221.15,32,15,14,47
3804,-25.494499999999043,2523.4736842105262,26,21,13,47
3805,2.9087500000012705,3037.5555555555557,78,20,7,98
3806,-7.541999999997917,4057.7,58,17,5,75
3807,18.08125000000343,2510.294117647059,67,5,12,72
3808,-14.880249999998853,2830.65,25,7,21,32
3809,-17.710749999997713,2361.8823529411766,48,15,3,63
3810,-10.709499999996783,3030.5263157894738,69,10,7,79
3811,-4.312749999998369,2223.6470588235293,71,17,7,88
3812,-14.49924999999906,2786.1666666666665,55,27,11,82
3813,-25.009499999999015,2587.1,31,9,6,40
3814,11.459750000002618,3957.0,73,14,5,87
3815,-7.831999999998335,2063.9411764705883,73,14,10,87
3816,-5.514749999998004,2799.2631578947367,37,16,16,53
3817,1.0372500000024167,2816.5882352941176,80,5,9,85
3818,-17.863749999997648,4203.473684210527,86,26,10,112
3819,7.640250000002036,4236.894736842105,82,16,7,98
3820,-5.339249999998356,3537.5789473684213,60,8,16,68
3821,-25.38299999999644,2072.8888888888887,29,4,35,33
3822,-23.638249999997868,3718.0,51,14,10,65
3823,-20.443749999998822,2750.9444444444443,56,11,26,67
3824,18.231500000003425,4508.5,79,3,3,82
3825,-15.182749999998393,2808.55,32,12,10,44
3826,-0.5064999999974944,3325.8888888888887,72,19,11,91
3827,-2.3612499999963856,3652.294117647059,93,17,6,110
3828,-10.08399999999899,3141.842105263158,57,13,17,70
3829,6.448750000002635,1481.9333333333334,86,17,3,103
3830,-23.819249999998735,2846.5,31,15,6,46
3831,-15.756499999998528,3822.5263157894738,74,13,19,87
3832,-9.606499999998748,2961.315789473684,68,11,8,79
3833,-6.843999999999177,2387.0,37,19,4,56
3834,-9.702999999998429,3042.315789473684,49,15,8,64
3835,-22.12100000000004,2039.0,33,13,17,46
3836,-1.8724999999968268,4065.65,67,10,10,77
3837,1.9442500000025789,2514.0588235294117,60,6,17,66
3838,-14.115749999998055,2770.3888888888887,40,13,14,53
3839,-7.684999999996006,3235.705882352941,86,12,9,98
3840,-16.028249999998007,2445.0526315789475,25,9,25,34
3841,-16.130999999997385,1541.125,49,10,9,59
3842,-13.125249999997198,3200.1052631578946,62,9,9,71
3843,-12.22249999999939,2297.8947368421054,28,4,8,32
3844,-4.323749999999652,2381.3888888888887,51,10,22,61
3845,-14.542749999999282,2179.5,28,17,11,45
3846,9.13125000000215,4223.5,68,18,4,86
3847,-9.832749999998876,2133.5625,47,11,2,58
3848,-15.238749999998584,3880.2105263157896,67,21,8,88
3849,-22.379499999997382,1917.4117647058824,24,16,27,40
3850,-7.258249999998557,2458.8823529411766,44,10,11,54
3851,-12.496499999997598,3526.7894736842104,69,13,7,82
3852,-20.49649999999955,1992.1176470588234,35,24,5,59
3853,-10.17874999999841,3275.85,50,12,5,62
3854,3.337500000002265,4154.45,65,8,7,73
3855,-24.372249999997926,2765.176470588235,60,16,14,76
3856,-22.570499999996834,1572.875,37,20,17,57
3857,4.385250000004097,3882.3888888888887,89,15,8,104
3858,-21.15924999999951,1429.0,12,24,4,36
3859,-19.999749999997295,4224.3,67,26,3,93
3860,-12.075999999998304,2493.4444444444443,36,10,9,46
3861,-8.566249999995959,2169.777777777778,66,11,12,77
3862,-11.383999999999151,2769.5,30,23,4,53
3863,-16.736499999999282,1699.7777777777778,13,12,8,25
3864,-27.803249999998336,2916.470588235294,65,20,17,85
3865,-25.378749999997833,2176.8888888888887,44,19,6,63
3866,-2.282999999998311,3651.3684210526317,63,8,8,71
3867,-37.88699999999885,2878.0555555555557,35,25,27,60
3868,-9.631999999997204,2433.4444444444443,41,17,17,58
3869,-15.30449999999735,1796.125,56,17,8,73
3870,-33.107749999997445,3276.9473684210525,43,19,10,62
3871,-7.583999999998044,5150.5,69,14,26,83
3872,-8.28899999999538,1742.5625,72,11,14,83
3873,-8.703749999998317,2598.75,69,25,4,94
3874,-12.290999999997009,3061.5789473684213,51,9,18,60
3875,-12.648499999999544,2059.294117647059,43,18,6,61
3876,-4.086499999998908,1429.0,27,8,7,35
3877,-11.722749999997246,4175.85,69,24,6,93
3878,-15.333999999999037,2587.15,30,12,9,42
3879,-23.54574999999504,2278.375,75,10,23,85
3880,-18.199499999997567,2059.3529411764707,56,17,7,73
3881,-12.321999999998969,1599.6875,14,16,4,30
3882,-9.517749999998863,3042.2631578947367,34,21,12,55
3883,-12.727999999997852,2207.777777777778,37,20,7,57
3884,0.7285000000037946,3571.1052631578946,78,15,12,93
3885,0.42050000000160354,2321.5555555555557,34,13,7,47
3886,3.745250000002924,2488.625,89,24,5,113
3887,-15.904249999999655,1612.5625,48,15,15,63
3888,-16.656999999999478,1903.2941176470588,50,21,5,71
3889,6.582500000002909,4252.894736842105,99,15,14,114
3890,2.045750000001468,2270.3529411764707,48,16,5,64
3891,3.211250000001937,3402.315789473684,60,11,8,71
3892,-21.162499999998793,2726.5789473684213,42,16,20,58
3893,-20.395999999998068,4002.9,61,21,12,82
3894,-23.42224999999673,1617.5625,52,25,6,77
3895,-11.737749999998309,2347.2631578947367,27,7,13,34
3896,-24.125999999995134,1947.9375,77,15,15,92
3897,-14.188249999998778,3567.05,43,18,15,61
3898,-17.468249999997408,1822.9375,42,18,6,60
3899,-31.348999999998576,2637.1,26,18,6,44
3900,-4.680249999998038,2528.777777777778,68,14,11,82
3901,11.775750000002294,2831.842105263158,53,10,17,63
3902,7.4812500000030315,3273.375,113,11,14,124
3903,-5.944749999998376,2739.9411764705883,78,26,0,104
3904,-11.30524999999935,2520.1052631578946,30,11,9,41
3905,-3.5084999999966135,4493.3,65,16,10,81
3906,-20.642999999998324,2340.1111111111113,37,15,7,52
3907,-0.24599999999693978,3806.5555555555557,99,10,7,109
3908,-7.645499999997452,4683.15,69,31,8,100
3909,-14.12749999999816,2187.5,23,16,23,39
3910,-15.734499999997809,3841.1,54,13,10,67
3911,-2.004499999998005,1589.6470588235295,37,14,5,51
3912,-0.5429999999989088,1514.375,50,17,6,67
3913,-29.795000000000204,2012.1052631578948,30,21,22,51
3914,-13.447999999998382,2942.65,31,11,8,42
3915,13.332750000002358,2963.1176470588234,69,7,18,76
3916,-12.510249999999337,2024.7058823529412,28,15,11,43
3917,14.130750000002275,3723.6111111111113,92,7,12,99
3918,-18.955749999999504,2429.1111111111113,49,18,7,67
3919,-10.308499999998432,3147.35,36,13,11,49
3920,-17.956999999996984,2766.777777777778,65,14,13,79
3921,-8.056249999997153,3272.0,67,20,10,87
3922,8.259750000002214,2576.529411764706,96,21,3,117
3923,-14.359499999994672,1534.8666666666666,100,14,8,114
3924,-7.604499999998029,3828.4,59,10,17,69
3925,-5.476749999996553,2816.1111111111113,68,10,7,78
3926,-11.847999999998152,4444.1578947368425,85,20,10,105
3927,-40.3817499999988,2644.2,33,23,1,56
3928,6.610250000001868,2664.235294117647,84,15,8,99
3929,-5.355499999998907,1879.1176470588234,35,7,20,42
3930,-3.60424999999778,3536.15,52,9,6,61
3931,-9.29874999999769,2460.8333333333335,43,2,9,45
3932,-14.139499999998293,1623.2941176470588,24,22,7,46
3933,-13.286499999999469,2448.2631578947367,30,18,16,48
3934,-15.120749999996317,1858.625,68,15,8,83
3935,-3.5402499999984256,2131.176470588235,43,14,7,57
3936,-9.112499999997324,2383.1666666666665,55,12,12,67
3937,-17.204499999998696,1429.0,23,24,4,47
3938,-14.028499999999113,2193.722222222222,21,11,3,32
3939,-4.642249999998038,3875.05,58,22,4,80
3940,-29.26849999999938,1429.0,12,17,13,29
3941,-14.280499999998522,3181.45,42,19,10,61
3942,-8.915499999997794,3763.315789473684,69,16,6,85
3943,-4.655249999997495,4238.75,63,14,5,77
3944,5.965500000002292,4167.2,72,12,3,84
3945,-1.479999999997967,3404.8947368421054,57,16,3,73
3946,1.257250000001609,3655.5263157894738,77,9,8,86
3947,-17.01799999999749,4215.7,63,14,14,77
3948,-9.849999999998278,3139.4,39,21,3,60
3949,-16.33949999999755,3068.277777777778,60,13,18,73
3950,-11.31174999999859,2857.55,30,13,2,43
3951,3.2282500000019594,2610.235294117647,90,17,4,107
3952,6.000500000003292,5144.95,95,8,8,103
3953,-10.512749999998652,3392.6,44,22,0,66
3954,2.0827500000015413,3191.9444444444443,79,13,9,92
3955,-2.333749999998537,3720.3,58,13,3,71
3956,-6.149749999998971,3123.65,42,16,5,58
3957,-15.64200000000009,1429.0,32,16,16,48
3958,4.911750000002541,2897.7368421052633,57,4,9,61
3959,-6.7387499999955836,5940.15,102,23,2,125
3960,8.577750000001139,3178.25,48,10,0,58
3961,1.6095000000022206,4222.7,65,14,5,79
3962,-16.317999999998577,3713.1,51,14,9,65
3963,4.653250000003678,2234.5625,81,11,7,92
3964,-10.395749999998026,2091.6315789473683,31,21,12,52
3965,-22.072249999998213,1583.8125,28,10,9,38
3966,-2.5844999999983385,2509.529411764706,67,19,9,86
3967,-0.4127499999974587,3552.4444444444443,73,14,10,87
3968,-1.1852499999970747,2545.25,87,13,11,100
3969,1.818250000001321,3006.6666666666665,58,14,10,72
3970,-18.929249999998778,1539.235294117647,12,13,13,25
3971,9.707250000003494,5129.1,94,15,11,109
3972,9.008750000001243,3442.65,50,13,3,63
3973,-15.22399999999883,2103.8125,38,12,14,50
3974,-2.8442499999950974,3176.8888888888887,103,20,3,123
3975,-1.9232499999989812,2774.1052631578946,29,9,4,38
3976,25.02250000000268,3344.3888888888887,82,19,6,101
3977,-18.83824999999839,2973.7894736842104,39,21,7,60
3978,-4.38599999999602,1528.25,67,14,6,81
3979,-2.246749999998041,2345.9411764705883,46,18,8,64
3980,-1.4147499999991602,2610.0,27,15,3,42
3981,8.660250000001469,3019.684210526316,42,11,11,53
3982,-25.253999999997763,4706.85,78,15,3,93
3983,2.559250000001461,3102.4210526315787,65,11,6,76
3984,-4.775499999995896,3121.5625,98,8,6,106
3985,-20.13299999999906,1991.625,32,24,7,56
3986,5.929250000001464,3418.3684210526317,57,5,21,62
3987,-24.64475000000029,1618.5294117647059,11,20,33,31
3988,-10.688249999999313,2553.6315789473683,41,20,10,61
3989,-11.603999999999383,1541.1875,12,18,1,30
3990,-38.806249999997966,1709.1764705882354,23,28,10,51
3991,-16.829249999996776,2592.529411764706,50,16,21,66
3992,-25.618249999998152,3516.0526315789475,62,6,16,68
3993,-8.807499999998102,2245.5,59,21,4,80
3994,-15.076749999998896,3120.7894736842104,43,13,12,56
3995,-11.760999999999001,3475.15,48,14,1,62
3996,-26.207249999996755,4508.45,60,5,28,65
3997,19.403000000000105,3000.4444444444443,77,7,13,84
3998,-0.5117499999951454,1528.25,82,9,4,91
3999,-8.549999999997745,4187.05,67,16,11,83
4000,-24.16650000000065,2025.7058823529412,42,13,26,55
4001,-20.041999999999113,3005.4736842105262,57,20,7,77
4002,11.039000000002693,4951.25,85,15,8,100
4003,-5.041499999998162,3889.4210526315787,90,17,4,107
4004,-19.193499999997563,4192.631578947368,78,14,21,92
4005,-0.32449999999901474,2965.4210526315787,43,10,11,53
4006,-8.21399999999949,2103.625,40,10,33,50
4007,-19.692999999998882,2749.0526315789475,32,20,8,52
4008,-6.411749999997198,4150.45,68,15,9,83
4009,-8.58249999999796,3697.3,53,9,12,62
4010,4.8880000000017425,3898.9,63,12,5,75
4011,-24.516249999997456,1652.111111111111,41,24,2,65
4012,-8.242499999998945,2171.5555555555557,41,14,7,55
4013,-14.00449999999832,1943.0,53,11,8,64
4014,1.4595000000027418,3588.5789473684213,72,15,4,87
4015,0.9360000000022388,2652.277777777778,55,8,12,63
4016,4.765500000004364,2512.5,98,10,6,108
4017,-11.453999999998377,3036.25,45,10,7,55
4018,-6.314999999999467,2688.0,43,14,10,57
4019,-6.697249999997363,2085.8125,56,19,7,75
4020,8.473000000001552,2406.375,78,19,7,97
4021,-6.253749999997739,2478.705882352941,48,18,3,66
4022,12.556500000004313,2556.1176470588234,84,15,17,99
4023,-11.972499999997037,2619.5882352941176,66,13,5,79
4024,-1.7582499999967467,1945.7777777777778,51,14,22,65
4025,-6.964499999996134,3448.5555555555557,84,10,10,94
4026,-0.880499999997463,3666.2631578947367,65,16,12,81
4027,-3.763749999999058,2508.4210526315787,45,8,8,53
4028,-11.832249999997131,2089.6875,62,12,5,74
4029,-31.100249999999143,2247.4444444444443,42,26,14,68
4030,0.7525000000025499,2937.9411764705883,94,12,4,106
4031,-16.86549999999845,3159.2,43,15,2,58
4032,-6.061749999997611,1534.8666666666666,45,10,11,55
4033,-24.336249999999165,2286.1176470588234,42,14,6,56
4034,-9.728499999998535,3865.5,54,24,2,78
4035,-14.405999999998272,1989.625,46,16,4,62
4036,-4.213999999997459,3274.777777777778,83,20,11,103
4037,-11.093499999998844,2921.9473684210525,38,4,9,42
4038,-7.508999999998196,3034.0,76,20,8,96
4039,-11.927999999998637,1514.7333333333333,46,25,8,71
4040,-33.36324999999792,2863.5263157894738,32,22,16,54
4041,-9.941999999997403,2937.8823529411766,63,12,18,75
4042,-20.624249999999606,2060.05,13,23,2,36
4043,-18.937999999999263,2150.1052631578946,20,19,1,39
4044,-18.392249999998445,3249.65,44,16,7,60
4045,-4.901499999999192,1839.6875,46,15,1,61
4046,-19.71499999999741,1528.25,51,20,8,71
4047,-1.0594999999987649,1429.0,64,28,6,92
4048,-17.051249999999015,2582.1052631578946,28,12,11,40
4049,1.4957500000022013,2608.0555555555557,60,15,11,75
4050,-6.894249999997466,4894.421052631579,87,27,6,114
4051,-1.1467499999987918,3377.315789473684,73,18,10,91
4052,-17.797999999998858,3763.157894736842,75,28,4,103
4053,-18.988249999996267,3750.8333333333335,80,23,12,103
4054,-3.1369999999976583,4170.105263157895,80,11,10,91
4055,-20.938249999998014,1429.0,27,17,7,44
4056,-3.2309999999973216,4833.95,89,10,8,99
4057,-6.890999999996292,2761.4117647058824,77,14,7,91
4058,-3.578999999997383,4206.8,72,25,4,97
4059,-8.068999999995238,5583.9,96,17,11,113
4060,-6.391249999995447,2871.722222222222,96,21,3,117
4061,-0.6677499999982504,3980.3684210526317,76,9,6,85
4062,-6.106499999995464,5372.75,65,14,27,79
4063,9.00175000000303,6409.25,119,17,0,136
4064,8.73600000000263,3574.5555555555557,101,17,12,118
4065,-5.52874999999957,2508.4444444444443,62,25,5,87
4066,-20.380499999997856,3313.0,54,14,7,68
4067,8.997750000001998,3164.157894736842,55,19,3,74
4068,-5.923749999999084,2520.777777777778,33,23,14,56
4069,-12.85874999999837,3311.55,46,7,9,53
4070,4.428750000000818,2176.0,65,12,8,77
4071,-21.16724999999874,2433.705882352941,60,14,8,74
4072,-11.870749999998171,3511.7894736842104,51,22,6,73
4073,-18.551999999998053,3787.8,54,16,3,70
4074,-7.536499999997972,2854.1111111111113,51,18,8,69
4075,0.8237500000010878,2750.6,34,11,7,45
4076,-4.555749999999426,2441.4444444444443,49,11,13,60
4077,-28.115249999997683,1640.1176470588234,13,21,18,34
4078,-4.40424999999796,3153.6470588235293,58,15,10,73
4079,-12.69649999999944,2486.3888888888887,23,28,1,51
4080,-1.4319999999962523,2266.6470588235293,70,26,3,96
4081,5.81425000000298,4948.9,82,21,5,103
4082,15.120500000003085,4025.6315789473683,80,4,7,84
4083,8.992750000003912,4151.684210526316,85,8,10,93
4084,-18.60899999999821,2832.35,31,9,15,40
4085,-17.56474999999957,2591.2105263157896,21,9,21,30
4086,-18.105249999997156,2472.1176470588234,53,13,16,66
4087,-8.851999999997297,4519.5,70,15,9,85
4088,-26.196999999998404,2596.235294117647,57,15,11,72
4089,-2.0957499999991684,3127.5555555555557,72,12,12,84
4090,-3.962249999996002,4651.4,84,11,10,95
4091,-14.58649999999805,3382.315789473684,58,24,2,82
4092,-8.547249999997243,2281.8888888888887,59,14,6,73
4093,-6.503749999998069,3701.4,66,16,2,82
4094,11.757250000001463,3694.95,53,20,3,73
4095,-23.270249999998686,3693.3,31,10,16,41
4096,6.414750000002857,4283.1,66,16,7,82
4097,-2.770999999997663,4085.842105263158,80,23,5,103
4098,-2.4622499999982184,3764.1052631578946,57,15,15,72
4099,-18.72324999999856,3280.65,44,15,7,59
4100,-2.7817499999981554,4955.3,74,14,7,88
4101,2.337500000003519,3682.1666666666665,99,13,5,112
4102,-11.69349999999907,2239.4444444444443,29,10,13,39
4103,2.3475000000031643,2760.6666666666665,67,7,12,74
4104,-19.21399999999763,2189.0,30,1,30,31
4105,-37.18524999999849,2836.95,24,12,16,36
4106,4.905750000001286,1817.9375,60,15,11,75
4107,-17.391999999998507,3161.7,50,11,1,61
4108,-15.826749999998913,3042.4736842105262,60,13,13,73
4109,-16.713999999999306,1438.5333333333333,13,13,5,26
4110,-7.290999999999215,3127.5,67,18,11,85
4111,-10.826499999997631,2446.6666666666665,42,10,15,52
4112,-6.629249999996678,3030.3529411764707,81,9,17,90
4113,-22.069249999998227,2821.5,49,19,10,68
4114,-13.149499999998323,2530.8823529411766,38,4,14,42
4115,2.8030000000023856,3733.9473684210525,84,10,10,94
4116,-30.60374999999728,2103.6875,66,31,16,97
4117,1.613500000000687,2470.8947368421054,51,7,7,58
4118,-9.259499999998662,2652.9,32,17,5,49
4119,-1.709249999996843,4058.45,62,9,10,71
4120,-28.18999999999881,2725.3888888888887,28,21,6,49
4121,-11.207749999996453,2525.277777777778,49,12,18,61
4122,-3.757249999997075,2442.4444444444443,58,7,13,65
4123,-0.514999999998105,2148.6666666666665,42,8,9,50
4124,-13.306999999998482,4203.75,55,23,13,78
4125,-20.462749999998206,2942.0,41,13,9,54
4126,-1.295499999998487,2806.4444444444443,70,16,9,86
4127,-12.30474999999548,3881.1052631578946,74,17,12,91
4128,-6.301499999999155,2470.7894736842104,26,16,12,42
4129,4.720250000003809,2833.3529411764707,70,8,5,78
4130,-11.704999999998599,2666.3684210526317,25,10,4,35
4131,-50.402749999999735,2433.2631578947367,29,13,32,42
4132,-20.37924999999682,6144.85,96,31,6,127
4133,-11.120249999999567,1429.0,17,5,6,22
4134,6.011000000001131,3698.1052631578946,76,10,12,86
4135,-24.25474999999804,1581.875,24,16,13,40
4136,-6.234999999999152,2989.6315789473683,56,19,13,75
4137,10.578250000003127,4876.6,82,19,3,101
4138,-19.281749999999683,2443.3,14,13,4,27
4139,-14.676499999997443,3450.842105263158,48,13,12,61
4140,6.84850000000502,5544.15,108,15,7,123
4141,-10.937999999997936,3650.3333333333335,86,19,8,105
4142,-15.953999999998931,2134.6111111111113,23,18,8,41
4143,3.3502500000034474,3430.0,80,5,20,85
4144,-13.466999999999114,2689.705882352941,70,24,16,94
4145,-3.81874999999737,2407.125,75,17,14,92
4146,-15.282249999999157,1550.0625,27,20,12,47
4147,-5.462999999997881,2743.1111111111113,60,16,11,76
4148,-16.733500000000056,1429.0,32,13,17,45
4149,-12.592999999997277,2763.277777777778,58,15,8,73
4150,-11.406999999998142,3925.15,58,15,7,73
4151,-23.764499999997994,3008.4,42,13,10,55
4152,-2.2734999999975045,3417.6111111111113,75,9,10,84
4153,-6.71524999999706,2177.0625,75,19,14,94
4154,-8.446749999998183,2707.2631578947367,31,14,13,45
4155,-17.379749999997028,2712.1111111111113,62,14,10,76
4156,-20.13624999999794,2362.315789473684,14,13,22,27
4157,-2.7469999999977635,2171.294117647059,52,6,13,58
4158,11.365500000001859,4376.65,68,20,3,88
4159,-11.935749999999166,1728.6875,55,17,13,72
4160,-9.88324999999848,1719.6875,30,9,15,39
4161,-7.4334999999985385,2116.9444444444443,35,13,5,48
4162,-9.770249999998727,2677.777777777778,36,14,12,50
4163,-14.831749999997637,2846.222222222222,88,29,7,117
4164,1.1982500000021719,2689.529411764706,84,10,7,94
4165,6.321500000001224,3397.4444444444443,73,26,9,99
4166,-21.49949999999824,1951.0,24,8,19,32
4167,1.1327500000019939,3546.0526315789475,87,14,7,101
4168,-5.430999999998297,4279.0,62,11,8,73
4169,-18.061999999998903,2345.0588235294117,45,22,16,67
4170,-25.952749999997394,2965.4210526315787,50,10,14,60
4171,-14.730249999999064,2623.45,28,11,7,39
4172,-20.007249999998475,2443.1111111111113,40,11,4,51
4173,-23.975499999998732,2504.2631578947367,25,13,18,38
4174,-22.89024999999981,2008.8235294117646,41,26,6,67
4175,-10.104999999999361,2219.1111111111113,36,9,14,45
4176,-3.0262499999979546,2975.8333333333335,46,14,7,60
4177,-3.426499999996918,3571.8947368421054,74,10,12,84
4178,-11.814249999998868,1832.875,29,8,9,37
4179,-15.724999999998584,2891.235294117647,85,10,6,95
4180,-17.358499999998344,3576.2631578947367,55,20,17,75
4181,-19.043749999999662,1517.764705882353,9,12,10,21
4182,-2.7672499999981968,2188.3333333333335,42,11,4,53
4183,-13.43124999999829,1481.9333333333334,36,16,8,52
4184,-1.152749999998847,3446.684210526316,61,16,7,77
4185,-5.509499999996857,4029.7368421052633,73,8,11,81
4186,9.466250000001603,3586.1052631578946,78,13,4,91
4187,-9.182249999997273,2273.1176470588234,57,22,10,79
4188,-12.931499999998053,3395.684210526316,59,6,11,65
4189,-5.309499999998329,2729.705882352941,87,13,5,100
4190,-5.267749999997875,2872.5882352941176,66,13,11,79
4191,-19.317249999998218,1429.0,12,7,27,19
4192,14.21900000000372,4626.210526315789,92,11,7,103
4193,-0.4769999999982196,2317.1176470588234,42,1,8,43
4194,-11.845749999997485,3017.235294117647,72,16,13,88
4195,-7.406999999999411,1429.0,14,3,8,17
4196,-10.860749999997932,2459.9473684210525,28,14,14,42
4197,7.913500000001962,3717.15,58,8,8,66
4198,-1.664749999997952,3355.8888888888887,87,14,2,101
4199,6.965000000000662,2322.3888888888887,41,11,10,52
4200,-17.05799999999729,2942.277777777778,58,7,13,65
4201,-21.748999999999754,2005.0555555555557,30,14,4,44
4202,-10.452999999998172,3682.1052631578946,54,17,12,71
4203,6.046000000002115,2567.5,58,8,5,66
4204,-15.529249999998617,3377.4,38,20,12,58
4205,-0.18574999999742978,2585.75,70,5,8,75
4206,-16.78349999999842,3171.15,44,23,5,67
4207,-10.484999999997795,2953.0,53,20,14,73
4208,-28.409499999998427,3455.2,42,20,5,62
4209,-13.862249999999246,2989.7894736842104,39,10,22,49
4210,-12.79049999999772,2349.6470588235293,54,14,22,68
4211,-10.186249999998783,3103.65,44,15,4,59
4212,-5.747999999997418,4201.611111111111,96,23,1,119
4213,12.57775000000269,4640.2,82,7,10,89
4214,-5.56274999999745,2525.176470588235,60,11,15,71
4215,-8.362249999997362,3000.4210526315787,55,11,9,66
4216,-27.589749999998524,3334.684210526316,40,15,16,55
4217,3.9582500000033454,3060.235294117647,84,13,10,97
4218,-2.821249999997174,3743.0,81,15,4,96
4219,0.4557500000035303,3587.8947368421054,73,9,12,82
4220,-13.202499999997476,3076.222222222222,50,11,8,61
4221,1.4330000000002883,1821.9375,65,22,9,87
4222,-8.96449999999803,2189.0,53,14,8,67
4223,-14.17199999999877,2666.3684210526317,25,8,15,33
4224,-23.76124999999835,2555.2631578947367,29,15,7,44
4225,2.078500000003087,3570.2105263157896,70,22,6,92
4226,-11.356749999997415,3132.5789473684213,51,16,11,67
4227,-17.644999999999673,1997.157894736842,14,15,9,29
4228,-14.378249999999337,2106.5263157894738,14,17,7,31
4229,-17.33424999999896,2751.4736842105262,30,11,9,41
4230,-18.000999999998985,2752.05,31,13,5,44
4231,-29.537249999997208,2488.9411764705883,49,10,15,59
4232,-3.5232499999989826,2599.1666666666665,65,11,6,76
4233,7.396250000000583,3595.3684210526317,70,19,6,89
4234,-4.686749999999957,2101.294117647059,37,20,4,57
4235,-31.05549999999701,1830.2777777777778,14,18,30,32
4236,-28.479749999998905,2126.529411764706,52,18,17,70
4237,-16.326749999999013,2463.2631578947367,33,12,24,45
4238,1.3957500000027732,2494.529411764706,94,17,10,111
4239,5.949000000003339,4734.65,86,12,8,98
4240,-5.177249999999978,2034.7894736842106,31,12,10,43
4241,-10.945749999998588,3087.75,37,18,4,55
4242,-1.588499999998327,2307.125,47,18,7,65
4243,-2.4242499999965963,3496.1666666666665,81,14,12,95
4244,-18.209499999998943,1701.875,28,15,7,43
4245,-12.800749999998601,2714.7894736842104,29,16,13,45
4246,-12.269999999999046,2681.315789473684,46,18,15,64
4247,-16.608749999998444,1971.5882352941176,47,17,15,64
4248,-30.863999999998533,3576.2105263157896,60,8,35,68
4249,-7.067000000000775,1429.0,13,13,14,26
4250,-15.529499999998517,2502.222222222222,36,5,13,41
4251,2.766500000001151,3949.5263157894738,75,21,13,96
4252,-3.63274999999915,1576.875,47,12,11,59
4253,-25.694749999999136,1429.0,30,23,5,53
4254,3.886500000002929,3779.157894736842,71,19,5,90
4255,4.1440000000024115,4354.736842105263,80,7,12,87
4256,-25.1769999999992,2235.0,13,20,9,33
4257,-26.226749999998436,2001.388888888889,17,22,31,39
4258,6.482500000002277,4376.473684210527,84,26,16,110
4259,-24.84099999999818,3908.5789473684213,69,13,21,82
4260,-9.26649999999687,2128.3333333333335,56,13,6,69
4261,-10.700999999998839,1930.0,26,12,10,38
4262,-0.257249999997636,3166.222222222222,62,19,4,81
4263,-19.96849999999818,3836.1,61,16,11,77
4264,4.85075000000261,4978.0,93,19,10,112
4265,12.737750000002332,1835.8125,87,13,4,100
4266,2.485250000003404,4783.05,81,8,9,89
4267,-18.4332499999983,3770.3,49,17,3,66
4268,11.380750000002111,4091.5263157894738,73,4,23,77
4269,-6.9477499999971615,3466.6315789473683,69,19,5,88
4270,5.755250000000963,2905.3333333333335,76,15,7,91
4271,6.258000000001467,3836.7368421052633,65,23,5,88
4272,-2.3022499999988444,2921.1,35,18,7,53
4273,-7.1802499999978195,4207.631578947368,79,17,15,96
4274,-17.487999999998273,2523.4736842105262,43,20,5,63
4275,-6.17874999999769,1956.9375,47,20,8,67
4276,-23.049249999999393,2925.8,24,11,14,35
4277,4.766500000001431,3857.5555555555557,105,17,6,122
4278,-16.717499999998434,2823.5263157894738,38,11,7,49
4279,-30.658749999998328,2999.6111111111113,43,17,18,60
4280,-12.502249999998806,2913.2,38,17,9,55
4281,-22.184999999998876,2619.4444444444443,43,9,12,52
4282,-2.615249999999132,1429.0,57,17,1,74
4283,-10.417249999995416,4118.315789473684,81,8,14,89
4284,-13.452999999998525,2463.315789473684,31,11,11,42
4285,-15.43599999999976,2598.7894736842104,46,10,14,56
4286,-2.161499999997237,2598.8125,66,20,5,86
4287,-25.64899999999825,2915.315789473684,38,19,9,57
4288,-7.129999999998404,2512.1111111111113,57,21,9,78
4289,-17.474749999998362,2479.157894736842,36,16,10,52
4290,-2.0169999999978674,3193.8823529411766,79,11,4,90
4291,-15.246499999998585,2464.75,57,29,10,86
4292,-5.673249999998563,3610.315789473684,60,13,25,73
4293,-14.591999999998697,2744.7368421052633,31,18,9,49
4294,-25.308249999997066,1644.2222222222222,17,23,23,40
4295,-14.869249999998539,3131.7894736842104,62,9,5,71
4296,-14.163749999998682,1547.6470588235295,12,15,10,27
4297,-10.969749999999474,1671.125,11,15,5,26
4298,-14.8434999999991,2198.0,23,8,18,31
4299,9.021250000004098,2783.0588235294117,82,9,8,91
4300,-16.6594999999976,2602.9473684210525,22,21,18,43
4301,-16.460499999996735,2218.1176470588234,46,11,17,57
4302,-15.868749999998684,2897.3333333333335,51,21,7,72
4303,-15.486999999998554,2586.9473684210525,26,15,10,41
4304,-7.312499999997343,2434.0625,79,21,16,100
4305,5.628750000001774,3072.315789473684,62,6,5,68
4306,-5.7067499999970215,1979.625,64,13,5,77
4307,-11.507749999998346,2846.8947368421054,45,18,7,63
4308,-14.182999999998277,2554.0625,81,22,4,103
4309,7.373000000003595,4598.684210526316,88,18,2,106
4310,-15.40924999999881,3119.55,32,16,6,48
4311,-15.562749999997326,2866.0,40,13,19,53
4312,4.6710000000027,4004.684210526316,69,8,20,77
4313,-10.03999999999883,2093.9444444444443,16,10,9,26
4314,-12.872249999997639,2478.3888888888887,52,10,11,62
4315,0.5825000000016457,3532.277777777778,67,23,9,90
4316,-33.471749999997016,3165.9473684210525,39,17,22,56
4317,-7.11524999999781,2148.722222222222,39,15,13,54
4318,-14.170249999998427,3441.75,48,7,7,55
4319,-12.574999999999015,3306.8,35,13,7,48
4320,-16.42499999999929,2651.3684210526317,59,23,5,82
4321,-3.619749999997506,4571.888888888889,112,21,14,133
4322,27.712750000003155,5333.8,103,14,6,117
4323,-14.264749999998134,2068.0625,24,13,28,37
4324,-27.329999999998602,3275.0,49,19,5,68
4325,-6.208249999996082,1743.5,70,17,8,87
4326,0.5905000000028375,3563.5789473684213,64,7,10,71
4327,-11.308499999998734,2213.1111111111113,29,12,7,41
4328,-4.480999999998864,2425.4444444444443,26,16,20,42
4329,-16.590749999999307,2946.6666666666665,44,15,16,59
4330,-10.328749999997875,2480.470588235294,53,6,11,59
4331,-9.380249999997977,2997.8888888888887,53,8,13,61
4332,-17.63749999999719,2524.25,61,11,14,72
4333,-4.6349999999981595,3473.222222222222,71,20,15,91
4334,-22.33649999999949,2495.277777777778,24,24,10,48
4335,-33.36099999999878,3390.95,38,21,6,59
4336,-16.109499999997002,2517.705882352941,77,12,14,89
4337,-26.892749999998536,2038.764705882353,59,20,10,79
4338,-22.268499999998575,3101.3,37,16,8,53
4339,-11.914749999999257,2185.470588235294,29,17,14,46
4340,-22.299249999998988,1429.0,8,13,15,21
4341,-17.603750000000474,1429.0,0,11,21,11
4342,6.452250000002027,3358.6111111111113,71,15,8,86
4343,1.8167500000006807,2643.7894736842104,40,10,7,50
4344,1.3217500000017446,3224.35,41,9,5,50
4345,-12.250999999998063,3013.0,44,15,18,59
4346,-24.95824999999879,2936.157894736842,40,15,16,55
4347,-20.65399999999683,2406.1111111111113,43,24,18,67
4348,-0.18299999999797517,4552.95,71,7,14,78
4349,-4.644999999998254,3468.3684210526317,62,12,9,74
4350,-6.919249999998191,4002.85,63,8,15,71
4351,5.86975000000425,2840.75,89,8,14,97
4352,-7.930249999998149,2033.111111111111,24,21,10,45
4353,-1.2497499999999309,2437.9375,78,20,19,98
4354,-27.788499999998425,2671.6111111111113,43,9,22,52
4355,-6.189499999996999,2430.0,58,10,15,68
4356,-14.45374999999883,2143.3529411764707,46,19,15,65
4357,-9.21574999999814,3929.9,62,11,9,73
4358,-2.5984999999963017,4324.684210526316,80,9,8,89
4359,-3.472749999998688,2958.6470588235293,61,14,11,75
4360,-11.940749999997895,3914.75,57,20,9,77
4361,-3.8224999999983735,3147.5263157894738,58,7,11,65
4362,-15.120499999998552,4015.4736842105262,70,17,5,87
4363,11.732500000001686,4155.0,94,8,2,102
4364,-12.121749999996533,3903.5789473684213,65,6,16,71
4365,-0.28524999999865025,3211.75,46,12,9,58
4366,-14.091999999998858,2621.2105263157896,42,18,8,60
4367,-10.785249999998996,1601.764705882353,29,14,10,43
4368,-26.44474999999885,3019.7368421052633,43,16,18,59
4369,-7.443749999997995,2776.1428571428573,82,10,9,92
4370,-5.768999999997987,3883.9,66,6,2,72
4371,-5.76574999999719,3043.9473684210525,60,12,5,72
4372,6.914500000001982,4341.368421052632,86,13,12,99
4373,-4.945999999996419,2051.823529411765,60,8,17,68
4374,-14.837999999996693,4342.55,71,10,10,81
4375,-2.1637499999973024,2985.5555555555557,76,7,9,83
4376,-5.880999999998033,2557.684210526316,27,6,19,33
4377,-5.908499999999899,2373.5,64,20,7,84
4378,-13.4912499999969,2951.8823529411766,77,15,10,92
4379,-10.080499999998887,3496.6,49,19,10,68
4380,-5.276999999996647,2782.0,68,4,8,72
4381,-0.16174999999644815,4385.631578947368,87,18,8,105
4382,-8.398749999998945,2306.5,43,13,11,56
4383,0.6515000000018749,3538.4736842105262,75,14,14,89
4384,1.3467500000041077,1983.75,78,9,13,87
4385,-11.022249999997571,2349.764705882353,79,14,11,93
4386,-10.26674999999855,2779.1052631578946,48,14,15,62
4387,-21.659749999997764,3869.6,60,15,9,75
4388,-12.429249999998436,4371.15,58,15,6,73
4389,10.369000000002304,2231.625,54,9,11,63
4390,-16.726499999998687,2433.5555555555557,41,9,15,50
4391,-14.097749999996825,1626.5,52,21,8,73
4392,-11.30649999999892,1979.9411764705883,43,11,10,54
4393,-20.251999999998606,3371.95,35,14,8,49
4394,-12.664499999996918,2635.294117647059,63,16,10,79
4395,-15.279499999998407,3069.8947368421054,48,12,9,60
4396,-7.099249999998176,2945.8888888888887,57,24,10,81
4397,-16.66699999999643,5329.8,101,12,7,113
4398,-7.735999999998228,3715.55,49,13,3,62
4399,-18.408749999998815,1639.375,30,18,16,48
4400,-6.599249999998089,4083.05,62,13,11,75
4401,-26.92399999999672,2566.3529411764707,64,16,7,80
4402,-20.059249999997117,2798.5,43,10,22,53
4403,-18.40874999999741,4629.526315789473,73,26,16,99
4404,-21.331499999997835,2649.470588235294,56,16,13,72
4405,-4.128999999996736,4530.7,71,14,13,85
4406,-25.666999999999852,2116.0,25,17,32,42
4407,-5.367999999997758,3626.5555555555557,83,22,5,105
4408,9.517250000001832,2885.8888888888887,75,5,6,80
4409,-4.812999999995704,2116.5,80,11,10,91
4410,-17.716249999999924,2003.1666666666667,32,24,20,56
4411,-4.362999999998847,3374.2,46,17,6,63
4412,-11.304999999998737,3514.2631578947367,68,24,7,92
4413,-7.192999999998898,3084.8947368421054,43,14,12,57
4414,-10.327999999996798,2861.1666666666665,56,13,14,69
4415,-2.237249999996905,5976.7,104,16,13,120
4416,6.951500000002262,2214.625,69,13,9,82
4417,-53.41574999999553,2046.125,27,11,44,38
4418,-0.41099999999648285,2051.1875,79,17,7,96
4419,-22.018499999996727,3607.7894736842104,44,12,32,56
4420,-19.05449999999928,2039.0,13,17,4,30
4421,-2.0947499999994355,3865.5555555555557,95,17,1,112
4422,1.07550000000345,3669.0,84,12,11,96
4423,-4.196749999997397,2873.470588235294,87,18,7,105
4424,20.635750000002044,3508.277777777778,94,14,4,108
4425,-26.026750000000362,1429.0,14,11,15,25
4426,-19.034249999996426,2376.1666666666665,56,15,14,71
4427,4.568750000002171,3166.222222222222,72,9,4,81
4428,10.243250000004872,2278.25,95,12,7,107
4429,0.9482500000032654,3520.8333333333335,84,14,8,98
4430,-15.198499999996837,3403.157894736842,60,15,14,75
4431,-7.30274999999849,3091.75,45,13,9,58
4432,-14.057499999997665,2478.8125,50,17,14,67
4433,1.5312500000023974,3704.1666666666665,89,20,15,109
4434,1.5705000000011924,2198.470588235294,59,14,5,73
4435,-17.536499999999155,2658.7894736842104,43,14,8,57
4436,-7.694999999997518,3869.4210526315787,68,6,11,74
4437,1.7720000000030836,4162.578947368421,87,14,6,101
4438,-20.240249999996273,2520.5882352941176,65,21,7,86
4439,-24.512749999997975,3358.45,35,20,9,55
4440,-7.879249999997249,4805.25,69,22,8,91
4441,-10.089499999997443,2882.6315789473683,44,13,11,57
4442,-2.1769999999980802,2749.3529411764707,82,9,12,91
4443,-16.783499999999318,2863.2,26,14,6,40
4444,-22.922999999999483,2794.1111111111113,41,28,4,69
4445,-7.636499999998202,2584.8823529411766,52,9,23,61
4446,-13.911749999999202,1550.0625,14,12,5,26
4447,-5.623749999997259,2928.6470588235293,59,16,16,75
4448,0.35700000000154547,2885.8888888888887,60,11,8,71
4449,-12.791999999998257,2521.6666666666665,42,10,6,52
4450,-4.970499999999292,2151.7368421052633,21,13,4,34
4451,-15.055999999997692,1951.8125,42,14,6,56
4452,-8.908249999997304,4086.35,76,9,8,85
4453,-19.34349999999818,3245.65,39,8,14,47
4454,2.833750000002637,3740.3333333333335,95,26,10,121
4455,-4.63699999999905,3500.9473684210525,74,17,5,91
4456,-8.732249999997928,3789.2105263157896,64,11,18,75
4457,-15.946999999998274,2110.5882352941176,28,11,21,39
4458,-18.71549999999747,3719.7894736842104,63,11,16,74
4459,-5.057249999998538,2114.4117647058824,64,21,11,85
4460,-15.525999999997333,2534.5882352941176,49,12,8,61
4461,-17.37649999999779,3076.3333333333335,67,16,22,83
4462,-34.1482499999976,1925.611111111111,36,17,23,53
4463,-15.98849999999742,2474.0555555555557,50,10,9,60
4464,-22.23624999999829,2274.1176470588234,43,10,19,53
4465,-7.369749999997568,3779.1052631578946,76,14,7,90
4466,-20.041749999997812,2437.8888888888887,31,10,26,41
4467,1.1030000000044864,3215.6666666666665,74,10,13,84
4468,-11.283999999997796,1760.375,35,17,6,52
4469,-10.263749999998142,4130.6,57,17,7,74
4470,-0.3734999999976336,3327.842105263158,55,10,10,65
4471,-6.096249999996291,3128.4210526315787,71,7,9,78
4472,7.769250000003703,5040.2,86,15,10,101
4473,-8.825499999997827,3942.1052631578946,68,18,14,86
4474,-18.7199999999981,2191.0,41,16,7,57
4475,-2.0554999999983314,2509.4117647058824,78,12,8,90
4476,8.924000000002362,3933.4444444444443,95,15,5,110
4477,-17.327750000000044,1795.125,41,23,16,64
4478,-6.8634999999993935,2452.8888888888887,30,11,13,41
4479,-30.611999999999547,2866.7368421052633,45,18,18,63
4480,5.071500000002703,3698.1,58,10,10,68
4481,-7.598499999998184,2146.0,39,18,8,57
4482,-14.819499999997769,3703.8947368421054,73,12,12,85
4483,-13.522749999998336,3723.9473684210525,74,13,11,87
4484,-9.87974999999782,4107.368421052632,71,18,5,89
4485,-11.472749999997967,3424.722222222222,54,7,18,61
4486,-10.479749999997356,1973.3529411764705,40,16,8,56
4487,-17.67274999999878,2633.8,30,20,5,50
4488,-2.166499999995233,2252.5625,92,21,8,113
4489,19.760250000005303,4064.8888888888887,112,4,10,116
4490,-14.132499999998467,2711.0588235294117,49,13,17,62
4491,-15.764249999997642,2485.5,51,14,11,65
4492,0.006500000003678963,3915.0555555555557,89,16,7,105
4493,-16.34299999999961,2305.4210526315787,23,14,12,37
4494,3.1960000000026403,3652.222222222222,103,23,11,126
4495,-12.403499999997493,2763.4444444444443,41,8,24,49
4496,-5.116249999997899,2845.470588235294,92,9,4,101
4497,-18.611999999999345,2068.157894736842,16,19,2,35
4498,14.04250000000284,3656.2631578947367,64,13,5,77
4499,-12.431500000000053,1438.5333333333333,0,16,1,16
4500,14.467000000004612,3414.1111111111113,96,9,9,105
4501,-5.6297499999993335,2568.6315789473683,48,12,9,60
4502,6.299500000000616,2770.3333333333335,68,14,3,82
4503,-10.331749999998495,3087.4210526315787,55,14,8,69
4504,1.247250000002019,3975.05,60,8,5,68
4505,-9.84099999999832,3355.5789473684213,56,16,12,72
4506,-13.940249999999036,2190.0,29,15,9,44
4507,-1.1769999999970528,2961.5555555555557,65,11,7,76
4508,-12.898249999999587,1949.3333333333333,16,10,4,26
4509,-28.840999999998605,2187.4444444444443,16,10,12,26
4510,-18.045999999999157,2919.4210526315787,29,20,10,49
4511,-12.888749999998685,2479.2631578947367,27,10,12,37
4512,-5.993249999998506,3068.0,47,7,7,54
4513,-22.408249999998723,2779.157894736842,50,13,8,63
4514,-3.451749999997073,2879.0588235294117,75,18,5,93
4515,7.50800000000132,3317.9444444444443,86,20,9,106
4516,10.029000000003135,5143.3,72,16,7,88
4517,-10.76074999999899,2657.8947368421054,52,11,8,63
4518,-1.003499999994627,5708.4,107,13,4,120
4519,19.653250000002593,2982.6875,107,13,9,120
4520,-27.064749999999446,2484.6666666666665,26,17,20,43
4521,-23.300749999998043,2512.375,73,27,6,100
4522,-1.3362499999976087,5098.2,79,9,10,88
4523,-12.737249999997587,2169.470588235294,40,15,12,55
4524,-10.300749999998745,2958.222222222222,46,19,11,65
4525,23.34350000000207,5102.85,89,9,2,98
4526,-13.965499999997501,2845.222222222222,58,8,5,66
4527,-5.753499999998933,3437.8,46,20,6,66
4528,-42.26124999999986,2071.8888888888887,15,19,39,34
4529,0.9967500000028892,5411.6,98,10,7,108
4530,-18.709249999997258,3615.6,53,15,11,68
4531,-13.49699999999813,3092.8823529411766,81,21,15,102
4532,-13.320749999996432,2975.777777777778,68,11,10,79
4533,-9.154000000000066,2076.0588235294117,57,18,6,75
4534,12.953750000002112,5125.1,93,12,10,105
4535,-7.147249999998715,2970.315789473684,38,17,13,55
4536,-9.601499999998401,1481.9333333333334,42,5,11,47
4537,-8.345249999996724,5378.3,89,17,11,106
4538,-26.269249999998912,2437.9444444444443,58,23,11,81
4539,-7.533999999997515,2088.6666666666665,32,17,9,49
4540,-8.531749999999125,3081.45,30,13,4,43
4541,0.13650000000158916,2547.0625,85,25,6,110
4542,4.093500000002177,2697.1176470588234,63,17,4,80
4543,-7.840749999996001,5267.2,97,17,4,114
4544,3.6982500000036156,4568.1,81,13,12,94
4545,-25.763249999999005,1457.6,11,12,15,23
4546,-13.889499999998739,1528.25,13,11,16,24
4547,-1.115749999998415,2215.235294117647,55,20,5,75
4548,7.7265000000026305,3343.5555555555557,82,11,11,93
4549,-0.14099999999931043,2054.125,81,17,9,98
4550,-22.799999999999585,2459.0555555555557,28,14,35,42
4551,-10.29524999999849,3175.9,33,14,9,47
4552,-19.272749999998826,2653.65,28,27,1,55
4553,7.642250000001811,2458.8823529411766,58,15,10,73
4554,2.103750000001129,2179.0625,78,19,9,97
4555,-12.919499999999008,1429.0,42,15,9,57
4556,-8.021249999997103,2522.4117647058824,58,16,7,74
4557,6.838750000002735,2023.3125,76,7,5,83
4558,2.568750000004524,5710.9,109,10,5,119
4559,19.66600000000308,5196.5,90,10,6,100
4560,-14.510499999998625,3543.35,48,16,18,64
4561,-21.1389999999943,2627.9411764705883,74,16,25,90
4562,-6.663999999998933,3338.7894736842104,65,15,22,80
4563,4.034250000002301,2732.529411764706,83,22,10,105
4564,3.0167500000021503,4246.55,68,18,5,86
4565,-22.140499999998625,2801.6315789473683,36,22,10,58
4566,-2.8249999999980937,4057.4210526315787,83,8,10,91
4567,-6.641499999996523,2897.0,76,19,5,95
4568,-0.6802499999998617,1514.375,44,11,7,55
4569,-25.354499999998666,2062.235294117647,26,13,17,39
4570,2.7450000000026082,2579.470588235294,53,11,12,64
4571,-1.6654999999983868,3117.2,45,6,11,51
4572,-2.972499999998819,2959.684210526316,60,6,7,66
4573,-10.831249999998215,3691.0,50,10,15,60
4574,-2.814749999998252,3221.8947368421054,50,6,21,56
4575,-2.385999999996407,3475.8888888888887,78,17,17,95
4576,-15.015249999998677,3067.95,37,10,12,47
4577,-9.925749999999553,2205.75,39,31,8,70
4578,-17.536249999998514,3356.15,40,15,8,55
4579,-3.657999999998714,2580.8125,66,31,1,97
4580,-16.934249999998745,2473.222222222222,41,18,7,59
4581,-6.9874999999968095,2593.0555555555557,68,14,4,82
4582,-16.4032499999982,2072.777777777778,29,13,15,42
4583,-4.338749999997863,3224.4210526315787,57,13,3,70
4584,-3.5599999999956005,1894.3125,75,3,16,78
4585,-10.436249999999147,2039.0526315789473,16,7,10,23
4586,-10.85849999999974,1429.0,34,15,13,49
4587,-2.2582499999981365,4447.3,75,10,3,85
4588,-3.0259999999978477,4140.0526315789475,88,14,12,102
4589,1.5120000000021776,2593.4117647058824,71,16,4,87
4590,-5.1489999999982565,3222.6111111111113,53,12,10,65
4591,9.310250000003258,4195.9473684210525,90,17,4,107
4592,-19.0144999999986,3359.7894736842104,51,28,6,79
4593,7.817500000002805,3441.3888888888887,91,8,6,99
4594,-18.046749999998955,1866.5,15,12,12,27
4595,-7.864499999999066,1576.875,25,21,4,46
4596,-5.195999999999213,2740.5789473684213,46,13,3,59
4597,-24.528749999996887,4538.631578947368,78,24,10,102
4598,0.18425000000169298,3902.85,59,15,5,74
4599,-17.26199999999714,2711.0,64,16,8,80
4600,-7.711499999998521,2739.9411764705883,70,15,12,85
4601,2.9007500000023754,2568.1176470588234,84,17,6,101
4602,-22.734749999997703,3526.1111111111113,72,15,16,87
4603,-11.743249999996872,5021.95,62,14,21,76
4604,-2.5999999999971957,2529.1875,92,12,6,104
4605,-0.7129999999970069,2903.6315789473683,56,18,8,74
4606,-17.341749999998715,2895.157894736842,30,11,13,41
4607,-18.940999999999026,2319.8823529411766,60,13,14,73
4608,-5.2652499999969695,3640.4210526315787,62,15,10,77
4609,-14.332999999999775,2298.684210526316,32,5,23,37
4610,-9.460999999998696,2298.5,66,18,8,84
4611,4.0802500000015325,2815.6470588235293,81,23,18,104
4612,-23.854499999998204,3534.6,47,15,11,62
4613,-11.325749999999594,2227.1111111111113,53,19,7,72
4614,-7.828749999997314,3538.4444444444443,56,16,14,72
4615,-7.559749999997642,3082.3684210526317,48,19,8,67
4616,3.0680000000017067,2420.470588235294,86,22,5,108
4617,-15.569999999996725,4158.4,53,19,4,72
4618,-13.974499999997514,3491.7368421052633,56,27,6,83
4619,-25.404249999999152,2584.3333333333335,59,10,9,69
4620,-26.711499999999763,1429.0,0,22,7,22
4621,-15.774249999997679,2847.0555555555557,59,12,7,71
4622,-14.21949999999757,2272.4375,45,22,9,67
4623,-15.891999999997747,3025.5789473684213,42,10,21,52
4624,-43.85424999999742,2072.8333333333335,21,24,21,45
4625,-17.21649999999613,2825.0625,51,14,29,65
4626,-17.956999999998935,2449.277777777778,30,10,16,40
4627,-5.4509999999988334,3402.315789473684,69,19,8,88
4628,-14.18874999999839,3576.157894736842,59,13,7,72
4629,-3.8222499999982587,4353.75,63,17,10,80
4630,-5.354000000000622,1429.0,17,13,14,30
4631,-0.5544999999966148,5283.0,88,15,9,103
4632,-8.031249999996092,2755.3888888888887,65,11,13,76
4633,-0.6982499999978554,3841.8,56,5,6,61
4634,-14.096749999998334,4013.1,53,16,6,69
4635,-20.256250000000374,1429.0,35,26,7,61
4636,-6.041999999998739,2219.277777777778,58,11,15,69
4637,-7.120999999999903,2572.0,56,12,12,68
4638,-15.408499999998204,3180.8947368421054,57,9,4,66
4639,-1.321749999997237,2854.1666666666665,39,11,20,50
4640,-10.658749999998372,3048.15,42,6,12,48
4641,-16.385999999997647,2615.9444444444443,40,9,15,49
4642,-10.151749999996873,2517.222222222222,60,16,9,76
4643,0.6135000000002866,2130.7894736842104,18,16,1,34
4644,-24.33374999999853,2843.4736842105262,25,16,7,41
4645,-18.775999999998163,1429.0,26,15,8,41
4646,-4.532749999997492,2121.5625,65,12,5,77
4647,-5.948249999997959,3028.777777777778,53,25,5,78
4648,-8.374249999998506,3506.05,42,15,4,57
4649,8.57225000000065,2395.470588235294,106,13,7,119
4650,-21.566749999998834,3472.7,40,13,12,53
4651,-3.7109999999971643,3540.2105263157896,65,11,14,76
4652,-14.081999999998516,3213.15,47,4,4,51
4653,9.578250000001669,1963.1176470588234,81,16,5,97
4654,-17.142249999999628,2314.3888888888887,49,21,9,70
4655,-5.728249999997811,3822.3888888888887,88,15,13,103
4656,-4.599749999998729,3695.4736842105262,78,11,10,89
4657,-19.46824999999769,4258.5,75,17,6,92
4658,-15.058749999998986,2108.0,27,7,7,34
4659,5.499500000001662,2917.6111111111113,66,2,8,68
4660,5.482500000002444,2157.1875,74,11,5,85
4661,-6.949749999999047,2571.8823529411766,72,19,10,91
4662,-2.578499999996809,4615.65,83,4,6,87
4663,-16.65574999999682,3437.4210526315787,56,17,12,73
4664,-4.259249999997982,3709.7368421052633,61,11,4,72
4665,-11.180999999995029,2501.4444444444443,71,9,29,80
4666,-17.807999999998806,2400.8888888888887,50,21,15,71
4667,-26.726749999996674,2442.1176470588234,52,27,10,79
4668,-7.366249999997845,3076.3333333333335,72,18,12,90
4669,-25.913749999997737,2731.5,34,12,15,46
4670,6.259000000001702,2929.5882352941176,76,6,12,82
4671,-7.435999999998268,3718.65,64,16,5,80
4672,-11.881999999998921,2241.5625,52,18,13,70
4673,-20.119749999999154,2884.3684210526317,47,16,30,63
4674,-13.886249999999228,2472.222222222222,46,12,12,58
4675,1.2272500000037698,4982.1578947368425,99,14,7,113
4676,-13.02874999999666,2026.764705882353,64,19,8,83
4677,1.3492500000030583,5199.05,85,13,10,98
4678,-13.140749999998325,3555.2105263157896,73,12,12,85
4679,-13.063999999998611,2708.45,33,8,6,41
4680,-10.048749999998636,2077.0,45,14,17,59
4681,-3.5114999999978864,1429.0,48,26,5,74
4682,-26.090749999997644,2648.0,36,15,16,51
4683,-14.339749999998594,2098.315789473684,32,16,9,48
4684,9.801500000002022,2377.4,81,10,25,91
4685,-10.32174999999732,4198.9,74,13,4,87
4686,-16.80749999999855,2876.1052631578946,48,13,11,61
4687,-29.66800000000028,1429.0,14,13,31,27
4688,-1.7517499999971236,3576.705882352941,81,4,18,85
4689,-1.9577499999982444,2532.764705882353,58,17,6,75
4690,-22.347249999998446,3079.9,36,17,3,53
4691,-7.494499999998288,2383.294117647059,59,9,9,68
4692,-22.64474999999735,4808.5,73,21,10,94
4693,-14.168749999996043,3358.1176470588234,111,14,11,125
4694,-12.659749999997903,2048.8947368421054,15,17,32,32
4695,-19.19449999999954,2207.7368421052633,37,12,19,49
4696,-12.836499999999006,2405.1666666666665,41,20,8,61
4697,9.449250000002127,2956.3684210526317,52,14,13,66
4698,1.3957500000029675,2300.0625,77,15,16,92
4699,-1.3539999999983328,3060.4444444444443,54,11,6,65
4700,4.5525000000021185,2711.0588235294117,57,6,12,63
4701,-7.36474999999894,2760.85,34,25,0,59
4702,-2.67649999999883,1429.0,59,16,10,75
4703,-11.546749999997333,2571.0,61,12,12,73
4704,-10.494749999998623,2266.9444444444443,49,18,2,67
4705,4.327250000001286,2978.7894736842104,70,15,7,85
4706,-3.2277499999978323,2398.3125,58,20,2,78
4707,-31.44624999999787,2299.235294117647,52,13,26,65
4708,-4.017999999996986,3809.1052631578946,64,7,13,71
4709,-22.804249999998195,2633.722222222222,49,15,6,64
4710,-12.112499999998196,3452.9,45,16,8,61
4711,-9.268999999996733,3030.4117647058824,77,16,11,93
4712,-10.167499999998244,3609.4210526315787,46,14,16,60
4713,-7.332999999997004,3449.1052631578946,71,7,14,78
4714,-4.384749999998086,3116.684210526316,43,9,10,52
4715,-13.729999999998673,3205.1111111111113,62,28,10,90
4716,4.499250000003306,5717.2,92,27,4,119
4717,-10.001249999997086,2060.0,35,8,28,43
4718,-25.472749999997923,2979.684210526316,47,14,5,61
4719,-14.828749999998308,2008.4375,58,22,7,80
4720,-7.572249999998066,3696.4210526315787,77,11,5,88
4721,4.244000000003848,3060.4117647058824,74,17,7,91
4722,-28.115499999998907,2096.529411764706,40,15,29,55
4723,-14.455249999996209,3636.3529411764707,85,15,11,100
4724,-26.02199999999761,3207.684210526316,50,16,10,66
4725,-10.434999999997986,2683.9444444444443,43,19,7,62
4726,-8.161499999997604,2818.8333333333335,50,7,18,57
4727,1.5537500000028412,2673.764705882353,67,12,10,79
4728,-10.311999999997656,2677.5882352941176,86,10,22,96
4729,-1.5654999999974997,3529.85,56,5,10,61
4730,-22.943749999998357,3652.15,49,11,11,60
4731,0.2635000000026982,4658.4,75,16,8,91
4732,-5.19974999999806,2830.5882352941176,85,12,8,97
4733,8.324500000004424,5345.0,98,17,2,115
4734,-18.759499999998866,1666.125,42,14,6,56
4735,-30.472999999997846,2299.3529411764707,64,18,12,82
4736,-14.430499999997537,3421.5263157894738,64,26,3,90
4737,-24.864249999998133,2177.6315789473683,14,18,16,32
4738,-5.386249999997098,2077.1666666666665,50,8,10,58
4739,-2.5317499999993713,3342.2105263157896,54,17,14,71
4740,-6.3884999999979115,2822.5714285714284,73,5,22,78
4741,-20.67224999999832,3223.5,33,17,7,50
4742,7.1710000000043355,2326.875,106,16,8,122
4743,-30.383249999999144,2218.9411764705883,36,16,30,52
4744,-5.479499999997981,2810.3333333333335,35,13,17,48
4745,-27.53974999999715,1429.0,10,10,33,20
4746,-14.326249999997406,3219.277777777778,70,8,11,78
4747,-19.726249999998693,2198.4117647058824,50,20,7,70
4748,-4.612999999997885,2008.0588235294117,24,10,20,34
4749,-13.298999999999083,3147.5263157894738,43,7,17,50
4750,7.805500000002587,2335.75,90,8,10,98
4751,-20.955249999996305,2001.4705882352941,45,18,16,63
4752,-28.643249999998773,2171.6111111111113,40,26,7,66
4753,22.708250000002316,2492.5882352941176,68,2,20,70
4754,-21.18049999999704,3078.1111111111113,57,18,13,75
4755,-2.450749999998382,2265.764705882353,46,7,10,53
4756,-19.679749999999963,1429.0,0,17,4,17
4757,-1.8824999999990102,2346.1111111111113,27,10,12,37
4758,-9.1817499999977,2719.1666666666665,58,5,6,63
4759,-11.236499999999188,1429.0,17,2,5,19
4760,4.404750000001064,2616.4375,54,16,11,70
4761,-5.842249999998736,2571.8125,69,18,9,87
4762,-15.471749999998318,3450.842105263158,63,15,10,78
4763,6.628250000001914,3294.0555555555557,70,5,18,75
4764,-18.249999999998305,2655.777777777778,48,14,13,62
4765,0.024000000003562238,3250.0555555555557,78,13,11,91
4766,-11.137999999998438,4180.7,51,15,9,66
4767,-17.41749999999947,2044.6666666666667,15,16,13,31
4768,6.488250000001964,4016.3684210526317,75,13,14,88
4769,-19.26149999999897,1585.8125,34,21,10,55
4770,-10.43899999999756,4398.1,67,17,11,84
4771,-20.22649999999869,2698.8947368421054,33,17,15,50
4772,-13.214249999998163,3607.5,59,8,8,67
4773,-17.789249999998205,3028.6111111111113,60,16,14,76
4774,6.9537500000018895,3269.4444444444443,61,14,14,75
4775,3.609500000003132,3248.222222222222,71,10,15,81
4776,1.557750000002806,4093.2631578947367,71,14,11,85
4777,-6.338999999999664,2833.4736842105262,39,15,18,54
4778,-24.190499999997822,1429.0,39,11,13,50
4779,-26.31674999999941,2099.75,13,17,6,30
4780,-25.2842499999982,2828.705882352941,66,18,13,84
4781,-27.787999999998696,2696.3888888888887,44,20,11,64
4782,-12.005499999996664,3602.842105263158,72,13,6,85
4783,0.5512500000011226,3722.75,50,16,6,66
4784,-13.525249999998561,2931.777777777778,55,24,6,79
4785,-24.244249999999287,1429.0,0,15,12,15
4786,-22.24049999999805,3119.5,58,16,9,74
4787,-9.462999999998996,3382.25,42,16,5,58
4788,6.815250000002204,3135.4444444444443,89,11,10,100
4789,7.966750000002544,4304.5,66,9,15,75
4790,0.6060000000005961,3896.8947368421054,56,11,18,67
4791,-3.7319999999995703,2413.157894736842,32,15,10,47
4792,-12.892749999999221,1429.0,19,16,2,35
4793,-7.146749999997081,2824.0588235294117,63,23,9,86
4794,15.232500000002014,3925.9,60,22,4,82
4795,-0.4679999999984936,2511.8888888888887,46,11,4,57
4796,-16.170999999997317,3823.4210526315787,64,3,18,67
4797,-12.177499999996831,4315.65,60,15,9,75
4798,-4.749499999996886,2627.0,103,13,13,116
4799,-7.511749999997678,2465.6470588235293,48,6,17,54
4800,-9.059249999996938,3239.5,63,13,13,76
4801,-16.03899999999711,2365.470588235294,66,13,5,79
4802,-20.25549999999848,3336.35,40,19,2,59
4803,-10.029749999996803,2286.375,69,16,2,85
4804,14.155500000002457,3626.5555555555557,81,12,10,93
4805,-12.29099999999936,2123.1666666666665,29,21,7,50
4806,-11.949249999997985,3738.6666666666665,73,18,8,91
4807,-6.241499999999075,2425.7368421052633,33,11,10,44
4808,-18.493499999998132,3983.0,55,15,11,70
4809,-17.173749999997636,3793.3,60,18,3,78
4810,0.7072500000026056,4040.25,58,7,21,65
4811,-9.685749999999853,2575.315789473684,49,16,5,65
4812,-10.287499999997117,2433.705882352941,73,14,10,87
4813,3.9980000000030294,3444.0555555555557,81,9,10,90
4814,-19.024999999998315,3034.842105263158,43,16,18,59
4815,15.169750000003706,3316.1666666666665,84,11,10,95
4816,-18.290249999998885,3105.8947368421054,50,18,9,68
4817,-15.390499999998818,2744.25,26,13,10,39
4818,2.003500000001928,3659.3,62,8,6,70
4819,-17.186999999997788,3076.6315789473683,46,11,12,57
4820,-8.887749999999007,3308.7368421052633,55,20,4,75
4821,-4.697249999998457,2911.4444444444443,55,9,10,64
4822,2.25025000000225,4163.3,72,10,5,82
4823,8.219250000004463,3623.8333333333335,90,6,14,96
4824,-15.872499999994819,2203.176470588235,78,12,26,90
4825,0.6687500000019555,4225.15,63,15,8,78
4826,2.6857500000018986,1987.5,54,16,7,70
4827,-20.950500000000634,1576.5882352941176,20,12,15,32
4828,-2.3839999999982338,2527.0588235294117,65,19,8,84
4829,-9.22549999999801,3727.6,55,16,6,71
4830,-15.830749999999194,2302.0555555555557,31,8,15,39
4831,-12.808249999996756,2144.375,39,3,37,42
4832,-2.445499999998193,2605.5,44,8,13,52
4833,0.23100000000150037,2105.0,36,13,19,49
4834,-33.396999999997966,3348.95,37,15,17,52
4835,-23.300999999999096,2080.0,12,8,11,20
4836,-18.353249999998212,2551.4117647058824,55,14,10,69
4837,-17.069499999997788,2606.277777777778,45,19,7,64
4838,7.453750000002776,3378.0555555555557,70,9,17,79
4839,-10.67649999999807,2547.684210526316,27,15,13,42
4840,-17.671749999999264,2976.6111111111113,60,15,20,75
4841,-4.6929999999968235,2559.0,86,7,29,93
4842,-0.45524999999679894,3107.5625,92,18,13,110
4843,-16.99949999999853,3306.15,46,7,14,53
4844,-4.417999999998691,3186.0,57,9,12,66
4845,-18.040749999998532,3240.3684210526317,69,15,10,84
4846,-7.845249999997945,2414.1111111111113,36,10,10,46
4847,-1.68749999999909,1953.7222222222222,55,10,13,65
4848,-25.84574999999996,2222.684210526316,13,17,15,30
4849,-18.77300000000018,1429.0,29,22,10,51
4850,-16.955499999999784,2759.842105263158,47,14,20,61
4851,-6.996249999998755,3931.35,59,14,11,73
4852,2.82525000000244,2678.9375,87,6,14,93
4853,25.340750000002167,4979.1,92,13,5,105
4854,-2.3057499999971673,3780.7894736842104,76,14,12,90
4855,0.22225000000137857,3538.6315789473683,72,9,16,81
4856,1.213250000000713,2953.684210526316,66,14,11,80
4857,11.447000000002529,3314.6111111111113,85,13,17,98
4858,-6.523499999998857,3127.5,44,8,9,52
4859,-13.913499999997688,2978.8947368421054,47,11,10,58
4860,-11.726499999999955,2492.5,52,23,12,75
4861,-12.618749999997679,2501.3888888888887,42,15,10,57
4862,-6.4942499999984395,3373.5,75,14,6,89
4863,-13.259249999995896,2699.823529411765,78,16,7,94
4864,-13.371499999998415,3548.3529411764707,52,5,8,57
4865,-12.17424999999796,4220.3,49,14,12,63
4866,13.124000000004013,4750.0,96,16,8,112
4867,3.4142500000014566,3043.777777777778,59,16,7,75
4868,-7.512499999998897,2693.35,29,10,9,39
4869,5.923750000001485,3455.842105263158,80,9,5,89
4870,10.708500000004939,2296.125,82,2,19,84
4871,6.6680000000005135,2595.9444444444443,58,18,7,76
4872,-10.01624999999725,4639.4,80,5,7,85
4873,-3.36374999999625,2735.294117647059,73,8,15,81
4874,11.633750000002294,4511.65,71,0,9,71
4875,7.295000000002456,3147.777777777778,89,15,6,104
4876,-9.539999999997729,3028.842105263158,48,5,12,53
4877,-5.897749999997708,3272.8,43,10,8,53
4878,-8.533999999999486,2053.3888888888887,27,11,6,38
4879,-13.34875000000084,2016.388888888889,44,27,10,71
4880,-12.150999999998326,2038.8947368421052,16,16,15,32
4881,-21.09174999999892,2171.6111111111113,32,15,9,47
4882,-3.416749999997498,2801.5882352941176,83,26,8,109
4883,-9.695499999997935,2627.0,64,5,13,69
4884,11.742000000002363,2607.625,71,10,15,81
4885,-8.802499999997046,4048.15,65,7,14,72
4886,1.561500000002321,2517.277777777778,53,4,12,57
4887,-15.401749999998277,3416.35,45,8,4,53
4888,-10.50149999999751,3209.4444444444443,56,11,12,67
4889,-15.129499999999686,2258.0,38,19,5,57
4890,-15.039499999998133,2237.684210526316,30,19,9,49
4891,-16.592249999997232,3718.9473684210525,48,24,16,72
4892,-16.69999999999886,2098.75,52,10,14,62
4893,6.044000000001146,1946.8125,58,8,2,66
4894,-12.389749999998118,3414.0,44,21,13,65
4895,4.311250000002149,2877.8333333333335,74,20,5,94
4896,-19.903499999998445,2562.222222222222,41,22,10,63
4897,-0.3187499999965612,4770.35,67,10,19,77
4898,21.035500000003246,4982.105263157895,109,6,5,115
4899,9.948750000002573,2854.0555555555557,63,15,9,78
4900,10.649250000001528,3741.4210526315787,79,15,7,94
4901,-6.8264999999987355,2922.842105263158,26,9,14,35
4902,-11.19099999999803,3857.55,64,13,7,77
4903,-32.73149999999636,2929.923076923077,40,6,35,46
4904,-8.498499999997318,3185.0526315789475,51,16,7,67
4905,-22.318249999998613,1946.2941176470588,29,21,20,50
4906,-5.906999999996996,3213.9444444444443,68,5,22,73
4907,-27.5179999999997,1429.0,30,18,12,48
4908,-28.58899999999785,3658.7894736842104,59,8,25,67
4909,-9.303999999998041,3042.5882352941176,100,25,13,125
4910,-7.360749999997087,2407.3125,76,7,21,83
4911,-10.542999999999058,2729.7368421052633,33,6,16,39
4912,-13.561499999999437,2204.3684210526317,12,13,4,25
4913,-25.253499999998727,2044.5555555555557,29,17,11,46
4914,-14.74174999999894,2028.7222222222222,43,2,16,45
4915,11.463000000003118,2358.5,66,6,9,72
4916,-11.21674999999814,2891.0526315789475,43,12,8,55
4917,-15.700249999998857,2479.4444444444443,42,13,9,55
4918,-10.180999999998658,1564.4117647058824,29,11,4,40
4919,7.124250000003812,5171.15,98,10,9,108
4920,9.553750000002305,2557.9411764705883,89,12,19,101
4921,-14.045999999999728,2290.1,17,17,1,34
4922,-19.479249999996497,4308.45,68,10,9,78
4923,-19.166249999998062,2876.222222222222,50,17,9,67
4924,-11.387749999998263,2047.1764705882354,42,9,12,51
4925,-5.126249999999923,1429.0,36,16,5,52
4926,3.8135000000026884,2839.0588235294117,81,11,10,92
4927,-15.881249999999136,2831.7894736842104,23,10,40,33
4928,-13.554499999997693,3809.2631578947367,60,12,27,72
4929,-9.58974999999877,2147.777777777778,59,9,20,68
4930,-8.168999999998817,2913.684210526316,45,16,7,61
4931,-13.673249999998419,2861.842105263158,43,17,9,60
4932,16.257000000002268,3483.4736842105262,66,5,11,71
4933,-16.193749999998253,2147.0,52,11,11,63
4934,-25.10124999999814,3171.8947368421054,44,18,14,62
4935,-20.059749999996534,3431.6315789473683,69,6,13,75
4936,11.066500000001785,2971.5882352941176,70,7,8,77
4937,-13.987749999995279,3620.3888888888887,89,10,20,99
4938,-0.9154999999945665,2526.3125,103,15,8,118
4939,-8.306249999997721,4089.45,56,10,21,66
4940,-0.8164999999978508,3102.0,57,12,10,69
4941,-10.541749999997135,3371.4736842105262,54,9,19,63
4942,-15.783499999998245,2670.5263157894738,25,10,18,35
4943,13.084750000003885,4368.8421052631575,83,9,16,92
4944,-18.075749999997925,1818.9375,40,7,18,47
4945,-5.962749999997765,2681.277777777778,60,14,6,74
4946,5.158500000002542,3136.842105263158,58,5,13,63
4947,-13.835999999996691,4151.736842105263,69,15,13,84
4948,5.908750000002675,3582.6111111111113,85,14,5,99
4949,-14.159249999998423,2642.9473684210525,40,13,10,53
4950,-29.55549999999879,2644.25,25,13,9,38
4951,-15.774249999999308,2363.722222222222,44,9,18,53
4952,-11.73049999999767,4143.35,63,18,7,81
4953,-19.50574999999967,1989.0,18,4,19,22
4954,-10.639499999998915,2009.3125,71,10,22,81
4955,-0.5992499999989286,3449.1052631578946,55,8,15,63
4956,8.993500000002367,1800.0625,62,14,7,76
4957,-4.237499999999144,2339.0,31,10,23,41
4958,-0.20574999999785834,4259.1,60,12,11,72
4959,8.343500000001459,2295.529411764706,60,12,8,72
4960,-24.569499999999028,2377.2631578947367,24,15,6,39
4961,-23.577249999997374,2600.277777777778,68,12,33,80
4962,-5.981999999998634,4086.15,53,15,6,68
4963,-14.329749999998407,2227.3529411764707,30,8,16,38
4964,-26.337499999998677,2601.764705882353,45,12,26,57
4965,-4.576749999999107,2028.8333333333333,32,8,11,40
4966,-12.661749999997289,3794.95,56,11,15,67
4967,-16.510499999999393,1429.0,9,12,7,21
4968,-16.178249999996275,2672.5555555555557,87,16,7,103
4969,-15.185999999998419,2531.7894736842104,31,16,12,47
4970,-17.52449999999815,1576.875,47,22,4,69
4971,-27.557499999998477,2736.777777777778,35,15,11,50
4972,-6.276999999998553,2698.0588235294117,57,17,14,74
4973,-11.663749999996845,1429.0,13,6,33,19
4974,-8.953499999998211,2332.2105263157896,23,13,10,36
4975,-28.833500000000033,2181.705882352941,23,3,38,26
4976,-9.173749999997538,2957.222222222222,55,9,7,64
4977,-5.035499999998715,2900.0555555555557,65,11,14,76
4978,1.980250000001318,1675.125,62,17,7,79
4979,-4.2607499999997405,1429.0,40,24,4,64
4980,-2.36399999999817,3697.157894736842,87,12,8,99
4981,-15.35199999999865,3435.4,41,11,13,52
4982,21.655750000002847,5274.2,86,12,12,98
4983,-6.428499999998256,1564.0,27,10,11,37
4984,-2.8582499999984092,2877.8888888888887,66,25,10,91
4985,-15.587749999997232,3149.0588235294117,63,13,23,76
4986,4.778000000003996,4612.8421052631575,102,7,10,109
4987,3.5362500000022314,3846.6,60,1,12,61
4988,2.7312500000004754,2471.0,76,11,10,87
4989,-19.5842499999972,2618.6666666666665,56,13,11,69
4990,-11.486749999998498,2841.777777777778,51,9,15,60
4991,-15.841249999999613,1429.0,37,23,13,60
4992,-5.997999999997782,3656.0,89,14,12,103
4993,6.464250000002471,4641.7,79,9,9,88
4994,-4.542249999998321,3887.1,53,7,13,60
4995,-1.7589999999986428,2497.684210526316,32,2,12,34
4996,-6.598749999997733,3648.05,58,15,5,73
4997,-7.939249999997879,2076.8125,59,9,10,68
4998,-0.5587499999981251,3478.2631578947367,71,7,7,78
4999,-3.385499999997454,4021.4210526315787,72,10,13,82
5000,-9.28774999999835,3833.8,53,17,8,70
