Episode,Average Reward,Average Lifespan,True Location Count,False Location Count,Explore Actions,Target Actions
1,-31.767999999999553,2537.6111111111113,15,30,2,45
2,-16.005500000000033,2275.3684210526317,17,24,15,41
3,-31.7757499999996,2177.6315789473683,11,28,8,39
4,-45.28624999999959,3755.3,18,39,2,57
5,-34.93999999999986,1598.0588235294117,3,27,7,30
6,-28.58274999999879,1853.625,20,31,16,51
7,-38.85299999999956,2804.157894736842,18,25,8,43
8,-31.565749999999674,2751.0,28,27,8,55
9,-29.395249999999567,1771.2222222222222,12,25,6,37
10,-37.2249999999999,2164.8823529411766,20,30,14,50
11,-33.6437500000001,1685.8235294117646,9,26,9,35
12,-22.218249999999433,3057.3684210526317,24,28,5,52
13,-31.11124999999985,1955.8125,16,36,5,52
14,-28.022499999999514,2098.4444444444443,15,25,5,40
15,-35.82249999999932,2304.684210526316,15,23,5,38
16,-43.98774999999966,2463.6470588235293,17,34,6,51
17,-21.792999999999225,1888.4705882352941,15,28,9,43
18,-34.97149999999813,2659.6470588235293,27,33,10,60
19,-20.81499999999825,3464.157894736842,31,28,11,59
20,-26.60499999999903,2889.45,17,25,9,42
21,-22.659750000000027,2473.8125,32,28,19,60
22,-21.294749999999247,2368.0,18,23,6,41
23,-34.55099999999844,2339.4117647058824,26,30,10,56
24,-18.217750000000414,2198.8888888888887,16,27,12,43
25,-27.4502499999998,2395.7368421052633,19,26,5,45
26,-37.535749999999446,2741.75,14,30,7,44
27,-16.8092499999998,3647.0526315789475,33,33,11,66
28,-23.824999999999697,2969.5,14,31,10,45
29,-6.970499999999104,3407.75,26,27,8,53
30,-29.500999999999767,2505.0,15,25,12,40
31,-42.53574999999948,3087.3684210526317,25,29,5,54
32,-34.07849999999992,2648.0,19,30,7,49
33,-19.578499999999224,2690.1111111111113,26,25,11,51
34,-27.419999999999327,2643.684210526316,14,24,9,38
35,-34.01174999999971,2285.45,11,24,6,35
36,-37.85174999999923,3764.8947368421054,14,37,11,51
37,-29.32324999999908,3625.05,26,34,7,60
38,-31.94724999999997,1634.375,20,36,13,56
39,-34.93549999999968,2818.4736842105262,21,26,9,47
40,-17.55899999999937,3806.1,29,35,8,64
41,-46.42024999999966,2349.722222222222,14,27,8,41
42,-23.910749999999727,2317.2105263157896,13,20,10,33
43,-26.840999999999536,2536.3,17,25,8,42
44,-33.07224999999973,2455.8947368421054,15,29,12,44
45,-35.8777499999993,2538.5789473684213,16,33,8,49
46,-30.629249999999978,1429.0,0,29,12,29
47,-25.409249999999833,2556.842105263158,15,30,6,45
48,-34.323499999999996,2873.5263157894738,13,33,10,46
49,-15.914499999999915,2217.4444444444443,13,26,11,39
50,-41.74949999999967,2427.3529411764707,23,25,6,48
51,-30.735249999999827,1975.8333333333333,11,23,11,34
52,-29.765000000000054,1983.842105263158,15,27,7,42
53,-33.98249999999864,2541.1111111111113,25,29,6,54
54,-27.35299999999929,2311.722222222222,14,31,6,45
55,-20.45425000000022,3358.9473684210525,32,36,12,68
56,-26.88599999999942,2176.0555555555557,14,24,16,38
57,-32.04249999999961,2309.684210526316,17,22,11,39
58,-31.890250000000144,2305.823529411765,20,33,11,53
59,-37.68675000000002,1429.0,8,30,5,38
60,-30.324750000000016,2335.35,12,24,9,36
61,-32.69724999999948,1833.4117647058824,13,26,12,39
62,-24.54224999999955,1953.7222222222222,11,25,6,36
63,-36.838999999999494,2106.0588235294117,18,27,11,45
64,-20.23149999999924,2539.5,18,22,9,40
65,-24.77424999999906,2766.5789473684213,25,27,9,52
66,-43.71725000000014,2524.3888888888887,23,39,5,62
67,-29.418749999999356,2625.85,14,24,6,38
68,-18.20450000000021,2187.4444444444443,34,26,13,60
69,-9.68924999999925,3084.3333333333335,33,23,7,56
70,-19.259249999999874,3254.5789473684213,19,29,12,48
71,-27.24949999999935,3048.9,21,27,7,48
72,-23.730999999999604,1598.0588235294117,10,25,9,35
73,-26.31374999999939,2654.8333333333335,20,28,5,48
74,-29.11174999999948,2810.8,14,29,7,43
75,-26.0752499999998,3972.157894736842,28,28,10,56
76,-32.502250000000004,2405.277777777778,19,37,7,56
77,-45.34849999999975,1643.764705882353,6,28,10,34
78,-29.335499999999154,2816.684210526316,20,25,7,45
79,-34.69974999999929,2035.0,12,32,16,44
80,-27.752999999999524,2945.9444444444443,22,19,10,41
81,-41.68574999999963,2600.3684210526317,12,24,7,36
82,-26.086249999998888,2737.6875,23,25,8,48
83,-30.390749999999638,2715.6315789473683,16,24,4,40
84,-29.344499999999243,2631.764705882353,19,27,12,46
85,-28.22249999999974,2207.6315789473683,15,25,13,40
86,-27.227749999999766,2223.6666666666665,17,27,9,44
87,-33.5324999999996,3138.1111111111113,26,37,8,63
88,-26.945999999999742,3008.7894736842104,18,32,8,50
89,-30.53750000000026,1429.0,12,29,8,41
90,-46.455999999999634,2169.8333333333335,14,42,7,56
91,-26.459749999999453,2538.4736842105262,17,28,11,45
92,-25.863999999999727,2637.9,13,29,5,42
93,-15.07074999999953,3301.2105263157896,21,35,16,56
94,-22.352749999999155,2911.9473684210525,22,32,6,54
95,-29.65024999999978,2304.5789473684213,10,24,9,34
96,-14.184499999999082,2854.1111111111113,28,21,13,49
97,-18.457499999999875,2786.684210526316,19,26,6,45
98,-29.505249999999705,3920.4,22,37,9,59
99,-36.093249999999884,2012.8333333333333,9,31,11,40
100,-35.55325000000009,2210.157894736842,13,28,8,41
101,-25.972749999999714,3418.2105263157896,20,28,10,48
102,-27.9997499999997,4161.55,21,34,9,55
103,-28.234249999999275,2223.705882352941,30,23,7,53
104,-19.675499999999694,1954.764705882353,14,27,11,41
105,-23.304249999999463,2307.764705882353,23,24,13,47
106,-29.917499999999468,2464.529411764706,13,33,17,46
107,-21.756249999999465,3627.0526315789475,30,25,10,55
108,-29.064499999999725,2236.0526315789475,7,29,8,36
109,-33.529499999999324,2255.3529411764707,20,30,12,50
110,-29.77674999999989,2847.6315789473683,15,31,10,46
111,-29.284999999999563,2198.8888888888887,19,29,6,48
112,-17.483499999999044,2444.9473684210525,19,20,12,39
113,-35.277749999999926,2382.277777777778,18,25,5,43
114,-36.42374999999912,3031.3888888888887,31,37,12,68
115,-25.14699999999995,2426.3888888888887,15,27,10,42
116,-34.99749999999949,1806.235294117647,10,28,10,38
117,-14.202749999999565,2779.1052631578946,22,29,9,51
118,-29.995500000000085,1933.4444444444443,18,30,12,48
119,-21.45424999999977,3291.157894736842,32,23,8,55
120,-46.020749999999325,2802.95,15,36,6,51
121,-30.6417499999995,3779.9,24,30,5,54
122,-12.511249999998585,3568.684210526316,40,34,14,74
123,-25.899249999999267,2564.0,15,30,11,45
124,-28.492749999999482,2786.25,20,23,13,43
125,-27.699499999999894,1652.1666666666667,6,25,12,31
126,-16.96799999999998,1774.7777777777778,13,25,11,38
127,-28.632250000000045,1576.875,10,26,13,36
128,-24.039249999999473,2411.6315789473683,15,25,8,40
129,-23.39299999999979,2196.7894736842104,11,29,12,40
130,-30.243999999998795,1942.6470588235295,12,28,9,40
131,-21.365249999999772,2283.4117647058824,19,29,10,48
132,-21.710999999999846,2008.0526315789473,10,25,10,35
133,-39.38100000000017,2497.0,22,23,9,45
134,-38.07724999999957,3384.7894736842104,19,31,8,50
135,-20.07724999999958,3598.6315789473683,29,28,10,57
136,-24.234999999999303,2463.5555555555557,27,35,3,62
137,-23.292249999999328,2826.777777777778,18,33,9,51
138,-25.494249999999425,2305.9411764705883,19,21,8,40
139,-26.668749999999733,3006.315789473684,14,36,9,50
140,-46.324249999999395,2863.25,13,32,5,45
141,-30.016999999999847,1589.75,10,24,7,34
142,-34.061999999999514,2125.5,15,34,11,49
143,-20.40249999999968,2634.6,10,26,12,36
144,-34.24774999999985,1778.235294117647,15,31,10,46
145,-24.452499999999013,3669.6,27,32,4,59
146,-19.186749999999172,3307.842105263158,25,28,8,53
147,-31.53225000000007,2775.842105263158,18,27,7,45
148,-35.25249999999959,2883.5789473684213,14,29,11,43
149,-28.27049999999958,2722.8,13,30,10,43
150,-27.828999999999127,2362.823529411765,16,32,7,48
151,-35.93674999999995,2561.9473684210525,15,32,7,47
152,-17.125499999999292,2407.5263157894738,21,21,13,42
153,-22.569749999999683,2008.45,4,23,18,27
154,-31.338500000000106,1429.0,3,28,14,31
155,-28.323999999999508,1760.4375,12,27,6,39
156,-27.69274999999981,2688.55,15,28,9,43
157,-27.021499999999598,2580.9375,30,45,9,75
158,-31.369249999999493,2502.6315789473683,16,31,4,47
159,-29.08049999999981,2036.15,5,30,15,35
160,-37.69999999999975,2314.5,20,33,4,53
161,-27.190499999999748,2009.3333333333333,10,25,13,35
162,-31.575500000000023,1429.0,0,25,8,25
163,-27.26674999999879,4675.1,32,34,3,66
164,-26.5224999999991,2961.65,20,26,11,46
165,-34.48124999999955,3315.4444444444443,24,32,11,56
166,-21.301749999999817,2691.8888888888887,20,28,10,48
167,-33.038499999999296,2644.222222222222,17,34,4,51
168,-32.18699999999933,3793.35,24,36,7,60
169,-33.60799999999974,2971.05,16,28,7,44
170,-39.01975000000006,2143.4444444444443,13,31,6,44
171,-30.365249999999,2510.4117647058824,19,27,11,46
172,-24.175250000000318,2429.0588235294117,26,44,11,70
173,-21.75574999999935,2536.722222222222,22,26,5,48
174,-16.93699999999931,3826.75,31,22,9,53
175,-12.84049999999965,2265.3684210526317,16,30,14,46
176,-28.217250000000707,2852.3333333333335,35,27,20,62
177,-34.135499999999624,2204.3684210526317,11,22,9,33
178,-18.541999999999238,2995.8,25,23,8,48
179,-40.78399999999991,2055.1666666666665,12,28,5,40
180,-27.339499999999077,3022.2105263157896,24,39,8,63
181,-32.3340000000002,1616.5625,10,30,10,40
182,-25.607249999999567,2811.55,17,29,9,46
183,-25.539999999999573,2552.15,19,25,8,44
184,-38.97824999999986,3871.85,14,35,7,49
185,-26.517750000000063,2389.3888888888887,16,26,5,42
186,-18.69749999999917,2878.0555555555557,29,25,12,54
187,-30.403499999998974,2951.2105263157896,23,28,8,51
188,5.0262500000003,3380.7368421052633,30,24,19,54
189,-19.180749999999826,1982.1052631578948,12,18,20,30
190,-20.96700000000034,2109.9473684210525,28,28,12,56
191,-22.901750000000384,2878.5789473684213,20,29,13,49
192,-22.44049999999978,2941.2631578947367,24,27,15,51
193,-16.628500000000006,2413.277777777778,23,28,12,51
194,-29.955500000000068,2524.4444444444443,23,36,5,59
195,-34.12824999999951,3182.222222222222,21,31,11,52
196,-26.39099999999967,2501.0,14,29,9,43
197,-31.22750000000004,1429.0,2,22,12,24
198,-29.2274999999996,2147.5263157894738,12,24,13,36
199,-31.661999999999786,1980.2777777777778,13,21,13,34
200,-32.16549999999999,2243.5,19,29,5,48
201,-20.03374999999935,2585.0588235294117,34,32,14,66
202,-27.570749999999634,2348.9473684210525,16,24,9,40
203,-22.517499999999686,2260.0,17,26,7,43
204,-32.311499999999796,3316.157894736842,26,25,9,51
205,-31.193999999999882,2179.6111111111113,15,25,16,40
206,-31.22649999999957,2036.611111111111,11,27,15,38
207,-33.998249999999395,2664.75,10,31,9,41
208,-17.5317500000002,1627.0588235294117,22,22,12,44
209,-23.772999999999264,2737.05,16,25,11,41
210,-16.39499999999917,2970.6470588235293,26,25,11,51
211,-15.33799999999955,2512.777777777778,26,26,13,52
212,-27.14124999999914,2958.842105263158,20,30,15,50
213,-36.74224999999979,2178.823529411765,9,29,14,38
214,-34.15399999999899,2192.9375,26,31,9,57
215,-27.852749999999702,1849.6666666666667,13,33,10,46
216,-26.551499999999635,2058.45,8,25,12,33
217,-29.586499999999766,3388.2631578947367,26,32,20,58
218,-34.878249999998985,2131.294117647059,14,24,13,38
219,-19.807999999999698,2130.0555555555557,16,21,18,37
220,-25.833749999999878,1925.5555555555557,10,25,11,35
221,-48.641249999999545,2608.0,11,26,7,37
222,-19.111249999999472,3287.0,26,25,7,51
223,-27.99424999999931,3418.2631578947367,24,27,13,51
224,-28.67224999999916,2779.1052631578946,22,28,5,50
225,-29.155249999999352,1976.235294117647,11,24,17,35
226,-16.29174999999988,2500.5,22,29,13,51
227,-32.391749999999284,3649.6315789473683,28,34,14,62
228,-28.976750000000017,1803.4705882352941,19,32,11,51
229,-17.56424999999921,2983.764705882353,28,37,15,65
230,-14.527249999999645,2365.6315789473683,16,18,20,34
231,-27.293999999999308,3282.722222222222,28,32,18,60
232,-21.798499999998803,2852.3333333333335,21,31,12,52
233,-21.67774999999987,1959.578947368421,13,20,19,33
234,-9.020999999999662,2221.1052631578946,13,21,18,34
235,-26.76599999999969,2443.4,10,23,15,33
236,-27.088249999999412,3923.5789473684213,30,31,12,61
237,-22.70249999999984,1677.4117647058824,8,20,15,28
238,-25.39874999999939,3353.7894736842104,26,29,10,55
239,-35.3545000000002,1429.0,7,30,23,37
240,-33.87175000000015,1828.764705882353,14,26,17,40
241,-6.293999999999853,2470.8947368421054,28,28,23,56
242,-8.99324999999969,2707.235294117647,14,26,22,40
243,-16.064750000000043,2316.1176470588234,20,25,21,45
244,-20.256499999999598,3079.9,16,24,12,40
245,-13.725249999999582,3057.777777777778,34,31,16,65
246,-24.516749999999348,2261.0588235294117,28,26,14,54
247,-27.395750000000067,1714.7058823529412,12,30,19,42
248,-27.017499999999792,2021.0588235294117,14,26,20,40
249,-9.26024999999841,3772.75,26,23,24,49
250,-26.3815,2087.722222222222,16,22,21,38
251,-13.819499999999527,3163.6666666666665,29,25,14,54
252,-20.2017499999998,2430.7368421052633,10,26,17,36
253,-22.372749999999527,3377.2105263157896,17,33,17,50
254,-20.200499999999124,3258.9444444444443,22,29,14,51
255,-6.078499999999125,1429.0,22,21,25,43
256,-17.457499999999534,2706.85,14,28,11,42
257,-21.189750000000004,3050.5789473684213,20,34,14,54
258,-20.6049999999999,2487.4736842105262,14,19,19,33
259,-23.622249999999468,3035.6315789473683,21,26,10,47
260,-13.656499999999165,2394.0,18,24,16,42
261,-15.423000000000135,2244.235294117647,21,33,15,54
262,-28.85474999999942,2407.8888888888887,13,35,17,48
263,-15.665750000000173,1914.421052631579,12,24,20,36
264,-26.412999999999652,2576.6470588235293,33,33,25,66
265,-6.985000000000248,2517.6315789473683,22,28,24,50
266,-14.853499999999652,2580.294117647059,20,36,14,56
267,-16.044249999999856,2496.4117647058824,20,28,15,48
268,-32.6772499999996,2206.8888888888887,12,29,8,41
269,-40.217749999999604,2499.157894736842,8,31,20,39
270,-29.776999999999816,2377.2631578947367,12,25,18,37
271,-24.198749999999777,3042.6470588235293,33,45,18,78
272,-25.081999999999475,3242.6,21,33,13,54
273,-19.574999999999996,2647.777777777778,17,28,17,45
274,-26.652749999999536,3136.277777777778,19,32,14,51
275,-20.434999999999867,2367.315789473684,12,22,16,34
276,-22.926499999999717,2106.6315789473683,11,22,15,33
277,-24.192499999999857,2406.0555555555557,14,28,14,42
278,1.3972500000001924,2951.0588235294117,56,27,21,83
279,-10.160999999999296,2358.176470588235,26,25,21,51
280,-16.93174999999965,2519.8888888888887,23,27,16,50
281,-6.4234999999994145,2564.8,17,23,20,40
282,-23.64274999999928,1429.0,12,22,15,34
283,-22.092749999999583,3614.5789473684213,20,32,16,52
284,-18.650249999999485,2697.315789473684,16,23,14,39
285,10.1630000000001,2131.176470588235,30,20,26,50
286,-22.13374999999933,3140.0,23,25,24,48
287,-20.631249999999348,2596.157894736842,15,27,26,42
288,-23.29524999999982,2775.7894736842104,15,34,14,49
289,-8.482249999999054,2734.8947368421054,21,28,16,49
290,-26.500250000000733,3575.2105263157896,25,30,23,55
291,-9.472749999999815,2858.4210526315787,24,26,24,50
292,-17.282499999999438,2803.0,20,20,20,40
293,-12.759749999999642,2070.7368421052633,10,26,17,36
294,-16.117249999999725,2754.4444444444443,23,35,21,58
295,-16.532749999999602,1599.6875,9,26,16,35
296,-27.41974999999951,2715.5789473684213,11,27,21,38
297,-18.757499999999546,2517.277777777778,14,19,25,33
298,-14.71649999999875,2413.1666666666665,23,25,18,48
299,-15.76499999999962,2118.1176470588234,17,26,19,43
300,-14.152249999999992,3098.2631578947367,16,22,22,38
301,-10.967999999999211,3077.4210526315787,17,22,26,39
302,-25.350499999999695,2317.0588235294117,24,32,17,56
303,-11.331499999999899,2839.2631578947367,29,22,20,51
304,2.7732500000007345,3379.9,26,21,27,47
305,-10.19699999999952,2879.9,19,19,23,38
306,-27.741999999999557,2384.8888888888887,10,25,32,35
307,-14.582999999999297,3047.2631578947367,19,22,24,41
308,-14.078499999999796,3849.7,21,30,26,51
309,-25.110499999999913,2629.6315789473683,28,25,22,53
310,-21.721749999999737,2940.2,13,25,13,38
311,-11.914249999999733,2121.3333333333335,10,19,28,29
312,-12.897000000000082,2958.7368421052633,16,24,33,40
313,-18.626500000000306,2905.277777777778,29,35,28,64
314,-18.565499999999236,1993.0588235294117,13,23,18,36
315,-14.227499999999731,2409.6666666666665,15,23,26,38
316,-19.070499999999786,1581.235294117647,7,22,21,29
317,-15.29349999999982,2212.0555555555557,16,26,29,42
318,-13.7112499999994,2699.7368421052633,11,33,21,44
319,-7.010999999999825,2136.25,10,18,21,28
320,-10.573999999999243,3891.9473684210525,37,27,35,64
321,-11.097250000000091,2286.235294117647,13,22,26,35
322,-11.487999999998843,4045.8,23,20,31,43
323,-19.225499999999972,2641.75,10,25,23,35
324,-3.4354999999992573,2219.6875,27,18,31,45
325,-18.917999999999797,2741.0,11,21,26,32
326,-4.53475000000009,3084.842105263158,22,18,43,40
327,-17.230999999999437,3476.722222222222,24,28,26,52
328,-16.517500000000037,2280.529411764706,13,24,29,37
329,-0.19949999999947632,3118.7,20,23,31,43
330,-4.886999999999796,2642.2105263157896,15,23,28,38
331,-25.084249999999475,3968.7894736842104,20,29,38,49
332,-12.195499999999322,2195.3888888888887,16,17,23,33
333,-1.7080000000000877,1438.5333333333333,13,16,35,29
334,-1.2827499999997538,3567.9,16,17,43,33
335,-3.3057500000000672,2818.8888888888887,23,20,40,43
336,-10.647499999999674,2281.157894736842,10,19,32,29
337,-15.016249999999118,2958.0526315789475,17,24,21,41
338,-0.315999999999591,2679.5,19,22,35,41
339,-2.8079999999994385,3524.2631578947367,25,20,34,45
340,-21.31949999999946,3498.15,14,20,29,34
341,9.890500000000163,2584.3333333333335,19,18,49,37
342,-5.932250000000144,2444.8333333333335,9,16,36,25
343,-7.719499999999765,2924.5789473684213,19,15,33,34
344,-7.453499999999755,2413.277777777778,16,23,46,39
345,-11.929499999999543,2033.1666666666667,10,18,35,28
346,-20.666249999999938,2191.0,11,23,32,34
347,-5.463249999999714,2050.8823529411766,23,28,44,51
348,-6.779499999999618,2279.684210526316,17,14,34,31
349,-14.627249999999526,3107.7,12,22,45,34
350,-15.60449999999923,2320.6111111111113,9,24,40,33
351,-6.7269999999998165,2215.2105263157896,11,17,37,28
352,-2.960999999999861,2166.7894736842104,9,11,45,20
353,-9.267249999999752,2626.65,15,15,32,30
354,9.215500000000397,2290.9411764705883,16,17,43,33
355,-17.84849999999964,1545.0625,7,23,29,30
356,-9.775749999999837,2725.9,9,16,33,25
357,-8.25749999999915,3582.0,17,21,38,38
358,-5.237749999999824,1638.5333333333333,8,21,43,29
359,-12.090750000000028,2174.222222222222,6,15,43,21
360,-7.996499999999514,2967.8333333333335,18,21,31,39
361,-15.56799999999956,2759.1052631578946,17,19,46,36
362,-8.804999999999962,2658.842105263158,15,14,37,29
363,-14.188000000000281,2734.222222222222,24,20,71,44
364,-6.783249999999866,1971.5882352941176,14,9,42,23
365,-1.9959999999997282,2186.5,12,13,42,25
366,-2.6192499999996777,2929.4736842105262,12,17,54,29
367,-11.395999999999841,2477.5555555555557,13,17,41,30
368,-2.4997499999999704,2687.3888888888887,20,16,67,36
369,3.140500000000472,3162.5789473684213,19,21,42,40
370,-4.709999999999571,2346.1176470588234,14,15,38,29
371,-7.804750000000006,2036.6666666666667,8,18,46,26
372,-6.185999999999514,3217.95,15,12,43,27
373,-3.3707500000001276,2616.2105263157896,16,23,54,39
374,-2.483249999999655,3028.722222222222,17,28,52,45
375,-2.5752499999995146,4439.35,21,23,45,44
376,0.21974999999999262,2825.8947368421054,16,18,43,34
377,-3.0252499999998337,1942.9375,8,15,54,23
378,3.697250000000312,4019.5,17,19,39,36
379,-8.648750000000225,2810.0,6,20,45,26
380,1.9610000000003325,1761.4117647058824,10,15,56,25
381,-6.327249999999928,1429.0,4,10,51,14
382,4.8485000000004295,3940.2,19,13,49,32
383,-1.4649999999999,3362.35,11,20,38,31
384,-7.555249999999833,2248.684210526316,8,13,43,21
385,-0.9592499999997516,3124.9444444444443,19,12,43,31
386,9.89225000000025,2611.6,10,9,53,19
387,2.1075000000006523,2639.176470588235,19,16,48,35
388,3.6425000000001737,2891.8947368421054,14,14,44,28
389,-5.285500000000004,2132.5789473684213,6,14,47,20
390,-4.171749999999735,2834.722222222222,19,17,45,36
391,-5.301499999999402,3049.7894736842104,17,20,42,37
392,0.5835000000002055,2414.8947368421054,11,12,36,23
393,1.8647500000003117,2465.277777777778,17,13,49,30
394,-1.2489999999994355,2180.3888888888887,9,14,44,23
395,-9.829249999999584,1728.6875,8,17,42,25
396,-10.25299999999957,1796.9411764705883,11,19,38,30
397,-9.754499999999396,1939.0625,11,17,50,28
398,-7.521249999999833,2151.3,3,17,44,20
399,-4.2874999999995325,2283.6315789473683,11,11,36,22
400,0.5012500000009419,4149.7,26,21,36,47
401,0.7979999999997365,1605.4705882352941,9,17,59,26
402,-15.144500000000281,2984.6111111111113,21,29,57,50
403,-2.3749999999996705,1429.0,7,12,57,19
404,2.9802499999996215,3008.8947368421054,21,20,57,41
405,-6.919999999999871,3124.1052631578946,21,23,58,44
406,-2.8859999999996724,1640.0588235294117,10,12,50,22
407,-8.995249999999867,2928.6315789473683,9,12,51,21
408,-8.21424999999986,2340.8888888888887,13,8,46,21
409,-0.2522500000003004,3045.4444444444443,20,20,46,40
410,-9.044999999999872,2752.4210526315787,10,18,51,28
411,5.545000000000097,2852.5789473684213,12,12,47,24
412,-4.031750000000027,1835.75,4,10,58,14
413,1.8965000000000227,1788.5882352941176,4,8,60,12
414,7.618000000000483,3873.5789473684213,18,15,68,33
415,10.77950000000052,4241.0526315789475,29,13,59,42
416,-4.009749999999682,2486.9411764705883,9,19,56,28
417,2.328749999999758,1581.4,12,19,56,31
418,1.9292500000000352,4071.4210526315787,19,22,54,41
419,-2.8387500000003514,1429.0,13,15,55,28
420,-4.026249999999442,2687.4444444444443,14,17,61,31
421,-12.946499999999872,2922.0,8,17,58,25
422,-1.9837499999997932,3204.222222222222,16,12,47,28
423,-4.008999999999714,1921.125,12,10,48,22
424,8.242500000000318,1795.1176470588234,9,14,54,23
425,-9.664749999999989,1916.4117647058824,6,18,51,24
426,7.308750000001099,3168.0555555555557,21,13,58,34
427,-0.8467499999994599,3439.1052631578946,12,19,56,31
428,-9.251249999999722,3086.5263157894738,10,16,56,26
429,0.5930000000003541,2990.95,13,11,52,24
430,3.2537499999998922,3174.2631578947367,15,15,53,30
431,1.1782500000002263,2173.294117647059,16,14,53,30
432,-3.710499999999211,2612.625,15,19,58,34
433,6.127000000000086,2080.8823529411766,13,13,51,26
434,-2.95774999999975,3821.7894736842104,17,14,52,31
435,2.037250000000328,1612.5625,12,12,56,24
436,-4.748249999999723,2666.3684210526317,14,11,52,25
437,14.798750000000178,1889.375,17,15,56,32
438,-5.7232499999996795,1981.111111111111,13,22,49,35
439,-17.578749999999413,2033.1666666666667,3,18,49,21
440,1.1475000000002407,4135.45,21,15,55,36
441,5.971000000000409,2932.8947368421054,17,19,45,36
442,-4.671749999999724,3063.9473684210525,14,17,59,31
443,4.0995000000001385,1887.4375,10,11,53,21
444,-12.598999999999759,2572.0,14,21,53,35
445,-2.9814999999997225,2630.1666666666665,12,16,38,28
446,4.596499999999846,3316.25,12,12,52,24
447,-0.9507499999999048,2121.0588235294117,9,15,43,24
448,-0.19874999999978818,2914.4210526315787,10,6,58,16
449,-10.943249999999166,2873.5,10,18,52,28
450,13.23850000000004,1630.5,15,9,58,24
451,-11.660999999999161,4744.1,19,27,48,46
452,-7.9329999999996845,1564.4117647058824,6,14,40,20
453,3.675500000000176,1761.4117647058824,7,7,51,14
454,20.185000000000695,4391.0,23,19,61,42
455,2.5687500000002443,2834.6666666666665,15,18,56,33
456,-3.327750000000015,1429.0,1,6,40,7
457,0.47825000000046547,5072.65,23,22,49,45
458,4.388750000000166,4108.35,22,10,59,32
459,7.562000000000674,3460.1,17,12,48,29
460,12.735250000000434,4419.55,20,11,46,31
461,11.112000000000581,3085.1666666666665,21,12,60,33
462,0.9992500000003831,2869.315789473684,13,12,56,25
463,-8.343749999999872,1913.125,5,14,56,19
464,-0.5979999999998975,2751.8333333333335,26,18,68,44
465,-9.641499999999745,1644.2222222222222,2,10,52,12
466,7.824000000000794,3658.0,24,14,50,38
467,-4.165249999999694,1668.0555555555557,5,11,51,16
468,-4.9989999999994374,2926.2105263157896,10,18,62,28
469,1.0905000000000853,2038.764705882353,8,15,55,23
470,-2.3684999999996426,2338.277777777778,21,19,62,40
471,-11.206499999999917,1813.0,11,24,54,35
472,13.135750000000366,2958.842105263158,19,11,54,30
473,-0.07349999999984343,1666.125,8,7,58,15
474,2.4100000000004007,3317.25,15,14,46,29
475,10.19575000000042,3837.05,14,5,56,19
476,3.671000000000531,1819.3529411764705,11,11,61,22
477,14.651999999999896,2729.7894736842104,23,17,56,40
478,11.710500000000144,2235.0555555555557,18,13,77,31
479,-7.109499999999632,2655.722222222222,12,15,52,27
480,6.7717500000002575,2732.625,28,22,52,50
481,4.464000000000431,4470.789473684211,23,21,57,44
482,-2.9094999999995848,3102.4210526315787,11,12,54,23
483,-5.50750000000029,2262.4444444444443,9,21,62,30
484,13.228499999999922,1741.5625,19,17,75,36
485,5.645750000000242,2822.3333333333335,10,14,65,24
486,-13.555749999999852,1448.0666666666666,4,15,52,19
487,-3.9809999999996273,1804.0625,6,22,50,28
488,-5.384999999999285,2994.277777777778,19,14,67,33
489,-0.8852499999996624,2744.2,8,11,64,19
490,0.3950000000000583,2179.5,8,11,52,19
491,-9.182499999999713,2997.4,7,16,47,23
492,0.40225000000016176,2156.470588235294,10,18,62,28
493,2.451749999999948,2339.1111111111113,14,15,71,29
494,7.424250000000005,1951.9375,19,22,69,41
495,9.146999999999691,3175.9473684210525,19,13,59,32
496,4.584250000000241,2868.3684210526317,22,10,52,32
497,0.8005000000001156,2984.5789473684213,10,12,66,22
498,3.4247500000001105,2666.315789473684,14,7,63,21
499,-6.958999999999617,2235.2631578947367,7,9,54,16
500,6.7080000000002045,1996.5625,15,12,49,27
501,5.431500000001035,4464.8,21,15,73,36
502,-12.634499999999687,3883.5263157894738,11,18,63,29
503,13.548000000000462,2613.9411764705883,29,21,71,50
504,15.536250000000171,3094.8947368421054,29,16,60,45
505,-0.7387500000000201,2023.25,7,5,60,12
506,-4.479499999999918,2185.3529411764707,15,14,56,29
507,4.449999999999997,3923.684210526316,27,21,56,48
508,-10.93599999999942,2846.7894736842104,6,18,54,24
509,-2.3769999999998914,3635.35,12,13,54,25
510,0.04200000000018166,2370.5263157894738,10,8,64,18
511,-1.0254999999993681,2279.222222222222,10,14,63,24
512,-1.397999999999604,3383.9473684210525,19,14,53,33
513,11.634750000000952,3350.6111111111113,26,12,58,38
514,-0.955249999999951,1778.25,3,9,62,12
515,1.8940000000001245,1429.0,6,5,59,11
516,3.8420000000003802,3158.4,13,11,51,24
517,9.89899999999997,3397.3333333333335,19,26,63,45
518,13.571750000000383,3042.2631578947367,18,8,63,26
519,-9.549749999999708,3426.5263157894738,13,17,49,30
520,10.836500000000523,2870.705882352941,23,12,54,35
521,5.958500000000261,3656.0,18,17,55,35
522,3.6585000000004855,2816.7368421052633,16,10,62,26
523,2.073500000000961,2763.3333333333335,15,17,76,32
524,-5.801249999999541,2083.4444444444443,19,10,51,29
525,7.255999999999984,2692.2631578947367,8,13,56,21
526,3.3842500000008355,2312.9375,20,14,50,34
527,4.953750000001097,2808.176470588235,23,14,65,37
528,1.6230000000002913,2106.85,20,6,37,26
529,5.891000000000053,4178.421052631579,26,12,46,38
530,4.609000000000188,2186.5555555555557,7,5,52,12
531,-2.49224999999944,2892.55,11,8,62,19
532,-2.06499999999969,2655.25,14,6,54,20
533,8.358750000000319,2166.1875,16,12,64,28
534,-3.030499999999577,2172.75,20,3,32,23
535,6.575750000000353,3861.6,19,9,52,28
536,3.7415000000003493,2017.2222222222222,14,9,38,23
537,-5.477499999999785,1898.2222222222222,3,13,49,16
538,-1.9127499999993653,2613.4444444444443,19,12,48,31
539,3.928500000000536,3719.1052631578946,22,22,52,44
540,6.96325000000044,3287.9444444444443,19,19,55,38
541,6.570250000000534,2345.0588235294117,18,10,52,28
542,3.0592500000000618,2965.3684210526317,15,7,47,22
543,9.978500000000302,2790.6111111111113,23,7,58,30
544,4.710750000000548,3718.75,25,6,48,31
545,-2.7869999999999955,1554.0,3,8,53,11
546,5.393750000000289,2783.3684210526317,14,10,72,24
547,8.516000000000464,3023.8947368421054,9,14,64,23
548,1.0375000000006247,4751.4,16,21,58,37
549,7.4110000000004534,4322.8,18,13,45,31
550,6.936499999999694,1429.0,18,21,65,39
551,17.63575000000035,4066.4736842105262,19,18,63,37
552,15.881500000000807,2832.5789473684213,26,10,56,36
553,25.386750000000482,2301.0625,21,14,57,35
554,4.407000000000191,4673.5,27,22,58,49
555,10.089250000000485,3191.75,19,6,57,25
556,-6.26024999999967,2443.0588235294117,12,17,52,29
557,12.635000000000215,2915.8333333333335,25,16,57,41
558,-3.0262500000000134,1661.1875,5,10,50,15
559,9.527750000000385,2686.4444444444443,25,15,47,40
560,2.7280000000002023,1559.0,6,6,49,12
561,8.32025000000041,3227.0,15,11,58,26
562,11.609999999999442,1616.5,21,17,67,38
563,0.6525000000005672,3068.5,25,13,48,38
564,6.415000000000172,2601.0,22,11,43,33
565,-10.686000000000003,2370.294117647059,24,19,54,43
566,-0.2562499999998349,2825.85,16,9,45,25
567,3.76125000000024,1691.8333333333333,5,8,50,13
568,-3.6725000000002517,1839.75,13,22,71,35
569,0.33875000000035527,2227.222222222222,17,9,56,26
570,-0.6494999999995855,2248.5789473684213,10,7,56,17
571,13.092250000000522,2843.5555555555557,16,10,53,26
572,7.321500000000161,1753.0588235294117,13,8,61,21
573,14.826250000000215,3017.235294117647,18,19,63,37
574,-6.166499999999931,3126.6315789473683,16,21,77,37
575,-1.5617499999995452,2929.8888888888887,19,10,58,29
576,3.4920000000004223,2608.9444444444443,19,7,54,26
577,2.241000000000199,2715.6315789473683,15,19,54,34
578,3.640000000000223,2727.1666666666665,16,17,53,33
579,18.22000000000029,2407.9444444444443,16,13,51,29
580,8.78650000000108,3801.4,31,10,61,41
581,7.687750000000618,3256.9473684210525,18,8,50,26
582,1.6817499999999075,2826.777777777778,19,12,56,31
583,10.427750000000561,3563.5263157894738,26,10,48,36
584,2.0839999999993797,1562.9375,16,28,51,44
585,-1.5789999999994078,2738.176470588235,18,14,52,32
586,6.1340000000004995,3452.1,20,6,53,26
587,10.360250000001013,3892.6,29,13,45,42
588,9.731500000000535,2620.3888888888887,18,9,53,27
589,7.9282500000004035,3665.6,19,10,50,29
590,15.510000000000186,2816.684210526316,15,11,62,26
591,10.022250000000295,2295.4210526315787,16,5,51,21
592,2.013500000000147,2607.0526315789475,16,8,40,24
593,-1.5127499999997653,3032.157894736842,17,12,53,29
594,0.969250000000417,2626.2105263157896,14,10,54,24
595,-8.276249999999814,1685.8823529411766,11,14,66,25
596,17.742250000000315,2703.3333333333335,27,15,65,42
597,8.907750000000648,2312.9473684210525,18,10,46,28
598,5.349750000000484,1996.5,14,16,50,30
599,12.806750000000097,2434.1052631578946,17,0,45,17
600,-1.023499999999516,2762.4210526315787,17,7,61,24
601,2.622250000000381,2454.235294117647,14,14,50,28
602,-1.8277499999996714,2299.235294117647,7,20,54,27
603,1.7052500000002848,1921.1764705882354,13,12,42,25
604,1.056000000000664,1528.25,14,10,66,24
605,7.428750000000642,2616.0555555555557,25,9,76,34
606,-5.278749999999837,1840.8125,3,9,54,12
607,-0.9139999999994275,2037.8823529411766,25,21,46,46
608,9.024750000000777,2306.5555555555557,33,11,45,44
609,2.045750000000375,3238.5,22,8,36,30
610,16.276750000000234,3167.222222222222,35,9,56,44
611,-3.71650000000011,1491.5625,5,11,61,16
612,17.92800000000059,2951.2105263157896,27,8,47,35
613,5.5042500000003685,1764.3125,16,13,54,29
614,2.0110000000004935,2740.0,26,8,48,34
615,5.331750000000636,3438.315789473684,24,14,40,38
616,-0.5642499999996613,3485.0526315789475,26,17,47,43
617,15.761250000000151,2814.8947368421054,26,9,55,35
618,-5.137999999999872,2343.0526315789475,24,5,34,29
619,11.129750000000993,3318.0,25,24,51,49
620,21.64775000000068,3719.842105263158,33,14,41,47
621,13.416500000000331,2685.823529411765,42,13,64,55
622,16.34325000000046,2896.0,28,16,66,44
623,7.630750000000367,2421.85,12,7,49,19
624,12.393250000000187,2624.0,28,11,56,39
625,-4.5532499999994265,3165.2105263157896,25,15,37,40
626,11.836250000000529,3260.4210526315787,30,13,59,43
627,0.11075000000046287,2024.7894736842106,18,8,43,26
628,-17.209249999999614,2418.2631578947367,21,8,27,29
629,12.630750000000567,4490.2,23,20,63,43
630,10.50325000000059,2306.5555555555557,16,13,52,29
631,-1.811499999999954,3104.235294117647,22,19,47,41
632,-3.2844999999994733,3978.3,15,22,56,37
633,-0.14999999999944724,3102.294117647059,23,13,56,36
634,15.57024999999978,2098.8125,32,14,52,46
635,9.780750000000541,4925.15,28,24,52,52
636,8.37075000000037,2675.0,18,18,56,36
637,8.41150000000054,3304.5789473684213,23,10,44,33
638,11.970249999999854,2134.9411764705883,19,24,65,43
639,3.017250000000319,2929.85,32,5,34,37
640,-5.396999999999491,2655.3333333333335,31,15,36,46
641,20.608000000000878,2839.1111111111113,26,18,51,44
642,13.1752500000004,2695.4444444444443,28,7,49,35
643,7.852500000000565,2946.777777777778,30,9,42,39
644,10.950000000000681,3582.35,24,15,39,39
645,17.907250000000722,3719.0,37,14,53,51
646,7.25200000000063,3348.2,22,10,51,32
647,2.6362500000007496,2522.6470588235293,20,10,60,30
648,26.98975000000011,3000.5555555555557,41,17,56,58
649,1.6105000000000316,2417.6111111111113,18,9,42,27
650,-0.6827499999999341,2160.1,13,5,38,18
651,-3.109750000000325,3455.842105263158,37,18,54,55
652,8.911500000000526,2828.3684210526317,20,13,37,33
653,7.700500000000223,4941.75,32,11,53,43
654,-0.8587499999992311,2811.684210526316,28,16,27,44
655,10.46225000000039,2048.1111111111113,20,7,48,27
656,-1.8927499999993889,2154.5882352941176,24,16,33,40
657,14.236000000000365,3032.1666666666665,25,13,43,38
658,2.197250000000914,2875.2631578947367,18,17,51,35
659,11.64625000000043,3301.1666666666665,35,11,42,46
660,17.349000000001215,4034.7368421052633,38,9,54,47
661,6.714250000000476,1556.0588235294117,14,9,55,23
662,2.170000000000207,2608.0555555555557,16,17,46,33
663,4.990500000000456,2790.7894736842104,24,12,40,36
664,6.102000000001089,2549.8888888888887,37,8,41,45
665,-1.7602499999999353,1429.0,11,18,52,29
666,-16.373499999999396,2100.7894736842104,24,9,23,33
667,6.494000000000201,3467.8888888888887,29,13,43,42
668,7.395750000000676,2049.9411764705883,15,10,58,25
669,5.62725000000041,2557.8333333333335,17,22,54,39
670,13.972750000000579,2211.529411764706,30,9,40,39
671,15.189000000000743,2329.1176470588234,23,11,52,34
672,1.8882499999998665,1429.0,10,22,51,32
673,0.3940000000003497,3209.2,10,15,43,25
674,7.3562500000001645,2170.2105263157896,24,11,51,35
675,-2.28424999999971,3396.5789473684213,20,14,37,34
676,9.158500000000327,3479.1,19,18,41,37
677,4.149500000000505,3781.6315789473683,26,17,42,43
678,17.7005000000002,2157.1875,35,11,66,46
679,13.383000000000504,2080.8823529411766,30,11,47,41
680,-8.060500000000022,2582.0,15,8,43,23
681,7.2369999999998145,1429.0,12,12,49,24
682,-5.805999999999502,2277.823529411765,28,16,36,44
683,4.11975000000052,2632.0555555555557,28,12,38,40
684,-6.702499999999705,3436.35,22,20,40,42
685,1.8565000000008005,2773.8333333333335,27,19,41,46
686,28.474250000000474,3615.3684210526317,48,12,50,60
687,1.5342500000008061,5067.2,46,15,29,61
688,9.830250000000422,2181.125,29,6,40,35
689,-7.660749999999304,2668.1666666666665,26,8,39,34
690,-3.2144999999991883,3381.5,21,19,43,40
691,2.5152500000006763,2722.2631578947367,30,8,30,38
692,-6.345249999999387,2923.722222222222,31,18,24,49
693,-2.901999999999854,2349.6111111111113,24,9,38,33
694,1.1655000000002167,2474.25,6,14,50,20
695,1.5727500000002028,2826.65,13,9,39,22
696,-3.988999999999307,2742.5263157894738,26,14,35,40
697,2.9197500000005823,2811.7894736842104,24,12,33,36
698,11.770750000000454,3796.5,33,10,42,43
699,7.690500000000275,1991.5,26,23,53,49
700,9.99175000000034,2112.6470588235293,33,7,34,40
701,-2.228000000000021,2524.277777777778,15,15,48,30
702,1.9260000000009925,2501.3333333333335,29,7,42,36
703,-19.721749999999762,2457.4444444444443,24,13,33,37
704,-4.746499999999239,2644.0666666666666,37,8,21,45
705,10.792500000000373,4390.2,35,17,47,52
706,9.315250000000379,2476.777777777778,22,7,45,29
707,4.778750000000655,4630.6,43,22,47,65
708,19.008250000000388,3537.684210526316,35,16,56,51
709,0.43750000000068595,4085.45,21,14,53,35
710,10.181000000000493,2473.222222222222,31,6,42,37
711,12.899750000000102,2279.1666666666665,24,16,63,40
712,2.546500000000441,2941.4444444444443,30,14,33,44
713,19.3447500000004,3544.3684210526317,33,8,50,41
714,14.955250000000182,2504.705882352941,37,18,54,55
715,-1.1487499999995043,2163.6666666666665,29,5,48,34
716,0.4190000000007984,2500.4444444444443,34,8,32,42
717,4.68300000000071,2757.0,26,20,41,46
718,20.375500000000503,2719.222222222222,28,15,49,43
719,5.57225000000042,2050.125,22,16,34,38
720,7.032000000000279,3239.4210526315787,24,17,40,41
721,-7.547999999999749,2406.5789473684213,25,7,34,32
722,24.307000000000794,3332.2105263157896,31,14,40,45
723,6.049750000000114,1429.0,8,9,40,17
724,7.83625000000058,2332.0,22,17,42,39
725,20.684750000000925,3671.15,34,10,48,44
726,6.097000000000464,3353.0526315789475,24,17,38,41
727,-9.173249999999518,2684.0,29,12,25,41
728,6.895000000000556,4302.1,41,16,49,57
729,-6.618999999999495,2271.157894736842,27,9,25,36
730,1.4115000000002853,2038.0526315789473,14,11,38,25
731,-6.938999999999631,2488.4736842105262,22,8,33,30
732,18.021000000000683,2878.5789473684213,35,15,34,50
733,0.9150000000003773,1429.0,8,15,52,23
734,17.89150000000137,5041.75,42,11,51,53
735,-0.06099999999947044,2501.0,31,13,38,44
736,11.60375000000067,2228.294117647059,17,12,57,29
737,8.58575000000066,3365.7,34,8,40,42
738,0.43150000000034094,4132.2,30,18,30,48
739,13.081500000000464,2782.0,33,14,45,47
740,-5.395249999999605,2515.9411764705883,31,17,24,48
741,20.777250000001185,4297.9473684210525,39,18,65,57
742,-2.7437499999994315,2491.1,16,8,48,24
743,1.8862500000004807,2865.55,19,11,36,30
744,8.841750000000719,3021.25,30,12,33,42
745,8.331250000000711,2834.65,27,7,37,34
746,-8.15874999999993,3155.8947368421054,7,24,47,31
747,9.72175000000048,2246.625,21,10,35,31
748,8.29175000000031,3421.5263157894738,29,19,46,48
749,-7.708749999999587,2350.5263157894738,16,12,37,28
750,0.17725000000050384,2794.1666666666665,25,20,48,45
751,7.0075000000005065,2235.823529411765,27,9,28,36
752,18.052000000000643,2719.470588235294,29,19,46,48
753,2.3985000000003454,3393.2105263157896,36,14,38,50
754,-2.3499999999994783,2164.8823529411766,28,5,40,33
755,2.3775000000003113,2139.8888888888887,18,7,39,25
756,6.850000000000859,3713.2,30,12,37,42
757,9.350250000000056,2763.3888888888887,31,7,45,38
758,-7.202749999999783,1904.2941176470588,3,15,61,18
759,3.702000000000686,3111.684210526316,35,13,34,48
760,-2.774999999998892,3809.157894736842,38,7,39,45
761,7.20875000000112,4202.85,37,21,31,58
762,11.384250000000762,2778.294117647059,44,15,45,59
763,6.604750000000374,2603.722222222222,23,7,36,30
764,1.3780000000001278,2558.5789473684213,18,13,49,31
765,2.4932500000002866,3133.05,20,14,36,34
766,-4.123749999999169,2056.5882352941176,20,12,48,32
767,12.2990000000003,2730.6111111111113,17,14,58,31
768,2.616750000000673,4018.0,35,8,56,43
769,-3.5994999999997015,2318.8947368421054,24,7,28,31
770,3.1215000000001845,2693.6111111111113,12,14,57,26
771,11.066500000000564,4122.75,31,15,40,46
772,16.318250000000532,3925.1,37,7,41,44
773,0.11575000000066989,2388.157894736842,17,16,42,33
774,-2.824499999999282,2515.8823529411766,34,16,43,50
775,15.703500000000664,3965.65,39,18,43,57
776,3.72325000000066,3240.25,26,12,35,38
777,5.595500000000291,2855.1052631578946,20,14,39,34
778,16.835250000000592,3743.35,27,9,58,36
779,14.585750000000882,3886.95,27,16,53,43
780,12.663500000000711,2586.25,23,11,40,34
781,0.32450000000004864,2195.3888888888887,7,11,60,18
782,-3.9699999999994127,2198.529411764706,22,10,38,32
783,-13.941999999999283,2281.8333333333335,29,10,24,39
784,12.031250000000599,3974.35,25,18,50,43
785,13.068500000000626,3846.7,38,9,38,47
786,10.675250000000462,3525.2,25,12,51,37
787,16.432499999999994,3999.6666666666665,35,27,51,62
788,-0.6732499999991448,2502.277777777778,23,7,53,30
789,5.494250000000547,2804.9473684210525,25,9,47,34
790,7.732750000000651,4186.95,38,13,33,51
791,9.908500000000284,2975.4210526315787,24,14,33,38
792,6.696500000000524,3171.85,23,17,32,40
793,6.895750000000751,1867.8823529411766,13,9,46,22
794,-0.706249999999385,2669.8333333333335,29,6,45,35
795,11.845750000000516,2989.8888888888887,23,13,47,36
796,14.727000000000576,2716.5,32,9,38,41
797,10.737750000000904,2242.5625,26,13,49,39
798,13.0697500000004,2997.2105263157896,28,10,48,38
799,13.352000000000544,3250.5,30,10,34,40
800,-3.7627499999994525,2779.1666666666665,17,16,51,33
801,-2.320999999999504,2178.4210526315787,30,6,22,36
802,13.244250000000722,2647.529411764706,30,18,34,48
803,12.518250000000494,2274.0588235294117,20,13,45,33
804,9.569500000000435,2571.8823529411766,29,17,37,46
805,12.866500000000325,1732.5625,25,12,54,37
806,-2.1497499999996297,3084.0526315789475,19,25,43,44
807,0.3422500000003571,2697.2631578947367,21,7,38,28
808,21.824750000000662,2318.125,33,16,39,49
809,11.83100000000077,4148.2,37,11,53,48
810,0.10700000000019758,2146.176470588235,20,15,45,35
811,11.350750000001069,3363.25,42,12,44,54
812,6.070750000000461,2574.6111111111113,33,9,35,42
813,0.5372500000002789,2433.705882352941,16,15,59,31
814,-7.632999999999498,2204.4210526315787,19,8,35,27
815,9.565000000000712,2643.3,32,8,26,40
816,9.895000000001053,3246.0526315789475,33,15,37,48
817,3.889750000000293,2439.722222222222,25,7,40,32
818,11.47625000000099,3252.9473684210525,50,9,23,59
819,-3.612249999999462,2600.1111111111113,21,11,45,32
820,3.048750000000284,2210.3333333333335,24,11,42,35
821,3.510750000000363,2291.2631578947367,9,12,49,21
822,16.784000000001086,3239.4210526315787,36,14,50,50
823,4.306250000000842,2571.1111111111113,30,9,39,39
824,6.82250000000135,3244.8888888888887,39,17,32,56
825,18.03500000000061,3287.0555555555557,32,11,48,43
826,1.1820000000004245,2044.15,21,5,35,26
827,24.359000000000375,3190.85,24,18,38,42
828,-1.5357499999995758,2664.8,23,8,26,31
829,4.904250000000095,2618.7894736842104,17,12,50,29
830,3.679250000000702,2497.6315789473683,23,10,38,33
831,-3.542499999999857,1853.8823529411766,6,15,57,21
832,-1.318999999999543,2250.1111111111113,21,6,40,27
833,8.760500000000215,2282.722222222222,36,9,42,45
834,9.145750000000708,3066.764705882353,33,13,45,46
835,3.019250000000812,2644.15,32,4,33,36
836,4.544500000000304,2178.6111111111113,22,13,37,35
837,5.539750000000522,3053.157894736842,33,12,33,45
838,0.7257500000001507,2289.0588235294117,26,12,39,38
839,0.04350000000033013,2267.6666666666665,15,15,68,30
840,28.421000000000355,3771.684210526316,33,14,49,47
841,9.894500000000795,4010.9,34,21,50,55
842,0.8980000000007775,2623.0714285714284,34,7,42,41
843,9.58275000000073,3086.5789473684213,35,7,36,42
844,14.678000000000262,3192.5,18,15,50,33
845,12.414000000001066,2807.0,37,12,65,49
846,9.592250000000474,2803.470588235294,33,14,39,47
847,5.220000000000124,2456.6315789473683,13,7,50,20
848,22.10225000000039,1523.25,33,17,56,50
849,5.466750000000312,2906.1111111111113,17,18,57,35
850,-7.900499999999238,2374.8823529411766,32,7,23,39
851,7.78600000000047,3691.0,34,20,32,54
852,2.861000000000519,2317.8888888888887,21,11,33,32
853,1.5605000000003293,2490.8947368421054,15,14,50,29
854,22.005750000000738,2568.3888888888887,45,10,39,55
855,3.7177500000004122,2286.176470588235,22,14,55,36
856,11.637500000000509,3036.3,30,7,36,37
857,19.41525000000047,2635.529411764706,33,16,42,49
858,-7.053249999999307,2582.0,26,15,24,41
859,-9.139749999999648,2347.3684210526317,20,13,30,33
860,23.488500000001018,2707.294117647059,38,15,40,53
861,8.279000000000691,2478.3333333333335,29,11,31,40
862,1.2127500000006954,2412.3333333333335,26,13,34,39
863,3.5367500000005094,2513.176470588235,34,20,35,54
864,-4.962749999999988,1684.0,4,17,41,21
865,25.072250000001173,3457.277777777778,44,8,27,52
866,1.5940000000005388,2278.823529411765,28,9,32,37
867,11.151750000001613,3481.1111111111113,54,15,29,69
868,29.91850000000008,2967.1052631578946,40,11,57,51
869,0.09100000000082578,2249.0,36,12,50,48
870,5.488500000000332,2908.176470588235,34,17,34,51
871,7.712750000000481,3816.684210526316,28,21,29,49
872,-3.327749999999613,2252.6470588235293,23,21,48,44
873,21.327000000000663,2667.157894736842,29,8,39,37
874,15.079500000000536,4137.15,36,12,32,48
875,4.068000000000695,2610.95,29,12,25,41
876,5.301000000000469,2952.9444444444443,20,17,42,37
877,-3.622749999999539,2619.5263157894738,15,18,45,33
878,17.846250000000506,2846.1666666666665,31,19,33,50
879,22.605750000000175,1954.7058823529412,32,10,46,42
880,10.808250000000488,2732.315789473684,37,11,24,48
881,16.527250000000898,2593.470588235294,43,14,45,57
882,-2.3407499999996,2724.0,27,4,37,31
883,2.2087500000003883,2474.157894736842,38,7,22,45
884,23.98500000000108,3374.45,50,7,22,57
885,0.9570000000001434,1429.0,15,14,56,29
886,26.209500000001146,4088.55,47,17,28,64
887,5.936750000000758,2348.0,27,10,46,37
888,-10.856249999999351,2046.4736842105262,28,3,24,31
889,10.841000000000493,3167.6315789473683,28,14,32,42
890,-8.678999999999524,2054.0526315789475,19,12,31,31
891,9.857000000000774,4448.315789473684,28,24,56,52
892,-10.966749999999603,2033.9473684210527,20,10,29,30
893,12.715250000001227,4064.0526315789475,41,15,37,56
894,-10.573999999999268,2109.0,26,15,29,41
895,-4.456749999999561,2059.7894736842104,27,6,33,33
896,14.322500000000408,3139.35,21,14,49,35
897,4.6942500000005065,2985.3684210526317,30,8,32,38
898,4.3140000000005205,2219.75,30,10,37,40
899,5.876000000000568,2605.5882352941176,37,13,35,50
900,11.254750000000652,3523.4210526315787,33,9,46,42
901,13.680750000000483,2238.5555555555557,20,9,47,29
902,18.321250000001186,3858.4,47,13,28,60
903,13.919750000000908,2548.705882352941,33,18,48,51
904,8.94175000000044,2929.1111111111113,25,23,57,48
905,0.10875000000008188,2283.7368421052633,9,9,49,18
906,28.10825000000047,2121.5625,33,11,43,44
907,15.353250000000505,2030.3125,28,11,49,39
908,18.299750000000987,4218.7,31,14,46,45
909,16.545750000000332,3191.842105263158,28,11,48,39
910,26.760500000001098,4034.55,42,12,45,54
911,14.09025000000033,2342.235294117647,19,18,52,37
912,7.14875000000057,2883.5263157894738,35,9,32,44
913,14.303250000000432,1982.625,31,13,35,44
914,23.594750000000793,3919.4736842105262,30,19,61,49
915,4.891500000000126,1973.625,20,21,73,41
916,17.998000000000328,2824.315789473684,28,10,40,38
917,14.01475000000047,2169.315789473684,27,3,31,30
918,15.911250000000726,2794.235294117647,35,9,50,44
919,4.681500000000609,2857.5789473684213,26,8,50,34
920,5.107500000000522,2356.235294117647,22,11,42,33
921,-2.69249999999946,2408.5882352941176,15,15,54,30
922,8.31525000000061,2075.176470588235,14,9,48,23
923,8.765500000000634,2492.6666666666665,24,8,45,32
924,16.146000000001138,2763.294117647059,42,12,51,54
925,4.233750000000169,3667.2,22,13,61,35
926,1.6225000000010628,2576.3888888888887,34,13,36,47
927,16.521000000000136,2720.1111111111113,26,7,35,33
928,9.05400000000043,2306.6470588235293,22,12,43,34
929,19.038250000000787,3593.684210526316,42,9,43,51
930,26.460500000000934,3649.5555555555557,42,9,39,51
931,7.551750000000512,2412.294117647059,20,15,56,35
932,7.073750000000447,2899.705882352941,40,19,37,59
933,7.004000000000943,2753.0,27,12,32,39
934,21.248000000001035,3561.6,35,6,51,41
935,2.8437500000005524,2267.8947368421054,25,9,42,34
936,18.04475000000087,4099.894736842105,43,8,38,51
937,8.870000000000553,3116.7368421052633,35,7,33,42
938,13.596750000000617,1929.6470588235295,25,15,50,40
939,1.2772500000004758,3266.5,31,9,42,40
940,10.901750000000304,1916.1875,26,12,37,38
941,2.7757500000002695,2095.75,14,4,39,18
942,5.07650000000057,2776.5,30,12,30,42
943,24.025250000001428,2980.1176470588234,55,11,44,66
944,13.54275000000085,2067.9375,28,10,43,38
945,-3.4687499999997407,2235.8823529411766,26,11,54,37
946,6.022500000000473,2672.1052631578946,19,13,50,32
947,-0.059999999999142115,2281.529411764706,29,12,34,41
948,2.117250000000742,3569.6,35,10,32,45
949,21.09300000000074,3798.2,33,17,44,50
950,10.671500000000986,2970.5555555555557,33,13,43,46
951,16.400000000000936,2957.277777777778,30,17,64,47
952,0.3262500000006211,2928.684210526316,31,14,23,45
953,5.681750000000801,2361.9411764705883,26,11,45,37
954,9.983250000000067,1973.6875,32,25,52,57
955,-2.7922499999996897,2027.2631578947369,13,10,41,23
956,24.953750000000806,3677.45,37,16,37,53
957,16.478250000000415,2140.5882352941176,23,5,43,28
958,13.972750000000497,2366.5,37,29,54,66
959,30.348500000001216,4538.8,46,10,36,56
960,5.4520000000007,2588.8823529411766,40,17,37,57
961,13.941500000000463,3060.8,29,8,38,37
962,7.894000000000638,2882.3333333333335,24,26,59,50
963,2.53850000000065,2659.6315789473683,26,13,30,39
964,25.980500000000934,3109.6875,40,16,51,56
965,4.349750000000845,2852.0588235294117,41,9,35,50
966,21.853000000000417,3913.1666666666665,42,26,38,68
967,23.383500000000925,3597.0,41,11,42,52
968,5.107500000000604,2670.6111111111113,28,16,35,44
969,13.214250000000186,2269.5,33,11,62,44
970,32.17825000000099,2610.176470588235,34,9,46,43
971,10.047500000001083,3426.5,38,12,42,50
972,27.391500000000896,3061.5789473684213,31,9,54,40
973,18.893000000000477,2072.3529411764707,23,14,66,37
974,7.320750000000368,2676.3684210526317,12,11,52,23
975,15.95225000000076,2425.470588235294,38,8,32,46
976,10.900000000000357,2054.0625,40,14,49,54
977,35.44425000000156,4265.6,53,6,34,59
978,5.786000000000306,2317.8888888888887,19,14,45,33
979,0.8685000000003429,2233.3333333333335,23,11,35,34
980,11.584250000000221,3610.315789473684,18,16,49,34
981,5.522500000000786,2937.05,30,13,24,43
982,16.407750000000938,2478.6875,31,24,44,55
983,7.571250000000502,2888.5263157894738,18,25,66,43
984,28.141250000000365,3197.529411764706,38,11,32,49
985,-4.80649999999974,2274.176470588235,27,6,21,33
986,-9.472749999999618,2109.1052631578946,21,14,23,35
987,7.044250000000913,2843.214285714286,34,11,38,45
988,17.25175000000087,4140.105263157895,34,27,38,61
989,14.384000000000901,3824.2631578947367,50,6,30,56
990,13.190750000000438,2471.1052631578946,28,10,41,38
991,10.316000000000884,2148.733333333333,37,14,29,51
992,16.311500000000606,3537.8,27,18,34,45
993,8.911750000001275,3705.25,42,10,53,52
994,9.270750000000469,3421.5263157894738,30,19,38,49
995,3.283250000000738,2514.823529411765,24,18,44,42
996,9.37950000000025,2343.235294117647,24,13,41,37
997,14.137000000000583,3089.9473684210525,26,15,28,41
998,6.817749999999964,1723.6875,10,15,47,25
999,25.773250000000626,2766.777777777778,36,11,40,47
1000,13.393750000000594,2935.4210526315787,29,10,37,39
1001,17.00250000000045,3452.1,33,11,36,44
1002,22.229750000000845,3819.6,34,18,38,52
1003,-0.7679999999992471,3140.0,39,10,27,49
1004,10.60025000000053,2344.176470588235,26,9,39,35
1005,8.294500000000797,2711.65,30,8,33,38
1006,6.638250000000265,2273.0588235294117,20,19,29,39
1007,17.477750000000647,2822.5555555555557,41,13,55,54
1008,14.49725000000058,2927.842105263158,31,10,43,41
1009,-3.507249999999645,2120.3,25,7,25,32
1010,6.733750000000235,3479.1,31,14,38,45
1011,11.430500000000832,2679.05,29,5,41,34
1012,7.608000000000939,2323.5882352941176,34,11,31,45
1013,4.489000000000859,3683.15,50,11,20,61
1014,-0.7137499999996681,2029.7368421052631,27,7,27,34
1015,-6.953999999999195,2627.0526315789475,38,12,21,50
1016,-3.8319999999993875,2671.315789473684,34,10,27,44
1017,16.06175000000078,2532.222222222222,28,17,46,45
1018,29.524500000000604,3068.4444444444443,28,18,55,46
1019,4.128750000000062,3053.1052631578946,13,18,42,31
1020,1.1175000000008295,2551.470588235294,22,15,39,37
1021,-0.6234999999999803,2059.294117647059,23,23,42,46
1022,0.1867500000002209,1952.0,14,14,34,28
1023,19.32125000000136,3704.7368421052633,38,16,44,54
1024,21.437250000000436,4038.6,39,17,41,56
1025,-0.07999999999881116,4074.8947368421054,38,18,28,56
1026,15.297750000000827,2684.0526315789475,32,12,34,44
1027,6.7625000000004025,2721.8888888888887,26,13,42,39
1028,13.029250000000843,2633.842105263158,32,8,34,40
1029,11.695500000000841,2839.1111111111113,45,11,34,56
1030,7.343750000000744,2924.785714285714,42,4,29,46
1031,32.08725000000033,4215.263157894737,43,20,51,63
1032,15.596250000000584,2809.1666666666665,34,13,37,47
1033,3.076250000001448,3399.8947368421054,43,11,38,54
1034,19.413500000000965,3711.1666666666665,46,9,46,55
1035,14.744750000000824,2616.0,22,19,64,41
1036,16.58475000000072,2469.8125,43,13,35,56
1037,6.780500000000404,2497.0,29,10,26,39
1038,13.292250000000706,2732.529411764706,37,14,26,51
1039,12.504500000000307,2639.176470588235,31,10,51,41
1040,7.842250000000645,2521.705882352941,27,14,40,41
1041,-1.214499999999527,2222.684210526316,17,10,45,27
1042,10.427000000000508,2643.7368421052633,26,11,38,37
1043,-8.497999999999767,2017.3529411764705,18,11,41,29
1044,16.525500000000683,2613.6315789473683,33,12,45,45
1045,8.022750000000402,2840.1052631578946,17,19,53,36
1046,26.089250000000163,2941.4444444444443,26,12,74,38
1047,12.361750000000626,2727.315789473684,38,7,30,45
1048,5.777500000000497,2884.3684210526317,27,18,41,45
1049,1.8110000000008537,2582.5,34,14,29,48
1050,22.153250000000565,3544.4736842105262,46,12,28,58
1051,10.408750000000145,2457.733333333333,49,19,37,68
1052,14.572250000000588,3169.65,33,11,35,44
1053,19.137250000000538,2907.0,44,23,53,67
1054,-1.9050000000000307,1429.0,3,10,53,13
1055,-4.5414999999994325,3480.222222222222,36,29,62,65
1056,1.8047500000003045,1680.0625,9,10,54,19
1057,17.8095000000004,2643.5,25,7,39,32
1058,35.425750000000605,2966.75,35,12,41,47
1059,11.053750000001223,3826.7,50,11,34,61
1060,-2.467499999999558,2192.6111111111113,17,14,59,31
1061,17.42825000000092,4158.45,25,5,57,30
1062,1.1457500000002419,2183.0,28,9,35,37
1063,4.544750000000231,1673.7058823529412,10,11,40,21
1064,11.819250000000665,2509.4375,33,17,41,50
1065,9.601250000000235,2087.4210526315787,17,9,45,26
1066,-4.007749999999507,2636.3333333333335,33,18,48,51
1067,4.605000000000463,3556.0,25,14,46,39
1068,-3.750249999999678,2028.611111111111,14,17,36,31
1069,8.985500000000235,2108.0555555555557,16,11,55,27
1070,20.955500000001038,3159.2631578947367,34,11,39,45
1071,26.916750000000878,3735.35,43,12,32,55
1072,12.318000000000179,2746.4444444444443,25,26,59,51
1073,18.419750000000878,4094.842105263158,39,17,60,56
1074,5.473500000000473,1997.2631578947369,17,8,52,25
1075,17.049500000001082,3121.4444444444443,37,18,31,55
1076,-4.555749999999185,2283.6315789473683,28,12,28,40
1077,11.710750000000823,2836.5555555555557,28,15,54,43
1078,25.926750000001476,2804.4117647058824,44,14,43,58
1079,28.592250000000654,3498.2,47,11,41,58
1080,6.968750000000564,3783.75,21,23,39,44
1081,2.0290000000019592,3143.4375,58,7,31,65
1082,10.806250000000444,2888.5789473684213,29,11,34,40
1083,-0.542499999999413,2806.85,27,9,32,36
1084,8.70700000000012,2064.0588235294117,20,14,42,34
1085,8.27075000000089,3104.0526315789475,39,9,30,48
1086,20.940000000000314,3467.5789473684213,27,23,46,50
1087,11.527000000000474,3698.9,25,10,48,35
1088,11.75375000000074,2680.294117647059,35,7,34,42
1089,11.768250000000664,4080.75,27,24,39,51
1090,20.684750000000427,2139.5882352941176,21,20,41,41
1091,-2.9269999999999845,1941.6470588235295,23,15,41,38
1092,16.850000000000335,2275.3684210526317,20,10,57,30
1093,12.074250000000378,3085.1111111111113,19,24,58,43
1094,7.855500000000335,3039.4,21,14,40,35
1095,32.091250000001864,4513.2,61,9,25,70
1096,5.499250000000222,2778.222222222222,29,18,34,47
1097,20.44400000000076,2473.0,44,17,46,61
1098,18.461750000000603,2890.529411764706,36,5,44,41
1099,27.60750000000065,3203.3888888888887,35,25,34,60
1100,3.306750000000798,2605.2105263157896,36,8,27,44
1101,16.60575000000066,3448.315789473684,29,21,57,50
1102,18.296750000000408,2496.294117647059,37,19,39,56
1103,30.43750000000146,3827.6111111111113,54,14,38,68
1104,12.08125000000055,4273.55,41,9,37,50
1105,-2.994499999999584,2598.875,36,9,34,45
1106,19.609000000000748,2241.5,42,13,35,55
1107,11.414750000000819,2899.4210526315787,31,14,50,45
1108,12.94425000000069,2914.4210526315787,26,13,59,39
1109,11.44625000000113,4052.3684210526317,35,19,39,54
1110,14.276500000001183,3156.722222222222,45,12,27,57
1111,15.103750000000952,4490.95,36,12,40,48
1112,7.39250000000073,2437.0555555555557,27,10,49,37
1113,4.925500000000808,2503.0,32,15,26,47
1114,23.325250000000757,3477.55,36,12,28,48
1115,17.24700000000124,3541.7894736842104,49,13,36,62
1116,13.041250000000607,3257.65,34,17,24,51
1117,10.27225000000082,3718.7,46,7,26,53
1118,18.039500000001127,2148.0588235294117,35,14,53,49
1119,8.827250000000394,2781.8888888888887,33,8,37,41
1120,6.661750000000384,2521.529411764706,36,9,35,45
1121,14.41750000000051,3312.157894736842,28,14,40,42
1122,5.769499999999756,1429.0,18,30,67,48
1123,8.771000000000598,2821.5555555555557,37,14,36,51
1124,3.7577500000007378,2748.2,29,10,36,39
1125,12.153500000001337,2774.6666666666665,36,13,38,49
1126,7.070250000001049,3017.4444444444443,38,16,31,54
1127,7.528250000000655,2938.133333333333,33,12,27,45
1128,27.751500000001016,4017.2105263157896,45,12,29,57
1129,11.604750000001033,2634.6111111111113,34,9,31,43
1130,5.722250000000468,2050.0588235294117,22,9,33,31
1131,12.151500000000437,3666.4,33,14,34,47
1132,12.68750000000092,2856.842105263158,26,13,45,39
1133,25.6792500000007,3028.722222222222,37,11,43,48
1134,2.1100000000004533,3985.4210526315787,25,29,45,54
1135,-6.92974999999949,2104.4,28,11,19,39
1136,1.5797500000005997,2147.8333333333335,26,17,48,43
1137,25.387000000000434,3254.4444444444443,34,13,56,47
1138,16.433750000001417,4215.75,51,10,22,61
1139,20.213500000000266,2970.315789473684,28,15,32,43
1140,9.755500000000271,2860.9473684210525,23,13,57,36
1141,-0.5804999999992534,2150.25,32,9,34,41
1142,6.005500000000401,1429.0,7,13,40,20
1143,11.934750000000511,2533.823529411765,32,9,26,41
1144,-4.2682499999996075,2266.8333333333335,17,18,40,35
1145,10.2057500000007,1976.235294117647,29,11,38,40
1146,17.198000000001247,2702.875,50,12,47,62
1147,6.6370000000006595,3170.7894736842104,21,24,42,45
1148,13.604250000000576,2678.8947368421054,32,8,34,40
1149,11.93475000000052,2404.3125,34,11,22,45
1150,2.394250000000762,2235.1111111111113,26,15,33,41
1151,9.425250000000549,2733.4444444444443,29,17,29,46
1152,13.304500000000527,2654.235294117647,37,11,38,48
1153,8.629250000000535,2743.0,35,7,54,42
1154,6.446500000000756,2757.4210526315787,27,10,39,37
1155,16.637250000000737,3103.722222222222,38,12,26,50
1156,0.5245000000004916,3330.4736842105262,29,27,40,56
1157,-7.21374999999956,2237.777777777778,23,9,29,32
1158,-7.107749999999122,2139.2105263157896,24,10,37,34
1159,14.469500000001066,2510.222222222222,34,11,49,45
1160,16.47000000000046,3130.842105263158,31,11,28,42
1161,18.94875000000116,3500.6111111111113,50,21,46,71
1162,-7.386499999999723,2043.9473684210527,22,4,32,26
1163,8.004000000000989,2428.235294117647,30,8,27,38
1164,25.23750000000083,3284.5,44,13,27,57
1165,33.719000000000605,4560.05,43,14,40,57
1166,17.920500000001017,3802.5263157894738,39,14,30,53
1167,10.252000000000873,4327.5,36,19,33,55
1168,6.020500000000115,2579.8333333333335,25,10,40,35
1169,23.26975000000079,3577.8947368421054,39,12,39,51
1170,1.5252500000007854,2619.6111111111113,28,12,35,40
1171,13.140750000000304,2266.529411764706,23,15,39,38
1172,-0.9179999999991816,2533.4736842105262,36,13,18,49
1173,23.289500000000906,3174.25,36,14,39,50
1174,16.49050000000089,2606.75,36,22,32,58
1175,26.58250000000017,3071.8888888888887,34,14,38,48
1176,21.17675000000048,3370.5789473684213,34,13,38,47
1177,24.390750000000843,3986.15,46,9,33,55
1178,15.45275000000078,3870.8333333333335,39,15,40,54
1179,12.886500000001126,3146.0555555555557,31,18,42,49
1180,7.096500000000364,3371.9,29,7,54,36
1181,28.695750000000753,2375.5,38,21,45,59
1182,2.327750000000621,2828.315789473684,28,15,35,43
1183,7.162500000000852,2825.9,20,15,36,35
1184,11.01675000000065,3575.9,40,11,21,51
1185,6.714000000000941,3405.25,30,14,31,44
1186,22.471750000000736,2781.722222222222,38,13,31,51
1187,14.71425000000074,3161.0,34,13,31,47
1188,24.14750000000006,3670.5789473684213,36,16,35,52
1189,0.05675000000031927,2227.4117647058824,28,18,35,46
1190,14.435500000000653,3086.5263157894738,36,11,45,47
1191,11.935000000000835,2838.277777777778,33,18,39,51
1192,18.23075000000083,4345.75,28,19,49,47
1193,12.179500000000454,2882.8823529411766,39,15,22,54
1194,12.72000000000093,2513.176470588235,42,10,44,52
1195,21.73625000000126,4254.578947368421,55,13,37,68
1196,7.791250000000974,2347.75,37,10,51,47
1197,15.776000000001059,2528.9411764705883,40,12,31,52
1198,3.6227500000006385,2564.4736842105262,41,13,28,54
1199,6.132250000000434,2137.1,19,5,36,24
1200,-5.848749999999286,2028.7222222222222,30,6,41,36
1201,22.877000000000095,3025.764705882353,38,23,47,61
1202,9.485750000000785,2898.1666666666665,38,11,31,49
1203,0.03800000000042568,2077.222222222222,27,9,21,36
1204,8.4135000000007,2579.5882352941176,32,8,41,40
1205,20.294500000001026,4003.0,43,20,40,63
1206,-0.9729999999997091,1977.8947368421052,14,11,46,25
1207,15.426750000001388,4194.15,44,13,34,57
1208,8.818500000000672,3612.714285714286,28,16,41,44
1209,-6.33974999999964,1991.3157894736842,27,7,21,34
1210,24.159250000000736,4023.5,45,14,39,59
1211,27.643500000001886,4532.3,55,11,29,66
1212,20.230750000001066,4777.5,61,18,28,79
1213,9.907250000000557,2350.6470588235293,27,12,23,39
1214,19.54075000000111,2900.2631578947367,39,12,37,51
1215,17.479500000000566,2900.157894736842,29,15,39,44
1216,21.49075000000058,3722.75,26,19,47,45
1217,6.468500000000293,2344.1176470588234,34,13,32,47
1218,11.420750000000684,2982.2105263157896,29,13,29,42
1219,9.905000000000356,2867.85,24,10,39,34
1220,18.54150000000066,2991.176470588235,38,16,45,54
1221,5.32825000000082,3240.25,36,14,33,50
1222,28.49050000000118,2997.8333333333335,50,8,37,58
1223,5.0765000000007765,3316.277777777778,40,10,41,50
1224,3.7125000000006345,2627.157894736842,29,20,42,49
1225,16.431500000001215,2663.777777777778,46,8,38,54
1226,-0.47674999999969936,2186.6111111111113,17,6,39,23
1227,3.5945000000006084,2715.0,33,10,21,43
1228,13.59350000000072,2043.8666666666666,37,15,25,52
1229,21.16825000000089,2584.3888888888887,35,12,38,47
1230,4.365250000000514,2740.6315789473683,32,14,24,46
1231,18.31725000000132,4303.0,46,14,33,60
1232,-0.27674999999957184,2117.5263157894738,24,10,41,34
1233,23.725750000000946,4064.75,39,21,37,60
1234,19.469500000001123,2958.7894736842104,37,13,33,50
1235,1.0122500000007923,2876.277777777778,28,18,31,46
1236,38.603000000001416,5787.8,55,13,47,68
1237,10.375000000001108,2356.5625,33,15,44,48
1238,40.91675000000133,2955.9375,70,7,42,77
1239,15.187250000000663,2405.3888888888887,28,17,45,45
1240,12.511000000000358,2099.277777777778,26,7,26,33
1241,4.708750000000511,2543.0588235294117,30,13,44,43
1242,8.588000000000587,2543.5263157894738,25,11,29,36
1243,9.557750000000805,2737.6666666666665,45,10,35,55
1244,28.377750000000624,3907.7368421052633,47,20,58,67
1245,30.56950000000013,2790.6111111111113,44,11,54,55
1246,5.383000000000353,2157.6315789473683,24,4,31,28
1247,13.56500000000086,3787.0555555555557,37,23,28,60
1248,12.457000000000644,2972.529411764706,40,13,31,53
1249,2.3565000000007905,2736.470588235294,26,17,54,43
1250,8.90525000000039,2103.75,30,14,41,44
1251,15.140000000001171,3221.9444444444443,41,18,28,59
1252,24.00650000000075,3153.1111111111113,39,13,37,52
1253,-8.157999999999523,1958.4117647058824,26,7,32,33
1254,-2.5657499999995026,2037.0,20,14,57,34
1255,9.777500000000774,2950.0588235294117,40,18,40,58
1256,6.330750000000685,2749.625,30,10,35,40
1257,-5.536499999999302,1988.4117647058824,25,16,49,41
1258,-0.7667499999995535,2589.6111111111113,20,16,56,36
1259,25.211500000000694,3220.5,39,7,46,46
1260,5.246250000000552,2373.0,27,11,29,38
1261,2.3802500000004048,2119.5555555555557,21,10,38,31
1262,15.936000000001115,2604.6470588235293,36,4,47,40
1263,1.3575000000007382,2633.6666666666665,33,7,23,40
1264,22.473000000001225,2210.875,39,13,49,52
1265,2.0480000000005667,2858.45,27,9,33,36
1266,23.265250000001053,2601.9411764705883,38,7,35,45
1267,-5.896249999999557,2883.85,31,9,25,40
1268,11.022750000000727,3316.1176470588234,31,17,34,48
1269,13.025750000000295,2587.705882352941,19,22,50,41
1270,37.994250000001855,3119.1176470588234,50,9,51,59
1271,9.478750000000753,2711.222222222222,33,10,31,43
1272,53.145000000001346,5241.8,59,13,57,72
1273,2.874000000000745,2137.764705882353,33,11,31,44
1274,22.77725000000071,4194.2,38,15,37,53
1275,18.57150000000079,2527.3125,34,18,41,52
1276,14.695250000000636,2798.823529411765,40,19,50,59
1277,8.237250000000458,2736.5789473684213,29,8,33,37
1278,1.7330000000004007,2179.315789473684,21,11,33,32
1279,22.552000000000593,4793.3,44,26,39,70
1280,7.989250000000216,2664.294117647059,25,26,45,51
1281,10.902500000000314,2995.0,20,10,43,30
1282,26.002000000000532,3644.5263157894738,36,19,35,55
1283,36.019750000000755,4008.4,42,8,51,50
1284,12.023250000001,2686.0,35,14,34,49
1285,15.641250000000943,2806.4117647058824,39,13,38,52
1286,-0.05199999999913363,2972.3888888888887,38,4,32,42
1287,30.204750000001194,2900.375,42,12,46,54
1288,8.208250000000723,3059.842105263158,27,13,46,40
1289,19.14950000000058,3777.45,25,20,43,45
1290,13.102250000000765,3063.95,37,12,21,49
1291,8.001500000000176,2202.176470588235,27,24,39,51
1292,3.0937500000005977,2455.6111111111113,26,13,51,39
1293,28.736750000001166,4090.1,56,8,27,64
1294,-1.8882499999993954,2269.5,24,17,36,41
1295,1.567250000000136,1907.3125,23,17,43,40
1296,11.678250000001018,2302.1875,35,7,27,42
1297,1.9377500000007246,2554.5263157894738,36,5,33,41
1298,27.847500000001293,2844.5882352941176,45,10,33,55
1299,13.400250000000586,3357.6,27,14,47,41
1300,12.570250000000826,3637.95,37,12,35,49
1301,-4.48849999999924,2368.157894736842,23,10,28,33
1302,29.97375000000065,3756.5789473684213,53,8,47,61
1303,3.4830000000001897,2042.5882352941176,23,23,40,46
1304,4.3947500000003865,2554.0,23,23,39,46
1305,13.137250000000444,3326.3684210526317,41,15,60,56
1306,12.347500000000903,3028.45,44,6,20,50
1307,13.906250000000767,3510.9473684210525,33,15,50,48
1308,3.8015000000008348,2765.65,28,12,30,40
1309,35.56475000000146,4326.7,60,9,33,69
1310,26.266500000000395,2571.9411764705883,39,14,39,53
1311,-7.559499999999225,2356.9,27,8,23,35
1312,16.058750000000945,3247.5,42,7,37,49
1313,17.209000000001463,4056.85,52,11,28,63
1314,15.651750000000675,3245.4210526315787,36,8,55,44
1315,3.4722500000009817,2500.9473684210525,36,10,25,46
1316,-8.358249999999803,1576.875,2,13,63,15
1317,10.670000000000702,3417.3684210526317,42,13,24,55
1318,7.5995000000015995,3918.8,51,11,31,62
1319,5.4415000000009,3110.8947368421054,40,13,26,53
1320,18.24500000000125,3152.277777777778,45,11,31,56
1321,8.655750000000683,2861.842105263158,37,6,30,43
1322,9.224000000000302,2139.8333333333335,20,9,49,29
1323,21.255750000000678,3158.3684210526317,42,22,31,64
1324,2.8275000000005863,2929.0,47,31,38,78
1325,7.500750000000927,3014.0,32,9,36,41
1326,-3.621249999999575,2108.4,22,10,29,32
1327,22.04375000000096,3292.157894736842,41,13,30,54
1328,15.742500000000282,2798.823529411765,37,21,35,58
1329,1.8672500000002912,4346.55,13,30,56,43
1330,34.85375000000102,4360.0,51,19,39,70
1331,25.959250000000953,3303.0588235294117,50,13,28,63
1332,1.4682500000003107,2242.1111111111113,19,16,37,35
1333,15.022500000000969,3335.5,41,7,30,48
1334,0.6895000000004742,2486.4444444444443,25,15,26,40
1335,16.696250000000738,3402.4210526315787,31,16,48,47
1336,10.790000000000823,2985.4210526315787,36,8,36,44
1337,16.93725000000088,3394.6666666666665,55,14,41,69
1338,18.3032500000004,3544.6666666666665,32,18,63,50
1339,4.357500000000425,2205.9444444444443,23,6,44,29
1340,15.539500000000473,3036.95,19,10,44,29
1341,-1.9102499999997178,2082.5555555555557,22,7,37,29
1342,17.25300000000105,3724.0526315789475,48,4,38,52
1343,16.928500000000874,3546.65,38,8,39,46
1344,17.44175000000043,3519.6,39,5,36,44
1345,-2.406249999998834,2415.0588235294117,34,15,30,49
1346,9.1807500000008,2791.0,29,9,38,38
1347,15.216750000001179,2723.9375,37,11,29,48
1348,22.806250000001224,2793.3529411764707,37,16,50,53
1349,12.261000000000507,2601.4,28,7,32,35
1350,28.41250000000104,1987.6875,35,11,53,46
1351,14.484000000000439,3807.75,32,19,38,51
1352,-6.693999999999744,2028.7222222222222,21,9,48,30
1353,30.467500000001433,3283.4117647058824,57,15,45,72
1354,18.06025000000065,3008.5,42,21,40,63
1355,-1.193749999999591,2269.5789473684213,20,9,31,29
1356,6.55400000000062,2589.4736842105262,33,14,27,47
1357,20.409250000000675,5082.25,53,14,29,67
1358,5.0300000000003875,2331.4210526315787,18,13,49,31
1359,7.669750000000823,3232.25,45,6,30,51
1360,21.45175000000098,3215.3333333333335,33,12,42,45
1361,19.372500000000635,2357.235294117647,27,11,37,38
1362,18.297500000000877,2681.3333333333335,38,12,45,50
1363,-2.445499999999495,2824.2105263157896,27,15,34,42
1364,12.510250000000111,1837.0588235294117,14,10,66,24
1365,8.698000000000397,2786.222222222222,25,5,49,30
1366,7.523750000000523,2709.7368421052633,16,19,57,35
1367,9.477750000000764,2800.6666666666665,36,15,17,51
1368,20.557000000001175,3804.45,39,16,43,55
1369,13.334250000000788,2688.5882352941176,33,16,35,49
1370,13.456000000000737,2850.8947368421054,28,15,35,43
1371,33.56100000000122,4836.2,64,13,36,77
1372,10.776000000000597,2333.0,33,13,72,46
1373,1.9597500000003099,2280.4210526315787,23,6,35,29
1374,22.735500000001377,3800.9473684210525,48,9,44,57
1375,9.855750000000608,2604.45,26,8,33,34
1376,7.362000000001098,2159.235294117647,30,10,41,40
1377,22.225250000000894,4518.7,47,14,38,61
1378,25.929000000001075,3659.684210526316,46,17,35,63
1379,24.737249999999992,3902.9,33,17,41,50
1380,8.210000000000097,2169.1875,29,15,24,44
1381,20.427000000000344,3592.157894736842,46,9,20,55
1382,-0.5444999999990519,2473.222222222222,35,4,29,39
1383,40.77025000000196,5155.8421052631575,68,20,31,88
1384,26.017250000001173,2766.3529411764707,37,9,54,46
1385,17.898500000000944,2760.8947368421054,37,8,30,45
1386,14.678750000001221,2434.5333333333333,41,16,42,57
1387,9.283500000000371,2467.8888888888887,26,9,45,35
1388,-5.7122499999990755,3424.1052631578946,39,10,41,49
1389,10.045500000000287,2450.5882352941176,21,28,42,49
1390,16.48250000000062,2298.4117647058824,29,12,40,41
1391,13.3195000000003,2644.3888888888887,24,15,48,39
1392,25.453750000000685,2475.764705882353,31,12,48,43
1393,3.6487500000007507,2737.15,28,8,36,36
1394,-0.6464999999994889,2116.0555555555557,24,12,34,36
1395,-1.151999999999259,2224.5,27,16,41,43
1396,5.342500000000694,2400.3125,37,16,26,53
1397,9.740750000000725,2789.1052631578946,28,19,38,47
1398,29.75075000000075,3413.2,31,5,56,36
1399,17.279000000000938,2571.1176470588234,39,11,47,50
1400,31.332750000000424,3059.6666666666665,35,18,57,53
1401,8.556000000000342,1639.375,11,13,65,24
1402,8.466500000000941,2501.9411764705883,31,16,40,47
1403,19.989500000000795,2678.7894736842104,31,10,34,41
1404,7.732500000000523,2852.1,30,14,25,44
1405,0.8202500000007852,2542.8333333333335,31,14,19,45
1406,6.663750000000505,1528.25,16,10,56,26
1407,14.080500000000324,2950.0588235294117,26,23,61,49
1408,7.368750000000132,3706.4210526315787,23,17,39,40
1409,33.27875000000069,3235.1666666666665,55,10,39,65
1410,17.09825000000078,2059.0625,39,6,48,45
1411,5.609000000000185,2185.3529411764707,32,12,44,44
1412,23.9180000000011,4182.35,47,13,39,60
1413,6.524250000000866,2506.5882352941176,30,8,34,38
1414,20.258250000001098,4129.9,49,10,35,59
1415,28.35350000000044,3034.8947368421054,26,11,60,37
1416,-3.8432499999998555,1429.0,9,17,40,26
1417,3.2855000000005132,2473.1666666666665,23,13,40,36
1418,19.384750000000658,2681.176470588235,31,19,41,50
1419,4.5235000000002845,2412.3333333333335,22,13,33,35
1420,43.62575000000102,3242.0526315789475,41,7,39,48
1421,30.01675000000062,4002.1666666666665,48,17,42,65
1422,8.116750000001375,2638.076923076923,40,13,36,53
1423,-6.6594999999994355,2087.0,26,7,24,33
1424,9.551750000000222,2373.2105263157896,16,16,60,32
1425,9.815250000000312,2128.5625,23,14,42,37
1426,31.67950000000069,3675.9,34,13,43,47
1427,8.587750000000705,2420.764705882353,32,14,45,46
1428,15.032750000000874,3225.529411764706,30,13,43,43
1429,10.998750000000282,2783.6111111111113,30,10,35,40
1430,7.2430000000004835,3727.55,37,15,32,52
1431,6.84500000000062,2280.4210526315787,25,9,39,34
1432,21.41300000000095,3059.6666666666665,41,15,45,56
1433,-2.4624999999995647,2653.8947368421054,33,10,32,43
1434,1.166500000000339,2520.8333333333335,31,9,42,40
1435,14.028250000000753,2627.4375,35,8,37,43
1436,39.75950000000097,4681.5,55,13,44,68
1437,15.559750000000623,3696.5263157894738,37,12,44,49
1438,16.540500000000815,3208.6315789473683,33,11,35,44
1439,33.01875000000082,3047.294117647059,54,7,57,61
1440,0.19850000000066975,2322.9473684210525,22,15,35,37
1441,-4.260999999999607,2055.6315789473683,19,9,27,28
1442,10.02650000000037,3058.5,27,8,38,35
1443,15.032500000001727,2930.0,42,15,64,57
1444,13.425750000000466,3494.85,29,17,28,46
1445,13.970750000000459,2553.4444444444443,32,9,51,41
1446,28.581000000001097,3718.1,43,8,43,51
1447,18.967250000001048,2922.1052631578946,36,11,30,47
1448,12.719000000000523,2473.1666666666665,25,9,40,34
1449,14.803500000000668,3683.0,43,11,40,54
1450,31.836500000001383,4200.210526315789,58,9,39,67
1451,25.092000000000645,3789.45,45,10,43,55
1452,9.116500000000539,2437.0555555555557,22,19,41,41
1453,27.731000000000698,3358.4444444444443,34,19,46,53
1454,13.516250000000294,2044.5555555555557,16,12,43,28
1455,4.127000000000435,2842.65,25,10,34,35
1456,14.319250000000732,2828.3,28,7,39,35
1457,1.8515000000009199,2776.4444444444443,36,14,40,50
1458,12.975750000000906,3573.6,35,11,39,46
1459,10.436500000001034,2467.5789473684213,32,6,38,38
1460,19.865000000001075,3379.9473684210525,32,14,45,46
1461,16.98950000000089,2623.4117647058824,28,13,49,41
1462,16.400500000000775,2795.6153846153848,38,12,28,50
1463,20.824500000001038,2832.0555555555557,39,13,46,52
1464,14.565750000000786,2550.315789473684,28,11,46,39
1465,12.2660000000014,4998.95,70,5,15,75
1466,6.70775000000112,2425.294117647059,32,5,26,37
1467,24.768499999999975,2824.0588235294117,38,37,64,75
1468,17.094250000000375,2191.0526315789475,26,5,59,31
1469,24.82275000000049,4065.5,38,10,43,48
1470,26.47400000000078,2879.1176470588234,40,20,40,60
1471,4.441250000000535,2520.2105263157896,32,9,29,41
1472,22.052750000000845,2826.764705882353,45,9,29,54
1473,11.093500000000814,2034.0588235294117,35,14,59,49
1474,24.256750000000885,4782.95,44,18,51,62
1475,1.8462500000006323,2837.176470588235,33,11,35,44
1476,11.744250000000351,3690.5789473684213,26,19,42,45
1477,26.097000000000758,3178.4736842105262,36,8,38,44
1478,16.674250000000903,2596.6111111111113,32,15,49,47
1479,24.817750000001492,4210.0,48,16,48,64
1480,1.0237500000006932,2515.8947368421054,34,12,19,46
1481,11.006250000001057,3004.8888888888887,37,14,28,51
1482,8.456000000000753,2607.75,35,8,23,43
1483,24.18125000000045,2735.8888888888887,30,20,54,50
1484,26.35450000000079,2593.6875,39,13,31,52
1485,-1.7344999999992126,2601.764705882353,37,18,63,55
1486,2.7180000000005555,2237.230769230769,23,17,29,40
1487,8.013250000000642,2698.0714285714284,31,14,31,45
1488,16.574500000000263,2261.0588235294117,28,11,42,39
1489,2.38575000000043,2853.5263157894738,33,13,22,46
1490,27.463750000000857,2973.1666666666665,43,13,51,56
1491,12.793250000000603,3625.1,41,15,32,56
1492,24.454500000001342,3813.4736842105262,45,12,46,57
1493,28.888250000000983,3429.0,60,26,37,86
1494,22.20700000000145,4149.8,50,9,31,59
1495,16.146000000001077,3405.5263157894738,35,15,41,50
1496,9.64300000000087,3061.0,33,17,45,50
1497,11.381250000000701,3317.157894736842,30,13,38,43
1498,-5.640499999999193,2619.6,37,16,26,53
1499,7.461750000000718,2948.866666666667,32,13,23,45
1500,14.231750000000767,2725.0714285714284,37,14,29,51
1501,-7.232749999999579,2348.5,26,12,17,38
1502,10.047250000000961,3479.3888888888887,47,15,28,62
1503,8.393500000001053,4043.1052631578946,45,19,38,64
1504,-5.08949999999954,2016.25,22,9,26,31
1505,10.085750000000901,2557.0,31,14,29,45
1506,22.031500000001028,3063.1111111111113,39,14,28,53
1507,33.74000000000075,3869.4210526315787,41,14,35,55
1508,34.037750000000955,4554.315789473684,55,19,47,74
1509,6.554000000000803,1996.8235294117646,21,17,61,38
1510,11.461500000000537,2611.2105263157896,32,7,44,39
1511,0.5382500000012289,2602.8333333333335,36,7,29,43
1512,6.0147500000001095,2872.6111111111113,11,15,47,26
1513,6.7777500000006174,3227.0,28,16,35,44
1514,8.834500000000293,2489.0555555555557,16,18,38,34
1515,13.049250000000262,2770.3888888888887,31,6,32,37
1516,30.246250000001048,2610.294117647059,42,16,46,58
1517,35.764500000001156,3945.05,50,8,34,58
1518,5.837750000000475,2032.3,17,6,38,23
1519,18.36900000000031,2384.4375,41,16,44,57
1520,17.154000000000615,2967.0526315789475,37,11,32,48
1521,12.887500000000992,3956.05,41,12,38,53
1522,13.522750000000784,2552.0526315789475,28,12,38,40
1523,25.41975000000084,3470.842105263158,32,11,65,43
1524,18.012250000000815,2360.625,33,12,47,45
1525,19.083500000001244,3505.1052631578946,47,7,34,54
1526,30.84025000000122,4350.4,49,19,31,68
1527,4.23875000000053,2841.9444444444443,28,11,57,39
1528,18.685750000000244,2050.8823529411766,23,11,46,34
1529,-2.695249999999775,1941.388888888889,22,12,29,34
1530,20.2300000000013,2624.5625,47,11,33,58
1531,21.592000000000674,4817.473684210527,37,31,57,68
1532,1.0390000000007082,2917.842105263158,41,12,25,53
1533,11.366500000001057,2553.4117647058824,39,15,37,54
1534,24.003500000000873,4497.4,53,16,33,69
1535,25.543000000000724,4456.85,45,14,35,59
1536,34.177500000001565,5823.6,72,13,43,85
1537,3.5332500000003777,2112.5555555555557,21,9,36,30
1538,16.729250000000736,3753.7,30,9,51,39
1539,9.485250000000908,2508.6,32,9,31,41
1540,23.179250000000593,3658.0,35,17,34,52
1541,20.39000000000063,2912.3333333333335,36,23,39,59
1542,7.122500000000592,2742.315789473684,26,10,37,36
1543,-1.6474999999996816,2143.4736842105262,15,13,43,28
1544,24.72500000000081,2732.625,45,11,34,56
1545,-2.0764999999996374,2277.8947368421054,15,16,52,31
1546,4.430750000000094,1528.25,8,7,58,15
1547,3.4097500000004453,2603.0,30,12,28,42
1548,19.544750000000633,2929.5882352941176,43,12,49,55
1549,25.739750000001482,3025.222222222222,47,10,34,57
1550,28.607000000000784,3547.7368421052633,36,14,41,50
1551,12.275000000000302,2609.470588235294,24,13,37,37
1552,23.012000000000373,3138.65,28,9,47,37
1553,24.018500000000806,3310.75,31,13,47,44
1554,17.66275000000043,2741.6875,39,13,29,52
1555,-2.4737499999994284,2602.1,25,12,21,37
1556,34.93125000000143,4387.05,63,7,32,70
1557,-3.477499999999503,1986.2631578947369,24,9,30,33
1558,13.236500000000703,2436.222222222222,35,14,53,49
1559,23.340250000001006,5317.2,50,28,28,78
1560,24.935000000001757,3885.2631578947367,48,19,22,67
1561,19.216750000001774,3769.1052631578946,61,18,18,79
1562,25.704500000001293,4602.85,53,21,34,74
1563,38.568750000001366,4555.25,40,17,38,57
1564,0.22125000000057654,2116.6315789473683,29,2,32,31
1565,-6.5600000000000165,1429.0,0,9,41,9
1566,7.1630000000003,2101.470588235294,24,21,46,45
1567,-1.3737499999994485,2894.3076923076924,28,15,27,43
1568,3.080000000000593,2881.5,29,13,38,42
1569,19.008500000001007,3130.3333333333335,47,9,20,56
1570,15.914000000001039,3182.1666666666665,32,20,61,52
1571,38.82825000000087,5172.75,59,10,36,69
1572,21.181250000000865,2753.6666666666665,34,13,44,47
1573,11.921000000000477,2943.6470588235293,36,17,41,53
1574,24.715500000000215,2597.1176470588234,33,26,60,59
1575,20.15200000000062,4133.1,33,20,46,53
1576,17.157750000000622,2825.0,18,17,50,35
1577,15.585250000001134,2467.4117647058824,28,17,51,45
1578,13.699750000000765,2867.625,38,17,30,55
1579,21.097500000001215,3426.4444444444443,48,9,31,57
1580,13.074000000000456,2917.9333333333334,29,9,39,38
1581,17.82650000000077,2658.8823529411766,37,13,27,50
1582,18.297750000000836,3873.4736842105262,42,18,27,60
1583,18.814000000000348,3426.6315789473683,30,14,47,44
1584,20.947000000000497,3186.5,40,11,37,51
1585,3.741500000000895,2931.8,31,13,35,44
1586,9.955000000000858,2589.6470588235293,27,15,48,42
1587,6.449000000000315,2986.3888888888887,24,16,48,40
1588,11.70650000000035,2161.25,25,10,31,35
1589,33.26050000000116,3683.9411764705883,55,10,31,65
1590,18.1827500000007,2173.294117647059,32,12,36,44
1591,24.685250000000728,2467.3529411764707,44,9,33,53
1592,15.875000000000878,2980.8823529411766,40,15,36,55
1593,30.766000000001203,3130.9444444444443,36,13,54,49
1594,10.54775000000041,2528.6315789473683,28,9,31,37
1595,9.39950000000079,2414.0555555555557,29,9,36,38
1596,12.44275000000041,2864.315789473684,27,18,51,45
1597,3.067750000000504,2606.2105263157896,28,6,39,34
1598,19.647000000000553,3981.45,28,16,47,44
1599,15.551500000001102,3567.95,36,12,42,48
1600,28.11075000000062,2901.722222222222,39,11,71,50
1601,17.3457500000006,3116.6315789473683,27,10,50,37
1602,9.02375000000087,2534.3684210526317,33,10,50,43
1603,12.818000000000797,3017.3333333333335,37,17,41,54
1604,20.387750000000487,3846.842105263158,32,21,64,53
1605,13.210750000000544,2211.529411764706,26,11,44,37
1606,10.719250000000711,2430.0588235294117,28,19,45,47
1607,8.813250000000473,2522.5789473684213,31,6,33,37
1608,29.17350000000159,4553.631578947368,57,25,36,82
1609,30.137250000001238,3301.2631578947367,46,11,34,57
1610,8.059000000000593,2575.5555555555557,32,8,30,40
1611,42.61050000000172,3821.4444444444443,60,14,41,74
1612,27.29100000000084,3542.8888888888887,42,19,41,61
1613,21.842750000000688,4626.75,32,23,56,55
1614,5.620000000000336,2114.4117647058824,17,15,36,32
1615,26.380750000001022,4516.0526315789475,42,15,46,57
1616,21.95725000000134,4017.315789473684,46,12,48,58
1617,18.048250000000458,2765.176470588235,27,13,63,40
1618,8.92450000000029,2646.2631578947367,25,8,36,33
1619,24.968000000001215,2684.125,39,12,35,51
1620,18.891750000000698,2544.6666666666665,25,15,54,40
1621,20.23600000000028,2838.65,28,9,33,37
1622,20.89475000000122,3112.6470588235293,56,15,34,71
1623,7.4225000000003805,2150.45,15,14,37,29
1624,32.76600000000093,2362.6,56,15,42,71
1625,11.317000000001595,3061.5555555555557,56,9,19,65
1626,9.126750000000381,3279.15,32,11,30,43
1627,25.81125000000086,2968.0,28,15,35,43
1628,2.937000000000405,2019.0555555555557,15,14,41,29
1629,23.18900000000071,3088.157894736842,38,10,43,48
1630,5.2975000000005705,2320.823529411765,25,9,33,34
1631,4.693250000000286,2098.75,32,11,41,43
1632,11.984000000001096,3131.1111111111113,49,11,35,60
1633,-2.969249999999355,2023.388888888889,21,11,33,32
1634,2.9777500000005546,2538.5263157894738,18,13,52,31
1635,18.77850000000097,2618.6111111111113,36,19,53,55
1636,14.70600000000124,3679.0,46,12,50,58
1637,17.16100000000068,2926.157894736842,31,14,51,45
1638,12.738250000001116,3138.9444444444443,37,16,34,53
1639,-4.707000000000209,1429.0,11,23,60,34
1640,3.455000000000054,2002.2222222222222,11,8,45,19
1641,13.51675000000146,3894.4210526315787,45,17,39,62
1642,13.497000000000643,2592.8947368421054,25,13,39,38
1643,14.918500000000668,2881.5833333333335,32,9,40,41
1644,14.448250000001257,2489.705882352941,41,18,31,59
1645,23.406250000000718,3000.9166666666665,35,17,38,52
1646,29.64000000000122,2460.875,45,15,36,60
1647,5.424500000000409,2449.75,18,15,33,33
1648,15.370000000000434,2615.9444444444443,26,12,41,38
1649,21.00925000000173,2984.705882352941,55,11,37,66
1650,22.955500000000665,2672.3888888888887,32,17,39,49
1651,26.021500000000355,2815.5882352941176,32,16,45,48
1652,25.878750000002093,3703.3888888888887,59,13,33,72
1653,12.636500000000721,3155.9473684210525,38,12,30,50
1654,21.008250000000903,4101.35,41,16,30,57
1655,14.596500000000805,2524.294117647059,29,25,28,54
1656,9.142000000000698,2753.5714285714284,36,12,15,48
1657,10.092000000001278,3280.4210526315787,48,13,34,61
1658,12.394250000000758,3289.5,35,7,33,42
1659,62.56925000000085,6103.65,74,15,37,89
1660,11.757000000000847,2274.1176470588234,32,12,25,44
1661,17.157000000000764,3590.4444444444443,44,24,51,68
1662,32.9572500000017,3251.0,66,12,36,78
1663,5.407000000000901,2103.75,27,19,33,46
1664,12.573250000000591,3409.722222222222,35,24,34,59
1665,-3.5399999999996004,2102.315789473684,22,13,22,35
1666,14.012750000000562,3452.9,30,21,35,51
1667,42.23875000000101,4610.85,58,15,26,73
1668,16.17750000000118,3511.842105263158,49,11,35,60
1669,24.355000000000587,2678.6666666666665,41,22,48,63
1670,9.197250000001137,4227.55,36,24,30,60
1671,-0.8904999999991766,2503.222222222222,30,13,60,43
1672,13.040250000001077,3465.6,46,16,22,62
1673,-1.1769999999997853,2112.4,11,10,30,21
1674,9.267000000000872,3036.4210526315787,41,18,22,59
1675,12.234000000000801,2553.5789473684213,33,6,34,39
1676,-3.9894999999993224,1963.1176470588234,23,13,30,36
1677,33.2560000000009,3684.6,34,12,45,46
1678,22.340750000000572,4238.6,41,17,30,58
1679,22.354750000000696,3135.6,43,10,37,53
1680,17.48200000000045,3176.65,32,9,35,41
1681,23.501000000000694,2779.277777777778,35,20,41,55
1682,9.324000000000625,2871.9473684210525,33,16,24,49
1683,11.623000000000676,2610.294117647059,44,18,38,62
1684,23.827250000000845,3872.8,51,17,15,68
1685,25.238000000001207,2541.375,46,12,32,58
1686,6.239500000000517,2332.1111111111113,29,18,40,47
1687,21.261750000000497,2549.529411764706,42,9,24,51
1688,6.473000000000928,3113.25,36,6,42,42
1689,29.82375000000109,4117.473684210527,58,4,39,62
1690,23.61875000000199,3507.6111111111113,64,13,19,77
1691,1.5567500000002066,2376.5263157894738,20,11,29,31
1692,19.596250000000758,3798.15,29,14,45,43
1693,22.946500000001112,3306.6111111111113,39,19,31,58
1694,41.959250000001205,3504.9444444444443,51,14,36,65
1695,30.238750000001495,4258.4,41,25,41,66
1696,6.621750000001372,3167.277777777778,45,9,29,54
1697,8.128500000000646,2938.5789473684213,24,17,39,41
1698,13.269500000000772,2152.705882352941,26,12,31,38
1699,14.627250000000643,2020.8333333333333,24,14,47,38
1700,18.724250000001213,2893.235294117647,37,9,30,46
1701,12.092250000000176,2477.5263157894738,22,11,38,33
1702,11.261000000000942,3577.7368421052633,42,14,34,56
1703,4.8355000000004305,2622.866666666667,32,15,22,47
1704,1.976250000001104,2463.5263157894738,30,11,21,41
1705,12.265750000000297,3406.0,29,16,28,45
1706,12.176750000000615,2402.9411764705883,27,11,42,38
1707,-4.575499999999632,2984.6111111111113,35,17,43,52
1708,3.450000000000587,2383.3529411764707,19,19,44,38
1709,0.1950000000007095,2551.9473684210525,34,5,18,39
1710,16.53225000000085,3777.6,40,22,29,62
1711,15.13425000000073,1951.9375,31,16,45,47
1712,4.175250000000438,2208.6470588235293,24,21,32,45
1713,6.148500000000722,3835.35,29,20,37,49
1714,12.915250000000531,2095.705882352941,34,21,53,55
1715,20.484500000001205,4044.2,43,13,35,56
1716,30.89375000000099,2362.8823529411766,44,9,37,53
1717,-10.531250000000002,1429.0,1,11,38,12
1718,32.9867500000006,4968.05,39,19,37,58
1719,22.478000000001295,3811.6,43,12,33,55
1720,20.43550000000058,2515.9473684210525,28,10,37,38
1721,36.784250000001194,4505.0526315789475,55,21,47,76
1722,10.814250000000566,3278.6315789473683,36,21,29,57
1723,18.37825000000084,2479.5882352941176,47,12,32,59
1724,11.749500000000658,2244.294117647059,20,12,38,32
1725,35.38600000000134,4523.473684210527,70,14,24,84
1726,27.56025000000131,4266.4,47,21,27,68
1727,3.0035000000004395,2861.842105263158,20,17,47,37
1728,13.66075000000077,4664.75,45,14,47,59
1729,22.856750000000854,3856.8,31,16,48,47
1730,44.7770000000019,3738.5,55,21,42,76
1731,33.73875000000137,4473.55,54,8,41,62
1732,4.199000000000807,2722.722222222222,36,15,31,51
1733,13.178500000000373,1657.1875,16,14,40,30
1734,17.370500000001137,5029.05,58,24,17,82
1735,24.78700000000054,3447.3,31,14,33,45
1736,42.39425000000158,3565.777777777778,69,16,40,85
1737,16.630750000001434,2353.5882352941176,31,13,38,44
1738,10.684500000000963,3949.7,30,21,35,51
1739,45.51250000000208,5437.1,71,22,29,93
1740,9.85625000000006,1992.1176470588234,20,15,37,35
1741,27.53025000000133,4337.85,43,23,32,66
1742,20.812000000000744,3164.2631578947367,35,16,30,51
1743,30.984250000000532,4038.0526315789475,52,17,42,69
1744,5.614250000000203,2630.0555555555557,13,29,34,42
1745,16.423750000000847,2089.235294117647,31,9,31,40
1746,10.198749999999986,2317.9444444444443,13,24,53,37
1747,28.01200000000106,4572.05,38,30,39,68
1748,9.040250000000848,2671.4210526315787,34,11,24,45
1749,16.111000000001034,3346.4736842105262,40,12,39,52
1750,25.258750000001594,2820.294117647059,49,5,33,54
1751,17.263750000001487,2640.235294117647,40,11,52,51
1752,19.07000000000094,3404.5,37,21,34,58
1753,14.822000000000386,2512.3333333333335,28,19,54,47
1754,21.53675000000033,3155.777777777778,28,11,42,39
1755,21.87100000000096,3356.85,40,18,27,58
1756,32.04475000000197,4832.2,67,18,36,85
1757,22.80375000000074,3363.8947368421054,37,16,47,53
1758,11.588750000000472,3205.25,29,14,23,43
1759,27.92975000000136,2162.25,37,12,45,49
1760,17.11950000000057,2798.315789473684,25,17,46,42
1761,3.7130000000005006,2099.277777777778,25,11,33,36
1762,2.7985000000005984,3614.3333333333335,42,12,32,54
1763,27.8642500000007,3066.5789473684213,39,12,42,51
1764,13.56375000000105,3492.7,43,21,21,64
1765,2.9630000000005814,2405.277777777778,19,18,37,37
1766,18.094000000001046,2319.8823529411766,38,11,38,49
1767,20.166500000001296,2129.5333333333333,49,14,34,63
1768,9.431750000000683,2777.5,31,18,35,49
1769,41.018250000002794,5315.65,66,20,27,86
1770,31.437000000000506,3927.0,47,10,45,57
1771,8.207500000000742,2072.777777777778,24,19,28,43
1772,20.83275000000058,2689.529411764706,34,18,52,52
1773,43.11050000000158,4132.526315789473,56,22,26,78
1774,18.828750000001,3446.5263157894738,32,21,45,53
1775,15.790000000001152,3330.4210526315787,48,18,24,66
1776,7.863000000000708,3095.7894736842104,33,9,42,42
1777,8.38100000000056,2374.9411764705883,31,20,37,51
1778,33.76275000000053,3776.5789473684213,44,20,20,64
1779,16.879250000000695,3137.1,35,13,30,48
1780,14.692000000000894,2824.1052631578946,38,7,35,45
1781,13.436250000000616,3146.1111111111113,33,14,41,47
1782,13.612500000001177,2945.0,47,17,29,64
1783,6.545750000000545,3958.55,37,14,33,51
1784,-2.893999999999866,1981.1666666666667,14,15,39,29
1785,6.791500000000376,2394.6111111111113,27,14,46,41
1786,7.073000000000704,3153.6,36,13,24,49
1787,8.198250000000739,2098.625,34,14,28,48
1788,-4.47849999999956,2140.0,24,12,33,36
1789,8.668250000000373,2462.705882352941,29,31,39,60
1790,19.98975000000129,2814.764705882353,44,10,45,54
1791,-0.12424999999923492,3352.1,34,25,26,59
1792,29.730250000000346,2856.777777777778,48,17,33,65
1793,21.41025000000095,2431.9411764705883,32,21,29,53
1794,31.755250000000842,3052.5,34,16,41,50
1795,28.216000000000935,4625.833333333333,82,12,26,94
1796,13.810000000000361,2290.6111111111113,22,20,31,42
1797,-2.5359999999995777,2192.7368421052633,22,19,46,41
1798,-2.5342499999991714,2198.8888888888887,20,17,43,37
1799,2.5475000000014245,3759.5882352941176,51,23,31,74
1800,12.16925000000095,3423.705882352941,37,22,32,59
1801,8.489750000000884,2438.4117647058824,34,12,29,46
1802,24.008250000000366,2991.6666666666665,36,21,47,57
1803,9.249250000000382,1963.1176470588234,23,16,32,39
1804,28.267250000001006,2633.5882352941176,51,16,39,67
1805,3.987750000000747,2072.8333333333335,19,18,55,37
1806,-0.7232499999996482,2233.85,20,8,29,28
1807,10.075000000000918,3520.4,48,21,17,69
1808,11.512750000000722,2734.1666666666665,37,11,32,48
1809,18.837750000000916,2442.176470588235,40,3,28,43
1810,29.165500000000783,3214.8333333333335,42,22,45,64
1811,18.125500000000848,2980.277777777778,35,17,19,52
1812,-4.965249999999772,2320.4210526315787,13,21,45,34
1813,20.065750000001557,3456.0588235294117,56,22,22,78
1814,17.28650000000067,3594.95,35,26,29,61
1815,31.441000000002084,5252.15,74,19,27,93
1816,19.438500000000808,3376.4210526315787,37,12,28,49
1817,13.597500000000725,4411.65,42,16,27,58
1818,15.710500000000739,2836.0,40,11,32,51
1819,4.135000000000376,2041.888888888889,31,12,46,43
1820,9.04450000000153,2794.3125,35,22,32,57
1821,21.053750000000868,2680.25,46,11,29,57
1822,2.752000000000556,2357.2631578947367,24,14,29,38
1823,26.1147500000008,3294.5263157894738,44,19,34,63
1824,14.516750000000826,4283.05,42,19,22,61
1825,29.231500000001006,4174.25,49,18,29,67
1826,10.641750000000677,3063.2105263157896,27,21,36,48
1827,35.74125000000099,4642.55,60,17,25,77
1828,27.754000000000975,4382.3,52,20,19,72
1829,13.949500000000867,2744.5625,46,11,25,57
1830,15.226250000000988,3312.875,48,11,39,59
1831,25.894750000000624,2966.823529411765,43,24,17,67
1832,33.47350000000168,4556.1,55,17,34,72
1833,25.363500000001032,2954.0625,41,23,29,64
1834,15.11825000000142,3192.823529411765,46,13,32,59
1835,26.9905000000005,2433.764705882353,37,11,40,48
1836,6.763500000000623,2433.5555555555557,27,17,24,44
1837,19.507500000001134,3006.722222222222,48,8,26,56
1838,13.460750000000772,2585.9375,38,8,34,46
1839,-1.2009999999992724,2048.157894736842,21,10,25,31
1840,11.756750000001082,3306.5,36,21,33,57
1841,27.681000000000978,4560.8,47,25,27,72
1842,24.609750000001412,4333.2,60,11,20,71
1843,-4.876999999999221,2807.1875,30,17,23,47
1844,10.21525000000071,2522.2,37,17,16,54
1845,15.80225000000095,3159.222222222222,45,23,31,68
1846,9.530250000001242,2704.5882352941176,47,22,21,69
1847,-3.1977499999993553,3357.157894736842,40,24,26,64
1848,30.328500000000787,4425.9,34,21,41,55
1849,15.642500000000386,3879.05,37,18,21,55
1850,17.493000000000645,4352.95,29,22,42,51
1851,20.784250000000494,4117.473684210527,49,21,32,70
1852,18.061750000001446,3521.9473684210525,47,21,25,68
1853,4.58284798998676e-13,1933.4444444444443,24,11,42,35
1854,21.281250000000373,4056.85,41,15,29,56
1855,20.041000000001397,2736.6875,44,17,40,61
1856,-7.716999999999163,2190.0555555555557,26,15,19,41
1857,2.776500000000607,2916.9473684210525,34,17,33,51
1858,5.624000000000769,2886.25,26,15,34,41
1859,7.40175000000072,2409.722222222222,31,10,21,41
1860,8.801250000000818,2681.1176470588234,34,24,20,58
1861,29.4280000000011,3929.05,39,24,35,63
1862,7.322000000001094,2855.0555555555557,35,16,26,51
1863,33.68925000000147,4198.421052631579,61,13,22,74
1864,35.85225000000192,3831.684210526316,62,23,48,85
1865,22.603500000001098,3691.9,42,20,24,62
1866,6.4282500000005935,3690.9444444444443,38,41,22,79
1867,10.404250000000417,2932.6111111111113,29,19,35,48
1868,11.111500000001152,3110.0,45,18,20,63
1869,10.545500000000652,2375.4375,31,23,27,54
1870,10.27175000000081,2458.8125,29,23,33,52
1871,4.345500000000846,2933.0,32,17,16,49
1872,15.557250000000716,3327.4,46,8,19,54
1873,33.02600000000146,4529.9,60,12,26,72
1874,13.571250000001132,3164.05,42,21,15,63
1875,7.484000000000414,3023.9333333333334,25,26,26,51
1876,28.355500000000937,3964.3888888888887,45,15,35,60
1877,12.76700000000108,2411.294117647059,34,23,30,57
1878,13.532750000001291,3211.222222222222,42,19,23,61
1879,23.365750000001647,3036.777777777778,56,20,26,76
1880,34.179750000000816,3391.222222222222,50,18,28,68
1881,11.613250000000592,2831.5882352941176,35,26,43,61
1882,1.9335000000006761,2323.277777777778,28,16,26,44
1883,25.56650000000063,3299.235294117647,45,19,25,64
1884,7.598000000000994,2541.1111111111113,33,9,21,42
1885,13.404250000001023,2642.9411764705883,36,19,46,55
1886,4.398500000000939,2638.0,40,13,16,53
1887,12.510250000001403,2532.277777777778,38,19,28,57
1888,14.357250000001121,2847.0,35,22,36,57
1889,13.008500000000572,2654.6315789473683,33,18,24,51
1890,5.946000000000389,2521.470588235294,34,31,26,65
1891,13.001750000001238,2433.823529411765,41,13,26,54
1892,27.562250000001352,4427.55,44,17,32,61
1893,-0.5997499999995914,2024.6842105263158,17,13,28,30
1894,13.764500000000742,2094.9444444444443,27,17,36,44
1895,12.346500000001274,2837.1176470588234,40,21,24,61
1896,23.539250000001125,3607.7,38,21,34,59
1897,12.085000000000253,4166.35,19,25,34,44
1898,29.233500000001403,3027.375,58,23,27,81
1899,9.166750000000643,2759.9473684210525,30,10,31,40
1900,8.21100000000084,3118.4285714285716,34,13,28,47
1901,4.965250000000458,2833.0625,33,12,14,45
1902,0.9372500000001738,2087.8888888888887,17,20,43,37
1903,25.46725000000138,3121.9411764705883,51,24,16,75
1904,7.896500000000989,2482.0,36,13,30,49
1905,13.716500000000389,2591.3888888888887,35,18,29,53
1906,25.906750000000848,3498.95,36,19,35,55
1907,6.957250000000533,2950.4210526315787,24,14,33,38
1908,20.76750000000065,2610.722222222222,18,19,41,37
1909,14.893500000000937,3128.315789473684,43,16,23,59
1910,38.36700000000094,4513.15,54,18,20,72
1911,5.988500000001013,2437.4117647058824,32,26,22,58
1912,23.72100000000088,1942.6470588235295,29,16,58,45
1913,19.124500000000857,2487.823529411765,39,15,27,54
1914,9.120250000001088,2688.9473684210525,35,8,41,43
1915,-2.165999999999286,3133.3684210526317,36,18,26,54
1916,35.69025000000152,4819.6,50,15,36,65
1917,22.882000000000865,3230.65,32,17,33,49
1918,15.891500000001216,2221.75,36,14,32,50
1919,1.4862500000010743,4093.2105263157896,49,14,30,63
1920,10.598750000000598,2743.1111111111113,24,17,38,41
1921,20.569250000000785,3059.0,41,14,34,55
1922,4.697000000000292,1937.0,14,12,66,26
1923,8.106500000000718,2784.1052631578946,37,14,27,51
1924,13.055750000000831,2726.3888888888887,32,19,36,51
1925,29.03300000000071,4602.25,42,22,34,64
1926,11.51500000000043,2727.1666666666665,25,16,50,41
1927,11.73000000000027,2887.684210526316,22,14,51,36
1928,21.33100000000072,3767.9,44,19,31,63
1929,26.728250000001008,4600.5,56,21,25,77
1930,24.131000000001343,2697.846153846154,48,15,49,63
1931,7.120000000000671,2151.3333333333335,24,16,43,40
1932,2.793000000000758,1943.0,28,12,43,40
1933,10.54575000000077,2594.0,30,10,37,40
1934,19.946000000000467,1481.9333333333334,38,20,58,58
1935,7.035750000001251,2966.315789473684,36,11,42,47
1936,27.025750000001125,3236.1111111111113,46,21,45,67
1937,39.2347500000013,4231.894736842105,46,15,40,61
1938,20.23300000000055,3333.8947368421054,39,13,43,52
1939,21.69875000000088,3424.4,39,13,36,52
1940,20.557250000001257,3651.35,38,14,37,52
1941,44.85150000000111,4892.6,67,9,20,76
1942,16.94375000000075,2592.277777777778,38,9,38,47
1943,-0.8417499999996962,2063.9473684210525,20,14,27,34
1944,14.589250000001542,4018.05,44,23,40,67
1945,14.751250000001244,2625.0666666666666,44,9,28,53
1946,27.41325000000082,3759.2,46,19,28,65
1947,21.08975000000037,3828.2,41,17,23,58
1948,4.343000000000795,2571.9444444444443,31,18,26,49
1949,23.381500000000877,4516.35,54,15,35,69
1950,23.357000000000635,4383.8,42,22,39,64
1951,25.409500000000907,3675.2,39,14,36,53
1952,13.831250000000708,1429.0,24,22,51,46
1953,0.38525000000039383,2151.7894736842104,18,14,39,32
1954,12.547750000000823,2763.3333333333335,41,18,38,59
1955,13.383750000000967,2318.125,35,15,47,50
1956,13.673250000000582,2500.1052631578946,34,11,31,45
1957,31.86375000000053,3506.85,39,9,38,48
1958,10.479250000000642,2854.1111111111113,22,15,41,37
1959,1.059000000000864,3057.8333333333335,31,16,35,47
1960,-0.4422499999992837,2072.4117647058824,25,21,37,46
1961,12.063000000001164,3820.4,37,23,32,60
1962,21.06175000000069,3746.55,25,20,43,45
1963,-2.7334999999990517,2066.6111111111113,24,13,43,37
1964,12.017000000000788,2843.0,28,15,40,43
1965,15.45975000000034,2937.0,29,15,37,44
1966,17.17875000000105,3020.235294117647,39,17,37,56
1967,13.065000000000467,2038.7058823529412,32,6,56,38
1968,20.35425000000072,2210.529411764706,25,16,49,41
1969,7.707250000000373,2488.4210526315787,26,10,38,36
1970,7.604000000000499,2580.0,35,20,45,55
1971,2.2837500000005244,2741.4736842105262,19,16,45,35
1972,12.787500000001007,2411.4117647058824,36,5,35,41
1973,-0.4464999999997338,2211.222222222222,18,13,47,31
1974,27.1960000000009,5069.105263157895,43,19,38,62
1975,10.213500000000415,3103.6666666666665,33,12,37,45
1976,10.867500000000764,2520.777777777778,22,13,47,35
1977,19.344000000000637,2981.1111111111113,26,14,53,40
1978,4.27075000000025,1748.3529411764705,19,19,42,38
1979,17.20075000000073,2179.125,30,13,56,43
1980,34.65075000000088,3511.0526315789475,29,23,37,52
1981,16.836750000000627,2199.9444444444443,26,14,42,40
1982,1.4095000000001563,1567.9375,13,18,50,31
1983,19.909000000000326,3426.7,25,14,43,39
1984,11.22175000000082,3477.55,39,10,35,49
1985,18.348750000000827,3676.75,23,13,46,36
1986,11.113250000000942,2611.294117647059,39,14,24,53
1987,21.236000000000214,3069.222222222222,35,14,42,49
1988,21.440250000001015,3275.3076923076924,43,10,23,53
1989,15.696250000000314,3989.4,25,24,52,49
1990,21.399500000000486,2670.9411764705883,40,12,56,52
1991,17.26675000000055,3345.0,31,9,40,40
1992,8.771749999999995,1429.0,18,15,53,33
1993,25.34000000000105,4894.15,56,5,21,61
1994,11.129000000001081,3172.5789473684213,48,10,40,58
1995,19.69875000000084,3109.8823529411766,44,23,44,67
1996,17.610750000000287,2957.3333333333335,28,14,55,42
1997,29.76800000000106,5469.5,41,19,53,60
1998,8.541000000001157,4037.15,45,14,38,59
1999,19.988500000000826,3240.3684210526317,37,11,50,48
2000,20.527500000001005,3468.722222222222,50,14,36,64
2001,39.311500000000834,4444.95,49,12,36,61
2002,8.108250000000469,2526.294117647059,33,10,21,43
2003,21.054750000000986,3223.5263157894738,28,12,50,40
2004,0.6780000000005363,1954.8235294117646,24,15,35,39
2005,12.24250000000121,2285.1875,36,19,43,55
2006,30.83900000000049,2979.0,48,12,54,60
2007,8.25025000000055,2210.3888888888887,24,9,38,33
2008,46.456000000001126,6185.35,69,21,41,90
2009,0.3697500000006288,2528.3,31,10,23,41
2010,2.603750000000123,1773.5294117647059,7,18,54,25
2011,1.2440000000006417,3049.8947368421054,32,14,32,46
2012,19.818500000000522,2787.5263157894738,30,14,35,44
2013,25.41200000000119,3559.5555555555557,55,14,32,69
2014,10.534750000000736,3487.05,33,16,24,49
2015,5.69425000000099,3110.8888888888887,39,11,30,50
2016,40.509250000001,3596.6666666666665,52,18,43,70
2017,38.40550000000097,3774.8947368421054,42,18,45,60
2018,8.793250000000992,2503.823529411765,35,18,18,53
2019,26.127250000000164,1539.0666666666666,30,15,47,45
2020,9.548750000000378,2809.2105263157896,27,11,42,38
2021,11.560500000000319,2306.823529411765,25,18,40,43
2022,44.92225000000221,4507.6,61,15,39,76
2023,6.212500000000445,3223.45,34,16,35,50
2024,35.80875000000114,4109.9473684210525,51,16,50,67
2025,0.7262500000003045,2311.3529411764707,20,15,36,35
2026,13.30175000000096,2561.3333333333335,33,12,27,45
2027,5.470000000000798,2552.684210526316,33,15,36,48
2028,29.103750000001327,3702.15,46,14,38,60
2029,20.063750000000795,2442.0625,33,15,29,48
2030,7.240500000001023,2526.294117647059,30,15,34,45
2031,31.331000000000717,2568.1176470588234,43,12,43,55
2032,23.80300000000131,2590.0,47,15,29,62
2033,29.149250000001427,5209.3,65,23,19,88
2034,-2.2504999999994495,1981.0555555555557,21,15,37,36
2035,19.503000000001123,3841.0,47,14,27,61
2036,1.063500000000604,2872.1,30,19,24,49
2037,31.50800000000056,3500.8947368421054,39,15,34,54
2038,8.588000000000397,2071.470588235294,20,14,46,34
2039,10.568000000001124,3141.1,42,13,31,55
2040,15.354250000000636,2881.5,30,24,38,54
2041,29.836750000001416,2438.0,47,12,34,59
2042,5.22500000000089,2667.1176470588234,32,20,19,52
2043,32.33000000000097,3857.722222222222,53,22,29,75
2044,9.996000000001075,3341.0,47,9,25,56
2045,12.59300000000123,3000.4736842105262,35,17,23,52
2046,11.239000000000784,2172.3529411764707,27,21,38,48
2047,12.197250000000642,2457.294117647059,30,15,47,45
2048,31.4612500000012,3041.1111111111113,41,12,32,53
2049,40.3135000000013,3479.5,53,20,46,73
2050,14.927750000000827,2504.823529411765,28,16,25,44
2051,32.68350000000103,3742.3684210526317,38,11,54,49
2052,3.5320000000004805,2908.45,23,11,34,34
2053,26.55825000000064,4837.75,51,18,38,69
2054,12.268250000000862,2867.9285714285716,36,12,38,48
2055,16.60850000000127,4081.5263157894738,41,12,45,53
2056,30.94525000000099,4202.85,49,18,36,67
2057,18.392750000000447,2689.5882352941176,27,18,40,45
2058,9.549750000000675,2701.6111111111113,29,19,34,48
2059,13.404500000000706,3154.2631578947367,43,9,49,52
2060,24.740000000000578,3550.2631578947367,45,12,34,57
2061,3.5372500000007867,3797.4,31,23,44,54
2062,12.807750000000699,3587.9473684210525,46,21,39,67
2063,5.159250000000908,2579.5263157894738,33,15,40,48
2064,21.205250000001204,2836.3529411764707,45,8,44,53
2065,8.776000000000325,1429.0,14,21,65,35
2066,35.62325000000092,3120.4444444444443,40,12,38,52
2067,46.41800000000058,4027.315789473684,50,17,30,67
2068,24.57900000000187,2589.9375,57,7,24,64
2069,28.349000000000764,3193.6666666666665,37,22,55,59
2070,4.910250000000227,1719.8125,12,18,73,30
2071,-2.8429999999995497,2235.1111111111113,15,13,49,28
2072,26.67000000000013,2733.157894736842,30,12,68,42
2073,8.999500000000403,2038.9473684210527,18,11,40,29
2074,18.736000000001106,2453.6,48,12,34,60
2075,18.50850000000069,2939.5789473684213,35,13,40,48
2076,12.766750000000341,2473.8125,35,15,38,50
2077,1.842500000000919,2835.9473684210525,29,11,34,40
2078,31.093750000001023,2951.875,56,15,44,71
2079,39.1090000000011,3791.7368421052633,48,11,39,59
2080,26.24825000000117,3312.777777777778,52,17,42,69
2081,17.220500000000534,2257.294117647059,29,9,62,38
2082,20.71100000000059,2972.3888888888887,38,10,29,48
2083,20.020500000000332,3074.8947368421054,24,8,43,32
2084,20.427000000000984,3031.3888888888887,37,17,30,54
2085,19.179000000000084,2814.4444444444443,23,15,56,38
2086,13.173500000001024,4437.9,40,14,39,54
2087,10.313250000000954,2764.5,39,14,24,53
2088,14.645000000000687,2753.8,23,11,44,34
2089,23.387750000001155,2753.235294117647,41,16,64,57
2090,31.73200000000129,4296.6,41,18,42,59
2091,10.325750000000772,2616.0555555555557,30,18,24,48
2092,31.395000000001204,2196.875,43,14,37,57
2093,36.3857500000008,4321.9,32,20,30,52
2094,13.892750000001021,2688.0,45,21,47,66
2095,6.632500000000688,2063.9411764705883,26,10,32,36
2096,15.34100000000088,3030.6315789473683,44,12,34,56
2097,20.143000000001322,4875.85,49,32,38,81
2098,20.25950000000172,4322.263157894737,57,18,29,75
2099,12.926500000000306,3135.7894736842104,23,16,38,39
2100,20.797750000000853,3067.315789473684,38,16,36,54
2101,28.718250000000705,3709.3,33,16,36,49
2102,15.75500000000046,3280.315789473684,39,14,34,53
2103,16.78725000000157,3744.9,32,24,44,56
2104,37.449500000001215,3564.0,53,13,36,66
2105,31.893250000001206,3047.277777777778,46,14,58,60
2106,14.282500000000619,3066.45,32,5,34,37
2107,19.22825000000058,2831.0,49,11,26,60
2108,26.283250000000713,3221.1111111111113,42,12,30,54
2109,26.332750000001322,4004.7368421052633,44,20,57,64
2110,27.304500000001248,3220.9411764705883,45,18,40,63
2111,1.7645000000004978,2028.7222222222222,22,12,27,34
2112,2.269000000000592,2949.5263157894738,22,16,42,38
2113,30.888250000001115,3909.3,43,18,26,61
2114,21.337500000000823,2999.6666666666665,40,14,32,54
2115,1.9630000000005832,2225.2631578947367,18,14,41,32
2116,36.928500000000994,2999.4615384615386,42,8,52,50
2117,28.314750000001236,4019.7368421052633,55,12,27,67
2118,9.62050000000091,3189.235294117647,42,16,35,58
2119,23.584000000002003,3330.6315789473683,59,7,48,66
2120,-4.332999999999602,2112.5,18,9,34,27
2121,0.6075000000002773,1956.5882352941176,18,13,47,31
2122,7.842000000000434,2214.722222222222,19,13,43,32
2123,19.290500000000627,3209.6111111111113,38,12,22,50
2124,9.00525000000091,2844.1,27,15,36,42
2125,12.435000000000446,2408.0,25,14,51,39
2126,25.691750000000848,3638.842105263158,51,20,23,71
2127,12.540250000000466,2539.4210526315787,29,10,36,39
2128,26.382000000000716,3540.1111111111113,43,26,39,69
2129,5.749250000000678,2815.55,28,16,18,44
2130,32.371750000001455,4487.0,50,15,33,65
2131,20.597250000000965,2851.1176470588234,36,15,48,51
2132,42.8457500000013,4802.95,53,15,32,68
2133,13.105500000000678,2588.705882352941,29,16,30,45
2134,12.436500000000917,3206.0526315789475,34,18,37,52
2135,13.252500000000623,3032.4,29,8,39,37
2136,2.63500000000054,2108.4,17,10,27,27
2137,10.466250000000375,2611.6666666666665,29,18,53,47
2138,12.110750000000982,2068.6470588235293,34,14,54,48
2139,25.924750000000774,3965.75,46,13,29,59
2140,13.882250000001502,4586.25,44,13,34,57
2141,7.497000000000467,1937.9411764705883,22,15,38,37
2142,16.720500000000776,2236.6875,36,18,30,54
2143,5.559750000000683,2166.6470588235293,31,12,25,43
2144,20.758500000000645,3651.3684210526317,36,14,47,50
2145,15.274000000000665,2996.823529411765,50,13,27,63
2146,15.064500000000724,2485.1052631578946,30,9,38,39
2147,10.16375000000071,2452.8888888888887,32,15,32,47
2148,3.7960000000003697,2464.0526315789475,24,16,39,40
2149,14.627750000000919,2744.85,37,11,27,48
2150,19.197250000001183,3462.5263157894738,42,14,28,56
2151,9.58150000000101,2981.4210526315787,42,16,53,58
2152,38.193500000001855,4860.0,77,12,18,89
2153,2.639250000000904,2674.277777777778,32,20,23,52
2154,1.7802500000014163,4241.8,43,26,25,69
2155,24.867250000001277,3783.4736842105262,50,15,29,65
2156,15.332000000000463,3196.6470588235293,37,11,42,48
2157,25.738000000000607,4520.5,55,14,39,69
2158,27.588000000000733,3262.4444444444443,36,12,39,48
2159,6.313250000000683,2675.5789473684213,30,17,23,47
2160,7.753000000000516,2155.6666666666665,15,15,62,30
2161,18.421500000000748,2914.0555555555557,30,19,35,49
2162,12.582750000000493,3077.3684210526317,27,15,34,42
2163,2.1020000000002836,2187.684210526316,22,17,27,39
2164,-6.61224999999929,2134.2105263157896,20,12,28,32
2165,9.685250000000638,2549.315789473684,28,17,38,45
2166,3.0637500000007885,2647.777777777778,34,16,23,50
2167,16.09975000000107,2311.0625,43,13,34,56
2168,12.54375000000071,2583.176470588235,32,20,45,52
2169,26.834000000000565,2963.5555555555557,27,18,39,45
2170,32.26125000000084,3775.7368421052633,39,16,49,55
2171,19.608000000000448,2946.55,29,12,34,41
2172,23.383750000001235,4312.4,49,16,39,65
2173,10.866500000000505,1925.125,31,10,31,41
2174,19.378750000000654,3602.842105263158,42,15,32,57
2175,-2.059749999999025,2245.1176470588234,24,12,31,36
2176,23.085000000000907,4519.55,36,18,36,54
2177,25.14250000000093,3012.777777777778,46,14,43,60
2178,37.58275000000055,4789.45,47,17,39,64
2179,5.962500000000736,3367.95,29,13,37,42
2180,15.072250000001157,3365.55,42,6,36,48
2181,11.007000000000268,2076.1176470588234,35,18,44,53
2182,19.173250000000863,2684.8333333333335,27,13,55,40
2183,26.062500000001176,3057.0555555555557,39,10,41,49
2184,14.168250000000594,2218.0588235294117,27,15,42,42
2185,28.073500000001133,3147.8888888888887,47,23,55,70
2186,29.191250000000895,4002.1,49,12,39,61
2187,7.807500000000571,2787.8,28,15,23,43
2188,10.773750000000986,2674.222222222222,35,14,30,49
2189,7.01300000000045,4102.421052631579,35,18,39,53
2190,34.25125000000123,3769.6,52,8,34,60
2191,15.476000000000457,2471.0588235294117,39,17,32,56
2192,27.232500000000663,3165.3888888888887,31,12,41,43
2193,27.918250000001244,2744.5625,45,24,43,69
2194,19.482000000000486,2021.9411764705883,25,10,71,35
2195,14.616750000000573,3780.65,31,25,35,56
2196,38.38500000000157,5151.4,62,16,30,78
2197,30.288000000000817,3542.0,48,14,34,62
2198,29.4345000000012,3294.6315789473683,39,11,41,50
2199,5.911500000000584,2758.625,33,4,30,37
2200,41.12275000000146,4410.05,60,17,24,77
2201,30.504750000000996,3433.3684210526317,43,15,39,58
2202,9.632250000000852,2166.1875,30,11,52,41
2203,29.600000000000154,3670.8333333333335,39,26,57,65
2204,1.858000000001074,2210.470588235294,30,19,23,49
2205,12.381750000000407,2177.0588235294117,31,16,42,47
2206,9.372250000001092,2689.3333333333335,39,14,30,53
2207,38.37950000000174,3871.0,51,9,43,60
2208,32.19200000000119,3798.95,35,24,35,59
2209,17.27375000000052,2515.5555555555557,31,13,53,44
2210,16.395000000001566,3666.45,48,15,19,63
2211,-1.8979999999990493,2556.8947368421054,30,14,27,44
2212,2.7222500000001935,2064.0,17,17,37,34
2213,21.233000000000633,2559.823529411765,41,11,52,52
2214,31.538250000001064,4028.25,35,25,33,60
2215,13.520250000000246,2639.1176470588234,29,23,39,52
2216,38.19650000000073,4743.4,49,15,38,64
2217,46.57475000000143,4951.4,55,12,33,67
2218,27.011750000001165,2598.75,41,17,33,58
2219,30.176000000001544,3756.5789473684213,44,20,43,64
2220,38.429500000001745,4312.35,64,14,32,78
2221,22.265750000000907,3378.25,39,13,34,52
2222,-1.042249999999338,2197.1111111111113,25,17,29,42
2223,24.580500000001187,4491.736842105263,55,21,24,76
2224,5.1640000000008595,2790.4166666666665,33,16,38,49
2225,22.91625000000149,2840.1111111111113,43,15,36,58
2226,19.148000000000756,2429.176470588235,41,16,32,57
2227,13.68450000000056,2445.8823529411766,38,27,36,65
2228,37.30700000000158,4562.25,53,17,35,70
2229,44.66750000000097,4530.65,59,14,24,73
2230,11.85500000000049,2568.1176470588234,29,18,26,47
2231,13.230000000000413,2684.3571428571427,44,18,29,62
2232,11.558250000000466,4942.5,32,29,36,61
2233,20.338500000000316,3444.25,25,15,33,40
2234,19.042250000000795,3098.1428571428573,44,9,32,53
2235,-0.9412499999991768,2022.0588235294117,22,16,50,38
2236,5.444000000000548,3192.6315789473683,29,14,28,43
2237,4.510500000000659,2649.2,33,16,19,49
2238,8.53175000000132,3135.5,43,24,37,67
2239,12.88675000000076,2698.0666666666666,31,14,32,45
2240,-9.67624999999986,2104.5555555555557,13,22,27,35
2241,9.558250000000296,2482.8333333333335,23,19,43,42
2242,22.69225000000085,2885.8888888888887,46,18,55,64
2243,4.4007500000009525,2719.1666666666665,33,19,30,52
2244,21.001500000001695,3430.0,59,14,41,73
2245,19.99225000000068,3834.65,32,13,38,45
2246,22.228250000001264,2740.0,58,14,28,72
2247,32.728000000001245,2925.823529411765,50,7,24,57
2248,10.606000000000487,2857.6111111111113,31,18,38,49
2249,33.014750000001705,2825.823529411765,62,16,30,78
2250,23.841500000001112,2567.5555555555557,41,9,33,50
2251,0.6527500000009281,2484.2631578947367,34,16,22,50
2252,-4.053249999999599,2177.9411764705883,24,10,35,34
2253,26.87350000000157,4720.3,65,17,15,82
2254,11.98800000000136,2858.4444444444443,32,27,30,59
2255,-1.6179999999997325,2176.7894736842104,21,14,27,35
2256,1.4242500000008165,2608.3571428571427,31,11,27,42
2257,21.724250000001028,3436.9444444444443,37,28,32,65
2258,46.97500000000123,5083.05,56,23,30,79
2259,28.497500000001473,5017.95,61,15,30,76
2260,36.374750000001654,4659.95,61,17,30,78
2261,21.193250000000695,2371.5,35,19,28,54
2262,26.214000000000993,2454.9375,37,21,32,58
2263,16.93425000000031,2672.9411764705883,27,22,35,49
2264,18.843250000001746,4772.578947368421,59,24,36,83
2265,15.561250000000731,1835.8125,33,18,40,51
2266,4.297750000000469,2101.4117647058824,28,16,34,44
2267,37.79800000000153,3914.3684210526317,57,11,33,68
2268,14.601750000000383,1888.4375,24,9,39,33
2269,24.736250000000844,2896.5,38,23,41,61
2270,20.872250000000644,3939.5,45,18,33,63
2271,21.68450000000051,4016.45,38,22,26,60
2272,15.552000000000689,3327.9473684210525,27,24,57,51
2273,4.511500000001137,3073.846153846154,35,23,20,58
2274,-2.549749999999286,2536.5555555555557,22,17,33,39
2275,9.858000000000704,2731.5882352941176,38,21,28,59
2276,-4.581249999999264,2715.684210526316,32,16,18,48
2277,6.183750000000719,2672.764705882353,30,24,38,54
2278,23.47175000000052,4692.263157894737,50,26,22,76
2279,38.24825000000111,4329.8,47,22,26,69
2280,10.222750000000776,2541.0,29,18,22,47
2281,28.3257500000013,4105.45,42,21,24,63
2282,33.943250000001676,3810.2105263157896,56,16,33,72
2283,11.302750000000247,2190.1176470588234,23,18,40,41
2284,4.505500000000479,2580.3529411764707,27,30,36,57
2285,15.908500000000629,4316.45,48,18,27,66
2286,8.994000000000788,3049.0555555555557,30,22,37,52
2287,29.547000000001127,3639.7368421052633,48,23,29,71
2288,-1.9622499999994758,2260.722222222222,18,20,46,38
2289,32.594500000001005,3947.8947368421054,57,21,31,78
2290,26.438500000001426,3758.5,51,20,33,71
2291,8.11800000000052,2827.3571428571427,31,14,44,45
2292,13.390500000000628,2737.3684210526317,30,19,23,49
2293,24.163750000000846,3051.8823529411766,42,20,30,62
2294,21.51750000000089,4125.9,36,27,33,63
2295,31.19800000000098,3731.684210526316,49,13,30,62
2296,6.395000000000987,2560.85,31,15,18,46
2297,28.15775000000092,3201.8947368421054,42,12,50,54
2298,25.952000000001675,3555.176470588235,59,17,24,76
2299,40.078250000001184,4054.5,55,18,27,73
2300,1.3850000000010465,2790.4166666666665,37,19,17,56
2301,8.041250000000478,3938.65,31,15,32,46
2302,14.257500000000586,3033.9473684210525,27,21,27,48
2303,4.98425000000058,2205.0588235294117,28,13,27,41
2304,12.75200000000076,3390.2,47,10,19,57
2305,9.852500000000672,2626.6111111111113,27,21,34,48
2306,14.884750000000318,2886.529411764706,26,25,35,51
2307,23.122750000000433,3331.45,33,11,49,44
2308,40.375000000001016,4093.2631578947367,53,19,61,72
2309,21.188000000002187,3333.0588235294117,63,17,42,80
2310,39.415750000001466,4968.75,61,14,23,75
2311,-1.9837499999997104,2441.6111111111113,14,18,33,32
2312,23.715750000000842,3969.65,39,21,43,60
2313,31.658250000000788,2825.875,42,9,46,51
2314,27.085250000001516,4358.1578947368425,59,17,32,76
2315,3.434000000000148,2376.3684210526317,19,13,32,32
2316,35.91300000000068,2545.1875,39,25,36,64
2317,26.070000000000753,3056.8333333333335,34,10,54,44
2318,29.84550000000139,3090.0588235294117,45,17,42,62
2319,20.412500000000755,2358.230769230769,34,21,46,55
2320,22.931000000001017,3581.2631578947367,53,16,32,69
2321,30.05325000000106,5114.05,68,20,26,88
2322,21.114000000000694,3093.0555555555557,39,15,23,54
2323,26.336750000000954,3032.4444444444443,42,23,42,65
2324,12.583250000000644,2215.722222222222,23,8,50,31
2325,21.721250000001017,3964.6315789473683,34,23,48,57
2326,22.763750000000634,2473.875,32,18,32,50
2327,10.52250000000072,2504.705882352941,35,25,41,60
2328,8.588250000001093,2906.157894736842,32,15,28,47
2329,18.775250000000803,3013.5882352941176,43,26,65,69
2330,4.745000000000288,2573.5789473684213,16,18,39,34
2331,31.592250000001297,3836.2,42,16,43,58
2332,10.180250000000505,2773.8333333333335,27,19,32,46
2333,13.368750000000222,2088.294117647059,26,18,49,44
2334,21.579750000000843,2668.1111111111113,31,12,42,43
2335,11.46800000000032,2733.9473684210525,23,20,44,43
2336,21.326750000000672,2129.470588235294,27,10,42,37
2337,36.789250000001495,4036.4736842105262,50,19,31,69
2338,18.794000000001727,3102.294117647059,52,9,30,61
2339,12.589000000000986,3180.2631578947367,38,16,26,54
2340,47.40825000000137,4625.2,64,13,28,77
2341,23.860500000000663,2210.875,38,16,46,54
2342,33.86125000000147,2519.4375,42,13,50,55
2343,13.3597500000009,3297.8947368421054,46,13,21,59
2344,16.747500000000404,2654.7368421052633,31,10,40,41
2345,22.046500000001092,2335.875,40,14,37,54
2346,16.75800000000055,2455.6111111111113,27,9,33,36
2347,20.116750000001197,4463.263157894737,43,21,37,64
2348,21.865000000001334,3670.823529411765,47,13,40,60
2349,29.963750000000864,3568.85,44,16,26,60
2350,47.88275000000158,3773.375,56,15,27,71
2351,32.0530000000011,2714.9411764705883,42,14,37,56
2352,21.39400000000078,3704.277777777778,46,22,40,68
2353,10.579250000000512,3895.7,30,23,36,53
2354,27.118000000001125,5068.05,43,25,45,68
2355,34.477000000001524,4607.65,41,21,44,62
2356,8.258500000000671,2683.842105263158,26,15,44,41
2357,11.43050000000083,2845.8947368421054,39,12,28,51
2358,4.015500000000576,2877.5,25,14,37,39
2359,23.591500000000764,2786.764705882353,38,26,44,64
2360,21.78900000000159,3906.95,45,18,23,63
2361,10.433750000000455,1979.8823529411766,30,10,58,40
2362,2.362250000000454,2106.0,22,15,22,37
2363,15.245500000001229,3246.0,53,17,51,70
2364,21.552250000001383,3502.85,43,19,30,62
2365,17.810250000000767,3353.9473684210525,36,16,26,52
2366,5.818750000000707,2055.5882352941176,25,18,33,43
2367,26.423750000001718,2441.733333333333,49,12,16,61
2368,11.87625000000072,4162.3,36,25,34,61
2369,35.70250000000141,4415.65,48,7,47,55
2370,35.35925000000141,3135.8823529411766,53,8,33,61
2371,8.244500000000507,2581.1052631578946,26,15,35,41
2372,28.974250000001206,3706.0555555555557,51,13,24,64
2373,13.472750000000781,2601.4285714285716,37,20,23,57
2374,12.366250000001024,3599.277777777778,55,12,25,67
2375,33.672500000000944,3265.705882352941,54,16,21,70
2376,11.704500000001065,2355.6875,38,15,32,53
2377,8.204750000000537,2725.214285714286,32,13,20,45
2378,39.20450000000052,2811.8823529411766,45,15,47,60
2379,11.39875000000073,3198.6315789473683,46,11,18,57
2380,30.048250000000913,4139.35,47,23,25,70
2381,-0.9499999999996067,2179.5555555555557,18,19,31,37
2382,24.91025000000115,4028.1052631578946,52,21,40,73
2383,12.888750000001064,2871.0,40,14,28,54
2384,5.324750000000626,3000.4444444444443,33,14,40,47
2385,-5.796499999999609,2106.6315789473683,13,14,41,27
2386,13.074500000000915,2744.157894736842,29,14,47,43
2387,16.757250000000546,3072.3684210526317,39,16,33,55
2388,-1.0084999999992248,2193.3076923076924,31,12,33,43
2389,21.70500000000073,4161.8421052631575,39,21,37,60
2390,33.02100000000118,3303.9411764705883,53,14,41,67
2391,19.52725000000076,3340.2,33,14,30,47
2392,6.6112500000006404,3606.95,25,19,29,44
2393,18.22350000000057,3051.6111111111113,29,12,41,41
2394,22.358000000001486,4517.2,56,13,30,69
2395,27.174750000001133,3386.777777777778,49,18,30,67
2396,25.714250000000995,2863.923076923077,36,15,41,51
2397,34.39950000000163,5573.6,52,24,39,76
2398,6.516000000001166,3548.1428571428573,40,23,29,63
2399,26.506500000000663,3899.4736842105262,35,16,35,51
2400,21.469250000000702,3417.6111111111113,38,19,23,57
2401,25.95275000000091,4352.95,44,17,42,61
2402,27.526500000000635,3341.0,32,19,38,51
2403,17.989500000001065,2807.235294117647,39,20,47,59
2404,18.019250000001033,2705.5882352941176,36,19,46,55
2405,8.550750000000594,3587.75,29,25,31,54
2406,-5.228999999999358,2647.8947368421054,28,22,25,50
2407,28.006500000001,3255.3684210526317,32,14,38,46
2408,16.35125000000077,2771.5789473684213,33,15,37,48
2409,15.024750000001063,2181.764705882353,32,11,36,43
2410,46.29900000000087,3698.8947368421054,49,11,38,60
2411,33.88725000000162,3011.5,67,5,27,72
2412,21.561250000001692,4358.9473684210525,57,15,31,72
2413,30.83500000000181,5416.35,67,10,37,77
2414,15.881750000001151,3509.25,47,9,15,56
2415,16.483000000000906,2491.777777777778,29,11,39,40
2416,42.39725000000149,3517.3888888888887,58,14,25,72
2417,43.462000000000735,3780.842105263158,49,12,30,61
2418,14.552250000001175,2465.5882352941176,31,18,31,49
2419,9.894750000000721,2556.9444444444443,32,22,26,54
2420,24.283000000001007,3767.3,46,20,17,66
2421,2.7827500000004615,1429.0,17,21,34,38
2422,34.42825000000134,3047.294117647059,48,20,39,68
2423,28.419250000001398,4561.55,54,22,21,76
2424,1.9212500000004327,2038.8823529411766,17,22,38,39
2425,39.242750000001806,4307.7,49,23,26,72
2426,35.750250000001415,3682.176470588235,51,26,31,77
2427,17.322000000000568,2394.5882352941176,37,19,36,56
2428,11.636250000000727,3829.2105263157896,42,26,17,68
2429,8.948250000000566,2580.9375,31,7,33,38
2430,17.491000000000774,2727.6,35,10,24,45
2431,42.4262500000021,3190.0,70,20,33,90
2432,4.279500000000679,3007.2105263157896,29,16,23,45
2433,-0.5864999999995024,2556.05,26,19,20,45
2434,15.683250000000893,3897.7894736842104,42,22,27,64
2435,22.37625000000118,3892.684210526316,39,28,37,67
2436,22.61550000000127,4546.55,45,20,26,65
2437,45.105000000001546,5268.75,67,17,21,84
2438,0.7812500000008447,2598.1,28,15,18,43
2439,31.54950000000136,2993.6666666666665,46,13,30,59
2440,44.49950000000107,4957.7,66,20,34,86
2441,-11.159749999999521,1937.0,25,17,30,42
2442,13.901750000000225,1973.6875,30,15,47,45
2443,14.527250000000786,2812.5,35,15,27,50
2444,-2.274749999999554,2198.05,19,12,22,31
2445,29.474000000000796,2525.4375,44,11,40,55
2446,37.27550000000129,3026.125,59,10,25,69
2447,0.6305000000004745,2002.1666666666667,23,16,27,39
2448,18.87400000000069,2846.222222222222,41,11,29,52
2449,7.460500000000766,1934.0,32,15,31,47
2450,23.998000000000786,2265.764705882353,46,12,36,58
2451,6.493250000000666,2696.315789473684,29,23,30,52
2452,20.682250000001282,2780.8333333333335,41,16,40,57
2453,-5.3204999999995115,2851.9411764705883,35,16,28,51
2454,16.200250000001102,3019.8888888888887,48,19,31,67
2455,33.48075000000186,4558.4,68,16,27,84
2456,16.69475000000109,3144.95,40,14,21,54
2457,18.44325000000077,2791.5,36,21,40,57
2458,-3.509749999999314,2959.5789473684213,37,17,22,54
2459,4.488500000000881,3242.65,37,15,23,52
2460,9.475000000001037,2820.294117647059,36,19,27,55
2461,25.156250000001048,3328.0526315789475,39,17,24,56
2462,1.6975000000004237,2198.0555555555557,25,19,27,44
2463,20.184000000000673,3876.0526315789475,37,31,32,68
2464,-14.928249999999721,2102.3684210526317,17,21,21,38
2465,25.784000000001345,4427.45,55,22,22,77
2466,32.62875000000131,4518.8,55,29,29,84
2467,20.85100000000142,5185.45,52,24,25,76
2468,38.88450000000216,4414.166666666667,71,7,28,78
2469,-5.858249999999346,2560.0,24,19,16,43
2470,21.21525000000056,3334.8333333333335,44,11,22,55
2471,28.331750000000305,2699.0,41,30,44,71
2472,25.635500000001105,5838.65,44,30,25,74
2473,13.134250000001211,3151.705882352941,42,34,20,76
2474,27.382250000001562,4661.65,69,13,30,82
2475,32.33800000000086,3676.7,42,19,27,61
2476,15.707000000000733,3725.15,42,17,21,59
2477,-2.667749999999175,2447.6111111111113,28,22,18,50
2478,34.02050000000084,4241.894736842105,49,26,33,75
2479,15.701500000001193,3156.8,33,24,28,57
2480,1.7837500000007736,2679.25,32,15,18,47
2481,7.541250000000312,2142.470588235294,29,22,31,51
2482,9.243250000001025,3201.842105263158,39,30,39,69
2483,23.115750000000546,2986.4210526315787,23,13,42,36
2484,9.011500000001027,3928.277777777778,44,24,40,68
2485,15.713750000000786,3762.4,46,13,24,59
2486,-1.9059999999994965,2639.5789473684213,18,22,28,40
2487,29.21550000000142,2922.235294117647,53,15,20,68
2488,15.281500000000431,3009.0,48,18,29,66
2489,1.356250000000489,2941.0,21,22,29,43
2490,20.639000000001076,5294.95,43,31,38,74
2491,7.938250000000565,3004.7368421052633,31,25,37,56
2492,24.470000000000788,3922.75,37,21,30,58
2493,14.605500000000967,3173.65,36,14,25,50
2494,11.245000000000772,2521.8947368421054,32,15,29,47
2495,4.618000000000242,1971.5294117647059,17,16,43,33
2496,16.546250000000207,4219.55,22,20,28,42
2497,15.099000000000839,3688.0526315789475,29,21,30,50
2498,42.97625000000151,4196.9473684210525,56,9,36,65
2499,25.23600000000077,2645.705882352941,38,17,25,55
2500,39.82425000000096,4809.35,59,20,31,79
2501,25.962500000001377,3253.6666666666665,46,17,34,63
2502,14.36250000000069,1853.6875,30,16,34,46
2503,25.074250000000823,4273.55,49,20,19,69
2504,14.368250000000762,3463.2,33,18,32,51
2505,13.205750000000691,3127.4444444444443,40,18,27,58
2506,29.633250000000935,2756.764705882353,52,20,40,72
2507,19.14325000000109,4517.15,36,23,28,59
2508,30.978500000001286,3623.0555555555557,52,14,23,66
2509,39.001750000001834,4731.45,76,11,20,87
2510,41.17650000000137,3179.8823529411766,60,15,36,75
2511,16.39850000000063,2992.157894736842,28,15,39,43
2512,26.760500000001297,3546.1052631578946,54,18,50,72
2513,0.8355000000010033,2631.9444444444443,30,16,42,46
2514,22.157500000000887,3334.6315789473683,40,23,33,63
2515,24.863500000000776,4402.15,40,21,26,61
2516,2.084000000000351,2241.1052631578946,13,16,35,29
2517,18.292250000001196,3591.85,40,18,26,58
2518,9.145500000000961,2757.6923076923076,35,19,33,54
2519,6.477500000000289,1626.5,9,16,45,25
2520,24.20700000000125,4533.0,56,18,21,74
2521,29.712000000000614,3985.45,36,25,32,61
2522,24.596000000000934,4161.5,39,22,40,61
2523,20.242000000001013,3237.75,45,17,25,62
2524,23.21075000000093,3483.5263157894738,44,17,36,61
2525,30.114750000001287,3820.8947368421054,50,13,29,63
2526,16.01500000000089,2966.8125,36,11,27,47
2527,13.394500000000289,2415.9444444444443,27,13,41,40
2528,33.45950000000064,4172.1,31,20,44,51
2529,21.64175000000069,3306.8823529411766,34,20,41,54
2530,12.681000000001543,3530.9473684210525,42,25,35,67
2531,39.893250000000975,4359.736842105263,58,23,33,81
2532,17.689250000000833,2278.3125,34,13,39,47
2533,0.7205000000004613,2028.7777777777778,23,15,33,38
2534,17.91825000000124,4092.5263157894738,56,21,28,77
2535,16.162500000001586,3821.0,50,18,23,68
2536,23.37150000000145,4688.55,35,37,43,72
2537,-0.6959999999997144,2372.2105263157896,18,13,44,31
2538,36.854750000000756,2925.6111111111113,39,8,48,47
2539,22.05200000000105,2925.5555555555557,52,12,37,64
2540,17.474500000001306,4421.2,44,19,27,63
2541,24.67350000000186,2719.9375,55,18,39,73
2542,19.618750000000972,2081.866666666667,34,19,33,53
2543,20.932000000000944,3214.85,41,13,27,54
2544,30.07700000000157,4808.5,46,23,37,69
2545,5.187750000000451,2595.4210526315787,26,19,32,45
2546,19.4422500000004,2503.823529411765,33,13,36,46
2547,-3.403999999999486,3719.55,23,25,26,48
2548,0.6457500000007866,2165.277777777778,23,20,31,43
2549,26.451000000000967,4040.2,51,17,35,68
2550,15.912500000000602,3885.4,43,16,37,59
2551,15.339250000000721,3030.3529411764707,43,17,27,60
2552,13.517750000000907,2855.1111111111113,27,20,34,47
2553,16.24575000000075,3918.684210526316,31,21,31,52
2554,2.121750000000338,2300.3333333333335,22,26,32,48
2555,2.828750000000487,2485.5625,31,21,28,52
2556,8.104250000000578,2780.7,25,17,28,42
2557,18.03425000000088,3827.6,44,20,17,64
2558,10.197250000000633,2700.9411764705883,29,13,40,42
2559,19.099250000001003,3488.3684210526317,27,19,56,46
2560,12.163000000000562,2610.315789473684,31,10,32,41
2561,14.149250000000993,3169.8333333333335,37,15,32,52
2562,32.59350000000115,2954.705882352941,43,13,44,56
2563,25.02275000000044,2492.705882352941,33,13,41,46
2564,10.46975000000087,3587.1052631578946,34,12,25,46
2565,9.981500000000123,3452.15,20,16,34,36
2566,45.17300000000098,4767.473684210527,58,18,67,76
2567,25.74675000000097,4182.166666666667,39,15,40,54
2568,17.222500000000974,2365.625,33,7,33,40
2569,22.48700000000044,2701.6111111111113,36,18,40,54
2570,6.659250000000466,2388.157894736842,19,13,40,32
2571,25.33375000000064,4765.55,54,11,36,65
2572,11.771500000000632,3557.7,36,13,35,49
2573,7.535000000000487,2652.9473684210525,28,15,37,43
2574,28.724250000000904,3380.6315789473683,36,14,53,50
2575,13.819500000000977,2813.923076923077,34,17,30,51
2576,24.748500000001098,3264.5789473684213,45,14,27,59
2577,4.133250000000237,1997.2105263157894,17,8,41,25
2578,16.207000000000317,2036.25,30,20,31,50
2579,3.9110000000004312,2664.3125,26,20,34,46
2580,2.470000000000345,2858.5,19,19,52,38
2581,10.941500000000607,2737.0,39,19,41,58
2582,32.56275000000103,3673.8947368421054,40,21,37,61
2583,16.239000000000694,2826.9411764705883,33,18,34,51
2584,15.19975000000041,3805.25,35,18,38,53
2585,30.43200000000067,3062.1176470588234,39,14,41,53
2586,-3.3627499999993824,2055.5789473684213,20,8,27,28
2587,24.06725000000114,4027.3684210526317,44,18,37,62
2588,22.79550000000098,4448.9,43,17,25,60
2589,6.445500000000715,2563.0625,32,15,25,47
2590,-0.30224999999969526,1977.5,17,17,50,34
2591,1.859750000000528,2064.842105263158,20,12,47,32
2592,9.6915000000004,2863.5263157894738,21,18,37,39
2593,7.180250000000437,2148.0,24,17,30,41
2594,27.70925000000158,3286.3333333333335,59,8,30,67
2595,38.032250000001284,3628.0,51,15,34,66
2596,20.88175000000089,3056.05,41,10,30,51
2597,44.44200000000103,4810.05,58,18,34,76
2598,22.269500000000576,2644.8823529411766,50,13,54,63
2599,27.5027500000009,3153.0555555555557,35,25,34,60
2600,10.259250000000135,2038.764705882353,19,17,36,36
2601,4.140750000000398,2483.6666666666665,24,18,32,42
2602,28.59850000000106,3705.6315789473683,42,21,43,63
2603,19.499000000001526,4120.0526315789475,65,12,33,77
2604,19.07925000000106,3338.0,42,11,29,53
2605,18.80275000000024,2521.470588235294,35,20,56,55
2606,13.016750000001213,2629.0588235294117,40,7,29,47
2607,29.655250000000507,3084.4117647058824,43,21,43,64
2608,37.58900000000132,4187.05,56,8,49,64
2609,12.501000000000815,2803.529411764706,36,19,24,55
2610,23.19700000000109,3159.2105263157896,42,14,28,56
2611,20.847750000000357,3279.75,27,17,38,44
2612,7.062500000000513,2623.6315789473683,27,15,32,42
2613,22.418500000000762,3325.1111111111113,37,20,41,57
2614,21.483750000000583,2995.0588235294117,34,14,31,48
2615,36.25350000000148,4620.35,61,25,23,86
2616,14.910500000000706,2630.4210526315787,30,10,38,40
2617,11.747000000000567,2484.235294117647,23,21,59,44
2618,8.957000000000601,2557.8888888888887,33,11,34,44
2619,-0.9772499999997022,2182.1666666666665,19,12,31,31
2620,-0.48549999999919635,2028.611111111111,21,13,34,34
2621,15.37275000000063,2929.0714285714284,33,11,33,44
2622,37.68875000000044,2515.375,50,10,32,60
2623,4.510250000000802,2459.9411764705883,25,14,37,39
2624,22.442750000000643,2731.6470588235293,35,18,33,53
2625,14.347000000000293,2377.0555555555557,21,14,41,35
2626,40.38575000000145,4521.8421052631575,63,15,31,78
2627,17.019750000000645,2420.25,37,11,33,48
2628,10.769750000000759,2583.3333333333335,36,21,30,57
2629,23.63050000000114,3715.5,42,22,31,64
2630,13.23725000000061,2860.2631578947367,19,21,45,40
2631,5.354750000000655,2520.529411764706,36,13,29,49
2632,10.94300000000005,2454.294117647059,34,21,34,55
2633,25.130500000001085,4285.45,48,12,38,60
2634,9.982250000000992,4029.684210526316,38,26,30,64
2635,36.32350000000075,4783.8,49,27,25,76
2636,28.828750000000856,2438.125,42,10,40,52
2637,20.832000000000697,4096.55,39,8,32,47
2638,32.78350000000127,4338.55,55,16,26,71
2639,12.410000000000881,3638.7894736842104,31,27,20,58
2640,31.00350000000075,3785.842105263158,36,26,47,62
2641,24.475250000001587,2948.3529411764707,46,16,30,62
2642,12.839000000000231,2467.5789473684213,18,10,42,28
2643,45.18250000000121,3397.529411764706,66,21,38,87
2644,39.8002500000013,4502.95,49,10,42,59
2645,29.24450000000137,3534.6,47,17,25,64
2646,30.524500000001098,4933.85,59,18,38,77
2647,15.823000000000771,3511.7,40,25,24,65
2648,12.262250000000853,2993.625,31,20,49,51
2649,35.4960000000019,2103.8125,50,19,56,69
2650,27.881250000000886,3874.3,40,20,39,60
2651,22.37925000000109,2478.75,49,14,35,63
2652,22.507750000001135,3328.35,46,14,25,60
2653,14.571750000001117,2430.133333333333,34,11,53,45
2654,40.75325000000149,3701.6470588235293,70,14,38,84
2655,6.534250000000908,2712.5,34,9,26,43
2656,10.039750000000716,2456.5,29,14,28,43
2657,8.444750000000768,2832.0555555555557,35,13,26,48
2658,14.138000000000655,3251.8888888888887,34,27,33,61
2659,43.04650000000208,3286.3529411764707,59,10,42,69
2660,28.886250000001922,5038.55,53,24,37,77
2661,23.586750000000727,2845.6923076923076,34,10,33,44
2662,40.90825000000128,2742.625,49,14,62,63
2663,31.28500000000098,2388.4375,46,8,44,54
2664,28.56875000000104,3385.684210526316,36,13,39,49
2665,22.95550000000079,2673.842105263158,26,11,52,37
2666,29.88700000000072,3803.75,36,14,42,50
2667,18.68150000000102,2759.777777777778,36,10,56,46
2668,15.327000000000812,2779.6923076923076,37,19,52,56
2669,14.647250000000463,2063.0625,28,17,39,45
2670,13.72600000000105,2670.6666666666665,41,11,37,52
2671,25.156000000000436,3379.95,32,12,35,44
2672,25.340750000000586,3058.6666666666665,42,13,47,55
2673,10.940000000000888,2690.9444444444443,34,20,56,54
2674,14.252500000000774,2471.0526315789475,31,8,33,39
2675,28.71625000000062,3150.157894736842,43,9,42,52
2676,20.599750000000686,3446.5789473684213,31,16,40,47
2677,7.51575000000067,2744.705882352941,32,10,29,42
2678,26.80200000000108,3766.6315789473683,60,21,56,81
2679,19.27950000000049,2450.6470588235293,32,14,39,46
2680,13.431000000000733,3440.15,25,17,46,42
2681,-1.3804999999991914,1911.25,29,19,22,48
2682,16.314250000000307,2580.3529411764707,31,16,31,47
2683,5.48250000000048,1988.3529411764705,25,21,49,46
2684,27.07275000000113,2932.6666666666665,47,9,37,56
2685,11.82100000000074,2440.9375,36,18,45,54
2686,17.89550000000063,2927.842105263158,30,24,31,54
2687,25.614750000000942,2882.1176470588234,51,11,23,62
2688,24.15400000000126,3860.157894736842,59,13,25,72
2689,15.82525000000066,2803.5882352941176,32,14,42,46
2690,39.26850000000178,4222.578947368421,61,12,33,73
2691,23.44750000000092,3390.2,39,18,22,57
2692,7.97200000000101,2572.0,34,11,21,45
2693,44.96850000000007,3111.5555555555557,63,17,53,80
2694,10.574250000000145,1929.0625,19,20,55,39
2695,12.303500000000561,3470.3,34,17,27,51
2696,8.164250000000685,2896.866666666667,32,7,36,39
2697,7.797500000000778,3450.222222222222,42,14,15,56
2698,22.797250000001966,3339.470588235294,50,26,21,76
2699,22.0257500000005,1912.6470588235295,28,13,47,41
2700,12.005000000000225,3013.2,26,17,37,43
2701,22.51200000000069,3586.157894736842,36,15,42,51
2702,23.19825000000151,3767.722222222222,55,17,30,72
2703,9.413250000000602,2217.4444444444443,25,15,36,40
2704,1.1042500000003224,2151.222222222222,15,19,45,34
2705,15.73675000000057,2680.3333333333335,26,21,57,47
2706,14.151000000000868,3212.6315789473683,34,16,41,50
2707,11.029000000000035,2245.2631578947367,25,12,60,37
2708,22.089000000000805,2799.0,42,17,35,59
2709,26.298000000000872,3706.777777777778,50,17,33,67
2710,9.02475000000045,2631.0555555555557,29,15,33,44
2711,26.725000000000954,3013.7368421052633,44,13,38,57
2712,11.00375000000062,2936.157894736842,32,15,21,47
2713,38.14300000000092,3706.777777777778,53,14,36,67
2714,29.471250000000992,3119.176470588235,57,19,28,76
2715,41.29000000000174,3165.3333333333335,60,8,39,68
2716,20.225500000001137,3158.5,49,7,20,56
2717,37.4362500000012,4746.7,59,19,22,78
2718,19.24175000000092,2625.625,39,12,35,51
2719,26.1942500000011,3688.842105263158,48,20,25,68
2720,19.703250000000885,3530.9473684210525,38,20,42,58
2721,12.33875000000046,1964.75,27,17,32,44
2722,16.752750000000706,3490.0526315789475,41,14,26,55
2723,13.916750000001395,3816.222222222222,59,27,22,86
2724,6.213250000000661,2556.0555555555557,38,22,41,60
2725,6.2247500000005385,2693.125,31,8,27,39
2726,11.15225000000046,2605.315789473684,34,11,48,45
2727,47.57600000000176,4556.95,59,21,44,80
2728,5.808250000000582,2312.6666666666665,26,16,28,42
2729,23.287250000000714,3014.470588235294,34,23,52,57
2730,24.92500000000164,2855.75,51,16,24,67
2731,18.058250000000704,2707.6153846153848,34,12,30,46
2732,10.67950000000017,2028.7777777777778,23,8,36,31
2733,24.14375000000126,5088.6,49,19,40,68
2734,49.70050000000132,2495.5,54,13,31,67
2735,0.8015000000002634,2109.842105263158,16,14,41,30
2736,36.51500000000078,3605.5882352941176,49,30,34,79
2737,14.038500000000885,2459.0,33,15,27,48
2738,37.22825000000133,4542.65,62,8,30,70
2739,20.313250000000984,3516.4,38,19,23,57
2740,17.18125000000169,3343.5555555555557,52,13,28,65
2741,44.755250000001915,5611.65,60,21,38,81
2742,25.238750000001517,5093.35,64,12,19,76
2743,4.3087500000009245,2463.5555555555557,35,11,20,46
2744,1.2342500000002214,2472.0,20,15,30,35
2745,36.55050000000075,3281.0,44,22,27,66
2746,11.04475000000044,2489.6470588235293,32,15,25,47
2747,28.939000000001055,4175.85,53,21,24,74
2748,24.33025000000132,2927.6470588235293,53,18,36,71
2749,18.60875000000114,2776.0,36,13,29,49
2750,34.61600000000119,1947.9375,45,11,46,56
2751,14.35825000000052,2686.764705882353,27,28,30,55
2752,8.503000000000501,2375.6875,33,19,42,52
2753,6.821500000000441,2174.222222222222,18,13,30,31
2754,0.841750000000823,2298.5555555555557,30,17,21,47
2755,0.05150000000064908,2005.0588235294117,18,14,45,32
2756,20.637750000000864,3302.157894736842,48,17,41,65
2757,16.62025000000135,3946.722222222222,52,11,34,63
2758,34.90325000000142,4693.0526315789475,64,20,30,84
2759,29.773500000000432,3266.1052631578946,32,19,29,51
2760,23.585750000000523,3112.5,33,25,48,58
2761,15.790500000000824,2206.866666666667,32,9,22,41
2762,-2.3372499999995386,2017.3529411764705,20,22,32,42
2763,28.57125000000081,4189.4,47,21,37,68
2764,29.44125000000151,4423.5,48,16,36,64
2765,12.66050000000077,3320.5263157894738,27,24,38,51
2766,15.591000000000687,3555.3,39,17,25,56
2767,21.850750000001607,2934.125,59,18,35,77
2768,-6.356499999999601,2866.0,15,23,41,38
2769,10.268750000000566,2824.1176470588234,32,22,46,54
2770,30.011250000001088,2540.176470588235,34,16,47,50
2771,9.209500000000629,2389.4375,30,11,45,41
2772,25.813500000000385,3072.3684210526317,39,20,40,59
2773,4.386500000000895,2391.764705882353,30,17,31,47
2774,20.64625000000102,4260.1,41,35,31,76
2775,7.635500000000254,1959.6315789473683,18,14,44,32
2776,23.94725000000104,2912.764705882353,48,14,28,62
2777,34.03650000000103,4253.736842105263,54,15,39,69
2778,37.112000000000876,4835.4,67,14,21,81
2779,19.355000000000963,3627.9473684210525,41,19,29,60
2780,18.659250000000387,3037.157894736842,44,11,18,55
2781,21.869750000000746,2674.1666666666665,35,23,35,58
2782,26.711750000001626,3285.3333333333335,60,11,21,71
2783,41.88925000000177,4605.35,63,17,30,80
2784,39.85225000000116,2485.5625,51,11,33,62
2785,25.457250000000887,4562.4,45,27,33,72
2786,19.687500000001656,3983.2,51,18,18,69
2787,11.184750000000628,2440.7368421052633,25,12,62,37
2788,22.288250000000588,3255.4210526315787,44,17,24,61
2789,19.76725000000136,2880.0588235294117,50,13,17,63
2790,10.717750000000882,2756.5263157894738,35,13,39,48
2791,18.811500000000603,3327.6666666666665,45,18,30,63
2792,30.864750000001287,3430.0,59,23,33,82
2793,28.059250000000826,2924.8823529411766,42,24,39,66
2794,-8.116249999999502,2204.315789473684,19,22,31,41
2795,33.17575000000059,4460.789473684211,51,20,37,71
2796,13.4592500000013,3122.9,48,13,22,61
2797,11.304500000001223,3425.6315789473683,47,25,31,72
2798,29.077750000001146,3699.7894736842104,51,14,37,65
2799,31.737250000000888,2946.875,54,29,32,83
2800,11.28700000000033,2800.3333333333335,22,16,40,38
2801,31.149500000001705,3074.294117647059,64,17,23,81
2802,22.491000000001314,4355.473684210527,60,20,25,80
2803,4.499750000000659,2224.5882352941176,24,14,44,38
2804,17.989500000001094,3407.9444444444443,41,16,28,57
2805,9.26125000000024,2762.4210526315787,33,18,38,51
2806,4.953000000000733,2616.6875,31,23,17,54
2807,7.023500000000327,2454.3529411764707,33,13,26,46
2808,39.28150000000068,5026.7,47,22,22,69
2809,9.281250000000941,2852.7368421052633,31,19,38,50
2810,25.740250000000707,4168.75,46,23,22,69
2811,2.1575000000005216,2615.7,22,12,28,34
2812,40.42250000000123,5018.8421052631575,63,21,34,84
2813,20.64150000000032,2748.315789473684,27,19,27,46
2814,28.34775000000072,2521.4375,46,12,46,58
2815,22.853250000001086,3837.05,50,4,28,54
2816,22.037250000000316,3059.3529411764707,52,25,31,77
2817,31.186000000000966,4435.4,44,20,34,64
2818,29.776250000000992,4199.7,51,15,27,66
2819,38.41175000000181,2057.0625,53,12,60,65
2820,20.131500000000997,3291.5555555555557,50,19,32,69
2821,25.872500000000837,3824.2631578947367,38,19,43,57
2822,32.55950000000057,2333.0,41,13,49,54
2823,60.370250000001555,2518.133333333333,74,17,45,91
2824,29.320250000001256,4138.7,53,20,30,73
2825,2.2032500000005855,2641.1176470588234,28,14,19,42
2826,50.89700000000081,4155.35,49,12,35,61
2827,4.474500000000324,2206.8888888888887,17,18,36,35
2828,21.929750000001004,3433.6666666666665,42,20,35,62
2829,10.643500000000781,2798.9411764705883,40,12,37,52
2830,41.716750000001646,4091.5789473684213,65,7,26,72
2831,42.20475000000165,4139.4375,81,19,23,100
2832,21.475500000001173,2756.5384615384614,42,15,33,57
2833,35.21375000000133,5019.55,61,15,37,76
2834,26.458000000001334,2663.4117647058824,55,21,37,76
2835,-6.629999999999773,2106.7,14,20,29,34
2836,33.78750000000066,4418.8,59,13,27,72
2837,17.077000000000986,4186.15,39,18,39,57
2838,20.25800000000077,3235.222222222222,49,9,26,58
2839,26.471500000000724,3470.7894736842104,38,16,22,54
2840,27.6347500000006,2854.0555555555557,36,16,32,52
2841,7.187000000000758,2623.684210526316,30,20,27,50
2842,10.499750000000757,2373.5,23,8,32,31
2843,10.238500000000602,2344.1176470588234,30,20,38,50
2844,25.633250000001055,3446.684210526316,46,12,21,58
2845,11.312250000000981,2998.0526315789475,40,14,28,54
2846,17.949750000000982,2600.6,43,24,20,67
2847,4.397000000000906,2519.0555555555557,24,21,20,45
2848,33.788250000000765,2870.705882352941,42,19,27,61
2849,-3.3677499999994973,2168.9444444444443,19,14,31,33
2850,17.808500000000723,2990.722222222222,47,10,29,57
2851,22.531750000001555,4064.8,45,26,41,71
2852,33.992250000001434,3433.764705882353,59,17,24,76
2853,33.35625000000114,4785.5,56,17,30,73
2854,12.89275000000086,3432.6428571428573,48,8,18,56
2855,2.9487500000005187,2635.3888888888887,32,23,24,55
2856,21.698250000000762,4003.65,35,18,28,53
2857,42.54850000000153,5292.65,63,21,32,84
2858,17.34500000000133,3224.4210526315787,50,15,25,65
2859,30.910000000001457,5045.8,54,21,40,75
2860,22.872000000000845,3967.8947368421054,50,20,19,70
2861,-0.04549999999915321,2065.764705882353,29,20,23,49
2862,6.421000000000096,1429.0,9,15,45,24
2863,5.187000000000978,2572.0,36,13,39,49
2864,15.723000000000875,3262.8947368421054,43,14,33,57
2865,43.12600000000092,1786.7333333333333,43,17,48,60
2866,8.656250000000737,3151.7368421052633,29,16,43,45
2867,6.249250000000652,2672.5,27,18,30,45
2868,21.864000000001052,3074.35,40,11,26,51
2869,-5.090249999999009,2613.9411764705883,31,27,27,58
2870,15.082250000000656,2346.0,27,21,25,48
2871,13.998250000001388,2734.214285714286,39,12,29,51
2872,25.371750000001917,3895.0,59,14,22,73
2873,13.842250000001092,4500.55,54,21,18,75
2874,19.866250000000242,2941.9473684210525,31,25,28,56
2875,0.8402500000003951,2121.3333333333335,23,16,34,39
2876,10.66200000000079,2419.823529411765,35,16,27,51
2877,33.72175000000125,4478.4,56,22,29,78
2878,39.52650000000169,2476.866666666667,60,19,50,79
2879,32.249500000001554,4167.15,64,17,16,81
2880,3.482000000000368,2639.8333333333335,19,19,44,38
2881,26.28850000000052,3362.2631578947367,37,18,29,55
2882,14.249500000000697,3190.222222222222,49,15,18,64
2883,47.40825000000156,4985.4,74,13,38,87
2884,11.099750000000332,2674.3,28,8,39,36
2885,5.917500000000826,2789.1052631578946,28,16,31,44
2886,42.22600000000152,4463.15,66,15,28,81
2887,13.855750000000722,3000.5,28,17,33,45
2888,31.509250000000907,3261.1176470588234,46,14,38,60
2889,22.778750000000937,3240.2631578947367,42,20,33,62
2890,50.61500000000146,5406.9,68,13,32,81
2891,36.016000000001306,4283.05,60,12,33,72
2892,12.940500000000416,2857.5555555555557,33,18,32,51
2893,14.784500000000227,2977.5555555555557,30,15,62,45
2894,9.679500000000207,2611.6111111111113,26,22,53,48
2895,16.876750000000495,2666.315789473684,22,12,45,34
2896,30.989000000001,2887.5882352941176,46,18,33,64
2897,10.668250000000556,2548.4736842105262,24,10,38,34
2898,12.584500000000327,3673.5,31,17,24,48
2899,17.2542500000004,2353.529411764706,32,21,45,53
2900,34.847250000000834,3334.55,35,20,37,55
2901,8.28250000000055,2771.5625,26,12,26,38
2902,42.76600000000133,4335.631578947368,55,18,37,73
2903,8.113750000000515,2581.157894736842,24,11,39,35
2904,18.312500000000618,2589.4736842105262,30,7,41,37
2905,22.308750000000405,2663.722222222222,28,8,55,36
2906,30.979250000000583,4788.65,39,16,39,55
2907,34.592250000001044,2983.777777777778,44,17,36,61
2908,17.840750000000853,2628.785714285714,38,10,45,48
2909,39.91225000000109,4106.05,52,12,34,64
2910,5.047250000000981,3210.2105263157896,38,19,27,57
2911,5.373500000000351,2866.45,18,20,45,38
2912,11.933000000000302,1981.111111111111,22,12,60,34
2913,18.550250000000624,2583.9375,37,8,34,45
2914,13.566750000000814,3288.7368421052633,31,20,41,51
2915,24.078250000000942,3206.0,42,9,40,51
2916,11.66125000000037,2524.3333333333335,20,21,48,41
2917,11.667500000000505,2782.0588235294117,33,20,34,53
2918,15.61825000000059,2764.157894736842,32,13,36,45
2919,14.897750000000238,3662.777777777778,31,30,57,61
2920,13.62800000000035,2976.176470588235,32,24,34,56
2921,53.05225000000138,5256.15,69,15,42,84
2922,21.558250000000747,3158.3333333333335,36,20,33,56
2923,29.906500000001643,4745.7,62,18,27,80
2924,24.4532500000005,1876.5,25,12,62,37
2925,32.6462500000009,3150.1052631578946,36,16,35,52
2926,22.21450000000076,2524.266666666667,39,16,35,55
2927,7.670250000000623,2286.125,29,23,31,52
2928,29.690500000000657,2491.5625,39,22,39,61
2929,19.228250000001243,2882.3333333333335,34,18,36,52
2930,12.4497500000006,3070.684210526316,30,16,36,46
2931,21.487000000000442,2714.764705882353,35,20,34,55
2932,31.330750000001366,3917.722222222222,34,34,33,68
2933,31.021250000001533,4199.944444444444,52,35,43,87
2934,15.069250000000427,2100.3529411764707,26,14,48,40
2935,8.713750000000532,3373.2105263157896,22,23,42,45
2936,28.560750000000787,3657.1052631578946,46,20,37,66
2937,14.145000000000369,2432.823529411765,30,13,41,43
2938,41.130500000000566,4947.35,45,27,38,72
2939,9.91300000000048,2256.4117647058824,23,22,26,45
2940,12.77350000000114,2168.6666666666665,33,15,29,48
2941,33.81250000000093,3649.684210526316,44,29,24,73
2942,6.8010000000006245,2842.722222222222,27,20,38,47
2943,43.31325000000099,3920.45,44,19,38,63
2944,8.378000000000785,2148.6,31,16,31,47
2945,37.119250000000896,3935.1666666666665,58,9,40,67
2946,25.88175000000092,4197.4,43,23,36,66
2947,31.477000000000935,3984.6315789473683,54,13,39,67
2948,29.11175000000058,3571.8888888888887,35,18,46,53
2949,15.829750000001308,4029.7368421052633,39,26,42,65
2950,32.24725000000136,2607.75,47,26,45,73
2951,29.854000000001328,2976.294117647059,49,15,36,64
2952,40.43225000000128,5450.55,52,28,27,80
2953,12.232500000000606,2551.5714285714284,27,13,46,40
2954,12.273250000000461,2631.8333333333335,23,18,37,41
2955,12.885250000001284,3657.9473684210525,45,18,20,63
2956,21.47750000000071,4708.45,41,20,26,61
2957,14.810500000000479,2560.4444444444443,30,16,51,46
2958,29.394000000000727,3378.9473684210525,40,8,39,48
2959,2.84750000000021,2005.235294117647,19,17,41,36
2960,28.780250000000812,3638.1052631578946,37,14,47,51
2961,25.13275000000064,2853.222222222222,37,17,23,54
2962,9.834750000000676,2455.842105263158,28,13,51,41
2963,43.53550000000083,2755.5,45,18,54,63
2964,10.444750000000427,3151.3333333333335,26,19,47,45
2965,30.016250000000987,3295.6470588235293,46,18,59,64
2966,31.5800000000011,4065.65,43,15,43,58
2967,36.334750000000234,2723.1176470588234,31,15,49,46
2968,14.612750000000602,3203.0,33,16,26,49
2969,42.59650000000095,4282.894736842105,50,16,36,66
2970,30.809500000001254,5156.95,40,31,48,71
2971,11.022250000001005,3207.9444444444443,35,28,23,63
2972,29.38975000000101,3607.6,38,17,31,55
2973,29.920750000001306,5003.65,43,19,39,62
2974,24.930000000001137,2590.5555555555557,33,17,40,50
2975,25.675500000000284,3462.5263157894738,26,18,46,44
2976,16.376750000000552,3176.0,30,13,31,43
2977,6.065500000000439,2531.764705882353,23,10,42,33
2978,25.455250000000532,3263.5789473684213,32,10,56,42
2979,8.039250000000196,2303.0,18,15,51,33
2980,43.96700000000063,2377.266666666667,46,14,41,60
2981,23.54175000000051,2450.9375,30,13,51,43
2982,27.4242500000004,2532.3125,23,18,53,41
2983,12.390000000000338,2483.8333333333335,18,15,43,33
2984,36.73025000000098,3130.5,41,21,52,62
2985,14.116750000000632,2221.8333333333335,22,15,41,37
2986,12.771750000000582,3717.95,15,21,50,36
2987,24.637500000000696,3741.5789473684213,38,18,44,56
2988,37.844750000001,4942.55,49,21,33,70
2989,36.97000000000113,4824.35,59,18,25,77
2990,32.88025000000069,3714.8,36,13,51,49
2991,30.22075000000076,2175.125,35,22,67,57
2992,33.869000000001066,4370.684210526316,48,20,40,68
2993,10.801250000000215,2194.705882352941,19,12,49,31
2994,20.586750000000876,3390.5263157894738,28,17,50,45
2995,11.297000000000818,3996.55,29,25,45,54
2996,26.832750000000637,4710.85,30,22,49,52
2997,27.356000000000705,2606.529411764706,33,10,51,43
2998,4.2352499999999305,2262.3333333333335,20,17,40,37
2999,24.65450000000093,4469.65,44,14,46,58
3000,5.448500000000038,1657.25,14,13,57,27
3001,22.163000000000515,2627.0,37,11,27,48
3002,13.543000000000333,3103.7,18,19,35,37
3003,24.406750000000958,3541.05,45,7,39,52
3004,14.31500000000049,3175.8947368421054,33,17,39,50
3005,25.731750000000766,3395.6315789473683,38,12,45,50
3006,24.873250000000663,3542.7368421052633,34,11,46,45
3007,9.49500000000051,2748.0,26,16,44,42
3008,52.97225000000138,4239.5,45,13,71,58
3009,32.595750000000606,2477.6875,39,11,42,50
3010,18.688500000000722,3102.8333333333335,37,13,47,50
3011,14.464250000001044,2883.277777777778,39,15,30,54
3012,11.545750000000607,2541.1176470588234,29,15,37,44
3013,30.32075000000006,3092.8823529411766,29,19,62,48
3014,3.7767500000007184,2605.315789473684,30,10,27,40
3015,9.15925000000061,2429.0588235294117,28,18,40,46
3016,23.473250000000903,3873.5789473684213,45,13,44,58
3017,37.401000000001126,4943.35,35,22,63,57
3018,29.85575000000078,3058.6666666666665,38,12,51,50
3019,47.45025000000088,5051.4,46,13,46,59
3020,8.68075000000055,2787.4736842105262,26,16,32,42
3021,19.50225000000043,2710.1176470588234,29,20,54,49
3022,7.807500000000712,2102.294117647059,26,16,48,42
3023,12.385750000000591,2753.722222222222,29,13,45,42
3024,9.97200000000024,2564.3684210526317,19,9,35,28
3025,9.53500000000015,2095.722222222222,18,14,64,32
3026,27.592250000000597,2954.8333333333335,35,7,45,42
3027,27.104000000001214,3300.294117647059,42,27,57,69
3028,19.361750000000605,2432.125,27,15,41,42
3029,36.253500000000585,3769.9473684210525,36,15,38,51
3030,43.06775000000065,4502.05,45,10,49,55
3031,28.723750000000717,4155.2,31,19,49,50
3032,14.995750000000758,2710.076923076923,29,12,44,41
3033,50.33500000000107,5226.8,50,20,54,70
3034,8.900500000000866,2781.1176470588234,33,14,41,47
3035,5.741500000000168,2648.8947368421054,21,9,51,30
3036,20.928750000001102,3127.5555555555557,42,23,45,65
3037,26.968500000001438,3914.4736842105262,45,10,46,55
3038,24.71975000000077,3437.470588235294,35,29,59,64
3039,6.565250000000226,2810.8947368421054,16,15,53,31
3040,24.42400000000074,3181.764705882353,38,16,44,54
3041,18.93400000000071,3690.95,33,10,48,43
3042,18.756500000000567,3143.529411764706,42,15,33,57
3043,35.40825000000069,3749.0526315789475,35,20,56,55
3044,21.83325000000054,3581.157894736842,34,10,48,44
3045,33.08125000000029,4714.05,39,18,71,57
3046,9.796250000000787,2779.1875,42,25,49,67
3047,28.746250000000543,3192.8333333333335,38,20,48,58
3048,36.335250000000826,3800.9473684210525,41,13,38,54
3049,0.9785000000003405,2332.9444444444443,13,15,63,28
3050,24.710000000000537,3328.0,25,17,50,42
3051,40.972500000001205,4495.7,52,16,48,68
3052,18.17200000000049,3125.0,23,15,61,38
3053,12.682500000000086,2592.7894736842104,18,15,45,33
3054,21.03525000000086,4459.210526315789,50,18,48,68
3055,4.055999999999998,1543.3333333333333,14,24,58,38
3056,3.7737500000002875,2384.375,27,19,48,46
3057,47.341000000001216,4952.95,53,6,41,59
3058,12.03375000000063,2754.9473684210525,30,11,42,41
3059,38.957250000001046,3986.2,47,8,42,55
3060,10.726750000000475,2516.277777777778,19,12,43,31
3061,27.482500000000925,4065.684210526316,46,22,36,68
3062,15.368750000000304,2744.8333333333335,29,20,84,49
3063,11.575000000000948,2576.9375,35,16,45,51
3064,16.95950000000041,2067.764705882353,22,14,66,36
3065,41.77050000000133,4387.0,55,12,41,67
3066,-2.8747499999995942,1982.888888888889,15,14,44,29
3067,11.650750000000887,2628.4444444444443,28,8,36,36
3068,39.36250000000062,3821.7894736842104,37,15,43,52
3069,43.96725000000153,2482.8125,54,16,49,70
3070,32.64125000000051,3940.2,33,20,43,53
3071,14.934250000000342,2454.3529411764707,23,15,36,38
3072,30.444750000000603,3639.3,39,12,44,51
3073,21.15875000000057,2455.6111111111113,27,12,41,39
3074,30.57350000000087,4604.55,54,11,40,65
3075,30.229750000000784,4342.6,40,18,45,58
3076,22.95000000000058,3056.1,28,10,43,38
3077,29.79725000000086,3202.176470588235,43,14,44,57
3078,24.43000000000089,4790.2,32,21,45,53
3079,10.214000000000429,2701.5555555555557,28,9,43,37
3080,40.32450000000084,4218.421052631579,55,15,51,70
3081,27.420250000000816,3768.75,34,13,46,47
3082,33.404000000000835,3430.0555555555557,34,16,49,50
3083,29.350750000000744,3047.2631578947367,31,17,57,48
3084,-1.5077499999996302,2122.8,13,9,37,22
3085,31.325000000000887,4264.8,42,12,32,54
3086,29.283000000001078,3725.15,43,11,39,54
3087,34.86075000000108,4732.315789473684,46,19,55,65
3088,11.349000000000322,2608.222222222222,28,11,42,39
3089,28.469500000000636,4123.5,39,14,30,53
3090,44.31900000000138,4301.35,52,10,47,62
3091,39.304250000000835,4067.15,41,13,47,54
3092,17.295500000000725,2905.277777777778,28,11,35,39
3093,18.18200000000037,2454.875,29,20,31,49
3094,17.17475000000012,2446.9375,36,31,53,67
3095,24.537000000001647,4027.5,53,11,33,64
3096,33.25550000000045,3528.4210526315787,37,12,48,49
3097,21.21800000000041,2588.823529411765,41,14,62,55
3098,-1.9757499999996715,2328.7894736842104,18,11,33,29
3099,21.354750000000926,2999.6470588235293,42,16,35,58
3100,39.375500000000784,3889.3888888888887,45,18,62,63
3101,32.583250000001,4100.6,44,10,48,54
3102,28.550500000000795,3167.1666666666665,32,18,46,50
3103,11.545750000000524,1916.125,22,14,57,36
3104,48.05750000000101,4485.894736842105,51,15,41,66
3105,2.6092500000006167,2577.842105263158,31,7,33,38
3106,13.422500000000678,3287.0,40,18,27,58
3107,17.216250000000784,2934.3888888888887,40,18,38,58
3108,8.370250000000285,1803.4117647058824,14,17,40,31
3109,42.2300000000012,4749.75,45,30,50,75
3110,10.269250000000445,2543.722222222222,27,20,42,47
3111,19.93375000000102,2406.823529411765,37,18,48,55
3112,11.548750000000478,2725.8125,26,18,32,44
3113,24.184250000000727,2804.8,31,10,41,41
3114,18.408750000000477,3169.55,36,16,25,52
3115,-1.6532499999998236,2050.8333333333335,14,17,30,31
3116,22.51175000000072,2013.5882352941176,26,13,54,39
3117,15.526000000000744,2957.3333333333335,31,17,50,48
3118,33.26450000000084,3548.1111111111113,39,27,40,66
3119,34.1792500000005,4140.9,36,16,30,52
3120,20.746000000000805,2708.1052631578946,32,9,37,41
3121,16.222750000000694,2835.0526315789475,34,22,30,56
3122,20.632000000000556,2693.8947368421054,31,10,39,41
3123,27.976250000001055,3130.1666666666665,44,16,32,60
3124,34.314000000000746,2918.4444444444443,38,8,40,46
3125,33.06725000000144,2900.705882352941,51,17,48,68
3126,30.096500000001345,3869.55,50,14,25,64
3127,46.14075000000129,4899.0,47,20,50,67
3128,35.723750000000926,4017.3684210526317,44,21,53,65
3129,46.231000000001686,2929.529411764706,52,16,48,68
3130,40.26475000000117,4003.8947368421054,44,21,41,65
3131,11.147500000001044,3237.05,39,13,36,52
3132,20.24725000000095,3425.6666666666665,33,23,27,56
3133,27.59275000000099,3860.2105263157896,44,19,30,63
3134,59.70600000000159,4876.9473684210525,64,18,53,82
3135,13.727500000001267,3239.5882352941176,41,15,29,56
3136,12.824250000000657,2813.823529411765,31,19,29,50
3137,21.42600000000052,2813.125,42,23,45,65
3138,33.15800000000077,3768.0,46,12,34,58
3139,13.73425000000097,4484.210526315789,28,26,50,54
3140,14.81825000000077,2830.8125,37,27,40,64
3141,28.47900000000077,4248.15,33,26,41,59
3142,35.146000000000946,4538.473684210527,40,16,65,56
3143,17.84075000000134,3785.8947368421054,54,18,24,72
3144,42.07075000000064,4670.578947368421,57,17,32,74
3145,-0.9037499999993399,2525.4,27,13,34,40
3146,26.198750000001098,4470.4,46,23,25,69
3147,42.428250000001086,3420.5882352941176,56,19,25,75
3148,32.83000000000193,4317.9,62,19,34,81
3149,26.54400000000094,3900.2105263157896,55,15,30,70
3150,28.20125000000113,4091.9,47,12,31,59
3151,13.364500000000536,2353.4117647058824,31,22,33,53
3152,8.334500000000528,2638.8947368421054,28,16,29,44
3153,35.12075000000126,4241.0,54,16,28,70
3154,5.605750000000677,2561.6,24,13,24,37
3155,14.181750000000566,2739.842105263158,33,13,29,46
3156,30.051250000001097,2318.0625,36,18,51,54
3157,13.886500000001144,3643.7894736842104,44,14,44,58
3158,1.9432500000004715,2941.4,25,10,36,35
3159,9.433000000000698,3526.0,29,27,29,56
3160,57.47775000000196,5226.85,75,17,27,92
3161,41.7237500000016,3895.3684210526317,51,16,45,67
3162,25.052500000000734,2989.0,37,11,31,48
3163,23.918500000001288,2879.176470588235,45,23,38,68
3164,28.148000000001247,5014.0,43,24,29,67
3165,12.362250000000733,2645.0666666666666,28,20,36,48
3166,25.422750000000967,4360.25,33,27,41,60
3167,29.63525000000093,3726.7,44,19,24,63
3168,22.38125000000048,2155.375,24,20,57,44
3169,23.062250000000724,3262.7894736842104,37,19,35,56
3170,-4.076999999999519,1995.1666666666667,21,17,32,38
3171,32.978250000001125,3834.6,51,13,35,64
3172,41.223000000000674,4587.75,45,27,24,72
3173,1.815500000000437,2020.0588235294117,20,14,40,34
3174,-0.6349999999995707,2753.5714285714284,27,14,21,41
3175,16.335250000001334,3858.45,58,12,28,70
3176,26.037750000000454,2763.3529411764707,39,16,49,55
3177,17.846000000000952,3119.0526315789475,39,15,22,54
3178,10.376500000000478,2255.5,26,9,48,35
3179,35.52175000000106,3426.75,42,13,35,55
3180,27.329500000000543,4182.3,37,19,27,56
3181,19.019500000001017,3962.1052631578946,50,20,32,70
3182,3.997250000000844,3414.9473684210525,39,19,46,58
3183,5.5300000000003795,2094.8125,29,15,48,44
3184,20.137250000001536,3618.8,39,13,39,52
3185,17.930250000000562,2617.8947368421054,25,12,33,37
3186,37.45875000000113,4738.55,63,15,24,78
3187,13.418750000001058,3437.4736842105262,39,10,40,49
3188,4.806750000000926,2446.764705882353,37,19,34,56
3189,20.234000000001174,3032.3333333333335,48,15,37,63
3190,8.607500000000472,2045.2941176470588,21,14,44,35
3191,21.217500000001372,4925.263157894737,47,37,36,84
3192,28.05250000000155,4040.684210526316,59,16,26,75
3193,22.491000000000785,2945.722222222222,37,20,35,57
3194,20.576750000000708,3508.4736842105262,48,13,28,61
3195,-12.908500000000123,1429.0,11,23,33,34
3196,35.68250000000207,4864.1,64,21,25,85
3197,3.478250000000343,2206.875,21,17,29,38
3198,15.664500000001073,2606.5882352941176,37,18,32,55
3199,5.345250000000572,2509.315789473684,22,21,25,43
3200,13.66250000000073,3170.777777777778,41,21,27,62
3201,20.5772500000013,3781.55,54,12,25,66
3202,6.709000000000873,2472.4736842105262,32,12,20,44
3203,23.30600000000146,3322.4444444444443,52,17,22,69
3204,17.15000000000042,2804.125,35,28,18,63
3205,43.12975000000232,4571.9,77,9,23,86
3206,19.411750000000797,3069.842105263158,38,21,16,59
3207,6.325250000000951,2346.0,31,21,37,52
3208,-11.5562499999997,2063.157894736842,10,27,50,37
3209,20.379250000001143,4429.15,62,7,20,69
3210,28.75800000000088,1956.875,43,15,29,58
3211,-3.3572499999992615,2074.6111111111113,25,19,34,44
3212,-13.566999999999599,1981.1666666666667,18,26,32,44
3213,31.458750000001324,4769.55,64,15,19,79
3214,12.731750000000517,2403.8823529411766,40,22,23,62
3215,30.3555000000023,4573.526315789473,72,22,18,94
3216,25.062000000001344,2437.0,46,9,27,55
3217,18.88050000000053,4601.25,52,24,35,76
3218,30.50950000000116,2782.3125,46,21,25,67
3219,44.053500000001286,4582.0,63,22,30,85
3220,9.560000000001112,4011.0555555555557,46,24,23,70
3221,10.207500000000907,3129.9473684210525,39,18,33,57
3222,30.07275000000137,5056.95,61,19,23,80
3223,20.047500000000756,2909.722222222222,49,18,26,67
3224,37.24325000000154,3196.9375,66,21,45,87
3225,13.629500000000524,2873.5,43,14,18,57
3226,26.424750000001694,3047.176470588235,66,11,33,77
3227,10.971250000000577,2556.133333333333,34,14,16,48
3228,26.921000000000333,4745.75,46,24,29,70
3229,-9.70274999999899,2645.6470588235293,26,30,23,56
3230,12.679000000001409,2554.0,44,25,26,69
3231,22.95125000000109,3060.1,37,15,40,52
3232,21.962000000000895,2527.375,43,16,29,59
3233,31.32200000000135,2978.176470588235,51,16,26,67
3234,12.572000000000262,2325.8888888888887,37,27,23,64
3235,-1.088249999999647,2039.0,17,15,31,32
3236,17.518500000001076,3326.8888888888887,36,24,32,60
3237,34.19075000000157,5108.55,67,15,25,82
3238,42.788750000000896,5394.25,58,20,24,78
3239,-1.3379999999991747,2632.1052631578946,35,13,28,48
3240,19.320750000001105,2974.1111111111113,51,11,19,62
3241,30.341750000001348,3658.684210526316,54,21,21,75
3242,31.364500000002018,4540.25,60,22,23,82
3243,11.978500000001068,2302.0625,34,15,30,49
3244,51.843500000001384,2769.8823529411766,56,14,53,70
3245,18.41350000000119,4754.35,59,17,32,76
3246,30.738750000001527,4498.473684210527,62,19,22,81
3247,11.744750000000703,2468.777777777778,31,14,41,45
3248,18.684000000001287,2625.5,45,20,25,65
3249,25.172750000001102,3095.75,46,12,18,58
3250,-0.2797499999986496,2520.529411764706,33,21,31,54
3251,8.527000000000573,2372.5555555555557,26,15,32,41
3252,0.9705000000005336,2099.75,21,25,40,46
3253,12.035500000001353,3725.9,56,8,21,64
3254,25.096250000000666,2823.9411764705883,45,20,36,65
3255,6.068500000000872,2824.0588235294117,44,22,13,66
3256,24.503000000000803,3133.777777777778,48,20,28,68
3257,4.2105000000003425,1429.0,16,11,47,27
3258,6.450000000000644,2563.5882352941176,31,18,37,49
3259,27.77075000000093,2583.9375,48,9,27,57
3260,5.4362500000008085,2551.5714285714284,36,15,27,51
3261,12.65550000000049,2364.6470588235293,29,24,44,53
3262,14.354500000000664,3049.9473684210525,44,8,28,52
3263,22.032250000000964,3198.0555555555557,55,11,24,66
3264,23.57775000000102,2667.176470588235,41,17,29,58
3265,44.01050000000042,5100.5,75,9,26,84
3266,17.897750000000855,3942.6,52,11,18,63
3267,13.058750000001249,3515.1052631578946,45,18,18,63
3268,29.731750000000766,2720.714285714286,43,13,31,56
3269,-8.905499999999794,2221.25,16,23,33,39
3270,15.154500000000738,2830.9473684210525,35,17,36,52
3271,23.993500000001482,2692.0625,48,24,18,72
3272,26.69750000000098,3794.2,46,11,22,57
3273,28.128000000000412,3864.85,39,16,38,55
3274,37.31650000000141,3245.176470588235,61,12,32,73
3275,26.49100000000119,4510.75,49,20,29,69
3276,4.413000000000762,2555.2105263157896,36,12,19,48
3277,33.048750000000844,3117.4210526315787,42,20,41,62
3278,11.33650000000124,2484.5625,43,21,13,64
3279,8.319000000000848,3020.6315789473683,34,20,22,54
3280,21.824500000001358,4159.35,55,18,20,73
3281,20.05400000000085,3016.4444444444443,36,19,41,55
3282,37.409750000001544,5445.0,79,15,29,94
3283,25.519000000000734,3487.5789473684213,38,20,25,58
3284,6.008750000000868,2612.9285714285716,44,17,34,61
3285,38.69375000000106,3584.4444444444443,49,18,48,67
3286,34.3600000000004,3316.3684210526317,39,16,40,55
3287,33.74350000000198,4462.55,73,11,11,84
3288,6.8487500000011226,3045.6315789473683,41,22,23,63
3289,16.53600000000119,3528.5263157894738,43,25,26,68
3290,20.76500000000058,2884.4210526315787,41,12,26,53
3291,7.654750000001028,2579.85,30,13,28,43
3292,9.66525000000062,2548.222222222222,30,13,41,43
3293,13.206750000000639,2859.9285714285716,37,14,31,51
3294,10.397500000001218,2565.6,35,16,33,51
3295,9.590000000000561,2442.3333333333335,29,17,36,46
3296,23.542500000000086,3191.0,36,22,30,58
3297,47.42575000000218,4858.6,77,8,27,85
3298,30.572500000001003,3303.0,42,23,33,65
3299,38.993000000001196,3757.277777777778,59,10,21,69
3300,21.853250000001378,3819.2631578947367,55,11,33,66
3301,21.053750000000424,2911.823529411765,39,15,35,54
3302,2.192250000000972,2168.529411764706,24,19,45,43
3303,9.64625000000067,2488.4736842105262,29,22,24,51
3304,31.93150000000143,4153.65,56,11,45,67
3305,38.29375000000177,3629.823529411765,65,11,19,76
3306,7.836000000000608,2681.4736842105262,39,13,36,52
3307,25.326500000001612,4280.7,55,20,31,75
3308,16.324500000001187,3822.5789473684213,40,23,42,63
3309,9.099500000000692,2218.3888888888887,25,12,46,37
3310,26.320750000000515,3467.5789473684213,40,20,47,60
3311,27.694750000000834,3532.15,40,16,39,56
3312,11.61375000000154,2579.9375,41,16,35,57
3313,25.51975000000113,3534.9444444444443,55,15,30,70
3314,15.897250000000799,2735.9444444444443,32,16,46,48
3315,23.502500000000623,3067.95,40,4,51,44
3316,-1.6852499999997943,2094.1052631578946,18,14,35,32
3317,7.741500000000426,2879.8,22,14,37,36
3318,10.610000000000483,2546.764705882353,34,14,41,48
3319,14.579750000000724,2311.3333333333335,25,14,41,39
3320,32.463250000001004,3982.8333333333335,53,18,21,71
3321,36.24200000000052,4688.8421052631575,47,26,24,73
3322,22.430999999999965,2794.8947368421054,25,21,44,46
3323,4.317750000000243,2059.8947368421054,16,11,43,27
3324,18.039500000000658,2534.0666666666666,29,19,35,48
3325,22.555250000001713,4800.45,58,20,31,78
3326,13.564250000000792,3341.0,36,17,28,53
3327,23.515250000000627,1955.8125,32,13,45,45
3328,22.83825000000062,3261.6111111111113,46,11,22,57
3329,19.164750000000716,2321.875,34,13,34,47
3330,33.288500000001136,4123.6,61,13,26,74
3331,5.428500000000782,2485.8947368421054,33,17,17,50
3332,29.24225000000053,3728.9444444444443,40,17,46,57
3333,11.633250000000986,2634.4666666666667,36,16,60,52
3334,34.21700000000094,3819.65,50,10,30,60
3335,18.884250000000403,2157.3125,29,15,63,44
3336,33.21025000000175,4154.45,68,8,26,76
3337,15.421750000000904,2601.0,41,11,29,52
3338,22.28975000000097,3433.2105263157896,37,10,48,47
3339,53.08100000000066,3652.277777777778,61,20,54,81
3340,21.540750000000564,2723.1052631578946,38,9,35,47
3341,29.151000000001357,3495.3888888888887,59,15,19,74
3342,22.826750000000523,2513.176470588235,36,14,24,50
3343,28.599000000000427,2622.8,37,19,26,56
3344,11.219750000000493,2727.1176470588234,32,11,30,43
3345,23.08525000000069,2679.6111111111113,35,10,41,45
3346,2.3572500000003354,1979.3333333333333,18,9,41,27
3347,27.354750000001168,4129.1,41,17,35,58
3348,15.46325000000048,2473.277777777778,28,13,40,41
3349,25.772250000000998,4245.263157894737,40,17,37,57
3350,40.80225000000094,3623.0555555555557,48,25,38,73
3351,7.23400000000076,2568.4444444444443,27,15,41,42
3352,21.3600000000007,3157.5555555555557,29,25,33,54
3353,39.91150000000081,4025.764705882353,57,15,21,72
3354,26.78900000000031,2330.9375,35,22,42,57
3355,22.092000000000645,3197.7368421052633,41,10,25,51
3356,14.400750000000405,2867.684210526316,34,12,47,46
3357,7.871500000000007,1429.0,19,12,42,31
3358,-5.678249999999964,1765.1176470588234,15,25,42,40
3359,49.519000000001085,4606.85,59,10,41,69
3360,25.51250000000094,2465.0666666666666,43,7,39,50
3361,27.720500000000648,2501.153846153846,35,13,34,48
3362,23.741500000000432,3134.5555555555557,32,21,34,53
3363,27.103250000000475,3379.842105263158,33,10,39,43
3364,15.202500000001175,1969.611111111111,30,13,66,43
3365,28.027000000000708,4913.9,43,26,38,69
3366,45.10575000000061,3785.3333333333335,49,15,28,64
3367,23.837500000000748,4143.35,44,20,32,64
3368,26.62525000000092,3786.95,35,21,34,56
3369,23.998750000000427,3255.4210526315787,26,15,51,41
3370,21.18150000000104,3100.7894736842104,46,15,25,61
3371,16.079000000000796,3600.222222222222,41,24,56,65
3372,34.102250000001746,4813.2,66,24,22,90
3373,20.693750000000826,3357.55,39,18,30,57
3374,-2.288499999999406,2568.5789473684213,28,24,43,52
3375,26.644250000000437,3532.277777777778,42,20,39,62
3376,45.24875000000186,4732.3,58,17,33,75
3377,16.715500000000244,2499.6666666666665,21,17,62,38
3378,24.974500000001008,3793.3,39,14,24,53
3379,15.817250000000888,2876.6666666666665,53,8,16,61
3380,-1.6804999999994021,2534.6470588235293,27,14,19,41
3381,25.41225000000093,4371.95,56,12,20,68
3382,6.976000000000694,2552.3,37,12,14,49
3383,5.149250000000342,2139.705882352941,16,16,36,32
3384,32.64725000000109,5018.8,59,18,31,77
3385,23.439250000001024,2300.125,41,15,29,56
3386,34.28550000000095,4133.9,45,22,38,67
3387,15.76950000000023,2226.3333333333335,13,12,48,25
3388,38.37300000000095,4312.45,61,10,29,71
3389,16.64575000000052,3240.315789473684,37,16,21,53
3390,45.54250000000118,3957.3333333333335,47,17,52,64
3391,21.444750000000543,3845.8,44,14,37,58
3392,5.214000000000002,2051.35,13,7,50,20
3393,46.21300000000143,3037.8823529411766,48,14,39,62
3394,30.2312500000007,3068.5555555555557,38,19,37,57
3395,42.320750000001055,3409.722222222222,51,9,43,60
3396,25.35175000000112,3162.777777777778,36,25,49,61
3397,7.402750000000583,1429.0,18,24,48,42
3398,12.23800000000027,2354.0555555555557,17,14,48,31
3399,53.922750000001635,4710.578947368421,67,13,47,80
3400,31.502250000001403,3820.470588235294,58,18,34,76
3401,10.039250000000983,2092.75,33,24,30,57
3402,24.30400000000099,4461.736842105263,49,21,35,70
3403,4.981750000000492,2079.85,20,11,27,31
3404,52.46775000000137,3821.235294117647,64,21,40,85
3405,19.164250000000614,3540.2631578947367,41,23,48,64
3406,16.90975000000027,2649.6111111111113,30,9,42,39
3407,24.111000000001116,4240.3,50,12,28,62
3408,43.41775000000053,3580.722222222222,57,18,41,75
3409,20.437750000000936,3781.6,51,15,16,66
3410,14.587750000000739,2467.3529411764707,34,18,26,52
3411,20.175750000000704,2869.5,27,8,47,35
3412,7.5285000000000695,2039.0526315789473,10,10,48,20
3413,-1.726749999999503,2079.8333333333335,24,9,37,33
3414,35.269750000001345,3459.1666666666665,57,7,33,64
3415,14.425250000000322,2277.8823529411766,34,27,33,61
3416,13.447500000000513,2785.3333333333335,26,20,43,46
3417,4.814750000000596,2106.0,18,18,61,36
3418,44.74550000000087,5237.789473684211,65,17,45,82
3419,16.97025000000047,2646.2,29,14,37,43
3420,15.645000000000447,2406.6470588235293,33,12,35,45
3421,29.738750000001414,4604.45,52,13,41,65
3422,43.43200000000064,4179.9,48,13,41,61
3423,27.04750000000069,3225.2,36,13,44,49
3424,37.41800000000138,5410.05,62,13,31,75
3425,6.218000000000793,3136.3333333333335,30,21,36,51
3426,31.33800000000045,2629.2,49,18,44,67
3427,27.713500000000664,3882.25,31,10,58,41
3428,25.657500000001313,3825.9,46,17,38,63
3429,22.8952500000008,2580.875,36,28,42,64
3430,27.197000000001434,3574.4210526315787,52,17,30,69
3431,34.60700000000165,4512.684210526316,49,11,42,60
3432,27.14700000000053,3069.277777777778,33,12,29,45
3433,26.058250000001436,3652.25,54,17,28,71
3434,19.15825000000087,3016.3888888888887,50,21,36,71
3435,28.831500000000823,5333.05,32,34,58,66
3436,28.295250000001165,4253.7,49,24,31,73
3437,38.28350000000062,4820.35,47,18,35,65
3438,17.934750000000978,2744.764705882353,31,18,34,49
3439,25.440500000001073,3087.5263157894738,38,15,37,53
3440,14.470500000000689,3127.5,34,12,30,46
3441,24.045500000000835,2995.0,48,14,25,62
3442,4.219500000000531,2104.5,15,10,42,25
3443,46.16775000000107,5195.05,62,14,23,76
3444,27.168250000001564,4483.1,56,13,26,69
3445,32.702250000000284,3585.3684210526317,46,11,36,57
3446,9.812250000000683,2048.1875,26,15,45,41
3447,19.679250000000728,3375.85,35,21,29,56
3448,32.68925000000103,4043.4,40,21,47,61
3449,33.89225000000099,4442.6,45,20,41,65
3450,37.66350000000103,2371.625,45,20,51,65
3451,36.356500000001134,2880.4375,42,25,36,67
3452,31.457750000001216,3683.0,45,16,27,61
3453,27.583000000000556,3041.0,28,15,46,43
3454,26.003750000000345,3056.4736842105262,31,14,39,45
3455,17.525500000001074,3811.7,44,20,37,64
3456,28.910750000000785,4027.5,42,13,36,55
3457,23.27350000000111,3917.7894736842104,54,17,25,71
3458,26.819250000000757,3825.8333333333335,34,30,56,64
3459,21.0602500000007,2943.875,47,14,35,61
3460,18.1732500000008,2662.529411764706,36,6,40,42
3461,40.99625000000063,3881.2105263157896,48,9,34,57
3462,28.919250000001103,3649.7368421052633,48,15,42,63
3463,30.67475000000071,3258.35,37,11,36,48
3464,6.87125000000024,2346.1666666666665,14,23,40,37
3465,33.35600000000051,3108.1111111111113,28,14,60,42
3466,28.77600000000076,4003.0,39,25,38,64
3467,3.533750000000135,1621.5,14,7,56,21
3468,21.791250000000954,4122.05,40,21,41,61
3469,29.791000000001212,3445.0,34,16,38,50
3470,26.173250000000632,4266.263157894737,39,27,51,66
3471,23.356500000000977,3697.45,46,20,21,66
3472,44.73825000000087,3983.85,43,12,45,55
3473,35.24000000000104,4240.15,44,19,48,63
3474,10.432000000000638,2732.2631578947367,28,17,39,45
3475,27.46725000000071,3595.6666666666665,59,19,35,78
3476,32.09875000000067,3009.0588235294117,38,16,46,54
3477,52.8885000000012,5417.15,65,15,40,80
3478,63.7747500000011,5758.5,60,25,49,85
3479,17.629250000001015,2358.0588235294117,33,13,39,46
3480,48.50825000000166,5214.75,65,18,39,83
3481,26.06450000000056,3786.684210526316,37,15,32,52
3482,27.489750000000463,2773.764705882353,32,22,40,54
3483,3.384500000000334,2206.1052631578946,17,8,36,25
3484,49.52525000000118,5310.15,65,14,35,79
3485,39.88850000000068,4712.35,40,20,39,60
3486,17.36550000000036,3073.470588235294,26,21,40,47
3487,43.303750000001266,2991.1176470588234,54,16,46,70
3488,10.14125000000045,2561.4444444444443,26,9,40,35
3489,15.51350000000112,3620.35,39,16,39,55
3490,42.13800000000078,4002.9,57,9,45,66
3491,2.99150000000052,2380.6666666666665,18,16,35,34
3492,14.15300000000077,2809.0714285714284,34,17,28,51
3493,30.281500000001206,4898.95,48,28,34,76
3494,38.0810000000012,3876.8947368421054,46,13,37,59
3495,22.487500000001138,2781.0588235294117,46,26,38,72
3496,4.096750000000166,2200.5,16,15,32,31
3497,13.166250000000408,2171.294117647059,26,11,52,37
3498,28.4220000000011,3454.9473684210525,44,15,41,59
3499,7.833250000000166,2076.4736842105262,13,10,44,23
3500,10.715250000000983,2391.0666666666666,39,22,32,61
3501,29.103750000000993,3517.222222222222,40,23,47,63
3502,29.943250000001036,2994.0833333333335,43,20,37,63
3503,58.11575000000099,5418.7,53,27,40,80
3504,25.74050000000158,4149.1578947368425,57,25,36,82
3505,22.440750000000243,2164.823529411765,19,21,45,40
3506,27.866500000001434,4150.65,51,21,31,72
3507,43.73950000000137,4962.3,61,14,41,75
3508,21.911000000000122,2393.375,36,31,45,67
3509,28.029750000000284,2660.705882352941,30,16,36,46
3510,32.72175000000152,4461.6,52,18,32,70
3511,27.89675000000063,3418.2631578947367,39,13,42,52
3512,14.63475000000048,2304.125,27,25,36,52
3513,40.92325000000061,2375.4375,42,17,52,59
3514,9.011000000000633,2852.3333333333335,31,24,29,55
3515,64.00725000000122,3435.5882352941176,70,23,44,93
3516,17.13250000000089,2355.5,24,32,44,56
3517,27.339000000001143,3064.8888888888887,40,21,45,61
3518,26.219750000000865,3616.0555555555557,35,22,50,57
3519,36.39925000000121,3107.277777777778,44,12,43,56
3520,24.66650000000073,2073.0,28,19,53,47
3521,36.314250000001046,4326.368421052632,65,7,37,72
3522,7.6042500000002935,2185.6666666666665,21,12,39,33
3523,6.558000000000225,2975.1,25,13,34,38
3524,13.877250000000592,3269.4736842105262,28,29,31,57
3525,37.66000000000066,4533.526315789473,40,20,47,60
3526,15.650250000000913,3898.95,30,18,35,48
3527,11.557750000000423,2766.5833333333335,34,22,28,56
3528,22.185500000000626,3394.7894736842104,30,18,32,48
3529,18.18475000000081,4519.55,33,25,44,58
3530,45.43900000000117,4896.55,57,17,27,74
3531,16.751250000000383,3318.842105263158,40,19,53,59
3532,17.563500000000897,2921.176470588235,32,20,39,52
3533,12.995750000000303,2138.315789473684,22,9,45,31
3534,28.43375000000147,4363.95,49,29,29,78
3535,27.92850000000044,2992.0588235294117,26,28,58,54
3536,14.330000000000785,2832.4117647058824,27,16,52,43
3537,1.740250000000368,2183.9444444444443,15,21,40,36
3538,19.59725000000045,2057.0,24,25,52,49
3539,10.67250000000069,2865.8571428571427,22,20,43,42
3540,42.96000000000067,4566.4,32,21,44,53
3541,17.509250000000407,2758.8888888888887,25,15,47,40
3542,23.055250000001358,3451.6315789473683,45,19,39,64
3543,26.03600000000107,4224.25,50,16,30,66
3544,17.324750000000464,3370.25,29,16,36,45
3545,43.20250000000126,3013.5882352941176,51,13,40,64
3546,37.02725000000071,5179.85,57,14,26,71
3547,43.51725000000048,4921.1,40,18,47,58
3548,25.397250000000433,2687.6111111111113,25,18,42,43
3549,0.3595000000002073,2072.777777777778,15,9,46,24
3550,31.813250000000643,3321.25,35,10,36,45
3551,17.982000000001108,2855.1111111111113,36,18,22,54
3552,15.577500000000876,3471.7368421052633,29,22,38,51
3553,13.586500000000745,2550.470588235294,32,22,30,54
3554,44.862250000001424,4338.277777777777,54,20,40,74
3555,19.846499999999942,1741.5,21,22,50,43
3556,26.72025000000064,3655.4736842105262,35,13,39,48
3557,36.133250000000764,2472.5333333333333,39,14,58,53
3558,13.295000000000167,2444.8888888888887,26,11,41,37
3559,8.562500000000517,2659.2,23,13,38,36
3560,15.20275000000078,5071.15,34,32,34,66
3561,35.773000000001495,4229.85,48,11,49,59
3562,28.085250000000872,2922.0555555555557,41,21,40,62
3563,37.398250000000736,3408.0,44,13,42,57
3564,3.7995000000002626,2016.2777777777778,12,20,51,32
3565,37.256250000000634,4157.65,51,13,38,64
3566,17.444750000000845,2620.529411764706,40,15,38,55
3567,45.08300000000104,3915.0555555555557,61,10,31,71
3568,18.669750000000185,2609.0555555555557,22,18,39,40
3569,21.290750000001182,3305.4736842105262,32,18,37,50
3570,26.23875000000077,2568.1176470588234,31,20,45,51
3571,32.47800000000088,2974.0,40,12,43,52
3572,37.70925000000072,2711.277777777778,42,12,38,54
3573,28.361000000000804,3966.315789473684,41,18,46,59
3574,29.08900000000014,3702.1,35,20,42,55
3575,41.89000000000158,3939.6666666666665,51,18,39,69
3576,32.19100000000071,3508.3888888888887,48,25,35,73
3577,54.70750000000193,4828.473684210527,70,13,32,83
3578,26.939750000000277,2851.7894736842104,22,21,49,43
3579,29.221000000001123,4725.95,45,15,38,60
3580,43.95775000000064,4918.8,42,18,35,60
3581,14.946500000000375,2888.55,30,12,33,42
3582,60.4600000000011,5406.15,77,10,26,87
3583,12.814750000000611,2496.294117647059,34,16,34,50
3584,25.752500000000317,2457.1176470588234,31,19,39,50
3585,19.807000000000897,2528.0,32,19,33,51
3586,33.71325000000094,3951.9444444444443,44,30,51,74
3587,16.426500000000512,2663.6111111111113,28,15,37,43
3588,16.758000000000756,2612.75,38,19,34,57
3589,28.224750000001062,4412.473684210527,48,30,37,78
3590,52.57275000000103,4396.473684210527,61,14,41,75
3591,21.72850000000145,3562.7894736842104,45,18,28,63
3592,17.314000000000796,3174.45,33,18,34,51
3593,22.531000000000827,3146.1111111111113,40,12,29,52
3594,16.863500000000762,2542.9411764705883,27,21,40,48
3595,17.07825000000066,2649.0,42,22,27,64
3596,30.191750000001413,3727.8823529411766,48,25,30,73
3597,23.79325000000089,3648.7368421052633,30,33,47,63
3598,20.35825000000069,3369.55,38,17,31,55
3599,5.169250000000302,3335.5263157894738,26,27,34,53
3600,16.142500000000908,3881.45,45,21,20,66
3601,20.525500000000868,2452.1111111111113,31,19,28,50
3602,42.01250000000115,4581.6,50,18,26,68
3603,15.656750000000532,2871.7894736842104,24,19,31,43
3604,24.864500000000707,3603.8,53,10,30,63
3605,23.984250000000635,2840.0555555555557,35,19,32,54
3606,52.0522500000017,5673.6,66,18,50,84
3607,59.83100000000151,5312.35,72,12,39,84
3608,19.15800000000027,2703.923076923077,25,21,39,46
3609,22.50075000000058,2983.05,29,26,35,55
3610,29.01175000000102,4217.15,48,19,22,67
3611,13.714000000000727,3090.4444444444443,23,27,33,50
3612,24.417500000000867,3667.9473684210525,38,22,34,60
3613,32.839000000001064,4262.4,40,25,43,65
3614,5.196750000000677,2556.05,24,13,31,37
3615,40.131250000001046,4648.8421052631575,46,29,43,75
3616,58.04325000000112,4901.210526315789,56,21,36,77
3617,16.238000000000657,2280.8333333333335,31,21,27,52
3618,9.936250000000436,2836.0,29,26,24,55
3619,13.995250000001253,3099.157894736842,43,20,21,63
3620,35.67350000000077,4482.95,44,15,39,59
3621,14.218500000000452,2185.4117647058824,26,20,35,46
3622,17.979500000000677,2880.6111111111113,30,24,39,54
3623,22.135000000000552,2684.0,26,25,35,51
3624,42.84250000000096,4012.4,51,13,31,64
3625,41.27375000000107,4733.2,60,14,34,74
3626,5.906500000001154,3087.8,40,21,18,61
3627,24.782250000000726,3951.95,46,22,26,68
3628,48.11775000000092,5070.4,55,21,23,76
3629,0.07700000000026695,1965.2222222222222,16,20,42,36
3630,13.61875000000081,3836.6315789473683,40,26,29,66
3631,10.161500000001018,3230.1176470588234,38,20,16,58
3632,34.77100000000108,4545.0,46,23,24,69
3633,31.384250000000794,2816.9375,39,27,24,66
3634,9.674250000001024,2914.222222222222,27,23,31,50
3635,44.91625000000165,4549.8,63,23,44,86
3636,12.502000000001036,2243.176470588235,32,17,37,49
3637,40.823500000000735,5289.4,43,24,34,67
3638,9.54225000000034,2491.7894736842104,24,16,30,40
3639,36.777000000001124,3643.5,59,20,15,79
3640,18.22825000000097,2676.8,33,22,35,55
3641,13.762250000000094,2020.1176470588234,21,11,56,32
3642,14.93875000000107,2952.1052631578946,37,22,31,59
3643,43.70225000000107,4007.6111111111113,56,22,32,78
3644,38.082250000001075,3373.0588235294117,56,13,37,69
3645,23.480750000001045,3125.842105263158,42,19,29,61
3646,32.51275000000057,2005.1764705882354,35,16,60,51
3647,15.921000000001001,3866.0526315789475,42,22,33,64
3648,30.99925000000108,4578.4,37,23,30,60
3649,-4.53749999999962,2019.6315789473683,16,19,22,35
3650,11.74875000000085,2596.176470588235,36,20,31,56
3651,18.92650000000119,3053.3888888888887,36,25,37,61
3652,33.43550000000079,3619.5789473684213,43,14,39,57
3653,37.000750000001254,3655.35,52,12,32,64
3654,32.246750000001114,2121.625,46,21,48,67
3655,18.36875000000058,2695.5789473684213,32,14,32,46
3656,29.54175000000073,4349.0,39,35,59,74
3657,24.34900000000105,3252.0,40,15,35,55
3658,22.87700000000097,3130.1666666666665,41,21,32,62
3659,27.040500000000748,3203.176470588235,45,15,23,60
3660,18.89800000000054,3628.0,25,30,36,55
3661,42.95750000000172,5379.15,61,25,25,86
3662,26.24275000000042,2551.470588235294,27,13,43,40
3663,27.053250000001366,3796.7368421052633,50,20,23,70
3664,38.46300000000122,3327.777777777778,50,11,41,61
3665,44.868250000001616,2501.0666666666666,61,10,46,71
3666,20.732000000000728,2673.705882352941,33,16,34,49
3667,28.254250000000923,4729.0526315789475,54,18,37,72
3668,15.44100000000044,2462.705882352941,26,22,42,48
3669,15.679500000000363,2771.0,31,12,31,43
3670,22.510000000000517,2538.3529411764707,39,16,35,55
3671,26.800250000001075,2638.235294117647,42,21,60,63
3672,20.55699999999993,2310.0,24,14,62,38
3673,23.90825000000097,3383.05,46,14,21,60
3674,12.86700000000096,3257.7368421052633,36,18,35,54
3675,33.91425000000062,3198.1666666666665,49,18,47,67
3676,28.532500000001345,4177.055555555556,58,21,31,79
3677,24.858250000000112,2638.1666666666665,35,24,59,59
3678,24.27325000000092,2589.6470588235293,36,15,38,51
3679,3.41600000000071,2815.9285714285716,28,21,24,49
3680,13.557750000001041,2227.866666666667,35,14,27,49
3681,31.971000000001084,3648.1052631578946,46,19,39,65
3682,8.293500000001169,2901.6111111111113,41,19,26,60
3683,21.752000000000734,3232.4,52,11,23,63
3684,37.472000000001415,3765.7894736842104,61,13,33,74
3685,12.867750000000498,2996.315789473684,27,20,33,47
3686,20.92250000000069,3670.35,39,26,28,65
3687,23.73875000000106,2618.6,36,15,36,51
3688,36.766250000000774,2460.8125,44,19,40,63
3689,29.762250000000734,2148.375,34,24,38,58
3690,-3.0090000000001136,1429.0,20,26,25,46
3691,21.927750000000355,2134.8823529411766,35,29,29,64
3692,31.222000000000623,2410.133333333333,48,9,22,57
3693,16.258750000000664,3899.75,51,11,34,62
3694,10.650000000000514,2806.5555555555557,35,21,37,56
3695,36.532000000001,4384.75,55,19,35,74
3696,9.822250000000835,3087.8333333333335,34,17,43,51
3697,9.042000000000233,2606.4117647058824,27,20,27,47
3698,36.09250000000083,4458.4,38,21,29,59
3699,30.38700000000038,2321.9375,56,24,26,80
3700,33.40900000000028,2807.1176470588234,44,26,23,70
3701,39.10575000000178,4774.3,58,17,29,75
3702,30.827500000001123,3638.7894736842104,49,15,26,64
3703,22.277000000000406,2201.875,23,20,57,43
3704,38.670500000001944,5588.6,58,24,32,82
3705,27.797250000001334,3650.4210526315787,50,10,35,60
3706,40.689000000000824,4345.526315789473,48,20,39,68
3707,41.98725000000142,2818.0,53,24,46,77
3708,15.478500000000585,2623.7894736842104,30,25,43,55
3709,8.049000000000454,2181.7894736842104,17,10,42,27
3710,42.93225000000214,4304.578947368421,61,27,40,88
3711,10.573250000000579,2620.4,32,12,28,44
3712,17.58800000000046,3440.2,24,24,34,48
3713,39.815750000001024,4257.75,53,17,38,70
3714,22.359000000000773,2393.4375,27,23,33,50
3715,38.6927500000012,3022.9411764705883,47,19,38,66
3716,7.876250000000539,2544.25,22,18,31,40
3717,-3.466999999999821,2338.1052631578946,13,16,37,29
3718,39.08300000000075,4642.9473684210525,49,21,49,70
3719,50.193750000001,4734.0526315789475,48,28,42,76
3720,15.28475000000033,2588.705882352941,31,21,36,52
3721,35.85850000000109,4305.2,48,22,39,70
3722,33.15750000000092,4512.45,46,29,34,75
3723,39.96400000000135,3521.6666666666665,56,12,36,68
3724,34.57525000000105,4249.75,51,13,37,64
3725,8.97800000000067,2421.0555555555557,27,21,23,48
3726,17.520750000000604,2593.4117647058824,27,16,42,43
3727,40.101500000001366,5183.0,57,22,39,79
3728,41.297250000000744,4680.75,43,22,42,65
3729,35.259750000000736,3780.8888888888887,43,17,40,60
3730,35.217500000001124,4373.105263157895,49,24,32,73
3731,6.4575000000005165,2402.9411764705883,21,23,37,44
3732,4.626500000000335,3214.3684210526317,28,21,33,49
3733,8.796000000000683,2888.4444444444443,35,17,33,52
3734,22.42325000000107,3034.7894736842104,44,11,53,55
3735,56.95975000000105,4095.6666666666665,69,29,52,98
3736,7.920250000000448,2254.529411764706,25,13,49,38
3737,32.81425000000107,4434.65,36,22,39,58
3738,33.007250000000646,2913.222222222222,36,19,44,55
3739,34.8665000000009,3832.684210526316,35,23,40,58
3740,9.327250000000525,2655.6666666666665,24,17,25,41
3741,26.707750000001464,2708.1176470588234,37,20,51,57
3742,66.71600000000126,5556.05,67,12,59,79
3743,34.711000000000844,4600.55,44,14,49,58
3744,21.543500000000478,2514.8,35,25,33,60
3745,31.705750000001235,4924.4,49,21,41,70
3746,29.751500000000355,3756.15,42,21,33,63
3747,41.76775000000109,3720.3,39,21,37,60
3748,6.865250000000328,2231.842105263158,14,13,49,27
3749,28.643000000000352,3064.0,30,15,42,45
3750,14.7935000000005,2561.4444444444443,22,17,30,39
3751,42.73175000000039,3923.684210526316,39,16,46,55
3752,12.546500000000806,3966.4,43,19,29,62
3753,21.269250000000735,3677.157894736842,29,17,37,46
3754,17.869750000000334,3782.3684210526317,32,16,52,48
3755,32.995250000000745,3142.470588235294,43,16,39,59
3756,31.305750000000764,3112.4736842105262,32,22,52,54
3757,19.66525000000029,2508.470588235294,23,15,38,38
3758,17.87875000000063,2489.1052631578946,20,9,48,29
3759,27.1510000000007,4724.25,32,17,44,49
3760,13.882500000000212,2252.529411764706,25,24,51,49
3761,16.082500000000557,2267.6470588235293,18,17,46,35
3762,21.087500000000475,2139.5882352941176,23,23,53,46
3763,10.548000000000261,3131.7368421052633,20,16,49,36
3764,29.825250000000626,2612.75,34,10,36,44
3765,35.17550000000075,3789.8333333333335,33,21,71,54
3766,28.34075000000042,2625.235294117647,30,12,30,42
3767,24.022000000000872,3222.625,28,16,45,44
3768,32.35825000000047,3169.315789473684,31,19,50,50
3769,23.027750000000424,3112.5,33,14,34,47
3770,47.08725000000111,3745.7894736842104,50,11,43,61
3771,16.915250000000473,3287.8947368421054,27,19,46,46
3772,17.682750000000034,2389.4444444444443,18,21,59,39
3773,11.008750000000438,2574.4210526315787,21,11,38,32
3774,18.43575000000056,3534.315789473684,19,17,61,36
3775,20.177500000000737,3853.75,30,18,43,48
3776,35.323250000001146,3706.5263157894738,44,14,49,58
3777,8.698750000000498,1982.6875,15,19,51,34
3778,28.843250000000666,3534.3684210526317,32,18,49,50
3779,22.84625000000046,4647.4,37,25,53,62
3780,40.39275000000086,4358.65,39,14,51,53
3781,41.878250000000655,5117.95,33,20,59,53
3782,32.493000000000805,4021.9,40,13,40,53
3783,45.33775000000087,3954.6315789473683,46,12,31,58
3784,28.368000000000926,2786.705882352941,33,16,54,49
3785,4.107250000000073,2757.0555555555557,15,20,46,35
3786,24.169250000001252,3674.4,42,11,40,53
3787,18.594000000000168,3409.2,21,14,41,35
3788,22.05775000000002,3027.315789473684,17,9,57,26
3789,29.245000000000527,3297.157894736842,33,8,51,41
3790,27.91725000000107,3853.75,43,17,37,60
3791,46.832000000000974,5128.95,37,20,68,57
3792,32.1400000000007,4127.421052631579,45,14,63,59
3793,26.78850000000059,2647.529411764706,29,5,73,34
3794,39.56775000000088,3068.705882352941,41,9,65,50
3795,23.118500000000264,3505.8333333333335,26,20,54,46
3796,25.377000000000617,2621.625,29,16,50,45
3797,30.60350000000063,3018.235294117647,37,19,50,56
3798,14.312000000000387,2123.5,20,14,41,34
3799,32.899750000000935,5030.65,37,13,57,50
3800,27.70525000000103,3076.1176470588234,36,19,47,55
3801,26.047000000000587,4014.0,42,14,45,56
3802,37.452000000000666,3883.8,34,25,36,59
3803,14.654000000000519,2173.176470588235,23,15,51,38
3804,22.054000000000766,3509.4736842105262,38,15,47,53
3805,29.239500000000724,3812.3,30,17,34,47
3806,25.822000000001236,4817.9,36,33,29,69
3807,22.906000000000617,2877.7368421052633,29,16,35,45
3808,57.41750000000214,2593.6428571428573,69,12,42,81
3809,26.604500000001018,3460.0555555555557,36,23,41,59
3810,36.19650000000084,3489.823529411765,54,24,65,78
3811,31.2895000000008,3405.35,36,18,49,54
3812,24.81650000000065,2708.157894736842,29,15,46,44
3813,12.833250000000413,2626.5555555555557,24,15,42,39
3814,17.500250000000698,2722.6666666666665,20,27,47,47
3815,7.789500000000311,2475.842105263158,21,22,28,43
3816,16.982250000000533,3219.0,25,33,37,58
3817,41.756500000001,3718.3333333333335,38,20,48,58
3818,38.8617500000012,4968.85,43,23,36,66
3819,20.656000000000706,3060.294117647059,39,25,28,64
3820,12.547750000001095,2610.8888888888887,36,16,30,52
3821,33.49625000000073,4773.55,40,28,53,68
3822,17.805000000000646,3106.3333333333335,27,23,38,50
3823,31.325250000001166,4268.05,45,22,41,67
3824,32.134250000000804,3753.0,36,17,33,53
3825,22.76975000000058,2580.8125,25,17,51,42
3826,12.865250000000424,3463.3684210526317,22,17,50,39
3827,-2.43574999999975,1983.7058823529412,15,18,41,33
3828,15.842500000000637,3206.8,38,11,35,49
3829,29.77625000000079,3894.866666666667,38,22,28,60
3830,16.919250000000083,2235.8823529411766,19,15,39,34
3831,26.15050000000071,2517.3888888888887,31,11,40,42
3832,20.07600000000064,2918.684210526316,29,17,37,46
3833,39.44500000000092,2431.0,49,14,53,63
3834,4.1797500000003405,1750.4375,23,29,41,52
3835,29.98800000000066,3090.5,33,14,42,47
3836,27.07275000000064,3432.4210526315787,35,21,34,56
3837,29.407250000000808,3232.7368421052633,33,8,52,41
3838,44.67050000000117,3631.9444444444443,43,23,66,66
3839,17.35975000000021,2144.3333333333335,18,14,38,32
3840,16.99550000000039,2666.375,19,13,37,32
3841,33.977000000000345,3305.4736842105262,39,14,36,53
3842,20.584500000000375,2853.4210526315787,23,13,61,36
3843,22.87575000000048,3029.6666666666665,28,16,40,44
3844,27.882000000000705,2598.8125,31,19,51,50
3845,18.41825000000068,2126.5,23,12,39,35
3846,25.819750000000575,2071.1111111111113,24,11,39,35
3847,7.7260000000003215,2063.0555555555557,14,17,39,31
3848,4.6890000000006715,2589.5789473684213,24,15,39,39
3849,22.96450000000124,2769.4375,35,19,35,54
3850,30.699000000000684,2417.0,39,15,60,54
3851,15.440250000000422,2600.1666666666665,23,16,47,39
3852,18.353750000001227,3826.7368421052633,54,19,39,73
3853,37.20700000000052,3983.85,35,23,33,58
3854,40.91025000000086,4694.866666666667,51,22,32,73
3855,23.61650000000122,3608.1666666666665,47,19,57,66
3856,21.154250000000594,2854.1111111111113,28,14,52,42
3857,54.19375000000171,5091.85,67,8,34,75
3858,24.10850000000079,3452.0,30,24,42,54
3859,29.732000000000518,3402.4736842105262,42,22,28,64
3860,38.38175000000048,4587.7,36,22,53,58
3861,23.13300000000039,2432.0625,29,15,44,44
3862,30.251000000000893,2598.625,36,20,42,56
3863,13.616250000000713,3258.684210526316,32,17,67,49
3864,49.654250000000495,3408.6470588235293,45,10,68,55
3865,14.116500000000112,1710.75,13,21,45,34
3866,22.91925000000044,3640.2,26,20,39,46
3867,20.076000000000178,3810.8947368421054,21,25,44,46
3868,37.696500000000846,4749.8421052631575,52,28,56,80
3869,57.28025000000106,2816.0625,43,25,47,68
3870,50.831750000001065,4837.85,55,18,40,73
3871,17.00025000000067,2600.0588235294117,29,23,38,52
3872,13.578500000000426,1955.8125,20,14,57,34
3873,39.2185000000016,3191.125,60,11,34,71
3874,30.952750000000435,2400.6,37,18,37,55
3875,17.32825000000053,3034.0,30,21,35,51
3876,22.918250000001102,3116.0555555555557,39,18,81,57
3877,39.203750000000554,3735.5,41,10,31,51
3878,15.531500000000596,3040.35,30,14,32,44
3879,60.584000000000984,4631.5,47,21,49,68
3880,7.857000000000386,2994.3333333333335,26,18,36,44
3881,36.02625000000047,3621.2,31,16,47,47
3882,40.70400000000069,3681.3684210526317,44,16,38,60
3883,14.192250000001085,4645.7,37,22,41,59
3884,39.1970000000009,2731.6875,31,20,58,51
3885,18.235750000000653,3081.722222222222,26,23,29,49
3886,25.727750000000952,3251.25,25,16,41,41
3887,30.16450000000046,2865.6111111111113,32,13,41,45
3888,39.119500000000436,3501.7894736842104,39,17,43,56
3889,17.74125000000044,2633.285714285714,27,11,44,38
3890,16.40125000000005,3007.65,20,13,46,33
3891,34.245750000000506,3956.2105263157896,35,21,51,56
3892,50.84300000000063,3538.5882352941176,45,26,34,71
3893,34.137000000000384,2888.6111111111113,33,12,59,45
3894,17.008000000000376,1994.8823529411766,24,14,60,38
3895,41.89275000000103,3280.6470588235293,53,21,64,74
3896,29.57525000000058,4065.55,30,28,47,58
3897,39.35975000000131,4435.4,51,14,33,65
3898,45.477000000001254,4639.35,51,17,45,68
3899,28.28525000000052,3504.8888888888887,46,17,62,63
3900,19.51925000000024,1925.125,24,19,66,43
3901,40.79425000000089,4468.0,46,20,40,66
3902,28.72450000000067,2896.0714285714284,31,16,68,47
3903,30.350000000001113,2442.9375,32,22,52,54
3904,14.800250000000375,3015.6,22,18,43,40
3905,1.7205000000000035,2084.277777777778,8,16,47,24
3906,17.23550000000016,2771.785714285714,19,17,58,36
3907,57.63350000000038,4376.526315789473,54,15,52,69
3908,-0.5272499999997804,1906.2222222222222,14,9,51,23
3909,14.17700000000084,2598.5789473684213,30,10,47,40
3910,26.37575000000039,3699.7368421052633,34,13,57,47
3911,38.02775000000089,3457.3333333333335,34,16,65,50
3912,24.535000000000434,3022.2631578947367,28,12,49,40
3913,13.31725000000091,3211.9473684210525,35,15,35,50
3914,13.329000000000297,1996.764705882353,18,10,52,28
3915,22.117750000000527,3829.15,25,16,47,41
3916,11.72775000000023,2494.2105263157896,15,9,58,24
3917,43.99150000000088,5122.8,41,17,43,58
3918,34.78500000000095,3080.1176470588234,35,17,40,52
3919,32.906000000000844,4113.315789473684,40,15,57,55
3920,18.569500000000566,2861.842105263158,22,14,50,36
3921,8.841750000000522,2638.076923076923,24,17,39,41
3922,17.358750000000143,2753.7,20,11,54,31
3923,10.946500000000226,1943.0,19,14,53,33
3924,33.02025000000016,2764.222222222222,33,14,67,47
3925,32.080750000000506,3712.45,27,15,61,42
3926,24.537500000000506,3146.0,35,18,59,53
3927,14.775000000000395,2301.125,22,17,33,39
3928,32.62650000000074,3041.3125,36,13,37,49
3929,26.50025000000121,4062.4,41,16,46,57
3930,39.35775000000042,3985.5263157894738,35,23,56,58
3931,32.00500000000022,3310.4736842105262,26,9,57,35
3932,32.55675000000075,2778.294117647059,33,9,60,42
3933,33.73900000000054,3102.0,30,15,55,45
3934,41.309750000000676,4008.0526315789475,41,10,42,51
3935,10.83125000000052,2798.25,21,10,42,31
3936,22.025500000000523,3027.722222222222,36,14,36,50
3937,17.242000000000623,2564.6923076923076,25,11,42,36
3938,39.42525000000066,3356.235294117647,43,23,77,66
3939,22.109000000000574,2609.625,26,11,46,37
3940,11.695500000000516,2480.3333333333335,24,14,47,38
3941,47.53625000000081,4487.85,45,10,50,55
3942,4.742500000000176,2117.4736842105262,11,17,48,28
3943,38.121750000000375,4256.0,35,17,44,52
3944,29.970000000000518,4350.55,33,12,51,45
3945,23.69300000000018,2686.3684210526317,19,16,56,35
3946,9.7582500000001,2125.5,17,14,42,31
3947,28.643750000000544,3095.7368421052633,33,14,49,47
3948,22.1697500000008,3283.85,32,12,39,44
3949,13.237750000000347,2674.7368421052633,28,17,39,45
3950,20.518750000000516,4002.157894736842,28,21,47,49
3951,17.861500000000856,3054.0526315789475,28,14,40,42
3952,26.017500000000645,2987.3529411764707,36,14,31,50
3953,47.0812500000016,4966.45,64,17,32,81
3954,31.310500000001202,4214.368421052632,51,19,44,70
3955,48.00475000000149,4243.25,59,16,35,75
3956,26.425500000000483,2750.5,36,15,28,51
3957,22.692000000000426,4226.65,24,25,39,49
3958,10.37575000000066,4460.05,28,21,38,49
3959,14.533500000000505,2776.153846153846,26,19,42,45
3960,57.889250000001006,4824.45,52,13,46,65
3961,63.103250000001424,5962.45,64,13,65,77
3962,9.954500000000024,1929.0555555555557,9,15,60,24
3963,24.872250000000754,3067.705882352941,39,28,47,67
3964,13.014250000000349,3220.315789473684,24,19,55,43
3965,31.538500000000926,3889.5,41,22,43,63
3966,36.52950000000058,4516.45,45,19,46,64
3967,24.13150000000054,3532.684210526316,39,18,50,57
3968,17.182250000001172,2168.125,38,12,40,50
3969,31.215000000001442,2972.3333333333335,42,13,50,55
3970,23.386750000000568,2463.6470588235293,24,16,34,40
3971,18.07600000000072,4218.0,33,25,31,58
3972,36.62825000000082,4596.55,41,15,56,56
3973,18.742750000000306,2441.4444444444443,19,14,65,33
3974,15.557000000000215,2457.3333333333335,24,18,61,42
3975,19.818250000000877,3775.9,41,19,29,60
3976,21.37725000000011,3000.4444444444443,34,32,40,66
3977,21.857500000000393,3271.9473684210525,28,14,43,42
3978,20.09725000000047,2661.6,27,12,34,39
3979,42.570500000000884,3944.1111111111113,43,19,39,62
3980,31.112000000000144,2780.235294117647,33,17,34,50
3981,51.2282500000008,5513.2,58,18,39,76
3982,18.12550000000023,2280.5882352941176,21,15,51,36
3983,10.081250000000201,2561.8947368421054,21,17,28,38
3984,19.830250000000312,2457.0588235294117,23,20,48,43
3985,31.444000000000415,3271.3333333333335,36,18,40,54
3986,11.605000000000455,2682.3529411764707,19,15,37,34
3987,17.6340000000005,3367.15,33,12,41,45
3988,13.22050000000078,3137.4736842105262,28,24,44,52
3989,58.95750000000072,4230.263157894737,51,19,61,70
3990,31.008250000000384,3161.0,41,16,45,57
3991,51.65575000000111,4261.1578947368425,61,22,26,83
3992,31.633750000000866,4044.1,42,10,44,52
3993,22.27275000000081,2646.2105263157896,29,16,39,45
3994,6.9507500000004825,1983.5882352941176,17,24,49,41
3995,19.54125000000098,2887.470588235294,33,17,34,50
3996,16.209500000000716,1630.4375,27,19,47,46
3997,23.6310000000008,2614.8823529411766,37,16,40,53
3998,39.25550000000067,2232.5625,43,21,38,64
3999,20.113750000000604,1971.4705882352941,21,22,38,43
4000,13.59200000000014,2235.705882352941,27,17,45,44
4001,13.20400000000057,3059.6111111111113,30,21,54,51
4002,6.95500000000077,2587.842105263158,25,8,35,33
4003,21.31050000000051,2521.375,27,17,25,44
4004,33.141250000000966,3643.0526315789475,43,14,42,57
4005,11.97875000000008,1429.0,18,11,62,29
4006,15.576500000000289,2538.5263157894738,24,18,31,42
4007,17.405000000000776,2524.277777777778,28,18,41,46
4008,33.73375000000145,4162.45,42,19,39,61
4009,27.302250000001333,4225.85,54,15,42,69
4010,12.624750000000361,3403.6,29,16,38,45
4011,43.55200000000117,4931.45,47,22,51,69
4012,22.38675000000074,3439.157894736842,33,16,32,49
4013,21.122250000001028,3245.722222222222,41,20,30,61
4014,23.56900000000051,3854.4,34,16,50,50
4015,18.588500000001012,3595.7,43,20,31,63
4016,39.834000000001055,2620.785714285714,52,22,51,74
4017,9.649250000000317,2752.85,25,13,36,38
4018,23.790500000000506,3008.0,30,10,38,40
4019,4.826250000000035,2223.55,10,13,38,23
4020,25.372250000000136,2215.294117647059,29,12,44,41
4021,17.88575000000045,2544.15,20,13,33,33
4022,39.4292500000009,3495.3333333333335,46,22,37,68
4023,22.742750000000548,2564.5333333333333,27,17,45,44
4024,23.394750000000716,3063.0,43,21,31,64
4025,39.62950000000064,3921.8,42,24,34,66
4026,18.94850000000123,2912.764705882353,44,12,45,56
4027,45.38450000000103,5409.15,56,20,38,76
4028,21.939000000000682,2166.1875,28,18,40,46
4029,29.22100000000131,4109.2,40,21,41,61
4030,16.765500000000326,2870.9444444444443,36,12,35,48
4031,50.47350000000096,4639.45,48,20,46,68
4032,35.022750000000656,3284.5,36,17,40,53
4033,32.93200000000071,2685.8823529411766,36,11,51,47
4034,27.887250000001274,3815.6,49,18,34,67
4035,8.949500000000949,2994.1666666666665,36,22,36,58
4036,20.45125000000057,2983.9473684210525,30,18,38,48
4037,29.669500000001086,2444.0,40,17,49,57
4038,7.195750000000463,2048.125,23,19,42,42
4039,26.444750000000873,4155.3,36,26,36,62
4040,22.7145000000008,3203.5789473684213,50,14,26,64
4041,9.66800000000007,2068.157894736842,10,12,42,22
4042,34.19575000000078,2861.470588235294,36,19,60,55
4043,32.263000000001384,3413.1666666666665,44,20,38,64
4044,7.585750000000397,2633.8333333333335,23,19,39,42
4045,17.50125000000053,4468.0,29,16,38,45
4046,30.26625000000094,3571.1052631578946,46,13,31,59
4047,33.21400000000049,3030.470588235294,36,18,27,54
4048,24.919000000000644,3183.5263157894738,34,21,37,55
4049,30.307500000000896,3550.8947368421054,44,15,41,59
4050,31.885500000000512,3453.8333333333335,38,10,34,48
4051,55.98100000000088,4651.4,56,18,48,74
4052,20.74150000000054,3071.8888888888887,38,24,37,62
4053,26.54200000000041,4155.25,41,25,29,66
4054,44.16525000000106,4406.15,45,24,39,69
4055,-7.202499999999493,2016.35,9,23,26,32
4056,9.802250000000537,2750.4117647058824,23,16,28,39
4057,62.696750000001984,5998.95,69,15,62,84
4058,27.279500000000873,3816.842105263158,42,17,31,59
4059,12.36275000000057,4582.736842105263,30,35,38,65
4060,44.2175000000007,2509.4117647058824,38,24,63,62
4061,19.11700000000061,2411.1875,37,17,37,54
4062,9.768250000000227,2366.625,25,34,60,59
4063,5.211750000000437,2694.7894736842104,21,25,29,46
4064,11.770500000000721,3863.5263157894738,24,31,31,55
4065,32.60425000000025,2018.25,30,19,44,49
4066,29.449000000001043,4486.95,42,25,33,67
4067,17.117500000000145,2586.9473684210525,23,13,36,36
4068,32.816750000000546,3060.5,41,12,58,53
4069,41.97325000000107,4176.944444444444,41,23,42,64
4070,45.25400000000063,3377.0,43,15,39,58
4071,8.705500000000136,2977.4,13,22,36,35
4072,34.762250000001195,5137.066666666667,43,34,38,77
4073,5.019750000000256,2005.1764705882354,16,23,47,39
4074,24.05650000000073,2527.1176470588234,30,13,39,43
4075,35.41500000000085,3774.35,41,15,50,56
4076,27.01650000000018,3056.1666666666665,33,17,77,50
4077,30.588000000001312,4218.7,47,23,35,70
4078,33.901000000000955,2677.125,52,16,53,68
4079,39.015000000000754,4793.5,38,23,44,61
4080,32.3057500000008,3595.75,34,17,39,51
4081,28.057000000000436,3429.15,30,15,38,45
4082,18.598750000000244,2418.2631578947367,24,15,43,39
4083,18.819250000000526,3054.5,33,16,34,49
4084,9.40400000000085,2823.3333333333335,21,32,31,53
4085,43.26450000000049,5029.85,40,18,37,58
4086,41.37425000000032,2496.5,35,13,44,48
4087,14.404750000000472,2134.5555555555557,18,16,38,34
4088,42.449500000000924,4775.9,42,25,52,67
4089,28.004000000000417,2971.5555555555557,37,11,40,48
4090,35.04225000000065,2975.3529411764707,36,26,57,62
4091,31.20350000000055,2507.470588235294,30,19,60,49
4092,20.639000000000316,1816.5882352941176,17,10,56,27
4093,24.688750000000777,3158.4736842105262,31,17,45,48
4094,28.01700000000064,3256.5,33,15,39,48
4095,31.74125000000074,3050.125,41,21,34,62
4096,28.506500000001125,3038.8823529411766,35,27,34,62
4097,49.65650000000069,5667.9,46,22,46,68
4098,24.9117500000005,2920.3888888888887,33,15,28,48
4099,25.700000000000493,3792.55,29,19,35,48
4100,13.082500000000342,1969.75,32,22,36,54
4101,39.09550000000101,4387.0,45,23,50,68
4102,23.45900000000102,2727.823529411765,39,24,43,63
4103,60.726500000001714,5524.25,75,19,35,94
4104,49.28475000000141,4184.833333333333,48,26,41,74
4105,40.87075000000112,3931.5,49,12,43,61
4106,34.695750000001176,4490.0526315789475,59,18,40,77
4107,28.971750000000725,2885.823529411765,38,13,37,51
4108,31.576000000001265,4738.65,50,25,31,75
4109,21.344750000000452,2327.6666666666665,27,16,40,43
4110,15.323250000001186,3771.9,37,14,38,51
4111,30.209500000001054,3616.0555555555557,34,22,39,56
4112,26.01225000000096,3725.6315789473683,44,16,41,60
4113,40.25300000000095,4112.473684210527,51,25,46,76
4114,36.742750000000676,2827.0625,47,18,42,65
4115,26.493000000000258,2611.176470588235,24,22,55,46
4116,26.841750000000662,3681.235294117647,42,24,32,66
4117,-2.4847500000000853,1429.0,9,19,59,28
4118,34.68900000000069,4487.9,36,23,43,59
4119,5.938000000000277,2101.8888888888887,17,21,42,38
4120,26.406750000000386,3028.3,25,17,36,42
4121,41.371500000000864,4410.0,38,20,45,58
4122,4.526250000000336,2171.1,11,13,40,24
4123,45.68675000000117,2902.375,55,17,35,72
4124,11.959000000000344,2589.875,27,20,31,47
4125,0.8330000000007308,2404.0,21,27,44,48
4126,10.407500000000475,2533.1666666666665,20,13,35,33
4127,24.042000000000733,2863.8333333333335,30,18,43,48
4128,28.943500000000302,3485.6666666666665,27,24,37,51
4129,42.25550000000037,3132.4615384615386,48,9,35,57
4130,26.58100000000031,3203.5789473684213,22,24,39,46
4131,14.981500000000532,2896.55,24,13,46,37
4132,6.868750000000526,2532.684210526316,21,14,31,35
4133,29.01775000000107,3967.157894736842,35,13,64,48
4134,11.087500000000103,2055.222222222222,16,14,55,30
4135,13.861750000000608,2999.5555555555557,37,17,35,54
4136,15.291750000000013,2160.294117647059,27,21,53,48
4137,33.984250000000756,3678.1052631578946,38,19,46,57
4138,42.3417500000008,4169.6,49,16,24,65
4139,17.179750000000457,2240.4117647058824,19,25,51,44
4140,16.904500000000425,2489.0555555555557,30,23,31,53
4141,38.60075000000081,4398.315789473684,41,21,57,62
4142,33.575500000001085,4064.842105263158,47,13,50,60
4143,28.630750000000603,2467.3529411764707,29,16,63,45
4144,34.40400000000076,2675.125,46,9,31,55
4145,50.37850000000121,4022.95,48,10,38,58
4146,38.704750000000814,3326.4117647058824,52,18,48,70
4147,24.516500000001223,3858.6315789473683,44,16,45,60
4148,33.461250000001144,4416.578947368421,45,19,47,64
4149,25.378750000000316,3277.2105263157896,34,16,48,50
4150,39.636250000000935,4079.1,44,12,43,56
4151,21.61500000000029,2756.85,24,6,45,30
4152,51.09225000000153,4285.421052631579,52,26,52,78
4153,44.183250000000925,5211.6,55,15,42,70
4154,26.346750000001002,4425.2,46,15,36,61
4155,19.577250000000237,2801.6923076923076,25,11,33,36
4156,39.445750000000906,4115.7,45,9,43,54
4157,7.767250000000365,2866.266666666667,19,23,41,42
4158,5.859000000000366,2847.684210526316,30,14,32,44
4159,15.974500000000711,3031.5263157894738,26,12,51,38
4160,21.128500000000578,2205.0,28,13,45,41
4161,13.975000000000616,2551.470588235294,30,10,49,40
4162,39.30425000000052,4483.0,38,22,53,60
4163,51.56275000000081,5347.9473684210525,50,29,62,79
4164,46.77800000000052,3030.4117647058824,41,12,45,53
4165,37.21075000000065,3474.705882352941,43,19,55,62
4166,42.46700000000046,2954.823529411765,37,19,47,56
4167,34.83300000000082,2690.470588235294,40,11,50,51
4168,38.65875000000126,4167.25,53,14,38,67
4169,19.243250000000604,2520.315789473684,24,14,33,38
4170,39.61575000000091,3516.4444444444443,45,12,45,57
4171,28.18775000000083,2837.1176470588234,31,17,43,48
4172,10.109750000000355,2432.823529411765,20,23,49,43
4173,27.691000000000393,3990.25,31,14,42,45
4174,26.38775000000029,3831.1666666666665,35,23,39,58
4175,25.180250000000463,2777.529411764706,27,16,45,43
4176,42.886750000000816,3889.3684210526317,39,18,36,57
4177,21.571750000000463,3044.7894736842104,25,15,51,40
4178,20.115000000000656,3428.3,33,12,31,45
4179,39.59650000000093,3637.85,41,10,41,51
4180,44.45650000000101,3656.2631578947367,43,16,45,59
4181,53.628750000001126,5276.85,55,20,41,75
4182,34.082250000001224,4008.9473684210525,50,19,36,69
4183,32.29650000000112,2920.3333333333335,43,15,47,58
4184,9.433250000000537,2201.294117647059,17,19,40,36
4185,12.655000000000566,2728.2105263157896,23,20,25,43
4186,27.047000000000832,3274.777777777778,33,17,47,50
4187,5.269250000000612,2196.842105263158,22,13,26,35
4188,39.42450000000075,4679.2,48,15,54,63
4189,17.76525000000026,2545.764705882353,26,11,44,37
4190,28.39250000000103,4320.421052631579,50,17,36,67
4191,5.505000000000457,2171.3529411764707,18,17,43,35
4192,52.302750000001026,4458.315789473684,58,13,39,71
4193,14.18200000000071,2246.5,32,14,37,46
4194,41.45725000000029,2364.625,38,19,38,57
4195,34.273500000000524,4013.9473684210525,34,25,41,59
4196,22.15275000000074,4409.25,30,17,45,47
4197,15.001250000000235,2074.9375,19,15,41,34
4198,52.755250000001,4806.85,48,8,53,56
4199,14.058500000000578,2855.0,24,19,36,43
4200,54.27825000000131,4726.75,59,19,43,78
4201,26.53500000000061,3775.85,31,21,34,52
4202,53.662500000001344,4262.789473684211,53,18,36,71
4203,64.29625000000075,4692.6,51,11,43,62
4204,38.109000000001416,3299.5,39,18,32,57
4205,32.329750000000786,3463.3684210526317,34,23,41,57
4206,21.70325000000012,2243.3529411764707,23,11,50,34
4207,23.035250000000197,1963.1764705882354,23,20,55,43
4208,14.872250000000571,2333.6875,35,13,27,48
4209,38.28550000000074,3226.0,34,22,37,56
4210,21.41775000000032,3275.3684210526317,28,16,50,44
4211,25.694750000000546,3726.65,34,18,34,52
4212,24.970250000000654,2395.375,27,22,37,49
4213,29.563250000000597,3626.0,32,17,35,49
4214,24.31050000000037,2933.4444444444443,28,14,52,42
4215,42.60125000000118,4282.25,42,23,39,65
4216,16.962750000000533,3667.15,26,20,46,46
4217,33.81125000000139,4710.05,37,22,42,59
4218,35.88375000000137,3753.2631578947367,44,21,54,65
4219,17.614000000000576,3238.5789473684213,37,19,43,56
4220,18.43500000000101,5491.7,31,35,46,66
4221,51.01775000000172,5314.15,60,22,45,82
4222,48.54175000000112,4496.944444444444,47,15,59,62
4223,58.2642500000012,4051.0,64,20,40,84
4224,26.514250000000466,3236.8947368421054,37,13,29,50
4225,24.90425000000122,2507.5,38,29,65,67
4226,-6.6567499999999615,1429.0,4,17,40,21
4227,10.739750000000415,2104.1176470588234,21,19,44,40
4228,27.534000000000155,2973.7894736842104,27,19,34,46
4229,-5.65274999999996,1429.0,3,22,34,25
4230,20.672000000000523,3652.15,29,22,26,51
4231,26.16625000000061,3202.5,35,28,47,63
4232,1.0852499999998737,1429.0,8,33,30,41
4233,20.24175000000066,3914.85,29,24,36,53
4234,20.760000000000538,2617.0526315789475,22,17,40,39
4235,27.017500000000894,5455.35,41,31,35,72
4236,27.796500000000368,3505.3,27,17,40,44
4237,11.954500000000433,1937.9375,14,21,64,35
4238,48.32275000000053,4548.2,50,19,36,69
4239,41.570250000001025,4030.5263157894738,44,13,54,57
4240,23.95000000000079,2803.470588235294,39,21,54,60
4241,31.40050000000043,3708.1052631578946,35,24,45,59
4242,33.9015000000006,3016.3529411764707,40,29,62,69
4243,22.663750000000228,2613.9411764705883,26,26,40,52
4244,24.63350000000051,3381.4444444444443,39,23,37,62
4245,30.090750000000888,3089.235294117647,39,11,42,50
4246,15.706250000000356,2403.823529411765,23,19,43,42
4247,47.37625000000103,3819.777777777778,36,26,40,62
4248,25.601250000000523,2643.823529411765,27,19,47,46
4249,17.961250000000803,3270.3529411764707,34,22,42,56
4250,11.724750000000572,3073.2105263157896,20,17,40,37
4251,35.49225000000063,4244.85,44,11,41,55
4252,24.035000000000622,2602.6875,28,19,49,47
4253,41.04200000000081,4570.35,37,18,56,55
4254,36.86475000000068,3569.3333333333335,45,18,53,63
4255,4.633750000000348,2046.388888888889,13,20,46,33
4256,27.8340000000004,2693.0,34,23,42,57
4257,41.97325000000048,3080.8333333333335,43,9,41,52
4258,11.266250000000351,2727.315789473684,18,18,38,36
4259,30.42950000000019,2660.25,32,22,58,54
4260,15.812500000000293,2740.3333333333335,23,15,41,38
4261,52.200750000001406,3492.6111111111113,62,26,67,88
4262,19.325500000000375,2971.3888888888887,21,21,49,42
4263,28.90000000000085,4979.9,45,28,33,73
4264,31.892000000000643,3506.684210526316,36,23,57,59
4265,14.371750000000716,3121.7368421052633,29,19,38,48
4266,23.510750000000375,3556.1052631578946,27,18,50,45
4267,27.712500000001103,3366.4375,58,21,24,79
4268,32.36025000000039,3724.6666666666665,35,24,39,59
4269,34.60675000000166,4693.3,54,19,25,73
4270,44.88175000000173,3849.8333333333335,63,16,39,79
4271,28.24950000000082,4487.0,43,29,40,72
4272,17.687250000000667,2431.9411764705883,30,17,38,47
4273,10.121250000000785,2057.0625,23,19,41,42
4274,39.17625000000088,3729.95,38,14,45,52
4275,33.928250000000865,3357.6666666666665,45,11,33,56
4276,1.9270000000001826,2374.4,16,14,35,30
4277,50.40575000000054,4940.2,50,19,43,69
4278,18.19500000000032,3731.4,30,23,38,53
4279,29.36950000000125,4447.4,56,15,26,71
4280,22.553750000000583,2922.0588235294117,32,19,37,51
4281,20.082250000000563,2693.6666666666665,30,21,35,51
4282,26.851250000000523,3382.3333333333335,31,23,36,54
4283,29.54875000000082,2248.823529411765,38,14,55,52
4284,51.84500000000146,2737.625,53,16,55,69
4285,24.730500000000685,3227.4117647058824,39,22,49,61
4286,-0.44099999999953343,2122.75,14,10,34,24
4287,38.48100000000036,4344.9,41,21,47,62
4288,31.24050000000048,2873.470588235294,40,24,37,64
4289,25.137250000001295,4034.65,47,11,37,58
4290,36.10450000000053,3852.8,40,12,44,52
4291,40.33700000000064,4255.421052631579,43,19,52,62
4292,22.991500000000734,3392.6,37,12,33,49
4293,41.340750000000824,4088.6,48,12,36,60
4294,26.588750000000516,4292.55,32,21,45,53
4295,24.68775000000044,3100.470588235294,36,20,35,56
4296,24.24300000000066,2578.470588235294,30,19,49,49
4297,9.025750000000256,2907.714285714286,21,19,36,40
4298,46.58550000000127,3480.529411764706,48,15,49,63
4299,11.002750000000226,1996.888888888889,12,18,54,30
4300,19.305500000000325,2881.9473684210525,28,9,35,37
4301,20.907000000000092,2330.4444444444443,21,11,39,32
4302,53.83825000000087,4436.95,45,18,50,63
4303,40.46975000000108,4452.578947368421,45,18,40,63
4304,43.15625000000094,4403.263157894737,47,23,32,70
4305,27.601500000000573,2035.1176470588234,26,8,52,34
4306,39.31975000000078,2971.6470588235293,35,12,58,47
4307,55.84350000000071,4760.1,48,14,57,62
4308,8.046250000000684,2822.176470588235,28,19,33,47
4309,25.335750000001084,3304.777777777778,36,26,42,62
4310,61.85750000000121,4849.85,52,15,48,67
4311,21.347000000000705,3774.157894736842,32,17,44,49
4312,26.672000000000935,3686.25,47,12,33,59
4313,27.152750000000594,2941.157894736842,32,18,32,50
4314,40.61125000000038,4553.8,42,15,44,57
4315,31.128000000001,2398.4666666666667,39,19,49,58
4316,33.757750000000684,3305.777777777778,35,19,34,54
4317,65.42025000000129,5735.55,62,17,47,79
4318,22.364750000000548,2592.222222222222,29,13,49,42
4319,16.22250000000054,2798.153846153846,27,16,40,43
4320,17.822000000000305,2980.75,23,19,35,42
4321,26.742500000000497,4687.0,41,21,38,62
4322,36.24675000000076,4406.9,47,16,37,63
4323,50.83875000000248,4964.1,67,17,38,84
4324,22.235750000000273,2687.5,26,16,37,42
4325,20.686750000001147,2763.3333333333335,32,13,41,45
4326,23.90100000000062,2109.5,26,11,54,37
4327,37.31625000000063,4634.55,32,23,43,55
4328,21.597000000000627,3123.3684210526317,34,20,46,54
4329,28.626750000000243,2581.3529411764707,31,19,48,50
4330,24.102000000000505,2925.5555555555557,31,11,42,42
4331,38.74025000000043,2456.4444444444443,37,19,53,56
4332,13.881000000000295,2404.3888888888887,20,22,47,42
4333,17.203500000000368,2516.823529411765,26,17,39,43
4334,17.393250000000396,2643.0,19,19,38,38
4335,30.52750000000065,2896.6111111111113,31,12,43,43
4336,10.884500000000466,2769.4285714285716,28,12,34,40
4337,49.78025000000123,4350.55,42,21,45,63
4338,38.2377500000011,3699.7,44,15,23,59
4339,-5.051250000000031,1429.0,4,17,45,21
4340,37.4357500000004,3603.722222222222,41,29,44,70
4341,31.958500000000743,3375.222222222222,42,21,33,63
4342,15.656750000000335,2515.5,19,13,49,32
4343,27.852000000001066,3382.3684210526317,37,22,45,59
4344,35.774750000000566,3409.722222222222,44,15,62,59
4345,28.54950000000013,2185.3529411764707,26,12,53,38
4346,27.689250000000328,2967.157894736842,32,7,37,39
4347,30.84150000000094,2876.235294117647,38,15,45,53
4348,28.567250000000467,2473.8823529411766,34,22,45,56
4349,14.764000000000511,2709.0625,27,12,44,39
4350,19.8167500000004,3373.157894736842,26,18,43,44
4351,23.384500000000692,3546.0526315789475,41,17,38,58
4352,20.642250000000352,2505.5,23,12,51,35
4353,39.38925000000122,3780.0555555555557,44,20,47,64
4354,30.742500000000895,4441.0,43,16,53,59
4355,62.98250000000102,4395.578947368421,54,17,42,71
4356,55.628250000001536,4476.833333333333,70,18,35,88
4357,29.912750000000983,3555.3333333333335,50,17,50,67
4358,23.113000000000824,2840.1052631578946,27,18,45,45
4359,23.91825000000103,3154.8333333333335,42,15,35,57
4360,44.22750000000079,4711.6,48,12,41,60
4361,37.35600000000038,2980.5789473684213,29,12,49,41
4362,29.863500000000148,3057.0555555555557,31,21,57,52
4363,8.049250000000374,2703.222222222222,22,17,38,39
4364,23.248500000000178,2712.714285714286,28,13,55,41
4365,24.578750000000483,3604.4,30,11,43,41
4366,22.284750000000408,2269.3529411764707,36,20,42,56
4367,19.088250000000283,2444.0,29,15,48,44
4368,38.220250000000746,3609.5263157894738,44,11,37,55
4369,38.464750000001025,5266.5,51,24,54,75
4370,34.30675000000068,2757.823529411765,37,17,50,54
4371,37.5390000000004,3797.5,38,15,40,53
4372,22.88225000000046,3688.842105263158,20,22,55,42
4373,26.84900000000105,4933.1,37,10,55,47
4374,30.898250000000708,3583.75,48,18,24,66
4375,40.25675000000085,4290.368421052632,49,19,35,68
4376,22.185750000000688,3165.3888888888887,39,33,47,72
4377,12.276000000000026,1902.25,25,15,65,40
4378,19.623500000000483,3241.2631578947367,37,13,37,50
4379,48.08025000000143,6300.45,64,27,42,91
4380,19.111500000000245,2677.733333333333,24,14,42,38
4381,26.64475000000017,3880.7,33,22,47,55
4382,21.43325000000031,2587.764705882353,24,22,57,46
4383,21.97700000000019,3998.85,23,20,44,43
4384,14.177750000000396,3025.2,25,16,48,41
4385,5.842500000000443,2625.625,21,14,33,35
4386,47.00700000000121,3888.65,39,14,50,53
4387,16.641750000000528,2617.722222222222,23,14,43,37
4388,16.71550000000027,3100.7894736842104,30,16,40,46
4389,13.955750000000748,2727.1111111111113,26,12,39,38
4390,27.5287500000004,3030.5263157894738,38,13,51,51
4391,32.176750000001405,3247.8823529411766,42,21,49,63
4392,39.49750000000086,3795.842105263158,38,21,53,59
4393,27.02500000000064,4098.1,35,13,44,48
4394,28.766250000000962,2800.705882352941,31,24,49,55
4395,45.493250000001154,4921.15,58,16,47,74
4396,1.5112500000001055,1909.6666666666667,14,19,55,33
4397,28.428000000000583,2572.0,39,13,47,52
4398,54.36250000000085,3341.294117647059,48,13,47,61
4399,31.21150000000109,4569.5,46,20,32,66
4400,18.212500000000887,2510.235294117647,28,22,45,50
4401,8.647250000000588,2950.222222222222,31,19,36,50
4402,30.361500000000724,2108.764705882353,27,20,42,47
4403,27.626000000000584,2218.0588235294117,25,12,55,37
4404,22.018750000000487,3229.9,34,15,39,49
4405,31.801000000000943,3818.529411764706,50,19,38,69
4406,52.62675000000102,4135.9473684210525,50,20,68,70
4407,28.954250000001046,4170.1578947368425,38,21,54,59
4408,14.969500000000167,2500.2105263157896,15,16,50,31
4409,26.342500000001234,3753.8,42,19,32,61
4410,57.54025000000085,5220.315789473684,65,25,56,90
4411,21.449250000000724,4192.6,39,9,35,48
4412,31.783000000000364,3871.05,35,21,43,56
4413,18.246250000000224,2214.8125,26,14,48,40
4414,47.54350000000089,4510.05,52,11,37,63
4415,23.114500000000625,3175.9473684210525,35,18,33,53
4416,17.355250000000634,2714.705882352941,25,23,43,48
4417,27.86050000000057,2356.625,31,16,43,47
4418,42.211250000000824,4638.789473684211,43,20,29,63
4419,53.59550000000115,4949.05,48,16,41,64
4420,10.374250000000362,2491.7368421052633,16,15,41,31
4421,33.35675000000093,3823.3333333333335,46,22,40,68
4422,43.011500000001135,4425.15,54,17,32,71
4423,42.91650000000039,3882.0,36,20,35,56
4424,28.985500000000194,3439.6111111111113,38,23,44,61
4425,9.62550000000037,2696.1666666666665,15,22,49,37
4426,35.02750000000069,3457.3888888888887,37,19,37,56
4427,32.43875000000034,3891.8,34,11,43,45
4428,18.070500000000386,2575.3333333333335,30,21,26,51
4429,15.03000000000051,2651.4285714285716,32,15,43,47
4430,32.95725000000144,4571.2,70,9,29,79
4431,21.9302500000004,3639.4,27,16,40,43
4432,44.50275000000137,5084.65,49,27,34,76
4433,10.561750000000467,2503.5263157894738,21,15,31,36
4434,22.209250000000715,3338.8947368421054,35,12,31,47
4435,32.494750000001694,3740.3888888888887,58,17,38,75
4436,20.081500000000304,2442.294117647059,23,15,50,38
4437,25.874750000000404,3138.3684210526317,37,17,47,54
4438,33.19425000000099,4225.2,46,18,24,64
4439,15.160000000000732,3898.15,30,24,37,54
4440,20.50300000000043,3322.8,37,12,34,49
4441,51.77225000000128,2930.1875,55,24,43,79
4442,38.5280000000012,4206.0526315789475,49,22,37,71
4443,29.45975000000019,3316.222222222222,32,23,48,55
4444,42.13875000000099,4296.315789473684,56,21,34,77
4445,25.995250000001153,3244.8888888888887,40,18,35,58
4446,14.34675000000089,2051.764705882353,22,15,31,37
4447,39.20725000000058,3235.315789473684,30,23,36,53
4448,-14.958499999999901,1429.0,2,29,26,31
4449,28.63500000000074,4480.6,41,25,32,66
4450,30.022000000001015,3346.076923076923,40,24,35,64
4451,54.358750000000406,5364.8,55,23,41,78
4452,48.46375000000147,4569.473684210527,49,24,35,73
4453,24.38250000000034,4063.2,36,17,44,53
4454,4.098000000000119,2093.9444444444443,17,19,34,36
4455,20.51600000000075,2519.9444444444443,23,17,42,40
4456,44.668000000000774,4163.2,46,9,39,55
4457,49.86550000000143,4711.8,56,13,37,69
4458,10.817250000000481,2807.6,29,17,28,46
4459,19.747750000000856,3619.5,43,27,27,70
4460,56.87250000000047,4848.1,38,26,41,64
4461,33.96425000000077,3623.1111111111113,41,34,30,75
4462,36.93350000000113,3519.0555555555557,47,27,45,74
4463,32.84900000000083,3267.8947368421054,33,18,45,51
4464,41.92650000000154,4552.1,70,13,26,83
4465,-17.569750000000255,1429.0,5,32,38,37
4466,4.11300000000014,2130.7,15,12,35,27
4467,4.986000000000129,2809.9473684210525,13,15,35,28
4468,0.9882500000001062,1637.375,15,25,31,40
4469,58.21575000000117,5663.25,72,19,27,91
4470,25.69525000000096,4137.0,49,13,38,62
4471,6.647250000001167,2718.625,26,22,35,48
4472,-4.606749999999886,2094.1,11,14,30,25
4473,43.49825000000088,4150.105263157895,50,21,37,71
4474,3.426000000000065,1429.0,10,25,48,35
4475,27.991500000000393,2538.294117647059,29,23,50,52
4476,23.335250000001118,4463.25,41,17,50,58
4477,12.168750000000228,2090.4444444444443,16,16,39,32
4478,5.48575000000025,2125.85,11,6,48,17
4479,18.747500000000535,2072.777777777778,21,17,51,38
4480,16.00900000000103,3327.5,33,16,30,49
4481,29.230000000000977,2978.1176470588234,45,20,37,65
4482,31.680000000000728,2955.5,38,14,41,52
4483,17.422250000000208,2246.625,19,15,58,34
4484,52.96425000000087,5856.05,52,19,54,71
4485,12.080000000000254,2028.8333333333333,12,11,53,23
4486,14.517250000000317,2553.3529411764707,23,20,65,43
4487,21.229000000000244,2697.9411764705883,22,21,42,43
4488,41.46825000000079,4488.6,37,26,41,63
4489,34.650500000000974,3723.5,40,14,45,54
4490,21.518750000000388,3224.35,32,13,28,45
4491,26.596000000000647,2442.235294117647,31,11,42,42
4492,22.669750000000963,4003.75,41,20,46,61
4493,36.92750000000114,4157.55,39,16,62,55
4494,26.61700000000041,3089.157894736842,35,7,52,42
4495,28.337250000000644,3681.3684210526317,29,28,56,57
4496,8.967000000000489,2552.1,19,17,33,36
4497,33.25350000000071,2807.125,37,16,48,53
4498,25.234000000000798,3034.0,32,18,35,50
4499,37.32650000000124,3680.176470588235,47,25,59,72
4500,26.090500000000482,2770.7368421052633,20,13,54,33
4501,27.2530000000004,2877.8888888888887,25,10,51,35
4502,39.2887500000008,4123.315789473684,45,15,52,60
4503,31.587250000000342,4546.105263157895,34,24,51,58
4504,39.93400000000091,4771.1,43,30,44,73
4505,21.988250000000725,2808.294117647059,25,13,66,38
4506,49.93150000000042,4356.9,44,18,55,62
4507,21.688250000001194,3752.85,33,15,50,48
4508,34.73100000000087,3952.25,40,15,40,55
4509,28.660500000000564,3021.4736842105262,36,14,37,50
4510,21.119500000000244,3396.65,28,14,44,42
4511,15.760250000000312,3043.8947368421054,23,11,46,34
4512,24.914000000000975,4375.95,56,15,23,71
4513,25.420500000000636,4315.473684210527,47,17,54,64
4514,7.899750000000479,2400.25,25,18,39,43
4515,3.8515000000001933,2133.0588235294117,11,13,55,24
4516,17.875500000000606,2676.0,26,12,51,38
4517,53.19250000000126,4479.9,52,11,42,63
4518,9.123500000000528,2698.1,19,18,42,37
4519,7.889000000000297,2707.65,20,16,45,36
4520,22.575250000000448,2773.6153846153848,33,15,33,48
4521,13.85375000000052,2979.0,33,22,42,55
4522,21.89775000000095,3716.5,29,19,41,48
4523,29.217500000000577,3018.0,27,13,48,40
4524,25.010250000000703,2736.1176470588234,31,24,48,55
4525,38.675250000000965,4679.789473684211,44,25,48,69
4526,31.928250000001412,2772.375,54,19,33,73
4527,33.95400000000052,3160.235294117647,45,21,57,66
4528,22.898000000000458,2646.0555555555557,30,18,39,48
4529,23.40775000000083,3099.75,35,15,32,50
4530,45.17350000000093,4029.842105263158,54,17,37,71
4531,35.004000000000644,3778.4444444444443,42,22,39,64
4532,26.215250000000403,3265.7,28,12,47,40
4533,45.17600000000114,4725.15,50,25,45,75
4534,36.078000000000884,3890.470588235294,47,22,31,69
4535,20.956250000000175,2972.65,27,10,44,37
4536,55.06750000000174,5072.05,63,12,39,75
4537,40.371750000000844,4340.95,37,17,57,54
4538,25.05800000000071,3212.0625,34,19,36,53
4539,32.844750000000964,3632.1052631578946,37,20,44,57
4540,17.391750000000314,2591.1052631578946,16,18,38,34
4541,21.30750000000062,3198.3076923076924,27,22,43,49
4542,9.579750000000393,1997.157894736842,18,8,45,26
4543,44.472750000001305,4556.15,44,18,47,62
4544,-2.377749999999355,2339.875,21,19,39,40
4545,41.00550000000059,2240.5625,29,18,61,47
4546,49.827250000000134,2538.294117647059,44,26,63,70
4547,19.10450000000028,3095.722222222222,22,21,53,43
4548,13.931000000000461,2475.157894736842,20,18,41,38
4549,46.36325000000099,3647.6470588235293,64,14,52,78
4550,32.80250000000059,3174.222222222222,37,18,45,55
4551,21.157500000000198,2441.5555555555557,22,17,49,39
4552,33.760750000000584,4356.05,40,14,39,54
4553,9.71500000000028,2551.3,15,13,34,28
4554,33.001000000000694,3881.9473684210525,39,17,52,56
4555,33.87050000000139,4368.0,49,12,53,61
4556,42.562000000000566,4394.95,35,16,49,51
4557,8.055750000000037,2754.3888888888887,13,26,58,39
4558,22.91250000000027,1869.5,20,15,57,35
4559,58.02550000000066,4825.15,45,18,41,63
4560,17.523250000000324,2966.9411764705883,25,27,34,52
4561,30.07200000000058,3603.6,35,13,34,48
4562,27.500000000001286,3527.777777777778,49,24,53,73
4563,5.759749999999995,2287.0526315789475,13,18,65,31
4564,50.93975000000116,4804.5,62,11,43,73
4565,11.4222500000001,2644.2,22,7,49,29
4566,23.900000000000862,2620.714285714286,27,19,33,46
4567,32.62175000000037,2863.4736842105262,26,17,44,43
4568,53.842250000001435,4683.85,67,8,33,75
4569,26.16350000000029,1429.0,20,22,54,42
4570,25.19950000000058,3241.8947368421054,39,16,40,55
4571,0.0875000000002907,2117.3684210526317,10,19,32,29
4572,40.34500000000079,4105.45,41,11,36,52
4573,12.427000000000076,2096.705882352941,15,14,53,29
4574,14.416000000000688,2681.277777777778,23,20,51,43
4575,51.22025000000085,5256.9,46,20,37,66
4576,14.767500000000641,2822.0,29,18,42,47
4577,29.641250000000518,3090.5,30,21,46,51
4578,20.85125000000125,4224.421052631579,33,27,42,60
4579,10.63950000000025,2573.45,22,14,33,36
4580,25.607250000000942,3339.75,31,24,26,55
4581,39.486750000001926,4460.894736842105,54,16,47,70
4582,51.64000000000111,3005.176470588235,54,14,66,68
4583,38.77250000000065,3884.55,37,15,32,52
4584,58.25450000000079,4382.444444444444,52,25,49,77
4585,25.60325000000076,2424.9333333333334,34,14,46,48
4586,5.3827500000002395,2117.4210526315787,9,12,45,21
4587,13.846000000000776,3311.125,28,22,34,50
4588,38.45975000000117,4132.526315789473,40,29,51,69
4589,37.43500000000092,3888.5789473684213,42,18,44,60
4590,33.62750000000098,3259.0,40,17,39,57
4591,35.46125000000074,3683.1052631578946,34,18,46,52
4592,47.07725000000137,4918.7,56,13,48,69
4593,33.909500000001195,5249.0,43,27,56,70
4594,41.238000000000454,3920.2631578947367,45,16,37,61
4595,35.32975000000055,3882.3,30,15,51,45
4596,39.125250000000875,3916.1052631578946,49,20,43,69
4597,25.7820000000006,3798.15,32,16,48,48
4598,19.83950000000032,2157.3529411764707,18,15,35,33
4599,39.978000000000605,3600.4210526315787,38,24,54,62
4600,18.65150000000053,2520.777777777778,27,10,42,37
4601,9.759500000000283,2485.5555555555557,23,19,43,42
4602,21.49525000000025,3248.5789473684213,26,17,48,43
4603,14.375750000000727,2724.5,25,27,37,52
4604,19.070500000000415,3152.5263157894738,26,22,34,48
4605,26.174500000000712,3222.7,36,7,41,43
4606,30.754750000000495,2910.8823529411766,38,18,23,56
4607,52.43625000000047,2821.9375,48,26,96,74
4608,34.21225000000081,4237.8,42,15,30,57
4609,40.334000000001076,4023.1052631578946,50,14,37,64
4610,43.70750000000065,4273.789473684211,55,17,51,72
4611,26.638000000000723,2523.375,31,29,63,60
4612,23.849500000000383,3284.6315789473683,34,9,38,43
4613,31.492000000000417,4211.0526315789475,41,17,47,58
4614,22.815750000000445,2461.823529411765,29,15,41,44
4615,20.309500000000337,3332.2631578947367,21,18,44,39
4616,21.760250000000788,3018.4375,50,24,38,74
4617,52.75250000000119,4940.25,58,20,39,78
4618,17.454250000000524,2535.529411764706,25,20,33,45
4619,72.21350000000226,6280.0,76,12,65,88
4620,4.061750000000113,2028.3,11,11,33,22
4621,41.82050000000133,4339.789473684211,52,28,41,80
4622,24.00675000000036,2510.1111111111113,23,15,48,38
4623,53.14700000000148,5791.8,64,19,32,83
4624,29.61375000000104,2496.6875,37,18,56,55
4625,45.13425000000183,5202.8,66,22,32,88
4626,15.525250000000204,2551.35,21,10,38,31
4627,34.840250000000616,3175.1111111111113,33,21,44,54
4628,15.357750000000399,2443.1111111111113,22,16,35,38
4629,38.572000000000706,3497.6315789473683,36,13,42,49
4630,19.553250000000524,3497.6315789473683,24,23,30,47
4631,49.08800000000065,4310.9,38,21,52,59
4632,15.733500000000754,2959.529411764706,31,15,49,46
4633,13.932750000000203,2434.3333333333335,24,16,45,40
4634,18.974000000000437,2071.9375,31,17,51,48
4635,24.774250000000144,2613.7894736842104,30,14,49,44
4636,29.89425000000059,3048.277777777778,38,20,40,58
4637,14.77200000000039,2561.8571428571427,21,22,40,43
4638,38.979000000001136,3481.222222222222,44,17,35,61
4639,26.202500000000544,2542.722222222222,39,19,71,58
4640,39.944250000001304,4568.1,60,9,33,69
4641,29.269250000001072,3098.529411764706,43,26,47,69
4642,34.20750000000144,4783.1,48,25,48,73
4643,37.1907500000018,3712.0,49,19,44,68
4644,34.69600000000089,5466.4,52,21,39,73
4645,51.69675000000099,5420.4,50,33,42,83
4646,38.53575000000047,3668.8888888888887,45,21,41,66
4647,28.27375000000098,3894.2,35,22,28,57
4648,11.833750000000466,3712.45,32,15,36,47
4649,34.147000000001,4353.65,46,23,28,69
4650,31.443000000000787,3777.3333333333335,38,37,47,75
4651,19.33475000000052,3594.2,22,20,49,42
4652,19.803500000000565,3336.315789473684,27,23,33,50
4653,27.941750000000518,2440.235294117647,40,19,48,59
4654,7.783750000000187,2511.7894736842104,14,15,33,29
4655,24.679750000001015,2828.764705882353,37,17,33,54
4656,15.13800000000011,1938.764705882353,30,16,35,46
4657,10.109000000000535,2764.842105263158,22,25,23,47
4658,14.275500000000687,3178.35,38,11,25,49
4659,56.884500000001346,4505.263157894737,65,14,26,79
4660,3.469250000001085,3287.0,31,20,23,51
4661,20.57900000000003,1991.5625,35,22,44,57
4662,53.35600000000079,5564.1,47,19,53,66
4663,47.89300000000136,4494.95,56,11,42,67
4664,20.774000000000534,2926.4444444444443,30,22,33,52
4665,22.042750000000673,2790.6111111111113,37,21,30,58
4666,27.876000000001035,4354.5,43,23,47,66
4667,33.53675000000062,3484.6111111111113,41,31,46,72
4668,10.466750000000108,2562.842105263158,22,17,50,39
4669,25.11325000000077,4190.2,39,19,50,58
4670,24.592250000001133,3071.529411764706,47,18,31,65
4671,37.82975000000113,4155.0526315789475,56,15,27,71
4672,43.00275000000064,2455.875,47,9,46,56
4673,33.76325000000093,3606.2631578947367,41,15,44,56
4674,37.713500000000444,3109.1111111111113,35,14,41,49
4675,28.571500000000736,3493.3684210526317,39,14,41,53
4676,48.87475000000124,3755.3888888888887,49,13,52,62
4677,41.326500000000955,3591.157894736842,38,18,43,56
4678,55.11075000000077,5824.25,60,30,44,90
4679,27.157750000000654,3701.4210526315787,39,14,37,53
4680,-2.730749999999558,2048.0555555555557,9,19,35,28
4681,34.20775000000028,4069.842105263158,39,20,60,59
4682,30.281000000000965,3143.5625,40,19,29,59
4683,61.07225000000098,4323.105263157895,67,16,49,83
4684,11.447000000000553,2639.235294117647,27,23,27,50
4685,33.986750000001386,3546.6470588235293,56,18,47,74
4686,29.860250000000757,3060.05,38,15,27,53
4687,65.62650000000086,5352.15,64,15,53,79
4688,49.40275000000134,2590.8125,51,16,65,67
4689,45.78825000000096,4759.35,57,21,23,78
4690,3.665250000000577,2825.8888888888887,27,17,33,44
4691,29.26575000000118,3801.4,44,16,24,60
4692,20.80150000000024,2562.4666666666667,24,23,41,47
4693,13.925750000000203,2945.315789473684,19,21,32,40
4694,52.23475000000151,5455.35,56,30,39,86
4695,13.327000000000357,2598.8125,23,20,45,43
4696,21.522750000000293,3761.55,28,23,35,51
4697,36.82550000000061,3591.7,38,13,29,51
4698,-4.200749999999811,2144.157894736842,10,20,30,30
4699,48.20325000000115,4570.45,51,12,29,63
4700,31.97700000000082,4174.3,40,24,23,64
4701,-3.827499999999887,2064.7368421052633,10,16,48,26
4702,9.701250000000517,2639.684210526316,22,17,36,39
4703,-0.5697499999999913,1528.25,13,14,35,27
4704,39.01325000000089,4139.3,47,18,42,65
4705,39.41900000000149,3604.5263157894738,48,17,47,65
4706,51.04300000000135,5026.7,61,11,31,72
4707,50.69525000000146,4632.105263157895,61,14,52,75
4708,52.106250000000685,4603.736842105263,49,15,44,64
4709,59.86325000000145,5529.05,59,22,53,81
4710,56.552750000000934,4460.75,44,24,42,68
4711,37.826750000000416,4304.5,35,26,25,61
4712,40.54125000000083,4436.526315789473,43,26,42,69
4713,28.74100000000046,3064.9473684210525,39,15,69,54
4714,37.10250000000048,2936.176470588235,29,17,37,46
4715,11.068750000000561,2451.470588235294,27,15,29,42
4716,33.63425000000028,2754.8823529411766,32,28,54,60
4717,17.708750000000084,4086.9,33,20,39,53
4718,33.98950000000052,3506.7368421052633,46,12,34,58
4719,12.718500000000482,2540.05,26,9,37,35
4720,47.617250000001384,4303.789473684211,58,22,44,80
4721,3.719500000000172,3429.0,19,25,35,44
4722,12.871000000000373,2580.9375,25,30,39,55
4723,30.34700000000105,4048.1,44,12,37,56
4724,41.678250000000716,4143.444444444444,55,26,37,81
4725,27.26875000000063,2572.8823529411766,34,16,27,50
4726,28.94350000000096,3043.470588235294,43,13,34,56
4727,18.515250000000815,3019.8888888888887,26,17,33,43
4728,38.12575000000138,5529.85,48,23,54,71
4729,17.2355000000005,3055.6315789473683,35,15,34,50
4730,21.92150000000024,2790.470588235294,33,12,35,45
4731,9.625250000000237,2293.6315789473683,20,12,36,32
4732,29.150000000000233,2622.529411764706,22,21,52,43
4733,43.18850000000101,2397.375,41,21,43,62
4734,16.118250000000607,3174.222222222222,33,19,38,52
4735,57.14975000000152,5155.3,61,10,57,71
4736,43.54475000000055,4318.85,37,19,50,56
4737,43.50775000000097,4147.3,50,11,31,61
4738,39.18775000000127,3868.9,41,22,38,63
4739,32.39325000000041,3905.25,44,17,40,61
4740,-5.422499999999758,2012.2631578947369,12,20,35,32
4741,36.22300000000058,3902.9,35,21,39,56
4742,43.46425000000138,4916.3,50,23,39,73
4743,30.032000000000757,3864.9,47,14,25,61
4744,31.361500000000593,3030.5789473684213,33,12,36,45
4745,34.42275000000061,4860.85,46,20,42,66
4746,48.4427500000014,4629.2,53,20,32,73
4747,37.022500000000704,2988.4117647058824,38,13,58,51
4748,14.75125000000094,2556.9444444444443,31,20,41,51
4749,63.97600000000142,5311.6,61,10,49,71
4750,31.25275000000076,3171.6111111111113,37,17,44,54
4751,50.33000000000125,5379.15,52,24,34,76
4752,31.595250000000846,3995.7,48,19,41,67
4753,44.968000000000956,4037.2631578947367,43,13,46,56
4754,43.232500000000506,4637.9,39,23,40,62
4755,50.15450000000148,4960.85,59,19,28,78
4756,39.079250000000904,3838.3684210526317,43,25,57,68
4757,21.784000000000894,3236.777777777778,33,26,38,59
4758,27.791750000000338,2246.0,24,15,35,39
4759,36.89700000000097,3724.75,46,22,34,68
4760,2.179750000000473,2527.3125,16,26,21,42
4761,36.17550000000142,3912.842105263158,58,16,35,74
4762,5.737250000000694,2152.705882352941,24,23,31,47
4763,31.534250000000604,4271.1,42,20,35,62
4764,37.476500000001636,3919.3888888888887,59,14,34,73
4765,17.332250000000336,2009.375,26,22,63,48
4766,32.31475000000086,3983.1,40,17,35,57
4767,70.08375000000083,3654.1176470588234,65,14,47,79
4768,15.752500000001152,3680.4736842105262,38,25,37,63
4769,26.97000000000076,3643.35,36,27,25,63
4770,21.131500000000518,2540.1111111111113,28,16,35,44
4771,38.99850000000118,4490.3,58,16,34,74
4772,-1.1992499999997817,2028.25,8,9,40,17
4773,42.717750000000784,4959.3,54,21,43,75
4774,11.983750000000867,2503.0,29,22,36,51
4775,41.497750000000444,3168.529411764706,64,33,53,97
4776,24.008000000000127,2703.0833333333335,42,35,30,77
4777,13.868750000000215,2171.294117647059,19,16,37,35
4778,17.18225000000074,2518.6470588235293,31,18,45,49
4779,30.10775000000087,4416.6,41,20,33,61
4780,15.380000000000326,2778.277777777778,34,17,34,51
4781,25.786250000000667,3703.1052631578946,32,22,31,54
4782,12.048000000000282,2632.1052631578946,24,14,40,38
4783,30.326250000001004,3567.0526315789475,37,20,38,57
4784,27.93875000000103,2929.5882352941176,45,28,44,73
4785,28.713750000000385,2561.785714285714,41,22,27,63
4786,41.80425000000072,4585.35,47,17,35,64
4787,25.599000000000263,3019.684210526316,33,10,34,43
4788,35.51050000000047,3349.777777777778,40,19,60,59
4789,21.27975000000064,2547.1428571428573,26,22,29,48
4790,6.09075000000043,2559.95,18,15,28,33
4791,46.264250000000956,4883.0,52,17,27,69
4792,12.297750000000285,2931.9444444444443,33,25,29,58
4793,27.732000000000745,3003.5,37,18,32,55
4794,28.035000000000576,3423.8333333333335,48,23,34,71
4795,53.00275000000145,4833.368421052632,60,20,35,80
4796,55.388750000000684,3503.222222222222,46,26,50,72
4797,33.46075000000076,2524.4,41,20,39,61
4798,12.01225000000036,2387.1176470588234,28,24,38,52
4799,37.283750000000616,2174.125,34,17,41,51
4800,8.152500000000419,2671.85,28,17,18,45
4801,52.757500000001166,4595.368421052632,54,18,46,72
4802,44.05275000000173,4243.111111111111,64,18,38,82
4803,42.071500000000995,5177.55,69,19,13,88
4804,32.29000000000057,4402.421052631579,57,29,49,86
4805,31.98850000000099,2314.866666666667,50,16,34,66
4806,36.58025000000053,3805.3,47,15,28,62
4807,13.107500000000135,2681.923076923077,21,14,35,35
4808,45.00900000000159,4710.95,67,17,32,84
4809,14.508500000000742,3169.65,45,13,18,58
4810,9.518000000000725,2962.0,30,23,33,53
4811,28.378000000000593,3783.2631578947367,36,23,44,59
4812,48.037500000001,4858.45,54,22,49,76
4813,20.698250000000538,4189.4,37,24,36,61
4814,14.855000000000922,3019.6315789473683,40,21,21,61
4815,36.38000000000086,4297.1578947368425,55,25,34,80
4816,4.405750000000418,2544.2,20,25,21,45
4817,19.71150000000105,4306.75,49,16,33,65
4818,26.339500000000804,3634.5555555555557,53,15,37,68
4819,1.1850000000001752,2154.8888888888887,17,19,33,36
4820,6.760000000000554,2428.9411764705883,26,26,31,52
4821,13.60950000000052,2471.3888888888887,31,17,29,48
4822,43.76975000000135,4472.473684210527,56,16,30,72
4823,34.85450000000097,3535.0,47,16,34,63
4824,24.22250000000063,4921.95,39,27,40,66
4825,16.69600000000067,2623.0714285714284,27,15,31,42
4826,16.531250000000735,2047.235294117647,33,17,33,50
4827,20.046500000000343,2197.0625,28,28,37,56
4828,48.616500000000414,3879.4736842105262,57,14,44,71
4829,50.483000000000764,4072.4736842105262,53,11,44,64
4830,45.72050000000088,3161.25,65,30,35,95
4831,6.69700000000041,2630.625,22,22,48,44
4832,65.05825000000097,5306.15,59,22,43,81
4833,33.92575000000102,3789.45,40,18,33,58
4834,34.85150000000131,4398.25,58,16,32,74
4835,22.528249999999957,2961.2105263157896,32,12,37,44
4836,37.89200000000126,4925.85,49,20,39,69
4837,-0.15249999999945735,2559.764705882353,27,27,48,54
4838,47.33675000000104,3770.9411764705883,49,25,38,74
4839,20.785000000001013,3083.5,41,25,28,66
4840,12.389000000000838,3160.05,35,16,30,51
4841,3.8222500000005475,1941.388888888889,14,18,40,32
4842,-2.4784999999999706,2151.277777777778,17,25,39,42
4843,26.33050000000059,4836.95,39,26,32,65
4844,17.274750000000598,2447.5555555555557,26,19,39,45
4845,46.89100000000129,4263.684210526316,46,21,45,67
4846,39.13275000000077,3371.294117647059,37,22,47,59
4847,7.123000000000404,2655.3125,23,19,25,42
4848,49.62800000000105,3302.0588235294117,58,18,46,76
4849,30.737500000000143,2705.0555555555557,22,21,42,43
4850,17.491250000000598,3637.9,39,15,38,54
4851,42.66125000000121,4447.611111111111,46,23,40,69
4852,36.103750000000566,5017.25,38,23,41,61
4853,11.799750000000175,2688.842105263158,23,14,45,37
4854,19.431250000000492,2148.25,28,18,53,46
4855,5.203500000000285,1973.0555555555557,14,17,55,31
4856,6.064500000000548,2666.375,25,16,46,41
4857,39.02875000000054,3824.4,36,18,44,54
4858,44.16375000000067,4230.9,53,20,26,73
4859,22.192750000000874,3286.1666666666665,31,24,38,55
4860,18.33200000000027,3158.4736842105262,28,18,47,46
4861,28.725000000000882,4195.0,52,14,31,66
4862,34.59300000000056,4171.789473684211,46,37,45,83
4863,38.919500000000475,2866.0588235294117,40,24,42,64
4864,13.506000000000498,2816.222222222222,28,22,32,50
4865,50.62175000000059,4649.05,47,16,50,63
4866,19.665500000000847,3249.65,40,20,28,60
4867,54.23150000000136,4414.15,60,14,26,74
4868,34.78025000000076,2664.4117647058824,41,17,47,58
4869,28.425000000000825,3560.2631578947367,51,9,29,60
4870,64.66050000000128,5778.35,66,18,43,84
4871,19.080000000000346,2611.1052631578946,22,16,44,38
4872,37.46700000000114,3122.0,44,17,44,61
4873,41.246000000000706,4316.35,44,22,32,66
4874,-0.7472499999996915,2899.4210526315787,21,20,31,41
4875,47.607750000000784,4157.555555555556,52,19,32,71
4876,30.56825000000116,3806.15,54,14,32,68
4877,47.14050000000119,4687.15,52,27,37,79
4878,9.945500000000072,1991.5625,25,20,44,45
4879,42.53225000000125,4413.210526315789,50,18,44,68
4880,40.53775000000105,4802.05,50,31,21,81
4881,26.447250000000924,3631.55,41,27,17,68
4882,33.55250000000097,4213.15,41,23,31,64
4883,9.440500000000444,2627.5,23,21,26,44
4884,4.978250000000192,2838.4210526315787,26,20,25,46
4885,21.011250000000707,4021.95,58,16,20,74
4886,-2.7672499999995273,2228.5789473684213,13,22,35,35
4887,15.430000000000376,2689.470588235294,43,25,35,68
4888,25.88000000000086,3083.705882352941,37,24,41,61
4889,32.065250000000574,3728.0,41,21,45,62
4890,40.035000000001276,4339.789473684211,59,22,24,81
4891,13.025250000000526,2534.529411764706,29,15,40,44
4892,25.667750000000417,3235.4,29,18,38,47
4893,18.92375000000061,2740.3888888888887,26,18,52,44
4894,1.178000000000104,2207.7368421052633,15,17,47,32
4895,28.565250000000738,2990.8333333333335,39,15,47,54
4896,7.3862500000002855,2784.3125,23,18,35,41
4897,34.24000000000083,4148.05,50,19,36,69
4898,25.254000000000595,2954.8333333333335,39,11,26,50
4899,43.14725000000141,5196.0526315789475,62,24,39,86
4900,62.78775000000154,5649.75,57,23,36,80
4901,-0.5842499999999881,1944.578947368421,8,16,33,24
4902,34.39500000000088,4103.6,41,7,51,48
4903,17.93725000000064,2690.5384615384614,32,17,44,49
4904,29.10650000000077,2936.235294117647,44,14,32,58
4905,11.842000000000631,2730.8823529411766,24,17,34,41
4906,43.434250000001086,3768.3684210526317,51,14,42,65
4907,24.19750000000029,3012.777777777778,29,13,58,42
4908,5.393500000000621,2346.823529411765,25,20,37,45
4909,49.218500000001335,5633.9,57,22,49,79
4910,-12.136000000000042,1438.5333333333333,2,20,39,22
4911,15.102000000000213,2596.6111111111113,21,19,38,40
4912,23.18425000000069,3442.55,32,16,38,48
4913,14.260250000000411,2692.285714285714,24,15,59,39
4914,20.095000000000518,2684.266666666667,25,26,44,51
4915,64.49825000000128,5348.15,49,24,50,73
4916,24.82950000000046,2659.277777777778,23,15,37,38
4917,24.60400000000056,3131.6315789473683,37,16,35,53
4918,56.10000000000044,3041.1666666666665,40,11,69,51
4919,13.33575000000047,2608.8888888888887,25,17,22,42
4920,27.63550000000089,4637.9,53,20,35,73
4921,47.09250000000073,3778.3684210526317,51,14,55,65
4922,45.159000000000745,3545.3684210526317,48,11,41,59
4923,30.556000000000616,3036.25,38,24,39,62
4924,31.84600000000075,4297.1578947368425,56,15,37,71
4925,9.64175000000046,2506.6666666666665,17,14,35,31
4926,52.09050000000049,3620.705882352941,53,13,49,66
4927,19.47000000000066,2152.823529411765,22,12,47,34
4928,33.46200000000087,3650.5789473684213,42,13,46,55
4929,24.02200000000015,2393.4375,26,20,52,46
4930,11.19300000000034,2740.0588235294117,24,24,48,48
4931,33.81900000000055,3795.0555555555557,44,27,51,71
4932,33.11500000000071,5036.473684210527,40,26,45,66
4933,19.915750000000138,2500.9473684210525,18,16,48,34
4934,42.36175000000096,2413.235294117647,39,22,61,61
4935,35.721000000001055,4231.5,49,23,48,72
4936,56.6890000000007,4186.0526315789475,57,22,57,79
4937,21.615250000000472,3076.5789473684213,29,17,32,46
4938,52.114750000001095,3632.0,51,11,60,62
4939,43.04600000000119,4281.5,45,14,37,59
4940,35.82525000000106,3602.0,44,26,40,70
4941,25.46225000000053,3476.65,30,20,33,50
4942,24.7995000000005,3323.8947368421054,28,16,47,44
4943,36.95750000000082,3853.7,43,13,40,56
4944,25.798000000000155,2936.2105263157896,26,9,54,35
4945,42.98600000000046,2698.823529411765,38,20,42,58
4946,33.02200000000032,2038.5333333333333,27,23,38,50
4947,26.916500000000262,2176.9411764705883,25,12,43,37
4948,20.433000000000526,2682.294117647059,21,14,36,35
4949,43.88325000000134,4386.9,62,11,41,73
4950,10.999250000000474,2008.8823529411766,18,24,46,42
4951,64.23800000000168,5174.277777777777,70,21,57,91
4952,17.719750000000207,2791.0666666666666,17,16,38,33
4953,33.65900000000045,3535.5,34,12,41,46
4954,37.613250000001145,5055.3,49,12,42,61
4955,39.53300000000034,3983.95,36,14,51,50
4956,28.838500000000852,3722.6666666666665,42,20,36,62
4957,27.17500000000037,3617.2,25,16,36,41
4958,37.794000000000544,2735.625,48,17,48,65
4959,53.86675000000112,4944.578947368421,54,18,46,72
4960,36.60075000000073,3900.55,47,18,46,65
4961,45.704250000001004,4761.6,55,16,41,71
4962,23.72750000000064,2249.5,32,18,42,50
4963,34.98950000000055,3989.35,36,11,43,47
4964,13.81275000000027,1982.625,27,26,61,53
4965,24.841250000000983,2119.5625,30,14,47,44
4966,37.27825000000112,4150.894736842105,38,22,55,60
4967,19.5007500000004,3048.157894736842,29,13,53,42
4968,15.212000000000051,2233.5789473684213,12,9,53,21
4969,29.12400000000087,3599.8,47,11,37,58
4970,29.09625000000067,2541.1176470588234,32,12,47,44
4971,29.299750000000166,2360.625,28,11,43,39
4972,26.191250000001226,3246.8947368421054,42,19,38,61
4973,48.194000000001026,4422.7,41,22,50,63
4974,30.428000000000953,2514.0,37,15,39,52
4975,51.187500000000824,3995.3333333333335,54,17,44,71
4976,61.29525000000133,5519.65,63,18,64,81
4977,41.77275000000092,4502.2,48,18,34,66
4978,34.011500000001035,4717.25,42,20,43,62
4979,29.27250000000094,3975.4736842105262,36,26,49,62
4980,23.31675000000053,3664.0,32,19,38,51
4981,20.803250000000247,2535.722222222222,20,13,49,33
4982,29.94100000000021,3052.6111111111113,24,16,45,40
4983,43.89150000000109,5297.3,51,13,47,64
4984,35.5485000000009,3169.2631578947367,31,15,43,46
4985,8.4982500000003,3364.684210526316,26,15,49,41
4986,39.76400000000026,3667.3333333333335,56,15,51,71
4987,7.36825000000046,2847.9444444444443,25,19,47,44
4988,37.34700000000026,3779.85,29,15,56,44
4989,39.6632500000008,3070.5882352941176,42,21,48,63
4990,15.873750000000772,3177.4,29,15,35,44
4991,27.93250000000066,3582.9473684210525,34,17,61,51
4992,26.19575000000064,2992.0526315789475,33,13,43,46
4993,29.369500000000652,4525.95,41,19,39,60
4994,44.84800000000082,4519.6,47,21,38,68
4995,-0.8547499999998329,2041.421052631579,14,20,34,34
4996,4.649250000000238,2129.95,10,16,38,26
4997,49.060750000001335,4190.222222222223,53,20,42,73
4998,25.77775000000072,2375.5,48,18,38,66
4999,24.122000000000682,3171.1,32,15,35,47
5000,31.897750000001178,4323.5,42,21,41,63
