Episode,Average Reward,Average Lifespan,True Location Count,False Location Count,Explore Actions,Target Actions
1,-51.32474999999802,1961.6666666666667,10,20,16,30
2,-55.17449999999799,3016.3,20,33,5,53
3,-41.75724999999777,2469.5555555555557,22,29,7,51
4,-36.563249999996984,3463.4210526315787,39,35,13,74
5,-39.60974999999822,1988.3529411764705,16,33,10,49
6,-34.14549999999922,2405.2,12,26,13,38
7,-37.321749999998936,2298.5555555555557,25,24,12,49
8,-41.355499999997775,2504.2105263157896,16,30,9,46
9,-42.77799999999886,2136.15,14,25,6,39
10,-41.06974999999941,1851.0588235294117,34,33,16,67
11,-40.12274999999887,1810.888888888889,6,27,8,33
12,-46.90324999999878,2001.3684210526317,6,28,8,34
13,-58.364999999998155,2219.0,26,41,5,67
14,-42.714499999997464,2854.1666666666665,31,36,9,67
15,-36.720999999998824,2214.4210526315787,17,28,6,45
16,-40.56649999999754,3419.55,25,34,7,59
17,-57.90974999999992,1562.9375,15,33,9,48
18,-48.57024999999793,2202.6111111111113,13,33,13,46
19,-45.9709999999988,2594.8888888888887,20,39,17,59
20,-44.47099999999832,2643.3333333333335,20,34,6,54
21,-47.297499999998365,2585.2631578947367,18,34,7,52
22,-61.67749999999761,3150.65,17,39,4,56
23,-43.10774999999888,2153.75,10,29,11,39
24,-49.207999999997526,2793.2105263157896,28,30,7,58
25,-43.808499999998716,2634.6315789473683,18,28,14,46
26,-57.648999999999134,1790.4117647058824,13,34,5,47
27,-44.729249999997116,2679.6111111111113,32,40,5,72
28,-45.11224999999761,3042.2105263157896,30,29,14,59
29,-45.40099999999804,3130.8947368421054,25,38,7,63
30,-51.56274999999677,3089.1052631578946,20,34,12,54
31,-51.20674999999822,2219.222222222222,13,27,8,40
32,-53.77749999999744,2377.2631578947367,15,28,12,43
33,-57.64624999999789,2469.6,10,34,8,44
34,-39.620249999997355,2916.722222222222,33,32,7,65
35,-39.80724999999818,2616.4,13,32,8,45
36,-46.189999999998086,2702.15,22,29,5,51
37,-47.01824999999815,2702.9,15,33,8,48
38,-52.96824999999793,2255.5,14,35,8,49
39,-47.11249999999875,1979.9411764705883,24,23,11,47
40,-54.68899999999826,2568.6315789473683,15,28,7,43
41,-48.021999999999124,2470.842105263158,34,28,15,62
42,-42.85574999999878,2683.1666666666665,23,30,8,53
43,-47.942999999997745,2401.8333333333335,15,34,8,49
44,-53.11499999999872,2008.8823529411766,21,37,7,58
45,-53.46349999999849,2533.5263157894738,24,31,10,55
46,-39.42149999999787,2324.529411764706,28,27,5,55
47,-41.65374999999858,2065.684210526316,14,22,8,36
48,-59.13449999999701,2907.8888888888887,22,35,11,57
49,-42.00249999999828,3068.1052631578946,29,35,11,64
50,-38.52499999999867,2314.05,13,26,7,39
51,-45.382749999998694,2531.0526315789475,25,34,9,59
52,-48.06724999999952,2044.7894736842106,14,25,5,39
53,-46.57149999999931,1885.9444444444443,16,22,8,38
54,-46.476999999999265,2018.0,10,26,10,36
55,-38.807499999998065,2628.3,18,30,5,48
56,-38.69024999999646,3514.4210526315787,32,37,11,69
57,-60.62749999999679,3659.3888888888887,37,46,7,83
58,-53.964499999996875,3393.35,22,38,6,60
59,-60.69749999999825,2914.5263157894738,19,33,10,52
60,-26.691999999998284,2537.684210526316,27,23,5,50
61,-46.50199999999762,2884.4736842105262,37,32,8,69
62,-52.43474999999794,2613.7368421052633,18,31,8,49
63,-46.75274999999795,3292.1052631578946,33,35,11,68
64,-58.987499999997524,2467.470588235294,19,35,7,54
65,-57.266999999997516,2779.1052631578946,23,30,10,53
66,-59.56999999999838,2867.95,15,27,10,42
67,-42.73999999999832,2788.6,15,33,8,48
68,-41.71274999999794,2412.277777777778,21,32,12,53
69,-47.52724999999769,2390.823529411765,16,27,14,43
70,-39.30799999999994,1429.0,6,28,4,34
71,-48.92149999999752,3242.6,18,36,8,54
72,-40.90599999999885,2183.0,14,31,9,45
73,-41.06624999999852,2379.15,13,23,10,36
74,-53.1834999999967,2580.8333333333335,25,30,9,55
75,-43.864249999998684,2118.176470588235,20,34,9,54
76,-39.40874999999933,2008.5,17,34,6,51
77,-46.713749999996764,3156.9,20,30,10,50
78,-50.88724999999811,2680.4736842105262,20,34,7,54
79,-50.665999999997915,3321.95,27,33,8,60
80,-48.55399999999851,1828.7058823529412,11,31,8,42
81,-34.63949999999794,3419.65,33,30,7,63
82,-32.326749999998846,2330.3333333333335,18,31,12,49
83,-46.27849999999782,2579.9,18,27,6,45
84,-45.95749999999829,2414.8,16,22,6,38
85,-45.88074999999908,2217.95,14,18,11,32
86,-60.2509999999976,3508.4736842105262,32,39,13,71
87,-54.63074999999746,3023.0,25,36,8,61
88,-48.29499999999762,3108.315789473684,25,33,6,58
89,-50.15024999999828,2351.315789473684,14,23,10,37
90,-56.11599999999756,3321.9,16,36,11,52
91,-37.959999999998786,2937.0,44,33,9,77
92,-45.249249999998426,2578.6315789473683,26,32,6,58
93,-58.72949999999673,3043.9473684210525,22,36,7,58
94,-40.89149999999894,1908.9411764705883,29,39,13,68
95,-41.581249999997155,3696.5,31,36,11,67
96,-39.141249999997555,1952.9375,20,33,4,53
97,-40.863249999999624,1727.111111111111,12,22,14,34
98,-60.162999999996295,2910.823529411765,41,42,12,83
99,-54.55874999999831,2468.777777777778,22,32,9,54
100,-61.9632499999979,2876.8947368421054,28,42,16,70
101,-48.36224999999906,1532.1875,33,32,16,65
102,-41.53949999999917,2363.8888888888887,20,36,3,56
103,-40.8342499999991,1660.0555555555557,3,24,11,27
104,-45.12249999999662,2662.0,30,25,10,55
105,-40.152249999998304,3156.05,25,35,8,60
106,-48.27174999999757,2612.0,21,28,4,49
107,-51.86749999999843,2140.0,10,31,7,41
108,-49.21499999999712,3738.7,35,31,11,66
109,-41.11899999999822,2106.9411764705883,18,26,7,44
110,-37.22274999999826,2862.4,28,26,6,54
111,-41.1614999999979,3445.85,28,33,7,61
112,-51.75599999999813,2736.3,16,35,5,51
113,-52.30074999999793,3164.75,26,25,12,51
114,-50.80449999999793,2803.0555555555557,38,33,9,71
115,-47.459999999997194,2878.0,32,34,11,66
116,-34.24499999999624,3707.65,34,33,9,67
117,-40.38499999999884,2187.1,13,23,10,36
118,-51.72649999999744,2748.315789473684,20,27,9,47
119,-50.41574999999652,3319.6315789473683,32,38,9,70
120,-51.50874999999742,2672.85,16,28,8,44
121,-40.226249999998835,1987.0,8,29,4,37
122,-44.95599999999834,2298.7368421052633,17,29,7,46
123,-54.06424999999854,1598.0588235294117,5,25,8,30
124,-37.109749999997824,3492.6,24,36,11,60
125,-53.613249999997365,3068.9473684210525,25,37,3,62
126,-42.090249999999514,2034.7894736842106,17,22,15,39
127,-41.14674999999862,2217.5,20,29,8,49
128,-41.3332499999989,2033.9473684210527,15,25,7,40
129,-42.15274999999723,3140.25,29,24,6,53
130,-60.483749999997215,3204.4210526315787,36,30,9,66
131,-43.22799999999738,3193.5789473684213,30,41,5,71
132,-60.817499999997985,2005.1764705882354,29,43,12,72
133,-41.06624999999775,3003.842105263158,29,38,5,67
134,-37.52949999999889,1778.235294117647,39,34,10,73
135,-51.48874999999687,3765.7,31,31,10,62
136,-40.92024999999849,2656.315789473684,19,36,8,55
137,-44.541999999997614,2894.25,21,26,9,47
138,-43.39374999999756,3132.5263157894738,29,31,9,60
139,-34.45524999999908,2030.5555555555557,13,33,8,46
140,-50.28524999999882,2009.5,22,26,7,48
141,-51.460749999996764,3589.4,31,33,10,64
142,-48.495249999999295,1888.4444444444443,9,29,8,38
143,-45.97524999999968,1550.0625,26,30,18,56
144,-49.2924999999985,2394.8947368421054,16,31,5,47
145,-47.614249999997206,2255.3888888888887,20,27,8,47
146,-41.09324999999841,2504.3684210526317,19,22,9,41
147,-47.061499999998105,2784.0526315789475,23,34,9,57
148,-38.97374999999862,2301.157894736842,17,20,10,37
149,-48.053249999997846,3068.8,18,30,10,48
150,-47.93099999999776,2539.277777777778,18,33,8,51
151,-46.49524999999802,2932.25,17,31,14,48
152,-50.069499999998236,1850.235294117647,10,24,13,34
153,-42.7234999999984,2957.65,22,33,4,55
154,-38.40249999999814,2323.222222222222,22,30,6,52
155,-42.64099999999693,3383.05,33,36,6,69
156,-50.15999999999745,2406.222222222222,19,23,10,42
157,-58.14024999999814,2868.4736842105262,26,35,6,61
158,-45.714999999998334,2588.7,14,29,9,43
159,-47.867499999997946,2127.470588235294,17,34,6,51
160,-49.80149999999817,2440.842105263158,12,30,4,42
161,-63.694249999998725,2628.7894736842104,34,29,18,63
162,-51.053249999997,2699.7894736842104,14,39,9,53
163,-59.51400000000005,2294.5789473684213,22,32,20,54
164,-37.63424999999684,3083.157894736842,24,32,10,56
165,-38.10924999999825,2861.0,25,33,9,58
166,-53.54474999999841,1922.0555555555557,9,26,10,35
167,-51.4497499999964,3834.65,35,36,6,71
168,-53.23374999999993,1429.0,5,22,8,27
169,-41.99974999999785,2826.7894736842104,24,33,5,57
170,-52.95024999999824,1771.2222222222222,11,26,9,37
171,-37.85099999999803,2869.3684210526317,24,31,7,55
172,-54.83949999999756,3009.7894736842104,25,43,9,68
173,-59.15724999999848,1598.0588235294117,7,26,9,33
174,-51.56524999999677,2949.5789473684213,24,28,11,52
175,-38.903499999997294,2201.3529411764707,27,29,5,56
176,-39.990749999998954,1842.6666666666667,11,17,9,28
177,-50.70099999999707,2122.4736842105262,22,35,8,57
178,-42.98174999999754,3275.1,23,33,9,56
179,-43.17249999999848,2492.6470588235293,44,29,9,73
180,-49.18099999999933,2018.0526315789473,8,27,12,35
181,-40.61474999999808,2294.684210526316,20,22,7,42
182,-55.63149999999931,2323.1666666666665,34,35,9,69
183,-58.27624999999688,2326.9375,46,39,14,85
184,-56.31199999999537,3505.0526315789475,36,33,12,69
185,-32.3609999999987,2463.4736842105262,23,24,7,47
186,-68.38249999999637,3151.823529411765,28,43,14,71
187,-64.06299999999466,2557.0,42,29,7,71
188,-46.12699999999743,3008.4,25,23,8,48
189,-47.92149999999755,2514.3684210526317,23,26,4,49
190,-45.3814999999989,2052.5,21,29,15,50
191,-40.61949999999856,2401.25,19,24,5,43
192,-33.37774999999856,2258.8888888888887,20,31,7,51
193,-42.592499999998275,2560.5555555555557,28,32,8,60
194,-47.49099999999803,2506.7894736842104,19,29,8,48
195,-48.10524999999819,2511.75,16,27,7,43
196,-47.931749999998814,2198.470588235294,41,26,6,67
197,-45.39249999999766,2428.222222222222,24,24,8,48
198,-59.5587499999967,3521.9,28,35,6,63
199,-52.564999999998676,2705.2,14,31,5,45
200,-46.85074999999709,2507.5789473684213,21,34,4,55
201,-55.41824999999835,2794.15,18,26,9,44
202,-57.957499999999264,1998.7777777777778,15,27,9,42
203,-34.1732499999987,2299.75,15,30,6,45
204,-50.238999999997496,3327.9473684210525,31,35,6,66
205,-56.03824999999754,3396.4736842105262,31,40,11,71
206,-39.77599999999909,2023.0,11,27,7,38
207,-37.66724999999899,2245.2631578947367,15,21,8,36
208,-40.79624999999867,2265.55,13,30,4,43
209,-53.712749999995935,2364.6470588235293,29,38,6,67
210,-47.528499999998566,2715.6315789473683,20,25,12,45
211,-54.100999999996745,3341.315789473684,35,34,11,69
212,-51.42599999999943,2230.6111111111113,19,28,16,47
213,-50.75474999999697,3925.05,29,32,10,61
214,-54.04249999999812,2840.9473684210525,23,26,14,49
215,-60.83499999999809,3360.5263157894738,32,38,11,70
216,-50.2284999999997,2095.0,21,28,16,49
217,-41.20749999999932,2233.5263157894738,12,31,11,43
218,-51.1419999999986,2537.0,15,26,7,41
219,-43.35374999999868,1967.9473684210527,10,27,9,37
220,-37.0754999999982,2227.1666666666665,39,28,9,67
221,-63.94374999999923,2492.5555555555557,29,44,6,73
222,-49.766249999998415,1921.1176470588234,20,22,9,42
223,-44.50649999999835,2968.7,19,26,11,45
224,-46.91574999999845,2999.7368421052633,42,35,12,77
225,-39.922249999999956,1429.0,4,21,8,25
226,-49.90224999999814,2666.4736842105262,19,33,4,52
227,-51.348499999996555,2612.176470588235,37,29,4,66
228,-54.80324999999691,2444.1111111111113,20,36,9,56
229,-47.71774999999605,3667.3,40,27,8,67
230,-42.62724999999918,2057.315789473684,17,28,6,45
231,-62.58924999999846,2763.2631578947367,21,38,10,59
232,-47.867249999996744,2915.315789473684,24,35,5,59
233,-45.28424999999844,2418.85,12,25,9,37
234,-40.588999999998535,2667.2,15,28,8,43
235,-48.47424999999761,4016.3,31,40,9,71
236,-53.2049999999975,2560.5555555555557,26,31,6,57
237,-40.60749999999711,3606.2105263157896,50,34,11,84
238,-45.89174999999624,3817.9,33,36,5,69
239,-47.05524999999809,2365.6,10,36,4,46
240,-57.845499999998424,2395.4117647058824,27,47,7,74
241,-56.52624999999656,3433.2105263157896,37,28,12,65
242,-48.70974999999817,2353.4117647058824,30,49,3,79
243,-43.06899999999857,2500.9473684210525,20,27,7,47
244,-39.87949999999713,2466.9444444444443,19,30,7,49
245,-44.497749999998874,2308.5,11,31,5,42
246,-41.300249999998094,2298.5555555555557,17,25,7,42
247,-53.46424999999831,2895.2631578947367,34,32,8,66
248,-50.29999999999755,2608.7894736842104,21,33,5,54
249,-43.73799999999811,2286.1875,29,41,10,70
250,-64.25499999999712,3300.4444444444443,34,43,7,77
251,-52.16424999999738,1648.25,16,32,8,48
252,-55.42249999999957,1429.0,3,22,10,25
253,-34.36949999999696,2561.3333333333335,31,30,7,61
254,-44.378749999998035,2784.9473684210525,27,36,2,63
255,-52.73624999999638,3046.3888888888887,28,38,10,66
256,-44.126499999998046,2467.95,17,29,5,46
257,-44.61049999999836,2568.684210526316,19,28,7,47
258,-52.9334999999988,1701.875,31,31,14,62
259,-38.41149999999832,2556.05,18,26,5,44
260,-52.64799999999896,2779.157894736842,41,32,11,73
261,-56.80024999999595,4069.157894736842,39,46,12,85
262,-37.27224999999849,2547.3333333333335,22,35,10,57
263,-48.788749999996696,3949.4736842105262,47,42,7,89
264,-34.29274999999896,2052.5555555555557,16,22,10,38
265,-29.87024999999735,2701.3684210526317,29,28,5,57
266,-45.48074999999809,2341.4117647058824,23,26,6,49
267,-49.32099999999866,2468.8333333333335,21,31,7,52
268,-43.70074999999916,2095.75,10,26,8,36
269,-58.27549999999786,3236.9473684210525,42,34,10,76
270,-31.972499999998426,2517.9,17,28,7,45
271,-31.00849999999847,2369.7894736842104,17,28,9,45
272,-40.98774999999766,3020.45,21,31,9,52
273,-45.75949999999866,2993.35,26,29,3,55
274,-43.71074999999769,2782.4736842105262,22,26,11,48
275,-43.46774999999741,3666.4,34,34,6,68
276,-47.292999999996326,3259.25,28,32,11,60
277,-50.5049999999978,2804.2631578947367,23,27,10,50
278,-36.326999999998364,2222.75,11,27,8,38
279,-51.018249999997245,3163.25,16,35,12,51
280,-42.924999999997965,2887.0,25,30,10,55
281,-46.678249999997945,2567.7368421052633,19,28,8,47
282,-45.39399999999592,3865.7,40,28,6,68
283,-42.90324999999821,2492.529411764706,39,27,18,66
284,-35.471499999998095,3420.684210526316,34,33,8,67
285,-35.4282499999979,2776.75,17,30,8,47
286,-55.10049999999751,2443.0,19,36,9,55
287,-39.98049999999935,2258.8888888888887,37,37,6,74
288,-49.657499999999246,1916.4117647058824,16,28,7,44
289,-43.80649999999785,3002.85,26,22,13,48
290,-30.879249999998525,3184.3684210526317,36,34,2,70
291,-49.70074999999814,2131.235294117647,39,29,16,68
292,-36.21174999999643,2510.222222222222,32,38,4,70
293,-39.923999999998884,2395.6315789473683,19,27,7,46
294,-56.2759999999984,2535.157894736842,15,33,10,48
295,-53.54924999999736,2667.315789473684,19,29,6,48
296,-57.69299999999655,3933.9,26,47,8,73
297,-42.4074999999968,2894.722222222222,31,33,6,64
298,-47.37699999999786,3302.9,26,38,4,64
299,-36.72249999999851,2191.1,15,22,8,37
300,-44.69099999999773,2699.153846153846,22,31,10,53
301,-59.199999999998155,2234.1666666666665,15,37,3,52
302,-41.10974999999776,2957.65,27,24,8,51
303,-43.987249999998404,2528.777777777778,25,33,8,58
304,-49.879499999997975,2812.4,23,29,7,52
305,-37.9157499999974,3270.5555555555557,41,44,6,85
306,-39.62499999999868,2148.0588235294117,41,29,10,70
307,-42.144499999998274,2185.1052631578946,14,30,6,44
308,-43.34874999999819,2930.65,27,27,5,54
309,-36.99949999999728,2320.6666666666665,26,29,4,55
310,-34.17974999999926,2008.45,13,25,4,38
311,-36.810999999996824,3203.6315789473683,30,36,8,66
312,-41.5342499999969,3584.6,33,40,2,73
313,-43.104749999997935,3041.0555555555557,32,36,10,68
314,-52.80524999999769,2636.2631578947367,21,37,6,58
315,-44.9199999999988,2230.2105263157896,22,27,8,49
316,-56.22499999999811,1904.3529411764705,15,33,3,48
317,-64.09399999999974,1429.0,13,40,7,53
318,-40.01724999999983,1794.9473684210527,8,36,6,44
319,-48.73599999999891,2581.1052631578946,18,30,7,48
320,-47.223499999998566,2544.95,17,35,6,52
321,-53.16375000000043,1825.888888888889,21,46,6,67
322,-51.87499999999843,2122.8823529411766,39,31,12,70
323,-35.106499999998526,2642.2105263157896,26,29,3,55
324,-57.15174999999768,2224.3684210526317,15,25,11,40
325,-48.04924999999608,2445.8823529411766,39,33,8,72
326,-48.2697499999975,2668.842105263158,25,24,6,49
327,-42.92249999999851,2914.5789473684213,25,35,6,60
328,-55.694749999997406,3337.2631578947367,28,41,7,69
329,-48.55124999999848,2487.15,19,30,3,49
330,-39.1857499999978,3123.315789473684,32,38,4,70
331,-41.668749999998106,2678.25,21,26,9,47
332,-43.66774999999896,2005.1176470588234,37,34,9,71
333,-41.92874999999787,2617.0555555555557,27,30,3,57
334,-49.32049999999766,2616.2105263157896,26,29,4,55
335,-46.699249999999594,1438.5333333333333,28,31,12,59
336,-49.78174999999693,2453.777777777778,23,25,13,48
337,-44.38924999999835,2854.315789473684,45,31,8,76
338,-58.46074999999685,3873.45,37,26,9,63
339,-39.92724999999931,2312.4,12,30,6,42
340,-45.41174999999952,1429.0,28,36,11,64
341,-47.19149999999814,2500.2631578947367,25,21,6,46
342,-48.60749999999741,2699.7894736842104,20,30,9,50
343,-43.71849999999877,2414.0,23,17,8,40
344,-46.104999999998846,2280.0555555555557,19,36,7,55
345,-36.73424999999749,3359.3,26,36,7,62
346,-44.99174999999728,3224.4210526315787,29,35,7,64
347,-48.1842499999979,1816.5882352941176,13,36,3,49
348,-41.155999999998826,2361.8823529411766,35,47,6,82
349,-37.666749999998714,2595.75,21,28,6,49
350,-58.33174999999708,3814.2105263157896,36,47,11,83
351,-33.182249999998135,2734.1052631578946,35,30,8,65
352,-45.81950000000011,1643.764705882353,24,31,12,55
353,-33.13374999999921,2245.315789473684,39,28,12,67
354,-34.67974999999876,2727.2105263157896,29,38,6,67
355,-41.72824999999794,1839.9444444444443,15,30,8,45
356,-43.72574999999814,2269.4117647058824,23,33,8,56
357,-34.02849999999723,3465.0526315789475,40,36,11,76
358,-51.552999999998335,2420.5882352941176,21,37,8,58
359,-35.33549999999901,2353.7894736842104,28,32,4,60
360,-37.62874999999714,3168.5263157894738,33,38,7,71
361,-47.798999999996994,3429.15,33,33,1,66
362,-40.40624999999885,1668.0555555555557,8,30,4,38
363,-54.98749999999808,2430.722222222222,21,30,8,51
364,-53.73624999999886,2262.4444444444443,20,28,5,48
365,-41.2679999999972,3081.6111111111113,33,32,8,65
366,-45.31124999999775,2856.8,15,35,7,50
367,-40.560999999999396,2141.684210526316,13,30,10,43
368,-55.547499999997584,3289.45,20,39,2,59
369,-37.914999999998074,2584.4210526315787,27,27,5,54
370,-41.579749999997105,2316.1176470588234,29,46,5,75
371,-56.48199999999694,3521.1,33,37,2,70
372,-43.21474999999889,2493.35,17,28,2,45
373,-39.33449999999826,2938.777777777778,51,34,12,85
374,-47.8529999999962,2758.9444444444443,44,46,7,90
375,-33.23174999999859,2251.3,16,27,5,43
376,-42.54074999999914,2064.0,38,31,12,69
377,-38.15874999999844,2369.7894736842104,19,33,6,52
378,-48.90274999999659,3693.9473684210525,34,44,5,78
379,-42.04449999999774,3155.25,24,33,4,57
380,-43.11424999999769,2364.722222222222,21,29,8,50
381,-43.3969999999975,2769.8947368421054,30,35,4,65
382,-44.91974999999829,2001.3333333333333,14,28,9,42
383,-65.49074999999789,2922.0,25,37,10,62
384,-35.19949999999939,2071.1111111111113,18,28,1,46
385,-41.129499999996824,3833.05,46,31,2,77
386,-40.94149999999723,3151.4,32,22,7,54
387,-40.79124999999679,3255.3,30,33,2,63
388,-44.806499999998096,1978.5625,24,39,5,63
389,-44.00474999999873,2172.6315789473683,17,23,4,40
390,-34.022499999997756,2758.0,26,28,3,54
391,-32.542749999998584,2642.285714285714,30,27,3,57
392,-45.34024999999913,2205.1111111111113,22,31,5,53
393,-43.08924999999861,2340.5263157894738,22,26,3,48
394,-45.058999999997056,3258.5,34,29,7,63
395,-40.76924999999867,2532.3,19,23,6,42
396,-38.07499999999872,2560.6111111111113,33,29,8,62
397,-46.54399999999853,2072.0,31,40,7,71
398,-37.03749999999986,1429.0,0,31,4,31
399,-41.72974999999777,3260.315789473684,53,33,6,86
400,-52.83899999999826,2580.294117647059,36,44,10,80
401,-33.340499999997135,3696.55,42,31,5,73
402,-33.061999999996814,2920.3888888888887,31,33,6,64
403,-39.42049999999936,1983.7058823529412,20,37,9,57
404,-41.239499999999296,1995.2222222222222,19,27,5,46
405,-30.668499999999028,2756.5789473684213,45,35,8,80
406,-38.94524999999895,1822.388888888889,22,36,2,58
407,-57.918749999998944,1918.3529411764705,16,30,4,46
408,-45.45349999999658,3527.5789473684213,38,39,7,77
409,-50.267249999998114,2222.0,15,25,8,40
410,-35.620499999997406,2978.0,35,35,2,70
411,-37.265749999998924,2162.5,16,21,5,37
412,-41.02474999999852,1601.8235294117646,10,34,1,44
413,-28.688749999999565,1904.235294117647,36,27,8,63
414,-34.31799999999763,2555.222222222222,31,29,1,60
415,-41.48074999999953,2162.684210526316,25,28,7,53
416,-39.52824999999943,2027.157894736842,24,20,8,44
417,-52.7827499999975,2928.1666666666665,33,42,7,75
418,-43.8702499999989,2286.222222222222,16,36,12,52
419,-43.31824999999602,4347.210526315789,47,37,8,84
420,-27.516249999998006,3008.35,31,29,6,60
421,-37.144999999997985,2707.65,19,35,6,54
422,-48.569749999997434,3235.45,31,29,5,60
423,-37.05649999999913,2536.7894736842104,35,30,7,65
424,-39.348749999997544,2854.277777777778,56,23,17,79
425,-38.95624999999849,2606.9,19,31,5,50
426,-54.089249999997904,2383.4117647058824,35,41,9,76
427,-28.90574999999805,3083.0,29,30,8,59
428,-43.687999999997075,2747.5,39,25,9,64
429,-49.59124999999962,1438.5333333333333,21,38,12,59
430,-37.46699999999767,3087.85,27,31,4,58
431,-28.69374999999784,2776.6111111111113,33,29,6,62
432,-34.03499999999876,3282.95,33,34,5,67
433,-41.53624999999957,2177.0,40,42,7,82
434,-32.9157499999994,1980.421052631579,20,27,4,47
435,-36.368249999998106,2559.823529411765,35,18,4,53
436,-33.81799999999815,2397.277777777778,27,37,5,64
437,-56.256999999998655,2097.5882352941176,28,30,6,58
438,-42.47399999999682,3173.4736842105262,49,21,4,70
439,-36.842249999998316,2735.35,23,30,6,53
440,-36.94649999999893,2151.684210526316,24,22,2,46
441,-32.002249999998455,2444.9285714285716,27,22,5,49
442,-35.31249999999796,2587.1,30,22,6,52
443,-33.22549999999937,1806.4444444444443,13,38,2,51
444,-29.70549999999799,2952.9473684210525,36,31,2,67
445,-40.05549999999822,1961.7222222222222,17,33,6,50
446,-39.33674999999816,2561.0,15,32,8,47
447,-23.070499999999136,2082.3684210526317,20,31,1,51
448,-40.83049999999888,2448.4736842105262,33,34,6,67
449,-20.43499999999663,3687.2,55,24,5,79
450,-45.79874999999838,2336.6470588235293,23,41,9,64
451,-50.445749999999826,1429.0,3,32,8,35
452,-30.383999999998895,2380.7368421052633,32,27,2,59
453,-33.58949999999874,2502.5789473684213,26,24,6,50
454,-42.83174999999769,2699.076923076923,42,26,3,68
455,-28.076999999996957,3115.0526315789475,40,25,7,65
456,-43.05649999999754,3307.2105263157896,32,47,5,79
457,-33.32399999999757,2630.0555555555557,35,29,2,64
458,-46.78699999999767,2545.25,36,30,3,66
459,-33.74574999999738,2942.9473684210525,37,37,4,74
460,-38.467499999998644,2552.684210526316,28,25,4,53
461,-32.411999999997654,3326.0,34,35,6,69
462,-33.90599999999863,2839.2631578947367,57,20,10,77
463,-51.152249999997444,3854.55,44,41,6,85
464,-30.468999999998193,2030.5294117647059,26,25,6,51
465,-40.43174999999951,1980.421052631579,26,16,3,42
466,-42.84449999999933,2223.6470588235293,41,27,11,68
467,-28.384249999998794,1964.75,37,32,6,69
468,-32.857749999996855,2180.0625,37,32,10,69
469,-30.574249999997342,3776.5789473684213,59,32,2,91
470,-35.221749999998764,2237.05,23,21,2,44
471,-19.767999999999788,2292.4444444444443,48,23,12,71
472,-31.204499999997147,3094.8823529411766,51,34,7,85
473,-29.14824999999878,2148.6111111111113,27,23,3,50
474,-45.29699999999767,2738.6875,32,22,6,54
475,-36.281249999998764,2112.5555555555557,31,17,3,48
476,-38.55724999999892,2320.4736842105262,23,34,7,57
477,-33.80549999999689,3868.5263157894738,51,38,7,89
478,-37.78924999999843,2038.8235294117646,36,28,3,64
479,-50.20624999999821,3240.2631578947367,44,29,5,73
480,-31.173499999999414,2072.8,19,27,4,46
481,-36.43224999999751,3345.7,41,30,2,71
482,-35.77274999999697,3477.6,41,36,2,77
483,-29.385749999997323,3145.9473684210525,51,21,3,72
484,-38.45149999999762,3484.7,32,36,7,68
485,-36.30024999999952,2028.3,27,16,0,43
486,-34.99924999999856,2203.1176470588234,30,22,4,52
487,-39.93274999999903,2106.8,19,24,5,43
488,-59.795999999996866,3272.1666666666665,39,44,4,83
489,-46.128499999998105,1429.0,11,41,3,52
490,-37.63274999999899,2452.777777777778,28,39,1,67
491,-42.63799999999899,2290.315789473684,18,37,8,55
492,-26.44674999999844,3124.4,55,25,2,80
493,-42.87024999999902,1652.25,13,41,4,54
494,-43.67774999999857,2023.4444444444443,22,25,6,47
495,-31.479749999998766,2392.0,34,22,3,56
496,-41.945249999997586,2030.4117647058824,45,34,5,79
497,-37.576499999998504,2363.214285714286,27,23,1,50
498,-36.412999999997886,3153.7,35,27,6,62
499,-23.46049999999623,3875.2105263157896,61,30,4,91
500,-31.27349999999901,2217.95,26,23,1,49
501,-34.920249999997225,4060.75,44,43,2,87
502,-41.648749999997875,2651.1111111111113,34,29,8,63
503,-42.02074999999864,2916.157894736842,36,45,8,81
504,-30.66674999999942,2098.05,26,19,1,45
505,-26.20974999999951,2040.15,25,18,3,43
506,-22.511749999998667,2229.235294117647,28,34,6,62
507,-26.34224999999829,2457.076923076923,44,19,5,63
508,-39.233499999998074,2554.4736842105262,27,31,5,58
509,-15.776999999999259,2881.0526315789475,57,31,7,88
510,-42.331749999997875,3347.2631578947367,32,44,7,76
511,-34.90524999999905,2079.9,24,18,2,42
512,-25.918249999997045,2348.8333333333335,41,23,8,64
513,-36.66399999999825,3079.8947368421054,44,39,12,83
514,-29.793249999997933,3193.8823529411766,64,41,8,105
515,-36.03774999999856,2000.4375,30,33,4,63
516,-29.80524999999861,2515.8947368421054,35,19,4,54
517,-39.00049999999791,2498.4210526315787,38,24,4,62
518,-24.5539999999972,1876.5,45,28,3,73
519,-40.07949999999545,1977.611111111111,53,28,9,81
520,-39.92950000000004,1429.0,17,30,10,47
521,-13.289499999998464,3232.0526315789475,59,23,8,82
522,-40.015749999998995,2304.777777777778,26,35,1,61
523,-29.246749999998105,3183.8,47,26,1,73
524,-29.04499999999872,2107.625,39,24,1,63
525,-10.766499999998505,3132.6315789473683,49,24,4,73
526,-26.551749999998965,2436.25,26,30,1,56
527,-35.16999999999494,4920.35,75,25,9,100
528,-24.5684999999935,4816.789473684211,85,26,9,111
529,-30.018249999998126,2276.8823529411766,36,21,5,57
530,-38.68900000000084,1429.0,26,56,6,82
531,-31.453749999997427,2572.8888888888887,35,31,3,66
532,-31.45649999999829,2256.714285714286,30,24,4,54
533,-32.84849999999936,2119.6,28,16,2,44
534,-35.36024999999939,2254.5,33,41,3,74
535,-37.27674999999728,2832.6315789473683,44,24,4,68
536,-37.51024999999838,2124.0555555555557,35,28,2,63
537,-26.494249999997862,2694.866666666667,37,28,4,65
538,-20.083249999997186,3164.2631578947367,48,26,7,74
539,-45.219249999998624,2134.0588235294117,36,33,9,69
540,-23.67999999999965,1905.2222222222222,28,30,0,58
541,-45.24449999999924,2378.1052631578946,26,25,7,51
542,-26.48699999999868,2602.1,30,24,5,54
543,-33.18749999999942,2072.315789473684,27,22,5,49
544,-29.588249999998045,3460.0,36,48,11,84
545,-53.47724999999811,3388.157894736842,46,52,9,98
546,-34.154499999999146,1929.0,34,25,5,59
547,-23.535999999999863,2028.25,21,22,4,43
548,-36.423749999998535,2352.277777777778,31,27,6,58
549,-24.32924999999843,2370.0,40,24,3,64
550,-24.991999999999045,1880.375,53,21,11,74
551,-60.3154999999972,1429.0,3,40,20,43
552,-33.16174999999726,2448.9166666666665,37,33,5,70
553,-22.848499999998786,2865.6111111111113,48,32,4,80
554,-30.82874999999591,2288.0555555555557,54,21,6,75
555,-39.25774999999908,1643.764705882353,8,42,2,50
556,-43.547499999997584,1942.9375,35,40,2,75
557,-23.27724999999792,4544.95,66,31,5,97
558,-62.67824999999821,1862.2941176470588,19,42,12,61
559,-30.37499999999839,2786.277777777778,44,32,3,76
560,-28.627749999998247,2072.875,39,24,2,63
561,-22.413999999998595,1912.1875,33,20,5,53
562,-18.812249999998535,2929.05,37,31,1,68
563,-49.546999999999755,1952.1052631578948,16,29,2,45
564,-22.94774999999811,2244.777777777778,38,25,5,63
565,-35.18824999999815,2475.764705882353,31,33,8,64
566,-36.18299999999883,2779.2105263157896,38,37,12,75
567,-25.371499999998825,2898.15,37,25,4,62
568,-31.629749999998023,2568.6315789473683,30,30,4,60
569,-13.547749999998882,2552.1,30,29,2,59
570,-24.904749999996206,3468.3684210526317,50,37,8,87
571,-28.981499999997755,2783.3684210526317,44,30,2,74
572,-21.261499999999053,2106.0,41,29,2,70
573,-50.58974999999833,2252.5882352941176,27,52,4,79
574,-31.297249999999373,2008.4,29,15,1,44
575,-21.860499999998826,2625.294117647059,36,17,6,53
576,-44.75924999999812,2494.5625,58,36,13,94
577,-25.62974999999823,3266.5,46,27,4,73
578,-26.945499999998468,1841.8235294117646,26,26,5,52
579,-37.67449999999747,3200.722222222222,38,42,5,80
580,-19.357499999997877,2877.7368421052633,42,27,3,69
581,-31.180749999999456,1621.5,34,37,9,71
582,-17.435999999997062,4794.2,68,41,5,109
583,-33.80724999999989,2134.1052631578946,36,22,16,58
584,-34.50449999999793,2106.0,42,26,2,68
585,-52.167999999999594,1703.3333333333333,19,48,13,67
586,-46.624999999999716,2028.7777777777778,26,29,14,55
587,-17.721749999997723,3150.55,47,28,1,75
588,-36.91724999999861,2184.470588235294,33,41,4,74
589,-22.03974999999754,2402.0588235294117,39,37,7,76
590,-27.24299999999916,2012.8333333333333,20,37,2,57
591,-20.680999999998594,3093.277777777778,54,22,4,76
592,-25.3794999999985,2868.05,40,24,1,64
593,-48.34349999999891,2122.764705882353,45,29,13,74
594,-23.742749999998694,2366.5625,43,30,5,73
595,-35.81349999999917,2156.9,20,25,4,45
596,-26.057499999997866,2311.0,31,29,6,60
597,-18.248999999997864,3627.1052631578946,61,27,4,88
598,-33.274499999998895,1778.235294117647,10,40,3,50
599,-42.069499999999,2352.3333333333335,39,30,7,69
600,-17.432749999998656,2743.2631578947367,60,13,1,73
601,-25.233499999998138,3462.45,51,27,1,78
602,-25.97674999999785,2545.25,52,35,5,87
603,-31.926499999996754,3900.5,63,18,4,81
604,-43.72049999999855,2235.1666666666665,43,32,19,75
605,-36.9024999999981,2089.235294117647,39,20,7,59
606,-29.389999999999283,2097.25,32,13,3,45
607,-25.339249999999076,2616.0555555555557,60,16,18,76
608,-37.51124999999928,2608.6315789473683,45,30,12,75
609,-26.02924999999964,2044.15,28,19,0,47
610,-25.535999999998715,1996.7058823529412,37,17,5,54
611,-30.810249999998963,2160.842105263158,30,22,2,52
612,-23.652749999998573,2134.375,35,32,4,67
613,-21.07149999999614,4176.8,56,37,6,93
614,-19.499749999998443,2352.3888888888887,29,26,3,55
615,-36.15824999999885,2290.722222222222,45,34,9,79
616,-24.811999999998367,2410.684210526316,22,42,1,64
617,-37.62249999999937,1982.8333333333333,33,22,3,55
618,-20.982499999998034,2282.5882352941176,35,31,2,66
619,-9.61599999999623,3172.6111111111113,70,23,9,93
620,-45.674499999998275,2822.684210526316,23,41,5,64
621,-33.166499999999516,2012.157894736842,28,18,3,46
622,-22.314749999998305,3059.9,40,30,2,70
623,-18.514749999997193,4454.6,58,36,6,94
624,-36.256499999999534,2012.1052631578948,22,24,10,46
625,-36.755999999998224,3303.65,32,36,3,68
626,-46.78724999999843,2944.5789473684213,40,34,8,74
627,-28.305249999998942,2300.0,31,18,3,49
628,-29.18699999999769,1599.6875,26,33,5,59
629,-28.513999999999193,2873.5555555555557,44,43,8,87
630,-35.78299999999712,2204.9375,53,17,5,70
631,-20.034749999996073,4704.55,61,38,7,99
632,-36.46049999999808,2112.5625,53,29,4,82
633,-30.402999999997178,3143.3684210526317,45,22,8,67
634,-29.41424999999783,3185.157894736842,49,25,6,74
635,-7.600499999998304,3251.25,56,20,0,76
636,-15.207249999998306,3212.684210526316,60,20,10,80
637,-25.884749999999002,2987.9473684210525,49,27,5,76
638,-13.933999999998198,3281.6,47,27,4,74
639,-9.185499999997923,3419.6,61,16,3,77
640,-27.028999999997943,3281.4,45,25,4,70
641,-36.17399999999863,2471.4444444444443,36,23,5,59
642,-12.96524999999815,3691.0,56,26,4,82
643,-19.14799999999737,3618.684210526316,62,28,3,90
644,-16.497999999996956,3783.5555555555557,66,46,8,112
645,-21.75724999999705,2497.4117647058824,57,21,5,78
646,-29.747499999998713,2906.8947368421054,26,43,6,69
647,-47.76699999999982,2070.5789473684213,11,40,8,51
648,-34.37474999999691,4075.1,46,47,2,93
649,-14.425749999998493,3087.8,43,32,1,75
650,-25.057249999998223,2828.6111111111113,33,41,4,74
651,-35.737999999997655,3701.3,49,27,2,76
652,-30.95449999999854,2401.6666666666665,36,38,13,74
653,-25.819749999998685,2423.8333333333335,34,25,4,59
654,-22.400999999998515,2591.0,46,30,5,76
655,-28.929249999999534,1972.0526315789473,29,22,2,51
656,-27.214749999999412,2099.8947368421054,32,17,2,49
657,-38.501749999999156,1986.4117647058824,49,31,12,80
658,-29.490249999996756,4225.85,50,41,4,91
659,-4.3777499999973735,3522.7,62,15,8,77
660,-30.98474999999786,2450.6470588235293,34,29,7,63
661,-33.65474999999823,2779.05,27,37,1,64
662,-27.826999999996712,2605.8125,51,37,10,88
663,-13.36699999999679,3177.8333333333335,73,14,7,87
664,-16.594249999997942,2110.4,54,23,7,77
665,-32.07999999999936,2028.2,31,13,1,44
666,-30.178999999998894,3048.05,26,35,5,61
667,-20.559499999998046,2862.1111111111113,52,25,5,77
668,-37.04124999999913,1750.4375,36,33,4,69
669,-18.822999999998906,2290.4210526315787,30,23,2,53
670,-26.234249999998575,2825.0,35,35,2,70
671,-18.21699999999722,2689.5882352941176,54,26,5,80
672,-35.14774999999705,3227.1111111111113,55,29,4,84
673,-14.241499999999018,2639.0,49,29,6,78
674,-27.227249999999067,2625.05,29,23,5,52
675,-25.54374999999818,3228.2,36,37,5,73
676,-28.28474999999896,2283.0,31,22,1,53
677,-25.40849999999909,2364.0,38,27,6,65
678,-33.48874999999642,2290.25,64,24,8,88
679,-17.768499999999705,1959.5263157894738,26,22,5,48
680,-26.39724999999811,2464.157894736842,37,23,6,60
681,-23.541749999999308,2119.55,30,18,1,48
682,-10.159749999996961,2974.0555555555557,58,20,11,78
683,-16.98049999999926,2648.9,40,21,2,61
684,-47.40224999999863,3159.222222222222,45,55,5,100
685,-32.70099999999751,3843.4,42,42,5,84
686,-24.348499999998193,2703.3333333333335,52,22,8,74
687,-27.874999999999137,2397.277777777778,38,41,8,79
688,-46.6015000000001,2095.7368421052633,31,29,10,60
689,-17.145249999996707,2611.1176470588234,53,27,4,80
690,-25.3072499999995,2166.45,21,28,1,49
691,-20.71499999999958,2225.3888888888887,42,32,15,74
692,-29.551999999997292,3421.5789473684213,50,38,4,88
693,-19.25474999999653,3841.8,59,25,7,84
694,-24.047249999998566,2600.1666666666665,50,29,4,79
695,-35.16949999999745,3101.235294117647,45,44,9,89
696,-27.18099999999792,2342.3846153846152,38,20,4,58
697,-19.798249999998283,2148.1176470588234,43,27,5,70
698,-37.08224999999871,1429.0,36,47,4,83
699,-19.37549999999961,1972.0526315789473,27,17,6,44
700,-29.341249999995814,2364.705882352941,62,22,8,84
701,-26.89624999999773,3421.1666666666665,56,39,8,95
702,-26.261999999998885,2621.85,26,28,10,54
703,-40.859249999998866,1929.4117647058824,49,27,5,76
704,-49.19899999999938,1429.0,7,32,7,39
705,-31.94624999999861,2915.55,34,28,5,62
706,-26.220749999998095,3135.45,39,37,0,76
707,-40.59899999999907,2290.6111111111113,35,23,3,58
708,-34.509249999999035,2291.714285714286,28,17,2,45
709,-23.424499999998588,2527.3125,46,28,4,74
710,-28.194249999998892,1887.5294117647059,41,28,5,69
711,-18.74199999999702,3567.4444444444443,60,37,5,97
712,-32.24324999999841,2322.3888888888887,34,40,5,74
713,-32.37699999999951,2323.5,20,29,5,49
714,-9.496749999997066,3975.8333333333335,78,24,4,102
715,-12.215749999997815,3050.8333333333335,56,25,3,81
716,-14.284749999998644,2581.5333333333333,44,29,5,73
717,-29.321249999998805,2199.777777777778,26,28,4,54
718,-22.725499999998735,2451.6315789473683,24,37,5,61
719,-2.7384999999975057,4163.95,65,34,3,99
720,-24.914749999996914,2138.705882352941,52,22,8,74
721,-24.470499999998047,3098.95,39,22,11,61
722,-38.41699999999986,2409.0,29,39,16,68
723,-30.00224999999914,2659.7368421052633,35,35,8,70
724,-25.72174999999922,2058.45,26,24,0,50
725,-22.348499999996772,3376.1666666666665,65,23,5,88
726,-27.05974999999915,2024.3,11,34,5,45
727,-29.75749999999518,4701.3,79,22,9,101
728,-28.844999999997828,3244.777777777778,61,31,5,92
729,-18.449249999998504,2665.4117647058824,39,22,5,61
730,-19.787999999999002,2036.0625,33,31,5,64
731,-12.449249999997225,4210.1,62,36,3,98
732,-21.161499999999382,2048.05,27,21,3,48
733,-37.22624999999839,2050.0625,39,21,7,60
734,-16.625999999998207,2832.470588235294,56,29,6,85
735,-24.693749999999408,2450.3333333333335,40,32,12,72
736,-23.02874999999944,2024.4,19,29,1,48
737,-41.56299999999932,1997.0526315789473,27,20,6,47
738,-28.955999999998596,2112.529411764706,37,31,8,68
739,-18.75799999999851,2723.6,43,19,2,62
740,-30.375999999998147,3312.9473684210525,41,41,7,82
741,-27.301749999998513,2799.7,33,29,4,62
742,-38.25974999999562,1698.8823529411766,46,33,14,79
743,-26.253249999997564,3864.8,61,26,6,87
744,-34.041749999999325,2018.0,28,14,4,42
745,-37.00674999999917,1429.0,37,47,7,84
746,1.1790000000019607,2912.3888888888887,55,20,8,75
747,-29.53024999999827,3183.05,49,22,3,71
748,-23.82974999999721,3827.5263157894738,66,37,4,103
749,-0.20649999999842938,2535.9333333333334,58,16,7,74
750,-21.847999999997118,4026.8,57,34,3,91
751,-12.053499999998966,2814.5333333333333,35,19,4,54
752,-24.425749999998736,3144.2631578947367,48,29,3,77
753,-5.475749999996929,3026.375,83,31,2,114
754,-27.683999999997507,3725.1,46,35,7,81
755,-19.948749999998082,3117.0555555555557,60,22,2,82
756,-36.917249999999825,2056.0555555555557,31,29,4,60
757,-32.37999999999877,1929.5294117647059,15,41,9,56
758,-12.31224999999652,4778.210526315789,93,36,6,129
759,-25.789499999997428,2838.4210526315787,40,35,11,75
760,-11.31899999999873,2423.45,24,32,4,56
761,-7.925749999998343,3158.4210526315787,60,13,2,73
762,-5.7194999999985034,3606.75,57,21,5,78
763,-13.807249999997804,3945.85,59,32,1,91
764,-18.18174999999864,2268.8333333333335,35,19,2,54
765,-40.22424999999866,2306.5,26,42,9,68
766,-28.426499999997247,2618.529411764706,32,48,11,80
767,-23.48399999999768,3305.4210526315787,50,32,10,82
768,-41.90599999999766,3091.0,18,46,8,64
769,-30.92699999999872,1994.8235294117646,44,16,4,60
770,-13.136999999997846,4358.4,60,39,6,99
771,-28.856250000000465,1429.0,20,33,14,53
772,-28.522499999998324,2647.1052631578946,30,34,3,64
773,-18.232249999995823,3432.6111111111113,59,34,14,93
774,-16.495749999998704,2426.235294117647,41,33,11,74
775,-14.498749999997354,3937.0526315789475,53,39,16,92
776,-21.806249999999338,2024.2,27,18,5,45
777,-48.26999999999954,2034.0588235294117,38,21,19,59
778,-30.985249999998665,2302.9473684210525,26,36,3,62
779,-7.360999999996648,4875.9,81,34,1,115
780,-11.52874999999792,3625.2,55,27,4,82
781,-22.251249999998358,2726.75,39,23,7,62
782,-24.537999999999442,2024.25,28,13,5,41
783,-36.74399999999875,2351.4210526315787,28,32,5,60
784,-29.668999999998835,2784.0526315789475,48,14,6,62
785,-52.74549999999952,1756.764705882353,15,60,8,75
786,-17.312499999998785,2786.684210526316,48,24,4,72
787,-25.83724999999801,3864.3684210526317,77,28,13,105
788,-22.642999999997876,3287.85,54,20,6,74
789,-8.7704999999978,3365.6315789473683,66,25,7,91
790,-18.328249999997933,3829.05,46,49,0,95
791,-10.252749999998105,4282.2,72,30,3,102
792,-12.481249999996939,3528.722222222222,72,29,4,101
793,-24.765749999997006,3320.6666666666665,61,30,8,91
794,-11.90674999999866,2597.8125,43,15,8,58
795,-19.902749999999315,2095.75,25,27,1,52
796,-26.701249999998122,2701.5263157894738,42,24,2,66
797,-21.824499999997265,4270.35,77,20,5,97
798,-18.97749999999798,3167.1111111111113,48,34,11,82
799,-27.069749999999395,2211.4444444444443,45,32,16,77
800,-19.432749999997462,2018.3529411764705,42,28,15,70
801,-33.30499999999682,2287.0555555555557,50,18,14,68
802,-27.43624999999924,2011.8333333333333,28,28,9,56
803,-38.27399999999937,1429.0,3,38,5,41
804,-6.4729999999963415,4860.1,91,25,4,116
805,-30.066499999999337,2032.35,20,23,3,43
806,-29.60749999999972,2004.7894736842106,20,19,9,39
807,-8.860749999998353,3440.8947368421054,65,19,11,84
808,-19.8177499999986,3278.3888888888887,46,43,4,89
809,-26.562999999999136,2084.222222222222,41,21,8,62
810,-38.01199999999993,2142.5789473684213,20,39,16,59
811,-16.357249999994444,2135.4375,94,20,11,114
812,-42.00849999999855,2662.9473684210525,35,39,3,74
813,-19.99774999999878,2528.25,35,28,0,63
814,-22.811999999998427,3215.3684210526317,52,23,7,75
815,-36.9099999999994,1514.375,29,33,5,62
816,-26.171749999997928,2150.823529411765,36,37,8,73
817,-21.60099999999933,2008.45,23,17,6,40
818,-23.58824999999888,2205.9444444444443,33,18,11,51
819,-28.30324999999898,2059.0,39,16,9,55
820,-30.122749999998582,2085.8125,31,25,1,56
821,-25.8677499999995,2048.1,30,17,0,47
822,-19.66524999999943,2008.35,21,26,1,47
823,-12.189499999998379,2534.705882352941,51,30,3,81
824,-33.97124999999833,2916.1052631578946,49,18,4,67
825,-14.344999999997743,4323.5,61,33,6,94
826,-15.883999999997593,3480.65,55,32,2,87
827,-8.30874999999806,3526.0,68,22,4,90
828,-23.46899999999895,2256.15,31,25,2,56
829,-27.144749999995888,4180.210526315789,78,19,11,97
830,-8.100999999997146,3938.7894736842104,55,42,4,97
831,-39.656499999997884,3403.5,42,53,9,95
832,-3.7262499999974805,3131.294117647059,69,20,8,89
833,2.3085000000030136,2997.6470588235293,85,19,4,104
834,-19.99999999999856,2255.3333333333335,37,18,11,55
835,-15.6934999999968,3506.684210526316,69,16,9,85
836,-18.309249999997462,3093.1666666666665,69,22,5,91
837,-24.703499999997714,2568.4444444444443,44,28,10,72
838,-13.422499999996536,4165.55,72,18,7,90
839,-2.8972499999987287,2661.375,53,19,4,72
840,-13.080499999997622,2545.125,50,31,4,81
841,-14.826749999997972,2356.3529411764707,48,20,6,68
842,-20.479249999998842,2739.7368421052633,46,14,7,60
843,-42.94399999999727,3417.6666666666665,58,35,14,93
844,-33.77299999999922,2087.05,23,25,0,48
845,-16.627749999999146,2479.3333333333335,38,27,6,65
846,-23.16974999999772,3660.1666666666665,67,48,5,115
847,-13.774499999998312,4091.75,61,27,6,88
848,-28.402249999998997,2190.15,20,31,3,51
849,-14.553999999997757,2699.0,54,22,9,76
850,-38.81924999999996,2079.7894736842104,25,30,17,55
851,-17.392499999997778,2337.6875,52,27,12,79
852,-6.011999999996785,4293.35,80,22,2,102
853,-5.89774999999814,3216.842105263158,57,25,1,82
854,-14.06624999999822,3900.55,62,32,1,94
855,-16.54249999999856,2550.1875,45,22,2,67
856,-15.109499999998235,2831.529411764706,56,28,8,84
857,-17.93249999999884,2439.5,28,27,4,55
858,-17.73149999999875,2966.315789473684,46,30,1,76
859,-30.620999999996343,2228.4117647058824,63,20,13,83
860,-22.841749999997432,4549.6,43,57,6,100
861,-28.858749999998587,2217.1176470588234,40,20,6,60
862,-17.943749999998595,2666.3684210526317,41,25,5,66
863,-16.88974999999939,2421.0555555555557,39,30,10,69
864,-21.28074999999837,3024.3333333333335,35,54,4,89
865,-19.34899999999851,2782.1176470588234,54,29,5,83
866,-26.585499999997857,2354.4117647058824,43,27,3,70
867,-22.651749999997566,3335.4736842105262,60,30,9,90
868,-32.91349999999947,2008.35,28,14,3,42
869,-9.388999999994962,3640.4210526315787,84,9,21,93
870,-27.327249999999395,2087.4736842105262,22,29,5,51
871,-13.150999999999694,2269.3529411764707,60,29,8,89
872,-20.34599999999788,3169.55,40,27,6,67
873,-20.884999999997262,4802.05,63,51,4,114
874,-39.64799999999814,2715.5789473684213,34,40,5,74
875,-27.077249999998475,2566.6111111111113,33,27,11,60
876,-29.010499999997165,4191.7,50,45,2,95
877,-21.970749999999306,1941.388888888889,28,21,5,49
878,-19.065499999998075,2595.315789473684,50,15,9,65
879,-28.19374999999808,3064.7894736842104,43,30,6,73
880,-15.118499999997766,3903.7,61,30,3,91
881,-20.84649999999815,2982.777777777778,54,23,7,77
882,-18.53274999999818,2080.764705882353,40,30,4,70
883,-21.959499999997803,2139.3125,48,19,6,67
884,-23.08824999999785,2783.8333333333335,51,30,10,81
885,-23.615499999999237,2237.0,24,26,5,50
886,-36.28099999999948,1950.0,30,28,6,58
887,-11.261999999998306,2353.75,47,24,5,71
888,-21.229249999999183,2302.0555555555557,46,18,0,64
889,-10.839749999998823,2639.294117647059,41,20,12,61
890,-25.48224999999903,1683.888888888889,12,36,4,48
891,-31.801499999999276,1983.6842105263158,24,17,7,41
892,-26.16899999999784,3246.2105263157896,53,30,4,83
893,-42.10774999999728,2008.8823529411766,41,27,11,68
894,-26.044749999999368,2188.55,31,18,1,49
895,-26.259249999998367,3069.6,49,18,2,67
896,-36.83224999999847,3310.3684210526317,40,33,14,73
897,-21.388999999998653,2669.7368421052633,38,27,3,65
898,-27.677749999996735,2411.294117647059,49,28,14,77
899,-16.880499999998392,2816.5,45,19,6,64
900,-23.841749999998108,3173.3684210526317,43,38,11,81
901,-25.00974999999898,2084.0,29,17,4,46
902,-34.85174999999815,3320.3,40,34,2,74
903,-35.89549999999819,3267.7894736842104,55,28,5,83
904,-25.721999999999515,2763.8571428571427,45,27,17,72
905,-38.85249999999615,2327.294117647059,35,37,17,72
906,-12.701999999997415,4300.55,84,22,3,106
907,-24.218249999998655,2762.3333333333335,36,45,5,81
908,-26.88474999999889,2211.222222222222,35,30,20,65
909,-14.33349999999711,2966.0588235294117,53,22,13,75
910,-0.5712499999981927,3443.277777777778,68,22,4,90
911,-27.83099999999909,2074.842105263158,30,18,5,48
912,-13.96799999999792,3274.4,48,27,5,75
913,-20.49524999999914,2070.6315789473683,24,26,2,50
914,-19.703499999998193,2491.8333333333335,42,19,4,61
915,-18.391499999998288,3030.6,48,25,2,73
916,-21.44899999999882,2395.4117647058824,39,29,6,68
917,-1.0664999999984683,3427.5,56,25,3,81
918,-28.884749999999336,2484.5555555555557,27,35,9,62
919,-14.730499999996528,3285.4444444444443,65,21,8,86
920,-20.36449999999811,3004.684210526316,48,38,17,86
921,-35.44774999999899,1429.0,12,33,14,45
922,-24.606749999998904,1956.3157894736842,22,25,9,47
923,-32.428249999997924,3412.3333333333335,62,41,7,103
924,-18.325499999998414,2815.7368421052633,43,20,8,63
925,-33.997749999999584,2079.8947368421054,26,22,10,48
926,-16.319499999998627,2647.8888888888887,54,23,15,77
927,-6.049249999996443,3421.9444444444443,74,24,7,98
928,-24.204999999998897,1959.0555555555557,22,36,5,58
929,-18.23049999999749,4048.1,65,21,8,86
930,-7.523499999997656,3587.9,55,30,5,85
931,-12.65724999999801,3706.85,47,36,7,83
932,-37.102499999999836,1952.8333333333333,32,27,7,59
933,-7.3284999999974785,4223.65,63,36,3,99
934,-6.97974999999879,2857.6111111111113,48,28,2,76
935,-18.895499999998943,2579.85,34,26,4,60
936,-31.415249999998252,3384.7894736842104,45,37,11,82
937,-27.147749999999775,2085.7368421052633,26,24,6,50
938,-26.787749999996226,2796.8333333333335,49,33,16,82
939,2.1830000000028464,4566.5,77,28,6,105
940,-15.924999999996071,2322.875,72,22,12,94
941,-32.14649999999902,1996.764705882353,32,19,6,51
942,-5.852249999996646,2614.823529411765,70,10,15,80
943,-36.74899999999914,1982.5,34,36,5,70
944,-14.931999999998173,2613.9411764705883,54,36,5,90
945,-49.896499999998746,2207.8333333333335,31,27,17,58
946,-40.35024999999968,1438.5333333333333,17,33,9,50
947,-19.86724999999833,2880.65,34,31,6,65
948,-18.218499999998862,2334.764705882353,40,18,9,58
949,-39.617249999996986,4006.4210526315787,61,40,7,101
950,-5.478249999997416,2126.5,49,23,11,72
951,-20.77149999999875,2218.9411764705883,35,26,8,61
952,-15.617749999998745,2833.4210526315787,48,19,5,67
953,-16.26324999999651,4724.25,69,38,7,107
954,-24.365499999998995,2553.684210526316,29,33,5,62
955,-12.909499999998406,3389.0,56,27,8,83
956,-16.835999999998727,2921.1,44,17,7,61
957,-29.821999999997086,3979.95,55,39,4,94
958,-30.865499999994817,2255.470588235294,66,32,15,98
959,-38.91399999999693,4288.736842105263,77,35,16,112
960,-24.937999999995817,2087.2,78,16,11,94
961,-4.017999999998405,2870.9444444444443,58,25,4,83
962,-16.24974999999812,3418.0526315789475,55,26,10,81
963,-2.3202499999980652,3071.1,56,19,4,75
964,-28.579999999998144,2938.6,33,36,3,69
965,-14.062499999999176,2706.9444444444443,48,26,13,74
966,-26.63574999999933,1616.5,23,34,2,57
967,-31.07674999999896,3474.3,38,37,6,75
968,-5.698999999997906,2606.6875,56,18,7,74
969,-27.139999999999155,1933.4444444444443,31,20,8,51
970,-3.614499999998113,3109.0555555555557,61,17,5,78
971,-24.696249999998994,2072.7,26,18,3,44
972,-34.99749999999856,2108.1111111111113,44,24,15,68
973,-34.87399999999839,2759.1052631578946,40,26,14,66
974,-36.060499999999664,1937.0,16,30,12,46
975,-12.584999999997802,4120.8421052631575,77,36,7,113
976,-28.200999999999446,2145.9444444444443,32,24,13,56
977,-18.661749999998854,2664.1,36,21,10,57
978,-4.023499999998177,4086.5263157894738,71,39,3,110
979,-31.1184999999997,2251.2,16,39,0,55
980,-22.559999999998645,3418.4210526315787,53,26,11,79
981,-15.329749999998361,3230.315789473684,60,29,18,89
982,-36.921749999998966,1562.9375,40,42,18,82
983,2.619750000003132,4099.8421052631575,86,16,8,102
984,-40.14724999999839,3140.0526315789475,48,33,18,81
985,-20.443999999998077,2915.7,39,29,7,68
986,-17.661249999998127,2848.0555555555557,53,10,14,63
987,-14.662499999998342,3094.842105263158,50,18,13,68
988,-22.19724999999944,1949.2222222222222,36,13,11,49
989,-21.815749999997998,2769.5,50,29,8,79
990,-28.78174999999799,3070.222222222222,48,29,18,77
991,-50.32874999999906,3188.4210526315787,45,37,18,82
992,-13.42074999999814,2995.4736842105262,41,31,3,72
993,-21.497499999999242,2188.0,48,30,17,78
994,-36.82399999999869,2124.705882352941,23,32,9,55
995,-11.88999999999899,2619.6666666666665,49,18,2,67
996,-36.15349999999981,1429.0,0,38,1,38
997,-18.822249999998586,3198.4210526315787,61,22,5,83
998,-13.90074999999562,2669.25,69,29,14,98
999,-26.278249999999275,2008.4,28,17,3,45
1000,-26.703249999998587,2909.2,31,24,11,55
1001,-13.019249999998376,2885.55,51,16,6,67
1002,-11.455249999997275,3732.5263157894738,72,19,4,91
1003,-15.927749999998435,2747.8571428571427,42,23,10,65
1004,-16.27799999999843,2840.0555555555557,53,16,12,69
1005,-20.03299999999727,4320.4,72,31,3,103
1006,-37.37749999999901,2011.888888888889,33,38,11,71
1007,-13.078499999998979,2440.842105263158,43,19,7,62
1008,-11.7027499999987,2934.294117647059,38,16,12,54
1009,-33.324749999999376,2203.8,18,26,7,44
1010,-10.12424999999767,3902.95,55,29,10,84
1011,-16.794749999998682,2854.315789473684,52,18,19,70
1012,-18.823999999998154,3087.8,51,13,4,64
1013,-25.206249999998988,2571.9,35,26,2,61
1014,-27.279249999999358,2049.7368421052633,17,25,9,42
1015,-24.5177499999988,2289.9411764705883,39,36,13,75
1016,-30.21974999999867,2245.6111111111113,26,19,15,45
1017,7.209250000003458,5187.05,84,29,11,113
1018,-28.983249999997913,1835.875,48,24,10,72
1019,-9.508499999996339,4800.5,76,29,9,105
1020,-15.942249999998324,2563.0625,41,21,11,62
1021,-45.24524999999875,2018.3125,26,47,11,73
1022,-10.186249999996793,4151.25,61,21,17,82
1023,-41.97249999999808,2767.6111111111113,32,49,10,81
1024,-9.018249999997964,3512.6315789473683,61,27,2,88
1025,-25.89274999999904,2101.3,23,23,4,46
1026,-1.1032499999974577,4633.85,79,31,6,110
1027,-20.475749999996648,2010.375,66,21,5,87
1028,-7.881499999997631,3530.3888888888887,74,31,7,105
1029,-37.58074999999811,2124.6470588235293,37,18,14,55
1030,-21.496249999998945,2595.8,37,23,3,60
1031,-12.9834999999968,4156.0,77,23,8,100
1032,-17.268249999998705,2873.6,41,29,2,70
1033,-19.584499999998595,2857.55,38,28,5,66
1034,-45.46324999999903,2506.8,16,33,8,49
1035,-25.189249999998385,3275.4736842105262,55,28,9,83
1036,-6.577249999996856,3789.9473684210525,81,21,3,102
1037,-15.871749999997968,3615.55,65,15,11,80
1038,-29.679999999995847,5042.65,75,34,6,109
1039,-22.220499999999035,2425.5555555555557,42,25,15,67
1040,-15.555999999998932,2571.95,40,18,6,58
1041,-11.642249999998352,3671.15,58,26,5,84
1042,-16.33699999999703,3940.9,66,20,7,86
1043,-12.124749999998455,3635.4736842105262,56,40,7,96
1044,-2.9162499999968863,2720.785714285714,81,31,11,112
1045,-33.32549999999905,2471.176470588235,34,45,13,79
1046,-24.50249999999809,3360.85,40,35,5,75
1047,-20.87699999999809,4443.263157894737,83,35,9,118
1048,-11.340249999997422,3552.6666666666665,64,37,4,101
1049,-28.451249999997287,2697.315789473684,24,46,17,70
1050,-15.013249999997559,4095.7,66,30,3,96
1051,-16.263999999998436,3510.9473684210525,57,28,9,85
1052,-40.9367499999983,2785.7894736842104,25,42,6,67
1053,-11.646999999998137,4261.65,44,47,10,91
1054,-25.260999999997956,2792.235294117647,49,18,15,67
1055,-25.50299999999904,1898.764705882353,26,41,8,67
1056,-12.238249999997747,3695.4444444444443,69,39,7,108
1057,-29.341999999997405,2017.3333333333333,25,27,17,52
1058,-8.770749999997458,3650.5,64,32,7,96
1059,-8.562499999997993,3637.8,57,27,5,84
1060,-28.800999999999163,2015.6,23,25,2,48
1061,-30.123749999999056,2020.7222222222222,32,16,7,48
1062,-4.2964999999968985,3467.0,71,24,10,95
1063,-21.24874999999722,3987.8,60,32,6,92
1064,-27.074499999996267,2295.1875,67,20,13,87
1065,-36.29949999999857,2061.277777777778,42,38,20,80
1066,-33.44474999999889,3402.1,38,36,5,74
1067,-6.316999999998799,2996.5,53,13,6,66
1068,-20.495749999997617,4017.9,48,42,4,90
1069,-26.307999999998117,2110.8333333333335,27,27,9,54
1070,-35.41124999999832,3429.95,38,37,5,75
1071,-19.08474999999728,3818.8,64,28,2,92
1072,-29.41374999999872,2673.5,31,29,5,60
1073,13.249000000003093,4651.3,82,26,5,108
1074,-22.309249999999004,2051.25,27,15,8,42
1075,-21.130749999998827,2371.777777777778,50,22,8,72
1076,-23.91749999999779,3263.2,47,23,8,70
1077,-19.92424999999869,2703.3333333333335,49,30,23,79
1078,-23.92574999999857,2939.4736842105262,55,25,6,80
1079,-23.34199999999685,4520.3,70,30,10,100
1080,-19.59324999999809,2707.722222222222,45,25,8,70
1081,-24.429249999999037,1963.1764705882354,38,24,7,62
1082,-14.248749999997703,3946.4,69,18,5,87
1083,-13.717749999997938,4225.1,59,35,5,94
1084,-15.756499999996885,2514.3684210526317,35,26,16,61
1085,-15.149499999998636,2639.294117647059,43,13,4,56
1086,-8.350999999998578,3439.285714285714,53,20,5,73
1087,-32.1977499999995,2728.157894736842,46,27,15,73
1088,-21.2974999999989,2352.0,33,28,4,61
1089,-23.025499999996384,2270.266666666667,59,21,14,80
1090,-23.15749999999854,3017.235294117647,72,36,8,108
1091,-16.714249999995406,2715.823529411765,73,16,16,89
1092,-13.730749999997784,4634.7,77,23,8,100
1093,-1.6347499999984634,2901.722222222222,67,9,8,76
1094,-11.964999999996996,2796.1176470588234,70,10,11,80
1095,-18.916249999998847,2741.3333333333335,42,15,8,57
1096,-23.05024999999924,2217.7368421052633,30,20,8,50
1097,-11.278749999998215,2809.1666666666665,51,22,5,73
1098,-25.75949999999848,2374.823529411765,66,18,11,84
1099,-28.950749999997033,3478.3684210526317,47,36,8,83
1100,-25.95449999999753,2761.4117647058824,54,36,18,90
1101,-23.03874999999892,2496.1111111111113,41,19,7,60
1102,-44.24474999999895,2742.75,41,40,12,81
1103,-1.318749999998257,3460.9473684210525,75,28,11,103
1104,-17.67999999999772,2648.4375,48,22,10,70
1105,-32.421749999997914,2043.7777777777778,30,30,5,60
1106,-13.195499999999143,2653.294117647059,39,21,5,60
1107,-7.50524999999831,3207.9375,39,32,3,71
1108,-9.447749999998123,3099.1052631578946,50,23,4,73
1109,-27.48574999999815,3129.85,46,28,2,74
1110,-39.10599999999981,1786.6470588235295,21,35,25,56
1111,-39.69949999999936,1532.1875,15,40,10,55
1112,-24.652499999997936,2928.3333333333335,40,35,3,75
1113,-26.859499999996768,4584.65,66,40,7,106
1114,-26.41874999999907,2008.4,23,21,3,44
1115,-31.616499999997547,2755.0,45,49,8,94
1116,-7.847749999998063,3798.05,65,23,2,88
1117,-28.73174999999881,2091.0,38,25,3,63
1118,-21.17724999999937,2008.45,27,20,3,47
1119,-14.712999999997924,2392.6470588235293,46,30,9,76
1120,-19.763999999999115,2786.3333333333335,43,38,7,81
1121,-17.215999999997774,3807.5263157894738,57,44,5,101
1122,-7.51749999999778,2318.0625,60,25,15,85
1123,-19.870749999997777,2157.3888888888887,39,21,11,60
1124,4.114250000003462,3999.0,80,23,8,103
1125,-29.352499999998724,2551.722222222222,39,30,9,69
1126,-23.042249999998955,2875.1052631578946,41,34,17,75
1127,-44.16974999999816,2509.5625,45,36,16,81
1128,-15.21199999999763,3294.529411764706,72,32,7,104
1129,-30.47074999999784,2467.529411764706,33,39,15,72
1130,-23.60724999999671,4648.85,57,44,5,101
1131,-35.98424999999364,2260.4375,66,26,31,92
1132,-10.996249999998557,2354.1666666666665,43,31,7,74
1133,-24.68774999999821,1993.7894736842106,14,31,18,45
1134,-16.71924999999788,2763.2105263157896,39,30,3,69
1135,-22.69124999999849,2629.5263157894738,36,27,7,63
1136,-41.81399999999982,2056.1666666666665,34,28,17,62
1137,-23.19824999999718,2485.9166666666665,52,21,13,73
1138,-26.903249999999474,2160.9473684210525,30,20,5,50
1139,-11.866999999997102,3835.5,69,16,9,85
1140,-24.3912499999992,2076.65,28,17,5,45
1141,-6.188249999998132,3929.95,54,42,2,96
1142,-17.833499999998168,3246.0526315789475,39,44,4,83
1143,-17.674499999998385,2557.0555555555557,42,17,8,59
1144,-20.900249999999286,2076.0588235294117,32,32,9,64
1145,-38.25624999999852,2748.3529411764707,50,35,8,85
1146,4.40125000000325,2780.3125,72,20,10,92
1147,-36.84199999999886,2059.4117647058824,44,34,9,78
1148,-11.170999999998571,2782.4736842105262,49,15,6,64
1149,-37.74124999999861,1963.1176470588234,34,35,13,69
1150,-22.208999999999406,2085.5,21,31,1,52
1151,-32.015499999998056,1881.0,12,34,19,46
1152,-33.03574999999791,2231.5555555555557,32,26,12,58
1153,-13.938249999998053,3599.6,67,16,7,83
1154,-8.297499999998214,3493.45,64,20,4,84
1155,-13.942499999998253,3972.0,60,35,1,95
1156,-22.85499999999803,3613.7894736842104,56,32,17,88
1157,-22.896499999997225,3431.8333333333335,56,37,7,93
1158,-27.45074999999908,2598.7368421052633,35,23,2,58
1159,-19.42399999999813,3281.4,43,25,8,68
1160,-24.46549999999768,2358.153846153846,45,21,9,66
1161,-10.499749999997714,3508.4736842105262,61,24,9,85
1162,-5.826249999996797,3806.5555555555557,101,16,5,117
1163,-24.848999999998604,2328.7894736842104,32,25,2,57
1164,-34.33024999999929,2597.1176470588234,54,28,18,82
1165,-27.792249999998955,2606.9,35,18,9,53
1166,-8.996249999997252,3551.45,61,17,7,78
1167,-21.96524999999884,2503.3684210526317,38,22,4,60
1168,-26.801999999999197,2148.0,53,22,20,75
1169,-24.291499999998234,2173.294117647059,55,23,12,78
1170,-15.306999999999377,2509.315789473684,44,15,6,59
1171,-14.000249999998246,4233.8,61,34,7,95
1172,-9.993999999997607,3651.3684210526317,58,36,13,94
1173,-20.606249999996272,4475.85,73,33,4,106
1174,-30.9329999999972,2063.157894736842,29,25,25,54
1175,-28.251249999999136,2910.85,31,38,3,69
1176,-23.38374999999834,2135.0526315789475,34,18,13,52
1177,-15.777499999997664,3726.4736842105262,67,26,22,93
1178,2.1852500000029154,4925.1,69,44,6,113
1179,-18.55449999999891,2603.8125,30,37,4,67
1180,-27.85774999999942,1929.0625,43,29,17,72
1181,-37.42399999999923,1677.4117647058824,11,36,12,47
1182,-20.591499999997584,3204.315789473684,59,27,7,86
1183,-36.66549999999674,4067.5555555555557,66,37,14,103
1184,-10.87124999999823,3179.1,56,20,5,76
1185,-9.92124999999774,2478.8125,73,28,6,101
1186,-24.27074999999821,2112.4444444444443,33,20,9,53
1187,-39.615749999998606,2076.4736842105262,27,12,15,39
1188,-23.3454999999991,2637.75,39,20,4,59
1189,-19.53324999999893,3010.5789473684213,59,23,26,82
1190,-34.06074999999991,1429.0,0,35,1,35
1191,-29.39299999999837,2177.777777777778,32,22,6,54
1192,-26.48574999999827,2461.823529411765,42,30,11,72
1193,-10.097249999998045,3682.2,45,43,5,88
1194,-30.193749999998676,2854.3684210526317,50,25,13,75
1195,-12.929749999998075,3357.65,57,27,4,84
1196,-22.354749999998223,2832.1111111111113,44,18,15,62
1197,-19.143499999998244,2125.5882352941176,37,19,8,56
1198,-7.902499999998758,2984.7894736842104,51,22,19,73
1199,-31.778499999997383,2976.722222222222,60,32,5,92
1200,-15.269749999998652,3542.55,46,35,7,81
1201,-36.693249999998386,2438.529411764706,58,29,14,87
1202,2.6730000000031096,4534.315789473684,97,25,3,122
1203,-38.14325000000043,1429.0,18,34,26,52
1204,-30.21699999999901,2072.75,23,26,2,49
1205,-40.97949999999854,1429.0,2,34,16,36
1206,-22.42474999999834,2318.0,49,20,15,69
1207,-3.3094999999981196,3225.2,56,20,4,76
1208,-15.86624999999906,2418.1052631578946,33,26,8,59
1209,-16.917499999998782,2693.1875,37,12,16,49
1210,-11.153249999998177,3345.7,55,24,3,79
1211,-12.724749999997346,2807.3888888888887,49,26,7,75
1212,-31.015249999997735,2854.1111111111113,48,40,12,88
1213,-16.04299999999463,2296.1875,87,24,13,111
1214,-0.2694999999976672,3259.0,79,23,10,102
1215,-25.161999999998525,2500.9473684210525,30,29,6,59
1216,-21.87424999999913,2463.6666666666665,37,29,12,66
1217,-22.660249999999458,1924.8235294117646,27,46,7,73
1218,-12.663499999998008,3587.8333333333335,70,37,4,107
1219,-12.150249999997214,2749.222222222222,59,13,14,72
1220,-17.20349999999788,3138.3684210526317,44,37,4,81
1221,-42.16375000000004,1429.0,1,37,5,38
1222,-26.67574999999876,2830.4,33,24,8,57
1223,3.3692500000025234,4065.7,65,33,5,98
1224,-47.66474999999688,2409.6666666666665,21,49,13,70
1225,-3.759249999997678,4069.45,77,22,4,99
1226,-10.08124999999884,3080.05,45,27,4,72
1227,-36.69874999999936,2046.2777777777778,31,38,23,69
1228,-41.42649999999914,1702.5882352941176,13,31,14,44
1229,-23.514249999998054,3355.5263157894738,51,38,5,89
1230,-22.953249999998945,2583.7368421052633,37,24,7,61
1231,3.1142500000031896,4760.85,92,25,2,117
1232,-4.94499999999867,2977.2631578947367,54,22,7,76
1233,-24.475999999997942,2833.777777777778,55,28,11,83
1234,-19.246249999999108,2945.4736842105262,41,36,11,77
1235,-15.606499999996007,2251.5,70,24,11,94
1236,-29.799499999998602,2061.4210526315787,30,21,12,51
1237,-5.21474999999649,4290.368421052632,87,29,7,116
1238,-33.39374999999891,2653.6,50,22,24,72
1239,-24.159499999999397,2544.5,44,27,26,71
1240,-31.687249999999352,2168.5882352941176,35,33,6,68
1241,-19.499999999998117,2858.6111111111113,54,32,7,86
1242,-21.930999999997024,2344.875,62,36,12,98
1243,-35.35274999999729,2677.5882352941176,48,33,9,81
1244,-19.064749999996074,3190.1111111111113,64,32,14,96
1245,-21.8064999999981,3838.3684210526317,73,30,4,103
1246,-13.509249999998474,3398.95,50,30,4,80
1247,-16.709749999996742,3739.7894736842104,72,31,8,103
1248,-11.211499999998718,2794.1111111111113,47,27,6,74
1249,-4.049749999997324,2952.0,61,20,10,81
1250,-18.835499999999247,2589.875,43,24,10,67
1251,-18.089999999997964,2768.0588235294117,63,23,6,86
1252,-21.71099999999842,2707.0,55,33,12,88
1253,-46.64724999999656,2374.9411764705883,51,37,12,88
1254,-19.896249999999217,2517.6315789473683,43,16,10,59
1255,-8.139749999997836,2777.3125,66,30,7,96
1256,-24.15199999999832,2917.0,54,16,4,70
1257,-22.679749999998794,2788.2631578947367,40,30,10,70
1258,3.596750000001877,3603.7,65,18,7,83
1259,-9.967499999997676,3640.3,68,15,5,83
1260,-12.517249999998507,2980.4210526315787,48,26,8,74
1261,-26.809499999997875,2051.0,48,24,8,72
1262,-3.567999999998149,3642.2105263157896,65,28,7,93
1263,-27.57474999999821,2794.1052631578946,39,32,8,71
1264,-19.683999999999145,2228.3,31,18,6,49
1265,-26.477999999998776,2632.9444444444443,40,18,2,58
1266,-42.349999999997976,3778.3,52,26,9,78
1267,-23.182749999999572,2054.1875,43,41,4,84
1268,-15.308999999998855,2572.0,56,31,16,87
1269,-7.896499999997746,4378.35,67,35,3,102
1270,-20.91649999999858,2637.8,42,23,0,65
1271,-11.921999999998548,3270.4,56,22,3,78
1272,-18.0024999999984,2747.315789473684,40,23,6,63
1273,-7.746499999997072,3726.8823529411766,86,31,13,117
1274,12.57700000000347,3780.0,92,18,5,110
1275,-5.282249999998429,2545.25,54,31,3,85
1276,-35.356999999998614,2164.823529411765,32,26,6,58
1277,-25.706999999999077,2279.85,27,23,7,50
1278,-7.340999999997365,4087.3684210526317,97,20,6,117
1279,-1.82399999999732,3921.8947368421054,77,26,3,103
1280,-23.900499999998267,2375.0,40,29,9,69
1281,-22.366999999998278,2543.4,43,21,7,64
1282,-30.344999999998276,2467.3529411764707,50,44,18,94
1283,-4.077999999998431,3533.9,45,35,5,80
1284,-14.12624999999901,2616.823529411765,37,24,2,61
1285,-28.12124999999814,2661.0,50,19,8,69
1286,-21.749749999998677,2850.55,37,17,11,54
1287,-23.245999999999448,2036.3,26,23,1,49
1288,-13.297249999998545,2508.55,39,19,5,58
1289,-20.833749999997835,2468.6666666666665,48,23,9,71
1290,3.366000000000463,2554.3333333333335,44,15,19,59
1291,-8.305249999998587,2950.4444444444443,58,23,4,81
1292,-13.131249999997717,3918.684210526316,64,33,6,97
1293,-29.882999999998255,2309.125,47,28,9,75
1294,-16.341499999998305,2921.1111111111113,70,26,4,96
1295,-21.071249999998372,3043.3,38,33,2,71
1296,-32.316499999998925,1719.6875,25,28,7,53
1297,-4.8217499999961975,3928.7368421052633,73,20,12,93
1298,-21.796749999996724,2147.375,59,31,8,90
1299,-15.980249999997634,3734.7894736842104,66,30,4,96
1300,-22.219249999999114,2143.3125,48,34,9,82
1301,-25.067749999997737,3933.7894736842104,66,32,1,98
1302,-14.889749999998397,2551.25,38,25,4,63
1303,-19.59899999999783,4058.9473684210525,57,43,4,100
1304,-13.525749999998698,2672.6666666666665,37,24,8,61
1305,1.4382500000020142,3218.05,63,14,4,77
1306,-6.274499999998061,3809.15,66,28,1,94
1307,-23.83249999999889,2912.222222222222,47,44,10,91
1308,-8.476249999997275,4677.6,78,30,4,108
1309,-13.437249999997377,4104.45,62,28,11,90
1310,-20.64624999999887,2280.75,37,18,6,55
1311,-25.37874999999916,2623.684210526316,39,24,10,63
1312,-28.186749999997932,2910.8823529411766,63,27,13,90
1313,-10.497499999996617,3760.684210526316,68,22,11,90
1314,-31.4172499999974,2490.722222222222,28,42,16,70
1315,-16.22099999999799,3829.1,64,22,4,86
1316,-16.965749999997417,3827.6666666666665,89,22,11,111
1317,-21.43224999999859,2627.5625,38,27,3,65
1318,-38.471750000000284,1429.0,3,37,19,40
1319,-15.92124999999848,2467.5263157894738,43,16,6,59
1320,-23.66174999999948,2042.3684210526317,27,24,17,51
1321,-39.53899999999836,2656.2105263157896,32,27,8,59
1322,-38.311499999998645,2667.3333333333335,39,34,4,73
1323,-24.926249999998532,2689.5882352941176,49,39,5,88
1324,-35.36449999999937,1951.0555555555557,33,19,5,52
1325,-19.94924999999803,3500.1052631578946,53,38,1,91
1326,-14.175999999998842,2478.5789473684213,39,25,4,64
1327,-35.521249999999114,1621.5,33,40,21,73
1328,-14.41874999999779,3623.7368421052633,66,22,15,88
1329,-24.08474999999877,2173.235294117647,44,23,7,67
1330,-30.95749999999645,2505.777777777778,45,37,12,82
1331,-19.892249999997677,3063.157894736842,57,21,5,78
1332,-30.53424999999931,2464.4444444444443,43,29,20,72
1333,-16.912249999998092,2995.1,44,26,4,70
1334,-27.71374999999866,2054.0,39,32,3,71
1335,3.9087500000023034,3811.7368421052633,81,17,1,98
1336,-22.896749999997553,4030.7,48,42,5,90
1337,-7.4454999999975895,3973.4,74,18,4,92
1338,-29.191249999995982,2154.0,55,26,19,81
1339,-36.96174999999765,2641.5,51,26,8,77
1340,-12.47849999999777,3310.9444444444443,67,27,2,94
1341,-15.19674999999767,3689.7368421052633,62,31,6,93
1342,-11.959499999998288,3155.842105263158,53,27,6,80
1343,-33.44749999999938,2132.4736842105262,24,23,7,47
1344,-31.037749999998102,1993.5555555555557,30,24,14,54
1345,-10.532999999997443,3191.1666666666665,62,28,8,90
1346,-4.966749999997402,2903.6111111111113,57,19,13,76
1347,-23.938999999997577,3360.5263157894738,43,32,14,75
1348,-18.86874999999926,1830.3333333333333,24,32,4,56
1349,-10.974249999997555,1916.1875,51,23,16,74
1350,-19.646999999998144,2957.3888888888887,51,21,6,72
1351,-20.443749999998186,3418.75,51,20,8,71
1352,-6.489499999997497,4529.8,69,39,4,108
1353,-12.979999999998663,3264.5263157894738,58,31,12,89
1354,-14.842999999997923,2669.1176470588234,49,31,11,80
1355,-36.392999999998814,2543.0,49,32,24,81
1356,-17.770749999999857,2001.3157894736842,21,30,6,51
1357,0.911750000002083,2647.375,72,20,6,92
1358,-14.993499999998694,2640.6666666666665,46,17,13,63
1359,-25.567249999999255,2027.2631578947369,25,22,9,47
1360,-24.155249999998652,2642.1052631578946,38,21,9,59
1361,-5.42549999999831,3064.1,49,26,4,75
1362,-23.106999999997093,4617.1,81,25,7,106
1363,-28.12199999999827,2198.470588235294,32,36,12,68
1364,-27.378749999999172,2020.7777777777778,32,15,9,47
1365,-27.000499999998834,2622.8947368421054,36,25,8,61
1366,-23.44374999999744,4105.3,66,30,6,96
1367,-31.15799999999726,2180.705882352941,37,29,10,66
1368,-33.17199999999504,1814.0,71,30,12,101
1369,-16.33799999999741,2933.235294117647,53,32,7,85
1370,-15.125999999995695,2119.0588235294117,65,31,13,96
1371,-35.694999999999425,2008.4,29,13,2,42
1372,-16.74149999999701,2487.8823529411766,56,19,14,75
1373,-2.8937499999952006,2180.3333333333335,79,29,18,108
1374,-44.091499999999265,1429.0,32,33,17,65
1375,-29.09624999999847,2280.529411764706,37,21,16,58
1376,-14.186499999999054,2625.235294117647,40,19,11,59
1377,-3.205999999997026,2240.625,66,17,15,83
1378,-15.325249999998196,2081.8125,36,37,11,73
1379,-5.8059999999983845,3167.1,53,23,5,76
1380,2.251750000001813,3793.35,61,31,5,92
1381,-32.06249999999893,2607.222222222222,44,25,22,69
1382,-13.74274999999894,2560.1,35,16,9,51
1383,-24.42049999999931,2103.7,26,23,2,49
1384,-15.025999999997945,2998.0526315789475,52,20,8,72
1385,-27.843499999998937,1996.888888888889,34,18,3,52
1386,-25.377499999998804,2362.5625,50,31,18,81
1387,-7.098749999997071,4269.65,68,30,7,98
1388,-25.771499999998888,2262.842105263158,33,24,2,57
1389,-24.1257499999991,2204.4,30,17,4,47
1390,-13.962999999998235,2215.235294117647,44,26,11,70
1391,-21.17099999999795,3912.35,55,40,1,95
1392,-37.28049999999929,1429.0,2,34,6,36
1393,-19.271999999998748,2523.4736842105262,26,35,8,61
1394,-10.917499999998144,3361.315789473684,51,34,2,85
1395,0.6635000000021767,4286.3,77,25,3,102
1396,-24.49874999999796,2647.1052631578946,36,28,5,64
1397,-26.39474999999905,1921.0625,30,19,7,49
1398,-4.167499999998051,3452.8888888888887,67,35,3,102
1399,-15.549749999997735,4289.45,72,29,5,101
1400,-26.347249999998706,2076.5263157894738,17,32,6,49
1401,-32.01649999999757,1931.6666666666667,28,33,15,61
1402,-16.16199999999872,2189.2631578947367,36,16,8,52
1403,-18.557999999996206,2280.25,68,15,11,83
1404,-9.491499999997547,3818.7,54,32,6,86
1405,-1.25649999999861,2464.875,57,44,8,101
1406,-42.212499999998805,2127.470588235294,36,46,15,82
1407,-15.43499999999825,3013.777777777778,53,31,8,84
1408,-25.241999999998907,2036.8823529411766,39,21,16,60
1409,-34.18799999999766,2184.0625,51,41,8,92
1410,-23.482749999998767,2853.4210526315787,34,32,8,66
1411,-30.768749999997862,3945.8,45,44,10,89
1412,-25.49474999999847,2600.277777777778,44,21,11,65
1413,-28.16099999999837,3833.8,48,38,6,86
1414,-25.832499999998124,3321.4210526315787,45,36,7,81
1415,5.240250000004071,3524.3333333333335,79,17,15,96
1416,-33.456499999997725,4243.45,42,52,6,94
1417,-3.3464999999986063,2400.176470588235,49,26,4,75
1418,-48.29924999999813,1429.0,14,28,14,42
1419,-23.165499999998307,3788.6,55,36,3,91
1420,-28.650499999997827,2395.3125,46,32,11,78
1421,-34.24149999999849,2407.3684210526317,36,24,4,60
1422,-31.66399999999881,2053.9473684210525,31,17,7,48
1423,-20.779249999999195,2087.0,28,14,8,42
1424,-24.881749999997027,3802.95,59,21,12,80
1425,-30.797249999998893,2164.764705882353,39,27,4,66
1426,-14.731749999998495,2491.5625,46,14,10,60
1427,-39.49899999999924,2425.25,25,22,8,47
1428,-18.247499999998347,2443.0555555555557,41,20,6,61
1429,-12.226249999997943,3905.3,64,24,8,88
1430,-19.297999999999327,2062.222222222222,45,18,17,63
1431,-7.281499999998006,4003.0,79,18,11,97
1432,-30.800249999998073,2081.8125,38,48,8,86
1433,-3.0177499999978705,3163.722222222222,55,20,10,75
1434,-12.175249999998268,2929.6470588235293,51,25,9,76
1435,-44.6002499999992,1908.0,36,44,11,80
1436,-29.253249999998786,2116.625,36,27,9,63
1437,-14.047999999998606,2598.4666666666667,42,27,3,69
1438,-17.173749999998037,3495.9473684210525,68,27,14,95
1439,-21.23249999999914,2478.3684210526317,39,21,7,60
1440,-12.972749999999323,2538.5263157894738,44,27,13,71
1441,-13.92674999999684,4264.9,67,30,6,97
1442,-15.075749999998706,2940.1,33,36,5,69
1443,-3.8522499999980466,3013.8947368421054,56,21,5,77
1444,-10.007249999998239,2868.6923076923076,50,20,10,70
1445,-27.470999999998874,2097.3684210526317,26,16,11,42
1446,-16.67324999999783,2566.4117647058824,53,23,7,76
1447,-21.115749999998037,3342.2105263157896,43,36,15,79
1448,-27.84574999999927,1989.0,33,10,13,43
1449,-11.279999999998813,2914.4210526315787,43,24,11,67
1450,-3.3254999999973442,4981.5,95,23,7,118
1451,0.9045000000015151,3140.1052631578946,55,26,11,81
1452,-6.765249999997154,4376.75,82,22,9,104
1453,-31.84324999999695,2913.1111111111113,42,26,20,68
1454,-0.8162499999961728,2639.5,90,27,13,117
1455,-25.03724999999689,1429.0,35,26,22,61
1456,-14.43274999999873,2902.15,37,30,4,67
1457,-2.161249999999338,3365.6111111111113,72,29,22,101
1458,-7.945499999997201,4387.05,74,33,2,107
1459,-18.840499999997853,2872.7368421052633,43,27,8,70
1460,-30.903999999996973,3924.3684210526317,79,20,10,99
1461,-14.553749999999113,2700.0625,37,19,5,56
1462,3.5512500000029257,2923.1875,76,21,10,97
1463,-14.482999999996968,3595.2631578947367,62,18,19,80
1464,-24.653749999998745,2610.315789473684,35,33,3,68
1465,-20.48399999999687,4207.736842105263,88,32,7,120
1466,-12.264249999995945,2385.4375,81,12,12,93
1467,-22.55574999999817,3771.85,59,23,10,82
1468,-28.48699999999913,2691.0625,34,24,6,58
1469,-10.52749999999726,3665.6,69,21,6,90
1470,-27.17324999999795,4398.315789473684,61,44,10,105
1471,-25.937999999997743,3483.9,52,32,2,84
1472,-11.483999999997735,3274.5263157894738,55,22,8,77
1473,0.2505000000021936,3940.3,73,18,5,91
1474,-6.748749999997251,2686.0,68,34,9,102
1475,9.887750000002324,2502.266666666667,74,13,5,87
1476,-4.511499999998625,3009.3333333333335,56,28,7,84
1477,-21.454499999998166,3147.35,34,36,8,70
1478,-33.03674999999995,1429.0,14,29,9,43
1479,-31.917499999998324,2095.6666666666665,45,16,13,61
1480,-26.16949999999746,3675.15,55,29,4,84
1481,-13.738499999999258,1946.875,35,38,6,73
1482,-36.10750000000007,1928.9444444444443,28,48,10,76
1483,-8.022999999998193,3844.95,72,27,2,99
1484,-17.426249999998554,2400.0,45,29,8,74
1485,-12.080499999996961,4050.4,48,35,13,83
1486,-15.174749999998818,3325.85,41,32,6,73
1487,-15.286249999998077,2598.6875,61,26,2,87
1488,-34.07624999999665,2207.8823529411766,42,27,13,69
1489,-32.87574999999764,2677.529411764706,48,34,10,82
1490,-36.04849999999828,3076.3888888888887,56,34,23,90
1491,-2.454499999998487,2892.1666666666665,61,25,6,86
1492,6.907500000002327,4037.2,78,18,6,96
1493,-33.56549999999873,2419.3076923076924,32,23,3,55
1494,-35.788249999999415,2067.15,23,17,7,40
1495,-35.3949999999974,4658.55,52,43,6,95
1496,-35.18724999999742,3295.0,44,43,12,87
1497,-13.45274999999765,2483.6875,53,21,10,74
1498,-21.147499999997684,3902.7894736842104,69,28,8,97
1499,-24.40224999999774,2651.4666666666667,42,25,8,67
1500,-30.469499999998295,2306.5,34,27,8,61
1501,-28.87049999999901,2139.777777777778,31,20,3,51
1502,-17.109749999997938,2659.7368421052633,42,22,12,64
1503,-27.54724999999842,3505.2631578947367,56,26,13,82
1504,-20.00949999999832,2292.230769230769,36,22,5,58
1505,-19.50674999999888,2526.7368421052633,39,20,7,59
1506,-11.968749999997804,2212.8125,61,23,6,84
1507,-16.534749999998873,2053.9375,35,28,4,63
1508,-9.950499999998604,3289.4,52,26,3,78
1509,-24.046499999997526,2147.9411764705883,48,37,13,85
1510,-14.13649999999657,2861.1666666666665,69,20,11,89
1511,-20.9552499999981,3547.6315789473683,55,39,4,94
1512,-5.644749999997862,3847.25,69,21,2,90
1513,-26.30499999999836,2317.0,66,24,10,90
1514,6.202250000003157,4394.15,83,25,3,108
1515,-26.390999999998503,2157.3125,41,20,5,61
1516,-27.30249999999932,1429.0,32,56,5,88
1517,-30.208999999998372,3541.0,48,30,7,78
1518,-17.404249999998854,2673.55,46,22,1,68
1519,-26.28299999999835,3224.3888888888887,57,41,12,98
1520,-14.050249999998902,2660.8,42,22,2,64
1521,-23.110499999997437,3703.75,51,35,4,86
1522,-32.47074999999977,2110.1052631578946,22,25,20,47
1523,-20.96249999999849,2185.1052631578946,36,18,9,54
1524,-5.879499999999238,2789.5882352941176,53,28,26,81
1525,-0.646499999998572,3394.85,54,25,1,79
1526,-28.00649999999818,2005.4375,58,32,15,90
1527,-10.734499999997542,4253.684210526316,73,39,10,112
1528,-28.113499999999295,2094.9473684210525,29,21,3,50
1529,-9.637999999997488,1967.6666666666667,72,26,6,98
1530,-16.517249999997425,4550.55,59,52,1,111
1531,-23.432249999997754,3503.0,52,28,5,80
1532,-7.517749999999035,2400.176470588235,37,30,7,67
1533,-14.35149999999904,2544.6666666666665,42,21,15,63
1534,-22.571249999999655,2300.3684210526317,14,45,11,59
1535,-25.488999999999415,2045.2941176470588,31,26,13,57
1536,-15.513999999998637,2170.0625,41,47,5,88
1537,-31.96999999999958,2024.3,25,14,7,39
1538,-19.113499999998307,3478.25,42,35,6,77
1539,-24.479499999999565,2008.4,30,14,3,44
1540,-19.01124999999868,2255.4117647058824,37,26,2,63
1541,-22.283999999998084,3671.2,41,45,4,86
1542,-21.2579999999977,2163.0,35,23,19,58
1543,-22.57974999999842,2981.1666666666665,38,42,8,80
1544,-30.70149999999962,1987.9473684210527,26,21,4,47
1545,-33.54324999999871,2394.5833333333335,39,28,11,67
1546,-18.588499999997588,3752.4736842105262,63,30,9,93
1547,-22.087749999999282,2437.0,42,30,3,72
1548,-0.6202499999974178,3568.5,82,28,14,110
1549,-5.525499999997175,2429.1875,68,18,16,86
1550,-18.833999999998127,2087.294117647059,53,35,17,88
1551,-19.534249999997225,3798.9,62,23,7,85
1552,-27.376499999998448,2043.5294117647059,36,21,7,57
1553,14.42175000000251,4384.75,86,22,1,108
1554,-26.13499999999869,2551.5714285714284,43,36,9,79
1555,-9.38599999999879,3111.65,40,36,4,76
1556,-20.000999999998733,2815.3333333333335,38,23,3,61
1557,-10.642999999999146,2465.6,29,30,2,59
1558,-24.546749999996383,2257.176470588235,54,29,13,83
1559,-18.294499999997726,3652.2,53,28,5,81
1560,-9.521999999998819,2913.277777777778,56,22,5,78
1561,-1.5014999999967003,4051.3,74,22,3,96
1562,-16.071499999998444,2490.315789473684,38,17,11,55
1563,-20.42524999999653,2319.0625,54,29,11,83
1564,-2.4474999999987426,2889.4444444444443,57,30,5,87
1565,-31.76524999999868,1666.125,46,38,13,84
1566,5.344250000003205,4204.388888888889,85,35,2,120
1567,-36.773749999998955,2330.875,36,30,9,66
1568,-15.50649999999934,2161.8888888888887,33,20,7,53
1569,-17.125249999998793,2572.1428571428573,44,30,4,74
1570,-33.624999999999105,2036.1,26,18,6,44
1571,-36.75799999999905,1429.0,32,42,9,74
1572,-23.90474999999867,2451.1111111111113,37,27,4,64
1573,-24.669749999998906,3095.65,36,30,5,66
1574,-30.53099999999953,2140.2,26,15,8,41
1575,-66.31524999999823,1627.0,23,51,19,74
1576,-25.39399999999882,2065.823529411765,50,21,8,71
1577,-16.387749999998494,2503.315789473684,39,14,12,53
1578,-15.10049999999815,3239.5263157894738,46,42,7,88
1579,-19.955749999998172,2629.6315789473683,37,27,5,64
1580,-36.57199999999889,2532.3,31,24,5,55
1581,-32.4159999999997,1913.111111111111,35,16,5,51
1582,-10.313499999998779,2476.8,44,30,5,74
1583,-1.8029999999983204,3671.315789473684,71,28,7,99
1584,-14.929249999997106,4181.9473684210525,64,42,13,106
1585,-8.198749999998743,3034.8947368421054,51,26,13,77
1586,-7.7812499999969,3465.277777777778,79,12,7,91
1587,-22.164749999999223,2028.2,29,20,1,49
1588,-26.40024999999931,2072.8,23,17,7,40
1589,-18.70724999999819,2196.266666666667,64,28,7,92
1590,-8.597749999997811,3882.25,61,32,3,93
1591,-23.477249999999238,2072.7,31,13,5,44
1592,-44.54849999999857,2092.1666666666665,24,32,17,56
1593,4.391500000002396,3639.842105263158,74,23,1,97
1594,-21.393999999999217,2584.3684210526317,34,38,6,72
1595,-11.979499999997957,3472.7,54,33,2,87
1596,-23.31224999999781,2540.2,40,22,7,62
1597,-16.524999999998684,2607.65,38,22,4,60
1598,-14.421499999998797,3327.45,46,35,2,81
1599,-31.47599999999931,1933.5555555555557,26,31,11,57
1600,-27.710499999999065,2055.5789473684213,24,22,5,46
1601,-20.5364999999971,2144.3529411764707,64,18,8,82
1602,-23.31699999999949,2622.842105263158,35,31,12,66
1603,-10.84174999999765,2064.0,56,19,8,75
1604,-11.43849999999844,3603.75,59,23,4,82
1605,-9.512749999998837,3198.25,53,18,4,71
1606,-6.1942499999973935,2746.625,73,23,7,96
1607,-8.150249999997406,2826.0,61,31,6,92
1608,-18.498749999998545,2492.529411764706,58,20,13,78
1609,-22.841749999998232,2274.0588235294117,43,25,7,68
1610,-34.684999999997615,4722.05,58,50,4,108
1611,-24.96474999999945,2016.3,19,34,1,53
1612,-27.130999999998476,2219.8125,66,27,21,93
1613,2.7120000000014177,3679.2,71,23,0,94
1614,-15.435999999997042,2412.277777777778,49,29,13,78
1615,-20.885499999999222,1887.375,35,25,3,60
1616,-31.30424999999891,2512.6315789473683,50,11,3,61
1617,-7.734999999997102,4512.4,86,19,5,105
1618,-29.03599999999981,1967.0,32,14,7,46
1619,-9.877749999997388,4723.5,84,35,3,119
1620,-14.815749999998156,3714.85,49,32,4,81
1621,-30.791999999999312,2637.0,43,38,14,81
1622,-16.100999999998777,2518.375,38,23,6,61
1623,-32.236999999997956,2072.9444444444443,37,28,11,65
1624,-21.352249999998968,1950.0,44,29,6,73
1625,-28.286499999999457,2038.65,24,16,8,40
1626,-19.711999999998717,3033.8947368421054,51,25,4,76
1627,0.9722500000023946,4202.95,74,25,4,99
1628,-40.059999999999505,2207.7368421052633,26,33,16,59
1629,5.88325000000513,2376.5,111,17,5,128
1630,-19.967999999999414,2044.1,26,18,4,44
1631,-16.779499999997153,2930.6666666666665,48,32,8,80
1632,-19.12699999999668,2408.3076923076924,60,23,11,83
1633,-29.231499999996952,4852.95,73,39,1,112
1634,-31.930249999997187,2826.684210526316,50,24,19,74
1635,-10.48924999999803,2512.1176470588234,45,27,7,72
1636,-1.545749999998299,2679.0625,61,33,2,94
1637,-4.541749999996728,4848.2,92,30,0,122
1638,-26.651499999999192,2351.0,30,22,1,52
1639,-23.006749999998974,3114.9473684210525,48,33,19,81
1640,-23.255750000000255,1967.0,31,15,32,46
1641,-36.02549999999926,2679.684210526316,34,34,20,68
1642,-28.155999999999143,2059.842105263158,21,22,6,43
1643,-5.056749999997164,3715.6666666666665,83,22,8,105
1644,-13.50524999999909,2665.4117647058824,41,24,0,65
1645,-18.029499999997917,2382.3888888888887,46,27,7,73
1646,-19.825499999998588,3445.8,43,33,2,76
1647,-30.85099999999668,4211.9473684210525,67,38,7,105
1648,-17.33949999999806,2282.4117647058824,53,22,21,75
1649,-33.56949999999843,2903.0,30,37,2,67
1650,-28.11124999999821,3166.0526315789475,48,32,7,80
1651,-16.20699999999821,3014.15,45,26,2,71
1652,-18.822499999998367,2650.5263157894738,43,17,9,60
1653,-13.454749999998986,2561.1052631578946,47,23,6,70
1654,-27.063749999999505,2032.25,25,15,7,40
1655,-25.018499999998767,2551.777777777778,40,29,9,69
1656,-20.8459999999985,2509.3333333333335,37,33,8,70
1657,-4.576249999997699,3704.45,59,28,5,87
1658,-13.614749999998475,2844.3684210526317,46,21,7,67
1659,-30.883999999999055,2026.9444444444443,33,29,5,62
1660,-30.71049999999879,2319.764705882353,44,35,2,79
1661,-17.10974999999828,3015.529411764706,59,33,2,92
1662,-3.4769999999972057,4402.1,72,28,3,100
1663,-11.679999999997392,2532.375,67,21,10,88
1664,-22.632999999998596,3149.0,52,19,7,71
1665,-10.89624999999818,2972.9473684210525,48,19,6,67
1666,-16.529249999998953,2587.8,44,17,4,61
1667,-36.55324999999875,2077.0,35,33,14,68
1668,-18.326249999997803,3410.5,64,40,7,104
1669,-23.483249999997962,4294.05,66,29,8,95
1670,-11.634999999998135,2941.764705882353,48,37,1,85
1671,-6.1722499999957945,2584.235294117647,84,30,9,114
1672,-39.11974999999809,3144.277777777778,46,47,4,93
1673,-5.79424999999848,3340.25,52,28,2,80
1674,-10.159999999998444,2530.3125,62,24,8,86
1675,-13.158499999998753,2434.0,38,29,7,67
1676,-13.871249999997307,2048.1875,51,30,7,81
1677,-12.621749999997935,3709.95,49,42,1,91
1678,-3.216499999996047,1867.5625,82,17,2,99
1679,-16.50724999999847,3468.75,40,43,2,83
1680,-23.411749999999223,1988.842105263158,28,21,9,49
1681,-27.105999999999703,1429.0,2,27,12,29
1682,-17.45099999999788,2430.0625,49,23,12,72
1683,-20.3622499999993,2110.9,21,28,3,49
1684,-8.78924999999884,3101.684210526316,52,29,4,81
1685,-27.129499999997716,3722.0,39,42,6,81
1686,1.0935000000020156,3621.9,59,27,4,86
1687,-27.772499999999347,2092.1666666666665,34,26,13,60
1688,-0.9972499999972397,4216.5,70,26,7,96
1689,-22.964499999998516,2669.0,48,41,18,89
1690,-16.03749999999834,2030.25,45,14,8,59
1691,-15.926749999997961,3207.8333333333335,67,13,3,80
1692,-14.029999999998557,2615.6,39,26,0,65
1693,-30.81249999999788,3790.95,37,39,10,76
1694,-29.459499999996257,2144.222222222222,55,30,14,85
1695,-24.37449999999713,4123.888888888889,79,40,5,119
1696,-15.329999999996781,3130.0,67,31,7,98
1697,-42.788249999999486,1857.5294117647059,29,34,7,63
1698,-15.290499999998834,3239.5263157894738,50,33,4,83
1699,-31.218249999997198,2514.375,64,39,11,103
1700,-6.123999999996363,4628.736842105263,98,21,8,119
1701,-27.311499999999377,2102.85,18,25,4,43
1702,-23.95799999999843,3105.266666666667,59,32,1,91
1703,-13.761999999998073,3185.1052631578946,53,29,8,82
1704,-22.485249999999056,2548.2,33,22,3,55
1705,-29.282749999998707,3410.6315789473683,49,34,17,83
1706,-16.207249999998567,3248.6315789473683,61,23,7,84
1707,-8.923249999997918,2941.5,66,28,5,94
1708,-11.196749999997824,2310.9375,71,21,8,92
1709,-12.457499999997617,3443.1666666666665,70,22,5,92
1710,-21.185749999998944,1963.1176470588234,41,33,21,74
1711,-22.0344999999993,2009.2777777777778,28,21,1,49
1712,-16.310499999997838,3802.95,50,36,7,86
1713,-29.815749999998342,2527.4375,63,34,4,97
1714,-18.582499999998454,3027.315789473684,37,36,7,73
1715,-14.645249999998384,3023.5,45,27,3,72
1716,-27.97499999999812,2606.3333333333335,35,36,2,71
1717,-45.09349999999732,2094.8125,59,39,10,98
1718,-22.834499999997746,3630.4210526315787,62,31,10,93
1719,-7.219749999997566,3794.157894736842,64,34,7,98
1720,-28.680749999999268,2206.8947368421054,31,22,10,53
1721,-31.6677499999983,2063.9411764705883,47,23,4,70
1722,-21.33624999999894,2224.35,30,26,0,56
1723,-33.555749999999115,2123.9444444444443,29,17,8,46
1724,-8.366999999998384,3116.4,53,19,4,72
1725,0.1700000000027128,4015.6,76,25,3,101
1726,-15.078999999999024,2752.1,42,24,1,66
1727,-8.593249999996242,3257.1111111111113,76,27,13,103
1728,-16.92699999999789,2911.315789473684,48,24,12,72
1729,-18.326749999998093,3066.6666666666665,65,24,13,89
1730,-37.07049999999947,2133.6666666666665,38,25,12,63
1731,-9.187249999998862,2627.076923076923,60,32,4,92
1732,0.2257500000042545,5024.3,103,15,5,118
1733,-39.497499999999505,1429.0,5,35,4,40
1734,-39.35024999999965,1429.0,10,36,3,46
1735,-10.579249999998519,3410.85,47,32,3,79
1736,-21.025249999999097,2365.5263157894738,35,27,3,62
1737,-5.430999999999173,3064.842105263158,55,26,18,81
1738,-21.305249999999074,2592.222222222222,50,26,23,76
1739,-14.58349999999786,4115.8421052631575,69,32,8,101
1740,-26.401999999998623,1657.25,45,38,9,83
1741,-18.92124999999863,3110.1,47,25,3,72
1742,-8.049499999997987,4169.5,62,31,9,93
1743,-28.252999999998348,3525.15,40,29,8,69
1744,-7.347249999997065,4177.578947368421,69,39,9,108
1745,-36.35599999999814,3056.85,23,43,6,66
1746,-26.551249999997832,2885.8888888888887,65,38,10,103
1747,-26.89324999999937,2156.5,23,34,5,57
1748,-12.973499999997628,4094.95,66,22,9,88
1749,-31.28974999999802,2168.3684210526317,25,26,10,51
1750,-9.852749999997709,2623.5625,61,30,9,91
1751,-29.496249999997637,3741.6315789473683,61,32,12,93
1752,-28.692999999999028,2006.611111111111,35,14,5,49
1753,-26.103499999998654,2038.8947368421052,32,20,3,52
1754,-38.37724999999962,2079.7894736842104,16,27,19,43
1755,-32.57024999999637,3110.705882352941,67,39,6,106
1756,-6.92899999999644,3022.9411764705883,83,21,5,104
1757,-12.790999999998512,2781.9411764705883,63,30,4,93
1758,-23.009999999998925,2562.4666666666667,41,26,4,67
1759,-6.0169999999989425,2968.8333333333335,57,26,3,83
1760,-14.613999999997423,4507.65,72,32,3,104
1761,-14.353249999998795,2543.5263157894738,36,25,5,61
1762,-4.891999999998342,3320.45,58,24,4,82
1763,-30.07474999999773,3170.1052631578946,42,30,8,72
1764,-12.014749999996335,2023.0,70,19,13,89
1765,-29.263499999999652,1429.0,26,40,9,66
1766,-30.770499999998076,2429.0,53,27,5,80
1767,0.11275000000304916,4508.5,88,12,7,100
1768,-33.11099999999902,2805.3,25,40,3,65
1769,-20.72424999999738,2979.3888888888887,67,15,4,82
1770,-19.160999999996314,2707.470588235294,73,17,15,90
1771,-15.411499999998693,3074.0526315789475,43,36,6,79
1772,-18.986249999998968,2692.5,35,32,3,67
1773,-9.580749999998028,3903.7,61,31,2,92
1774,-25.74549999999848,2107.823529411765,35,25,5,60
1775,-9.17899999999699,4310.7,59,44,4,103
1776,-14.374499999997875,2968.764705882353,62,24,5,86
1777,-26.84474999999832,2906.294117647059,54,19,7,73
1778,-17.755999999999613,2032.25,26,22,3,48
1779,-31.255749999998965,2181.842105263158,22,29,3,51
1780,-10.371749999997512,3049.1176470588234,64,24,6,88
1781,-19.341249999999206,2552.2,35,23,5,58
1782,-11.267499999998751,2735.4285714285716,38,26,4,64
1783,-20.375499999998578,2774.1052631578946,45,24,4,69
1784,-5.164499999996602,4152.526315789473,77,26,5,103
1785,-15.271249999998158,3139.5,53,18,6,71
1786,-15.104499999997262,4528.25,79,27,4,106
1787,-16.324249999997217,2219.75,58,31,5,89
1788,-12.66449999999734,4096.631578947368,67,44,6,111
1789,-36.897749999999434,2177.684210526316,28,25,11,53
1790,-22.715499999999,2744.1052631578946,33,35,5,68
1791,-23.03549999999752,2112.5625,71,27,8,98
1792,4.168250000002765,4679.05,80,30,1,110
1793,-8.647249999998728,2564.0,32,35,2,67
1794,-29.252499999998967,2751.6153846153848,39,27,8,66
1795,-14.547499999997047,3750.7894736842104,77,28,1,105
1796,-20.927999999998537,3191.0,57,43,11,100
1797,-15.464999999997946,3546.55,58,27,1,85
1798,-36.46724999999831,2446.823529411765,39,31,5,70
1799,-23.038249999996225,2268.266666666667,76,21,6,97
1800,-24.609749999998623,2524.3333333333335,37,38,5,75
1801,-12.723749999998402,2774.0,31,27,6,58
1802,-34.217499999999305,1975.235294117647,40,39,17,79
1803,-16.197749999997953,3236.3,59,19,3,78
1804,-2.280499999998059,3871.8947368421054,66,34,5,100
1805,-24.189499999998688,2531.1428571428573,40,32,7,72
1806,0.06500000000278065,4199.75,85,19,2,104
1807,-20.738999999998423,3757.4210526315787,72,27,4,99
1808,1.5600000000034857,4132.055555555556,106,27,3,133
1809,-22.730499999998806,2383.1052631578946,34,25,4,59
1810,-33.308499999998325,2649.375,42,24,2,66
1811,-21.245249999998748,2596.2631578947367,36,23,10,59
1812,-9.65349999999765,3082.5,67,20,6,87
1813,-23.16774999999837,2137.705882352941,42,32,4,74
1814,-15.490999999997575,3352.277777777778,69,29,3,98
1815,-8.274999999995707,5460.0,89,32,9,121
1816,-35.96399999999874,2014.4375,35,25,7,60
1817,-20.181749999998203,2554.0,57,45,5,102
1818,-2.4157499999980594,3659.25,79,15,0,94
1819,-8.878999999997342,3451.7368421052633,73,13,6,86
1820,-24.74249999999895,2779.6,40,19,1,59
1821,-14.828999999997535,3282.6666666666665,67,24,2,91
1822,-29.662499999998552,2723.8947368421054,38,23,10,61
1823,-7.208249999998626,2653.6428571428573,60,39,5,99
1824,-14.521749999997946,3559.4736842105262,64,33,6,97
1825,-13.519499999998024,3268.7368421052633,52,27,3,79
1826,-35.72874999999765,1986.2631578947369,33,21,13,54
1827,-12.696999999998118,3393.4,55,27,2,82
1828,-23.46724999999944,2282.157894736842,33,30,17,63
1829,-14.87199999999694,4098.1,62,36,5,98
1830,-17.543749999997058,3813.4210526315787,64,27,4,91
1831,-29.557499999999106,1429.0,36,48,3,84
1832,-16.415749999997686,4525.05,63,34,9,97
1833,13.319250000003148,2926.705882352941,87,22,3,109
1834,-25.55699999999919,2360.05,22,31,4,53
1835,-20.927499999997966,2168.9444444444443,36,24,5,60
1836,-20.964499999998548,2338.842105263158,28,35,4,63
1837,-32.834999999997436,2041.111111111111,27,31,15,58
1838,-2.0369999999981956,2413.176470588235,58,18,9,76
1839,-33.08474999999888,2387.176470588235,42,20,9,62
1840,-40.56674999999999,2050.8823529411766,36,35,15,71
1841,-23.762749999999365,2463.3684210526317,46,17,16,63
1842,-18.15949999999857,2914.7,43,24,3,67
1843,-11.827999999998061,2864.2631578947367,53,22,5,75
1844,-36.08174999999875,2269.4444444444443,32,20,9,52
1845,-27.343749999998458,2698.0588235294117,60,36,5,96
1846,-9.329749999998079,2981.0,65,38,9,103
1847,-30.062749999999625,2071.8125,41,33,15,74
1848,-18.769999999999122,2696.4736842105262,45,16,15,61
1849,-12.836249999998355,2317.8888888888887,40,22,6,62
1850,-22.11899999999925,2448.2631578947367,46,10,7,56
1851,-31.186999999999482,2024.2,23,20,4,43
1852,-8.789999999998134,3185.157894736842,61,19,6,80
1853,-19.906749999998834,2389.823529411765,47,27,6,74
1854,-7.3162499999976465,2570.0,64,29,4,93
1855,-18.341499999999122,3018.0526315789475,56,26,14,82
1856,-4.642499999998796,3286.0666666666666,56,22,7,78
1857,-7.902499999995769,4794.1,87,22,8,109
1858,-12.891999999998458,3169.55,47,29,1,76
1859,-21.987749999997195,2477.6875,53,32,5,85
1860,-7.557499999998514,2641.5,46,26,7,72
1861,-14.532499999998596,2631.2105263157896,44,16,7,60
1862,-5.576749999998235,3024.842105263158,55,17,6,72
1863,-12.836999999998108,3933.8,70,25,5,95
1864,-3.952999999995787,3365.705882352941,86,26,9,112
1865,-30.062499999999364,2108.1666666666665,32,29,13,61
1866,-10.511499999998131,2421.1666666666665,56,12,7,68
1867,-13.831249999996487,4186.555555555556,84,38,1,122
1868,-21.82299999999849,2689.9473684210525,35,33,7,68
1869,-39.268499999997736,2009.3333333333333,21,25,16,46
1870,-23.77149999999807,2496.75,63,25,8,88
1871,-26.23274999999891,2352.95,30,28,1,58
1872,-11.98299999999797,2870.823529411765,69,27,8,96
1873,-14.650249999998087,2368.1666666666665,44,20,5,64
1874,-36.96199999999811,2749.0526315789475,27,38,10,65
1875,-51.463749999998605,2402.375,32,59,16,91
1876,-19.556999999998787,2633.285714285714,38,26,1,64
1877,-8.738499999998284,2990.0,58,24,4,82
1878,-17.89449999999703,3139.6470588235293,60,41,9,101
1879,-37.12449999999877,1924.2,49,39,8,88
1880,-21.147249999999666,2032.3,19,26,2,45
1881,-25.732249999999425,1429.0,9,49,1,58
1882,-18.1774999999978,4045.8,60,34,3,94
1883,-30.957249999998304,3691.3684210526317,44,58,6,102
1884,-12.16949999999687,2566.3529411764707,59,28,11,87
1885,-19.90074999999893,2420.5882352941176,47,22,8,69
1886,-28.022749999999625,2028.3,24,24,1,48
1887,-30.924499999998517,2353.9473684210525,23,28,7,51
1888,-36.04974999999953,2033.0555555555557,34,34,21,68
1889,-1.3287499999968369,4812.631578947368,98,29,4,127
1890,-24.52574999999956,1980.3684210526317,30,19,8,49
1891,-17.058499999998638,3341.0,49,34,3,83
1892,-12.637499999997914,2273.0,78,27,5,105
1893,-31.680249999999337,2357.6111111111113,44,24,23,68
1894,-19.71824999999789,3891.0526315789475,62,39,9,101
1895,-27.551999999998884,2716.45,42,18,6,60
1896,-1.5874999999970116,3462.6315789473683,62,26,10,88
1897,-9.370249999997238,4182.25,66,33,3,99
1898,-20.30799999999742,3874.4,59,27,5,86
1899,-17.979749999999118,2571.95,32,24,2,56
1900,-8.432249999998081,3018.8947368421054,50,29,4,79
1901,-35.83274999999925,2633.285714285714,36,32,13,68
1902,-27.864999999999423,2061.6,24,13,12,37
1903,-3.9204999999950823,5461.5,99,27,6,126
1904,-14.05224999999877,2766.45,40,29,2,69
1905,-21.654499999998496,2886.2,37,30,5,67
1906,11.449000000003533,4880.0,91,28,7,119
1907,-23.321499999997464,2320.3846153846152,36,19,16,55
1908,-27.70349999999926,2260.85,34,19,5,53
1909,-30.063249999999265,2273.6315789473683,31,22,16,53
1910,-19.928999999999256,1971.5294117647059,38,25,8,63
1911,-23.576249999997565,1889.375,50,36,19,86
1912,-23.455499999999354,2020.4,22,18,8,40
1913,-9.455499999997986,4019.55,58,32,4,90
1914,-26.649499999997524,3592.1111111111113,71,15,11,86
1915,-6.100999999995056,2395.3529411764707,96,22,8,118
1916,-1.617749999996756,5068.75,92,30,1,122
1917,-25.395249999997482,3861.842105263158,64,40,2,104
1918,-11.40724999999797,2598.1428571428573,57,26,3,83
1919,-34.015999999999124,2112.5,29,19,8,48
1920,-10.92824999999923,2615.3684210526317,40,29,7,69
1921,-20.15999999999901,2395.5,20,42,7,62
1922,-39.692249999999895,2034.1176470588234,25,39,17,64
1923,-20.614249999998798,2688.0,35,25,9,60
1924,3.5135000000015593,2482.75,74,27,1,101
1925,-15.331999999997773,3744.25,56,27,7,83
1926,-45.70524999999901,1969.75,39,37,23,76
1927,-17.168999999998107,3522.0,55,30,2,85
1928,-24.09924999999871,3338.8947368421054,53,29,16,82
1929,-3.2042499999964718,4587.9,74,38,4,112
1930,-22.26774999999749,2676.125,77,33,7,110
1931,-21.362999999997744,3883.0,51,33,8,84
1932,-49.907999999998545,1429.0,34,37,17,71
1933,-9.791249999998062,3245.6,46,33,3,79
1934,-17.762249999998534,3477.45,42,39,4,81
1935,-2.943749999997912,3844.95,67,27,2,94
1936,-18.440749999996758,4233.05,62,35,6,97
1937,-14.668999999997794,3585.3684210526317,66,26,7,92
1938,-4.929749999997442,3524.35,66,22,3,88
1939,-26.26674999999841,3261.6,44,27,4,71
1940,-34.70549999999842,3196.0,34,45,5,79
1941,-13.42124999999696,2664.6315789473683,37,29,16,66
1942,-23.675499999999012,2698.8823529411766,33,20,9,53
1943,1.857500000003388,4370.631578947368,79,35,4,114
1944,-4.089499999998466,3230.6111111111113,68,20,8,88
1945,-6.571999999997705,3853.0,56,36,1,92
1946,-29.44474999999764,3370.684210526316,53,31,9,84
1947,1.5452500000028915,3221.8888888888887,80,15,12,95
1948,1.800000000002603,2550.125,77,26,3,103
1949,-20.24924999999858,2097.529411764706,39,30,6,69
1950,5.135250000003085,5138.7,104,19,2,123
1951,-11.615999999998342,2603.8125,48,18,13,66
1952,-34.19424999999696,2853.8125,73,37,16,110
1953,-1.6302499999980824,3705.35,58,29,4,87
1954,-26.39599999999881,2030.3529411764705,35,26,14,61
1955,1.4875000000027279,4295.85,83,21,5,104
1956,-18.31999999999844,2557.722222222222,44,28,10,72
1957,-27.690999999999015,3247.1052631578946,49,34,15,83
1958,-26.19124999999993,1980.4736842105262,17,20,9,37
1959,-11.535749999998185,2435.153846153846,44,17,11,61
1960,-26.921499999999376,2024.25,24,23,2,47
1961,-21.5902499999983,2802.0,46,35,4,81
1962,-22.558749999998252,3274.4210526315787,42,39,6,81
1963,-18.39699999999866,2544.25,48,27,9,75
1964,-25.776499999998215,2581.6111111111113,42,26,5,68
1965,-26.9547499999997,1429.0,1,39,1,40
1966,-10.094999999998553,3074.35,49,19,7,68
1967,-28.27599999999871,2556.0555555555557,31,38,5,69
1968,-3.7882499999986456,2939.5789473684213,49,24,7,73
1969,-28.377249999998874,1429.0,18,26,11,44
1970,-21.73974999999875,2722.470588235294,32,20,8,52
1971,-19.83549999999837,3309.25,54,22,8,76
1972,-30.043249999999112,1895.9411764705883,27,26,16,53
1973,-24.370249999998048,2875.5625,64,24,6,88
1974,-9.92874999999786,2677.529411764706,58,42,7,100
1975,-21.33099999999808,2018.25,47,31,5,78
1976,-37.742999999999824,1429.0,10,37,19,47
1977,-27.108749999997762,2026.7058823529412,44,32,15,76
1978,-30.535999999999138,2493.3684210526317,35,23,9,58
1979,-8.044999999996906,2448.9375,69,28,5,97
1980,-28.432499999999283,2102.95,25,24,1,49
1981,-15.588749999998097,3235.4,45,24,7,69
1982,18.88050000000491,5475.2,111,18,8,129
1983,-8.791749999998135,3080.777777777778,59,35,12,94
1984,-14.87924999999718,3734.0,72,26,5,98
1985,-14.790249999999096,2646.55,37,28,3,65
1986,-28.718999999999546,2160.842105263158,24,28,8,52
1987,-20.81374999999837,3913.95,52,38,3,90
1988,-12.20049999999773,4145.0,64,31,8,95
1989,-9.80499999999613,2359.1176470588234,67,22,16,89
1990,10.473250000002178,4056.6315789473683,77,27,8,104
1991,-16.479499999994687,2255.529411764706,65,30,20,95
1992,-41.92374999999895,1993.7894736842106,23,20,6,43
1993,-10.393999999998357,3527.684210526316,64,35,6,99
1994,-14.256249999998147,2824.0588235294117,43,34,7,77
1995,-37.258749999999445,2036.421052631579,23,25,7,48
1996,3.94175000000257,4369.55,81,27,2,108
1997,-17.316999999997403,2268.8333333333335,48,21,11,69
1998,-16.613249999997258,3985.35,61,30,6,91
1999,-14.927749999997005,2176.0,56,32,9,88
2000,-19.034249999999314,2523.4210526315787,45,16,6,61
2001,-44.861249999999316,2685.4,27,29,3,56
2002,-32.24899999999981,2222.7368421052633,24,22,24,46
2003,-19.68999999999855,3010.5789473684213,44,32,4,76
2004,-29.03799999999897,2892.6,31,28,6,59
2005,-39.98774999999936,2197.5789473684213,22,34,10,56
2006,-19.059999999999352,2028.25,29,20,1,49
2007,-31.23574999999954,1997.2105263157894,20,25,12,45
2008,16.98700000000256,4663.25,96,21,2,117
2009,-18.136999999998306,3207.7368421052633,52,33,5,85
2010,-11.806249999997092,3740.6315789473683,64,32,11,96
2011,9.191500000001716,3790.8947368421054,70,30,5,100
2012,-47.8697499999994,1971.5294117647059,36,27,27,63
2013,-20.69824999999764,2047.2777777777778,46,23,9,69
2014,-36.52074999999991,1429.0,22,32,25,54
2015,-13.07099999999833,1946.9375,61,33,6,94
2016,-12.47199999999911,3406.75,46,36,4,82
2017,-21.6534999999974,2657.25,77,39,12,116
2018,-30.52024999999902,2020.7222222222222,26,29,5,55
2019,-17.549249999998665,2539.4210526315787,37,29,5,66
2020,-25.999499999998342,3122.5263157894738,45,41,8,86
2021,-12.280999999998624,3018.8888888888887,53,33,10,86
2022,-9.577749999996795,4790.789473684211,90,41,7,131
2023,-18.43274999999798,2660.1111111111113,56,20,6,76
2024,-14.099249999998708,2232.6875,47,25,2,72
2025,-23.16849999999757,3478.315789473684,68,19,12,87
2026,0.9985000000027153,3775.2,72,18,7,90
2027,-23.061249999999553,2028.2,28,11,9,39
2028,-28.19224999999887,2748.0,42,35,13,77
2029,-7.027749999996997,2657.25,69,30,4,99
2030,-25.829499999998426,2282.470588235294,33,30,10,63
2031,-28.424499999999387,2592.8947368421054,44,27,23,71
2032,-9.647249999998657,2812.4,45,22,4,67
2033,-21.773499999998627,3200.2105263157896,55,25,14,80
2034,-29.884749999998565,2808.35,36,30,4,66
2035,-20.48999999999939,2008.4,27,12,8,39
2036,-20.63674999999812,2181.764705882353,42,40,8,82
2037,-6.841249999997001,2734.3529411764707,65,29,11,94
2038,-1.050499999996734,3526.8888888888887,68,29,9,97
2039,-23.198999999998684,3009.2,38,32,4,70
2040,-19.77524999999813,2362.625,67,24,15,91
2041,-8.457749999997521,3770.8947368421054,64,32,4,96
2042,-23.295499999999553,2034.6842105263158,28,20,17,48
2043,-26.498499999996177,5161.6,71,43,4,114
2044,-18.892749999997516,2353.6875,50,32,3,82
2045,-32.28124999999969,2255.15,19,32,4,51
2046,-1.520249999998262,3603.7,71,14,3,85
2047,-15.3524999999973,2166.1875,63,35,7,98
2048,-34.881499999999036,1882.764705882353,41,31,3,72
2049,-18.175249999998833,2185.6111111111113,39,30,4,69
2050,10.719000000002953,4373.1578947368425,99,24,6,123
2051,-19.244249999998342,3847.25,52,40,0,92
2052,-15.694499999998083,3332.95,47,31,7,78
2053,-29.315249999998855,2092.0588235294117,28,35,3,63
2054,-25.366499999997306,2372.6111111111113,55,22,4,77
2055,-19.267749999997626,4185.45,63,36,4,99
2056,-36.52049999999895,2429.9473684210525,22,40,1,62
2057,-20.54924999999771,3624.5789473684213,52,35,9,87
2058,-19.916999999998716,2691.0,26,36,5,62
2059,-12.760249999999008,2620.5882352941176,41,20,2,61
2060,-11.918749999998361,3225.95,49,32,2,81
2061,-4.709249999998048,3030.5555555555557,63,20,3,83
2062,-17.237749999998826,2534.777777777778,46,23,3,69
2063,-1.1479999999968318,4756.578947368421,97,31,4,128
2064,-20.327249999998745,3088.2631578947367,39,42,4,81
2065,-21.38574999999939,2190.9444444444443,31,25,8,56
2066,-13.393999999995719,3009.8823529411766,74,19,6,93
2067,-3.673249999998343,3658.0,76,18,3,94
2068,-23.794499999999054,2646.55,31,28,4,59
2069,-38.31974999999915,2347.2105263157896,27,31,9,58
2070,-24.170249999996873,2204.9411764705883,49,22,14,71
2071,-31.02549999999939,2532.3333333333335,47,40,7,87
2072,-17.440249999998205,4532.35,66,38,4,104
2073,-6.472499999996873,3729.0,60,31,5,91
2074,-20.606249999997726,4025.1,59,39,3,98
2075,-17.565249999998002,3254.4444444444443,78,23,8,101
2076,-6.0507499999975485,3460.8947368421054,61,32,1,93
2077,5.262250000001438,2726.9411764705883,52,31,3,83
2078,-21.675249999997895,3469.5,47,32,4,79
2079,-33.06424999999804,3835.45,49,36,6,85
2080,-15.929499999998361,2646.5882352941176,50,33,4,83
2081,-30.688749999999953,1944.9444444444443,22,38,5,60
2082,-7.974999999997823,4264.8,67,34,0,101
2083,-22.441999999999084,2161.8333333333335,29,28,7,57
2084,-24.92699999999906,2164.0,24,23,4,47
2085,-25.114499999998408,3080.777777777778,54,43,7,97
2086,-19.67974999999954,1980.3684210526317,23,22,10,45
2087,-29.551749999998908,2149.5,38,25,5,63
2088,-14.801499999997484,2699.777777777778,50,28,6,78
2089,14.578000000002593,4049.8947368421054,72,30,4,102
2090,-25.920249999994287,2607.625,97,16,22,113
2091,-20.053249999997732,2437.0,52,26,2,78
2092,-8.85899999999835,2811.8888888888887,43,26,3,69
2093,-13.522499999998558,2455.8125,51,24,6,75
2094,-29.830249999999285,1909.7222222222222,23,30,5,53
2095,-2.8014999999974073,4702.2,74,39,3,113
2096,-10.656249999998975,2673.9473684210525,47,34,3,81
2097,-21.048249999998845,2944.9444444444443,59,40,5,99
2098,-16.03299999999819,2851.4,34,29,5,63
2099,-32.64199999999893,2662.35,25,25,8,50
2100,-24.624249999997282,2081.9333333333334,60,32,8,92
2101,-23.580999999998518,2557.8333333333335,37,21,6,58
2102,-21.887249999998872,2597.176470588235,50,50,3,100
2103,-18.290499999998893,2107.5625,43,19,12,62
2104,-30.78924999999915,2429.1111111111113,32,38,6,70
2105,-20.479749999998933,2649.65,44,12,7,56
2106,-36.307499999999024,1996.375,33,29,14,62
2107,-11.641999999998614,2540.05,33,26,5,59
2108,-15.999749999997766,2597.1176470588234,58,23,5,81
2109,-20.495249999999224,2774.842105263158,51,26,1,77
2110,-8.456749999998173,3834.7,71,21,0,92
2111,-22.178999999996954,2800.733333333333,57,22,12,79
2112,-15.765249999997986,2281.8333333333335,39,28,11,67
2113,-25.87074999999794,2560.5555555555557,37,36,9,73
2114,-34.39824999999871,2666.4210526315787,32,27,16,59
2115,-17.36249999999806,2505.3333333333335,41,34,4,75
2116,-13.007999999997491,4334.65,64,34,6,98
2117,-22.73274999999896,2554.3333333333335,37,23,1,60
2118,-19.40024999999759,4304.4,66,32,5,98
2119,-1.1374999999984354,3008.55,57,11,5,68
2120,-12.970749999998677,2930.75,42,27,2,69
2121,-19.458749999998425,2566.4117647058824,40,27,7,67
2122,-21.314499999998922,3457.55,50,33,2,83
2123,-29.866999999999273,2564.75,22,41,2,63
2124,-6.085749999998515,3546.0,72,31,14,103
2125,-1.280999999997488,4294.15,73,29,1,102
2126,-17.646749999997166,3150.0526315789475,49,38,11,87
2127,-17.292249999998923,2473.1666666666665,40,24,2,64
2128,-20.791249999999497,2778.25,41,25,3,66
2129,-30.221249999999213,2021.8823529411766,41,26,18,67
2130,-26.460499999999303,2135.45,25,25,1,50
2131,-8.282999999998147,2940.3684210526317,53,20,6,73
2132,-7.789999999996939,4699.7,82,30,0,112
2133,-5.854999999996565,2068.705882352941,60,24,15,84
2134,-28.87724999999964,2125.0,23,25,7,48
2135,-15.586499999997255,3902.85,65,29,2,94
2136,18.40300000000247,4013.8888888888887,90,22,4,112
2137,-14.50749999999876,2767.3684210526317,42,27,3,69
2138,-30.63249999999901,2480.4444444444443,41,31,21,72
2139,-23.816499999998964,2508.4210526315787,31,34,7,65
2140,-20.99874999999799,2384.375,56,34,2,90
2141,-26.61299999999799,2138.705882352941,39,29,7,68
2142,6.912500000002339,4179.0,67,34,3,101
2143,-30.617999999999494,1429.0,20,29,3,49
2144,-2.898249999998247,3525.2105263157896,64,29,3,93
2145,-10.170249999998386,2773.705882352941,63,30,3,93
2146,-21.071249999998013,2635.4210526315787,38,34,5,72
2147,4.6132500000024255,4402.15,77,22,6,99
2148,0.5282500000026122,4328.4,80,30,0,110
2149,-34.259999999999565,2350.5263157894738,29,28,17,57
2150,-29.958749999998638,2658.45,20,37,5,57
2151,8.539750000002373,2825.875,77,26,9,103
2152,-35.37974999999814,3881.842105263158,63,39,14,102
2153,-20.622749999998643,1919.1875,49,31,5,80
2154,-18.479249999999148,2511.842105263158,38,25,2,63
2155,-28.463499999999215,2285.55,31,20,4,51
2156,-23.4987499999988,2691.733333333333,42,20,7,62
2157,-19.951249999997607,2070.470588235294,52,17,8,69
2158,-6.122249999997377,4064.8947368421054,78,29,6,107
2159,-18.51799999999872,2459.1111111111113,42,27,8,69
2160,-40.46550000000041,1429.0,6,31,9,37
2161,-15.388499999996355,3800.0,69,29,9,98
2162,-8.971999999998655,2458.3684210526317,40,21,4,61
2163,-30.821999999998734,3209.95,42,30,8,72
2164,-4.714999999998293,2928.1111111111113,58,29,2,87
2165,-4.652999999998373,2501.625,52,29,19,81
2166,-40.50475000000017,1952.7777777777778,19,45,12,64
2167,-2.015999999999189,2656.0588235294117,57,38,6,95
2168,-30.93174999999916,2205.25,28,24,2,52
2169,-31.922999999999327,2603.777777777778,41,41,14,82
2170,-13.317249999997355,3688.842105263158,75,28,6,103
2171,-25.8967499999985,3014.6315789473683,39,42,1,81
2172,-10.830249999997928,3226.8947368421054,48,42,5,90
2173,-31.236499999998205,2815.6470588235293,45,38,0,83
2174,-36.77449999999912,1429.0,21,37,10,58
2175,-17.81599999999897,1978.7368421052631,31,21,0,52
2176,-33.01699999999775,2035.0588235294117,37,24,8,61
2177,-24.424999999996054,3586.8333333333335,74,31,7,105
2178,-4.989999999997797,3468.0555555555557,68,34,4,102
2179,-15.809499999998096,3381.4736842105262,57,38,5,95
2180,-25.378999999998776,2268.3125,47,36,3,83
2181,-9.728999999997034,4338.6,77,23,6,100
2182,-30.724249999999266,2080.0,26,22,3,48
2183,-28.367749999996057,2638.1176470588234,70,15,8,85
2184,-5.632249999997308,3603.8,67,17,5,84
2185,-18.50699999999804,3177.684210526316,54,22,7,76
2186,-35.514249999999784,1429.0,7,33,7,40
2187,4.197000000001174,3075.9,51,25,3,76
2188,-1.2157499999970973,2549.866666666667,78,20,5,98
2189,-39.81999999999721,3961.2105263157896,66,32,16,98
2190,-14.096499999997146,2549.0,50,27,13,77
2191,-34.71824999999822,2384.4375,47,44,8,91
2192,-20.00624999999802,2959.1666666666665,59,25,7,84
2193,-4.822999999998179,3819.6,68,19,6,87
2194,-14.77699999999831,3325.9,42,29,8,71
2195,-7.629749999998401,3676.05,59,20,8,79
2196,-8.76474999999876,2675.2,33,35,0,68
2197,-25.416749999999276,2298.0526315789475,38,25,17,63
2198,-4.605749999997686,4182.25,77,27,2,104
2199,-34.87174999999955,2214.315789473684,29,23,8,52
2200,-30.217499999999355,1958.4117647058824,29,31,2,60
2201,-7.488749999997836,3242.0555555555557,66,21,6,87
2202,-11.726249999998638,3284.4444444444443,63,34,5,97
2203,-22.038499999998496,3104.2105263157896,48,35,2,83
2204,-16.886249999998377,2750.5625,55,31,13,86
2205,-23.248999999999132,2135.7368421052633,29,17,7,46
2206,-5.3612499999988525,2672.4444444444443,41,20,3,61
2207,-16.194499999998307,2467.470588235294,42,22,8,64
2208,-18.94549999999835,1960.8125,43,35,6,78
2209,-23.27124999999935,2358.0526315789475,34,30,10,64
2210,-16.976499999997706,2693.294117647059,48,26,10,74
2211,-23.461499999999184,2065.823529411765,44,34,19,78
2212,-19.911999999998972,2000.4375,37,25,10,62
2213,-33.68649999999799,2033.0,33,14,16,47
2214,-31.335499999999353,2365.5555555555557,31,38,5,69
2215,-14.424249999997551,3933.1,56,35,3,91
2216,-35.76674999999858,2696.4736842105262,38,31,5,69
2217,-25.43799999999963,2095.777777777778,24,33,5,57
2218,-7.524499999997959,3434.157894736842,57,31,5,88
2219,-9.930999999998408,3194.95,58,15,6,73
2220,-23.108249999998836,2510.05,31,32,0,63
2221,-15.922999999998646,3666.4736842105262,59,34,27,93
2222,-18.41574999999826,2837.235294117647,63,35,15,98
2223,-16.913249999998943,2479.4117647058824,45,38,9,83
2224,-7.459249999998379,3115.65,55,21,4,76
2225,-27.087249999997717,3546.5,46,40,4,86
2226,-5.6322499999989075,2534.8888888888887,50,26,4,76
2227,-29.714999999998224,2641.5,52,25,17,77
2228,-20.34024999999745,3512.8888888888887,70,19,10,89
2229,-7.323999999997571,2425.3529411764707,69,28,8,97
2230,-24.149249999998748,1961.6666666666667,29,30,3,59
2231,-18.324499999998984,2671.0,44,32,9,76
2232,-29.13049999999933,2040.1,27,18,3,45
2233,3.7070000000035686,3110.823529411765,78,17,13,95
2234,-19.992249999999256,2620.5882352941176,38,23,14,61
2235,-15.355749999996414,3973.684210526316,75,28,6,103
2236,-6.423999999997423,4020.4736842105262,71,40,1,111
2237,-8.709249999997411,4306.85,65,44,2,109
2238,-5.9674999999961775,5504.45,86,44,7,130
2239,-14.244249999998138,3117.5263157894738,65,18,2,83
2240,-27.817999999998154,2378.5,48,28,3,76
2241,-20.963499999998437,2661.4736842105262,38,31,4,69
2242,-17.04499999999846,2609.8333333333335,39,26,7,65
2243,-25.69574999999896,2117.4736842105262,29,30,6,59
2244,-18.674999999997958,3546.1052631578946,62,27,6,89
2245,-29.138999999999317,1710.8125,31,30,21,61
2246,-17.220499999998875,2596.8125,36,25,2,61
2247,-0.6897499999975187,2678.125,72,18,5,90
2248,-19.979749999998596,3514.05,45,35,3,80
2249,-8.428999999998274,3637.842105263158,66,21,10,87
2250,-18.66124999999689,3290.6111111111113,80,43,4,123
2251,-15.942999999998685,3148.1,43,39,0,82
2252,-27.333749999997924,3698.9444444444443,68,44,1,112
2253,-22.65799999999877,2532.222222222222,38,34,4,72
2254,-31.783249999998795,2976.8333333333335,36,42,4,78
2255,-12.825749999997882,2175.125,73,35,10,108
2256,-17.434999999999196,2591.0,43,16,3,59
2257,-11.990999999997237,3768.2631578947367,69,27,3,96
2258,-1.1884999999986436,3084.0,59,19,1,78
2259,-8.499749999998745,2991.75,43,29,2,72
2260,-10.690999999999097,2471.0526315789475,40,24,4,64
2261,-17.818749999997266,3409.1052631578946,46,37,6,83
2262,4.8112500000029925,4089.157894736842,89,17,4,106
2263,-1.3934999999982538,3741.1,59,31,2,90
2264,-18.132249999998912,2634.529411764706,37,21,5,58
2265,-15.673249999998925,2563.95,34,29,1,63
2266,-35.90099999999825,3343.0526315789475,56,30,3,86
2267,-10.639249999998478,3234.55,50,24,3,74
2268,3.3650000000025893,4262.5,78,28,1,106
2269,-17.27499999999796,3591.75,46,41,2,87
2270,-24.31224999999958,1957.3333333333333,29,26,8,55
2271,-18.973999999998572,2965.3846153846152,40,30,2,70
2272,-4.85924999999745,3080.9411764705883,74,24,3,98
2273,-9.022749999996755,2918.5555555555557,57,37,7,94
2274,-46.145749999999786,2044.611111111111,22,32,23,54
2275,-22.924499999999075,2478.4210526315787,35,35,6,70
2276,-22.500499999997125,2152.25,54,29,6,83
2277,-34.64624999999856,2449.5,31,34,6,65
2278,-17.27724999999862,2711.55,40,30,2,70
2279,-26.707499999998742,2449.3888888888887,36,34,2,70
2280,-45.03174999999874,1594.75,25,39,6,64
2281,6.214500000002799,4133.0,84,17,3,101
2282,-24.5257499999978,2584.176470588235,44,34,5,78
2283,-12.784749999998107,3023.842105263158,48,23,9,71
2284,-4.309999999997927,3130.222222222222,52,40,1,92
2285,-22.138749999998506,2672.823529411765,47,38,5,85
2286,-20.727249999995713,2122.277777777778,66,27,12,93
2287,-18.916999999996005,2432.823529411765,84,19,8,103
2288,-12.849499999997875,3060.7368421052633,49,27,8,76
2289,-14.954249999997277,4114.2,68,32,0,100
2290,-24.099249999998637,2386.9411764705883,33,33,8,66
2291,8.630750000002749,4387.368421052632,89,29,6,118
2292,-13.414499999998014,3868.75,65,33,2,98
2293,-20.197749999998514,2785.4444444444443,43,35,8,78
2294,-29.685249999998888,2801.684210526316,31,37,6,68
2295,-42.17999999999765,2034.0588235294117,62,41,13,103
2296,-28.26949999999823,2351.5882352941176,38,33,11,71
2297,-19.21499999999836,2900.8888888888887,48,30,2,78
2298,-23.885249999998265,2475.5882352941176,51,15,4,66
2299,-22.87624999999712,2138.764705882353,57,28,7,85
2300,-29.592749999999246,2824.315789473684,48,26,26,74
2301,-25.863749999998156,3469.55,59,19,3,78
2302,-25.40374999999621,2137.764705882353,69,19,12,88
2303,-23.215749999999552,1429.0,36,34,18,70
2304,-12.963499999998092,2664.25,43,29,3,72
2305,15.626000000003831,2911.3125,93,22,1,115
2306,-25.80624999999831,2459.8947368421054,36,27,7,63
2307,-27.07074999999897,2425.842105263158,33,25,12,58
2308,-28.19324999999943,2024.4,22,27,0,49
2309,-14.55299999999892,2477.6470588235293,44,34,10,78
2310,-22.096999999999234,2524.3333333333335,37,34,10,71
2311,-22.672999999996435,2286.0,56,26,12,82
2312,-34.218750000000156,1429.0,10,34,20,44
2313,-21.258249999999183,2572.0,39,24,12,63
2314,-21.12124999999728,2442.0588235294117,43,27,12,70
2315,-16.411999999999395,2012.35,26,19,4,45
2316,-11.462499999999002,2808.3125,33,30,2,63
2317,-30.21249999999918,1921.1764705882354,26,32,5,58
2318,-24.65499999999861,3223.6315789473683,40,45,6,85
2319,-18.12099999999794,2568.294117647059,53,33,13,86
2320,-22.80699999999893,2542.9444444444443,39,18,9,57
2321,-25.778749999999484,2032.25,22,28,1,50
2322,-15.11149999999848,3388.2631578947367,54,33,13,87
2323,-17.065999999994354,4120.444444444444,99,24,19,123
2324,-25.983999999997167,2051.9375,64,16,6,80
2325,-3.266999999996603,4424.3,78,29,5,107
2326,-19.46299999999845,3035.4736842105262,46,32,8,78
2327,-15.412999999997728,2409.6470588235293,49,31,3,80
2328,-8.84949999999883,2846.45,45,19,7,64
2329,-21.655249999999366,2028.25,26,20,2,46
2330,-18.67149999999835,3154.3684210526317,60,24,11,84
2331,-23.785499999997278,2894.0,66,38,7,104
2332,-23.37049999999847,2580.8333333333335,34,37,5,71
2333,-21.787749999996983,2280.125,55,25,4,80
2334,-5.908749999996892,4355.2,73,33,0,106
2335,-15.10374999999721,4316.263157894737,71,42,11,113
2336,-4.083999999998665,3175.1,51,29,1,80
2337,-7.614249999999077,2232.5625,39,26,4,65
2338,-17.727749999999915,2668.3125,33,27,23,60
2339,11.525000000002182,4293.4,71,32,2,103
2340,-20.3719999999983,2743.157894736842,37,36,2,73
2341,1.1665000000020658,3430.7368421052633,67,30,1,97
2342,-32.56599999999858,1750.4375,44,51,4,95
2343,-4.812249999997846,3606.2,63,22,1,85
2344,-1.5497499999985072,2669.0,54,18,4,72
2345,-20.07649999999898,2457.5,47,19,12,66
2346,-6.093499999997794,3370.1666666666665,73,25,4,98
2347,-33.236999999999924,2004.888888888889,28,22,27,50
2348,-15.185249999998732,3262.4444444444443,63,51,8,114
2349,-28.04699999999899,2473.1111111111113,27,41,13,68
2350,-7.820249999997782,2512.294117647059,63,29,3,92
2351,-10.423999999997587,4079.1052631578946,72,35,10,107
2352,-10.403999999997193,3814.5,74,28,5,102
2353,-31.564499999999462,1972.0,21,24,6,45
2354,-16.222499999998604,3171.0,46,40,3,86
2355,-6.048499999998437,3110.8,50,25,4,75
2356,6.936750000003092,4591.85,87,18,7,105
2357,-7.122749999998436,3699.0,66,25,1,91
2358,-1.6309999999976061,3114.8947368421054,56,27,6,83
2359,-12.005749999999633,1887.4705882352941,26,29,8,55
2360,-19.410999999998303,3768.7,55,29,4,84
2361,-10.071499999998569,2163.722222222222,42,31,14,73
2362,-13.560749999999013,2873.722222222222,57,30,9,87
2363,-23.886749999998212,1429.0,44,46,7,90
2364,16.957750000002143,4210.95,76,26,3,102
2365,-21.20974999999801,2080.823529411765,72,39,5,111
2366,-11.013499999998848,2348.8333333333335,37,28,4,65
2367,-18.11724999999848,2295.529411764706,44,22,3,66
2368,3.5277500000028352,3798.6111111111113,84,35,3,119
2369,-12.563249999998021,3403.1052631578946,51,29,7,80
2370,-33.06099999999855,2619.55,34,25,5,59
2371,-9.153249999995966,4703.894736842105,86,39,13,125
2372,-25.02774999999908,2054.125,29,44,1,73
2373,-29.899499999998902,2788.4210526315787,35,29,9,64
2374,-6.212999999998437,3395.7368421052633,55,35,12,90
2375,-28.333249999998806,2803.375,32,25,5,57
2376,-34.6270000000001,1429.0,21,49,4,70
2377,-8.74574999999635,4447.4,76,31,4,107
2378,-11.843749999997996,2433.764705882353,48,34,5,82
2379,-19.07949999999853,3134.6,40,30,6,70
2380,-30.192749999999158,2183.8333333333335,42,32,17,74
2381,-0.6762499999974586,3227.294117647059,87,28,7,115
2382,-21.97824999999902,2346.222222222222,38,24,9,62
2383,-25.680249999999326,2445.0555555555557,37,36,16,73
2384,-12.816499999997808,2434.5333333333333,61,30,8,91
2385,-10.142499999997328,3957.9473684210525,62,36,5,98
2386,-6.724249999995742,3342.6111111111113,78,34,9,112
2387,-21.403749999999583,1916.4705882352941,26,25,7,51
2388,-16.08874999999858,3048.25,51,22,1,73
2389,10.734000000002641,4668.95,94,25,0,119
2390,-24.613499999998925,2370.235294117647,45,26,17,71
2391,-29.092749999998624,2391.764705882353,54,29,24,83
2392,-13.714999999997355,4494.2,77,29,4,106
2393,12.62725000000219,4040.9,61,35,5,96
2394,-20.150249999997428,3039.0,65,21,4,86
2395,-22.892499999998204,2068.2631578947367,28,24,11,52
2396,-33.30499999999826,3598.85,45,39,2,84
2397,7.3240000000026715,4671.25,95,21,4,116
2398,0.5462500000022172,4322.8,76,31,5,107
2399,-29.68674999999923,2008.45,19,28,1,47
2400,-25.16799999999838,3676.65,36,44,4,80
2401,-19.309499999999094,2492.7368421052633,34,27,8,61
2402,-22.51399999999644,2364.1666666666665,29,31,24,60
2403,-18.973499999998815,2776.6315789473683,36,42,2,78
2404,-1.721999999998267,3383.05,59,19,4,78
2405,-29.716249999999082,2318.65,23,30,2,53
2406,-39.151749999999275,2177.6666666666665,31,31,8,62
2407,-18.076749999998817,2855.5714285714284,38,23,4,61
2408,-35.2889999999999,1952.7777777777778,26,26,7,52
2409,-17.63924999999747,4073.55,56,36,1,92
2410,-4.480749999996741,5806.9,94,45,1,139
2411,-14.801749999998538,2441.5555555555557,53,22,5,75
2412,-11.330999999998422,3440.8947368421054,45,34,21,79
2413,-26.23674999999767,3841.7368421052633,63,35,5,98
2414,-38.94349999999979,1881.5555555555557,14,36,1,50
2415,-28.670249999999083,2200.157894736842,25,29,7,54
2416,-29.93349999999853,2849.235294117647,59,44,14,103
2417,-9.609999999997477,4065.65,59,37,2,96
2418,8.965000000002865,5015.75,80,38,5,118
2419,-15.724499999998642,3723.9473684210525,52,42,7,94
2420,-13.478999999998683,3071.9,49,18,5,67
2421,-19.218249999998484,2887.05,40,29,1,69
2422,-33.59324999999943,1984.6666666666667,24,23,6,47
2423,4.1112500000018155,3932.35,61,37,1,98
2424,-29.74399999999904,2272.7,27,26,1,53
2425,-21.198499999998198,2417.0,69,31,5,100
2426,-24.992249999999427,2024.2,28,21,1,49
2427,-41.43699999999994,2018.0,24,18,13,42
2428,2.7000000000055184,2001.4375,103,19,11,122
2429,-26.472999999998173,3103.0,40,35,10,75
2430,-14.4497499999988,2521.470588235294,53,35,3,88
2431,-8.60499999999825,3076.5,63,30,12,93
2432,-11.029999999999053,2492.5555555555557,34,42,4,76
2433,-17.767249999999,2668.1666666666665,28,32,2,60
2434,-7.093249999997843,3519.2631578947367,54,29,11,83
2435,-11.680749999997579,3939.4736842105262,69,36,6,105
2436,-22.477749999999286,2471.0526315789475,37,28,17,65
2437,-24.370999999997537,2322.3333333333335,47,27,10,74
2438,-1.3642499999977507,4566.4,70,44,2,114
2439,-36.80274999999976,2114.75,14,36,2,50
2440,-19.026249999999532,2009.375,47,33,14,80
2441,-14.908249999997915,3870.35,57,36,1,93
2442,-4.557499999997124,2884.222222222222,56,26,10,82
2443,-5.18999999999714,2537.7368421052633,51,22,14,73
2444,-18.17274999999961,2008.5,24,23,2,47
2445,-7.595999999997535,3872.65,73,23,2,96
2446,-7.272249999997579,2784.6923076923076,55,29,7,84
2447,-41.7899999999995,1429.0,15,37,5,52
2448,-15.26049999999768,2812.0588235294117,57,27,10,84
2449,-22.969749999998843,2462.4736842105262,28,31,3,59
2450,-10.399499999998485,2430.722222222222,49,29,2,78
2451,-34.70024999999916,2244.1176470588234,30,27,6,57
2452,-21.745999999998368,2575.705882352941,76,33,9,109
2453,-26.028749999999405,2563.9444444444443,44,34,1,78
2454,-20.7744999999967,4373.210526315789,74,40,8,114
2455,-7.042749999997821,2997.8333333333335,61,20,5,81
2456,-1.0507499999969656,4244.2,75,26,5,101
2457,-19.029249999999134,2008.35,23,27,0,50
2458,-15.06874999999756,3940.95,67,22,7,89
2459,-24.10899999999726,3600.277777777778,76,34,13,110
2460,-31.406499999999888,2012.157894736842,35,19,24,54
2461,-16.168999999998388,2094.75,51,28,2,79
2462,-24.918749999998916,2668.75,20,39,3,59
2463,0.6760000000024782,4371.95,73,28,3,101
2464,-5.2437499999982276,3280.7,52,30,1,82
2465,-20.72924999999829,2544.2631578947367,41,25,3,66
2466,-12.18199999999769,3598.684210526316,66,30,7,96
2467,-23.98549999999849,2582.0714285714284,37,24,7,61
2468,-29.746249999999304,2913.7368421052633,40,37,17,77
2469,-34.675750000000036,1429.0,0,29,4,29
2470,-18.636249999998622,3173.55,52,22,1,74
2471,10.519250000002717,3209.9375,87,38,7,125
2472,-21.24849999999801,3281.2105263157896,54,24,3,78
2473,-5.101999999998316,3957.75,70,27,1,97
2474,-15.591999999998517,3022.95,51,22,4,73
2475,-9.268999999998396,2861.3529411764707,55,25,7,80
2476,-17.79074999999885,2703.0833333333335,35,27,4,62
2477,-10.362749999998325,2667.1176470588234,45,35,6,80
2478,-18.14324999999898,2952.0526315789475,54,16,11,70
2479,-28.624499999999436,1952.1052631578948,23,27,4,50
2480,-22.99699999999951,2115.55,24,23,2,47
2481,-12.679749999997052,3727.1666666666665,77,26,2,103
2482,-4.77099999999834,3152.05,52,28,2,80
2483,-26.59674999999831,3056.0555555555557,44,42,1,86
2484,-17.710999999998222,2874.4117647058824,76,29,10,105
2485,-2.02024999999738,4460.8,70,40,0,110
2486,-13.557749999998657,2520.25,44,27,2,71
2487,-3.603249999998033,3929.9,64,32,1,96
2488,-17.521499999998337,2512.5789473684213,36,27,6,63
2489,-20.509999999997696,4074.35,59,34,8,93
2490,-14.482499999998542,2480.6875,49,25,12,74
2491,9.996500000004406,5540.2,115,17,6,132
2492,-1.3689999999984788,3068.0,48,21,6,69
2493,-16.148499999998428,3008.7894736842104,33,44,7,77
2494,-12.746999999997783,4662.210526315789,89,43,3,132
2495,-14.11399999999872,3246.157894736842,65,21,1,86
2496,-27.648999999998914,2937.0555555555557,51,48,3,99
2497,-24.725999999996855,3121.3888888888887,59,35,10,94
2498,-30.39074999999941,2008.45,22,23,4,45
2499,-16.50524999999861,3380.7,43,35,3,78
2500,-2.9279999999983115,3598.7894736842104,55,32,5,87
2501,-28.97174999999936,2377.9444444444443,43,23,18,66
2502,-27.555499999997362,3692.2631578947367,83,17,4,100
2503,-17.10199999999821,3184.9444444444443,56,31,4,87
2504,-36.173999999998784,2506.6666666666665,42,19,16,61
2505,-12.765249999999288,2366.5,48,37,13,85
2506,-29.992499999999268,2008.4,27,16,3,43
2507,4.428000000002565,4668.05,86,26,1,112
2508,-19.19224999999863,2038.9473684210527,28,18,10,46
2509,-32.207249999999604,1429.0,2,38,1,40
2510,-24.944249999999666,1897.3333333333333,20,24,10,44
2511,-22.066499999998786,1963.1176470588234,42,26,4,68
2512,-11.964249999998737,2714.05,38,26,4,64
2513,-19.058499999998766,2714.0,42,24,3,66
2514,-9.225499999998377,3213.95,47,28,1,75
2515,-19.64174999999938,2088.6,29,19,3,48
2516,-20.158499999997535,2298.3529411764707,57,18,6,75
2517,-4.377249999998009,3388.2631578947367,65,28,8,93
2518,-15.512749999997576,2874.3888888888887,51,35,8,86
2519,-37.95374999999759,2896.4375,43,30,11,73
2520,-13.591999999998368,2650.470588235294,40,25,5,65
2521,-24.24149999999809,2094.8333333333335,45,19,11,64
2522,-39.15900000000009,2047.2777777777778,30,28,26,58
2523,-0.9307499999977221,4107.8,79,16,2,95
2524,-16.57649999999806,2442.235294117647,50,38,3,88
2525,7.835750000002619,4487.526315789473,97,23,6,120
2526,-20.06824999999881,2714.8,40,22,2,62
2527,-28.35899999999869,2591.0666666666666,42,29,1,71
2528,-20.317499999998496,3037.315789473684,51,34,5,85
2529,-25.401999999999603,2311.6,20,30,5,50
2530,-35.34524999999841,2323.6470588235293,33,43,9,76
2531,-16.436249999997074,2916.25,91,25,8,116
2532,-24.13324999999866,2705.0555555555557,45,36,9,81
2533,-27.862499999998676,2629.0666666666666,40,21,2,61
2534,-25.245999999998723,2259.4375,36,32,10,68
2535,-33.060749999997526,2038.8947368421052,27,25,15,52
2536,-27.549249999997848,1959.0,52,23,6,75
2537,-20.703999999998096,3298.0,57,30,10,87
2538,-18.508749999998752,2692.55,38,32,1,70
2539,-41.483499999999154,2947.1052631578946,47,36,5,83
2540,-20.978249999998404,2935.315789473684,47,27,3,74
2541,-16.570749999997076,2123.9444444444443,63,19,9,82
2542,-16.06124999999748,2451.9375,88,31,17,119
2543,-25.959249999998963,2868.4736842105262,47,25,6,72
2544,-7.44624999999841,4063.2,58,40,1,98
2545,-29.289249999999335,2221.0526315789475,27,21,14,48
2546,3.4075000000028552,4557.7,81,30,1,111
2547,-6.7667499999978515,4218.8,67,38,2,105
2548,-37.46149999999981,1921.9473684210527,12,27,14,39
2549,-17.93174999999804,3471.6315789473683,56,31,5,87
2550,-11.671749999998365,3501.95,60,24,2,84
2551,-15.916999999998314,2949.3888888888887,59,13,6,72
2552,-18.528499999998456,2933.470588235294,55,27,2,82
2553,-6.9317499999960095,4415.736842105263,85,33,9,118
2554,-32.99949999999887,2286.125,55,45,2,100
2555,-34.65249999999992,1959.578947368421,24,18,15,42
2556,0.432500000002061,3593.45,77,10,5,87
2557,-20.42274999999894,2134.375,35,30,3,65
2558,-13.73199999999743,3515.55,52,28,8,80
2559,-1.2927499999983045,3119.6,65,14,1,79
2560,-8.73524999999864,2610.235294117647,52,27,10,79
2561,-39.27499999999901,2295.1875,56,35,20,91
2562,-28.343249999998285,2622.1666666666665,39,49,3,88
2563,12.86900000000214,3695.0,65,29,1,94
2564,-29.181249999998833,2334.705882352941,37,28,12,65
2565,-15.929499999998779,2508.6,36,21,4,57
2566,-16.4289999999986,2534.3125,49,28,4,77
2567,-19.603249999998646,2562.4666666666667,37,18,11,55
2568,-31.162249999998192,3123.9444444444443,60,41,9,101
2569,-33.68899999999935,1997.157894736842,25,22,3,47
2570,-16.371749999998478,3500.5,42,42,1,84
2571,-33.63349999999924,2725.214285714286,35,29,2,64
2572,6.509500000002842,4207.65,86,22,1,108
2573,-3.0247499999983383,3471.0,69,23,0,92
2574,-30.530499999997584,3413.157894736842,57,29,9,86
2575,-25.31699999999882,2923.7368421052633,46,33,5,79
2576,-0.8897499999983509,2764.294117647059,61,26,5,87
2577,-31.228749999999195,2332.0,32,33,8,65
2578,-6.804249999998701,3072.315789473684,58,22,10,80
2579,-37.487749999999075,1429.0,39,36,2,75
2580,-16.901499999997778,2995.705882352941,83,32,4,115
2581,-24.218999999999305,2482.777777777778,58,22,16,80
2582,-13.545499999995608,3088.4117647058824,78,25,15,103
2583,-24.912999999998593,2318.0555555555557,27,32,6,59
2584,-18.48149999999834,2990.9444444444443,58,30,6,88
2585,-6.2902499999961154,2551.3529411764707,61,40,14,101
2586,-4.561499999998477,3010.5789473684213,53,22,9,75
2587,-17.013249999998745,2471.0588235294117,39,23,4,62
2588,-3.730749999997601,3964.75,61,32,2,93
2589,-8.704499999998234,2531.3333333333335,46,26,2,72
2590,-11.154249999998031,3003.0526315789475,53,24,2,77
2591,-16.512499999997125,4903.75,75,42,3,117
2592,-6.047499999998861,2713.9444444444443,59,33,15,92
2593,-14.318749999997886,3327.65,53,28,2,81
2594,-17.624749999999302,2566.8947368421054,35,22,8,57
2595,3.8367500000017314,2362.4,80,23,5,103
2596,-22.782499999998855,3043.157894736842,45,35,6,80
2597,-14.771249999998616,2524.4,46,14,3,60
2598,-4.623249999997636,3930.75,75,22,1,97
2599,-13.019499999999093,3032.2105263157896,51,31,10,82
2600,3.4687500000019136,3852.6315789473683,73,44,5,117
2601,-13.980999999998321,2544.8823529411766,39,27,8,66
2602,-28.018249999999448,2024.2777777777778,35,24,4,59
2603,-18.520999999999084,2722.8,36,29,1,65
2604,-40.304249999998454,3065.55,28,38,4,66
2605,-32.1699999999984,3193.4736842105262,43,36,7,79
2606,-29.697499999999735,1997.1052631578948,24,24,12,48
2607,-31.667749999998485,3399.0,46,42,9,88
2608,16.85025000000424,3054.25,105,16,2,121
2609,-21.208249999997904,3162.5789473684213,52,29,5,81
2610,-28.074249999998404,3177.5263157894738,50,31,2,81
2611,-12.048749999997515,3639.684210526316,72,24,4,96
2612,-25.98524999999767,2067.875,55,24,4,79
2613,-12.022249999996522,3431.777777777778,87,23,2,110
2614,-11.875749999997065,4343.35,74,31,2,105
2615,-16.999999999998277,3735.35,60,27,2,87
2616,-13.818999999999093,2825.1052631578946,29,44,2,73
2617,-15.834499999998112,3049.7894736842104,51,26,4,77
2618,-28.67424999999958,1429.0,18,35,1,53
2619,-16.832749999998974,2455.3,27,31,4,58
2620,3.0220000000027176,3933.05,80,11,5,91
2621,-9.767999999998459,3003.0526315789475,50,30,5,80
2622,-21.92099999999842,2505.3333333333335,29,38,1,67
2623,-21.655499999998693,3087.15,43,30,1,73
2624,-16.86574999999778,3258.6315789473683,67,25,0,92
2625,-33.26399999999889,2653.7,40,19,5,59
2626,-16.46874999999867,2802.222222222222,46,32,8,78
2627,-13.536249999996633,2703.3888888888887,52,31,16,83
2628,-29.45774999999918,2101.45,18,27,5,45
2629,-12.663249999998092,2881.0526315789475,52,16,9,68
2630,-8.215499999998276,3230.2105263157896,64,23,8,87
2631,-23.9997499999988,2039.2777777777778,40,16,5,56
2632,-28.79124999999965,1925.5555555555557,25,26,13,51
2633,-21.43974999999826,2929.8888888888887,55,25,0,80
2634,-21.953499999999973,1897.3333333333333,31,32,1,63
2635,-27.51174999999871,3035.5789473684213,38,37,5,75
2636,12.154500000002532,2217.4666666666667,74,18,6,92
2637,-17.96549999999788,3843.25,66,28,1,94
2638,-12.941499999997927,4008.4,63,32,4,95
2639,-36.91674999999963,2122.277777777778,24,22,24,46
2640,-26.774499999999183,2142.6,25,25,1,50
2641,-25.670999999996916,2496.625,79,34,5,113
2642,-0.9122499999969232,2691.0,80,28,5,108
2643,-8.740999999998568,2583.0,76,30,7,106
2644,-2.2119999999978694,2795.235294117647,72,29,9,101
2645,-15.71924999999799,2574.705882352941,49,29,10,78
2646,-34.188499999999046,1981.0555555555557,30,19,0,49
2647,3.9677500000039907,2602.5,94,23,2,117
2648,-21.547999999999075,2281.5,28,22,4,50
2649,-11.266749999997455,2904.3529411764707,70,42,11,112
2650,-26.815749999999333,1804.0625,34,35,1,69
2651,-23.60899999999753,4163.3,64,34,1,98
2652,-35.104999999999784,2298.7894736842104,24,45,12,69
2653,-17.922999999998318,3185.157894736842,60,24,2,84
2654,-10.427499999996623,2383.294117647059,83,24,1,107
2655,-13.439499999999493,2500.0526315789475,42,20,20,62
2656,-36.15324999999954,1496.5,19,42,19,61
2657,-17.347249999998667,2508.45,41,17,3,58
2658,7.740250000004069,2787.4375,108,12,3,120
2659,3.35225000000111,3234.7,51,33,0,84
2660,-37.75274999999802,2498.294117647059,42,39,12,81
2661,0.37650000000277667,2762.5,83,21,2,104
2662,-38.2929999999983,3370.0555555555557,52,46,14,98
2663,-13.628999999998706,2219.75,46,31,5,77
2664,-37.80124999999885,2012.7777777777778,29,17,6,46
2665,0.5792500000032414,3143.235294117647,84,21,3,105
2666,-24.765999999998595,2198.4117647058824,39,29,3,68
2667,-25.23874999999949,1857.5882352941176,31,27,5,58
2668,-11.61174999999909,2615.6875,48,29,12,77
2669,-17.790999999998842,2487.7368421052633,41,22,6,63
2670,-20.766999999999168,2005.1176470588234,39,24,9,63
2671,-20.22924999999905,2156.9,28,27,1,55
2672,-22.62824999999843,3214.5263157894738,49,32,5,81
2673,-23.421249999998444,2679.6111111111113,49,19,6,68
2674,-27.787749999999665,2102.4736842105262,23,23,32,46
2675,-21.29224999999871,2929.1111111111113,58,34,3,92
2676,-9.788999999998108,3605.2631578947367,84,18,2,102
2677,-22.22924999999534,2777.3125,83,33,5,116
2678,-38.69574999999941,1790.4117647058824,22,38,3,60
2679,-14.693749999998797,2528.25,31,27,2,58
2680,-16.918249999999396,2649.076923076923,36,34,2,70
2681,3.8990000000027636,3363.8125,93,13,1,106
2682,-11.139999999998782,2536.45,34,31,3,65
2683,-15.493499999997383,4098.2,67,27,3,94
2684,-24.598249999998618,3341.6666666666665,51,46,14,97
2685,-20.44024999999949,2008.5,21,26,4,47
2686,-25.345249999997872,3825.85,55,33,2,88
2687,-14.745999999997078,2280.8333333333335,64,21,5,85
2688,-22.314499999998688,3386.6315789473683,48,40,16,88
2689,-17.215749999999453,2487.823529411765,57,41,6,98
2690,-25.5712499999998,1967.0526315789473,21,27,8,48
2691,-24.78449999999812,2160.0555555555557,34,29,7,63
2692,-31.265749999999862,2092.4210526315787,30,26,17,56
2693,-25.127749999997086,3159.315789473684,54,28,7,82
2694,-31.56199999999876,2294.1111111111113,29,25,5,54
2695,-31.13499999999944,2726.1176470588234,42,22,25,64
2696,-23.010499999998874,2548.15,35,24,1,59
2697,-6.9249999999983505,3416.45,53,28,2,81
2698,-15.475999999998981,2666.375,34,22,4,56
2699,-27.751499999998526,2913.1666666666665,52,34,13,86
2700,-12.706749999998781,2672.5555555555557,38,22,3,60
2701,-23.056749999998363,2561.842105263158,37,29,4,66
2702,-10.572999999998512,2703.3888888888887,57,26,3,83
2703,-32.554749999999494,2024.35,21,20,6,41
2704,-17.049499999998638,2748.15,48,20,0,68
2705,-34.24674999999954,2151.222222222222,31,29,13,60
2706,-2.24724999999806,3599.75,58,24,6,82
2707,-34.06374999999897,1862.3529411764705,49,30,13,79
2708,-32.189249999998715,2498.9,21,33,5,54
2709,-36.96024999999981,1429.0,9,36,7,45
2710,-1.3039999999979168,4337.8,72,31,2,103
2711,-18.36599999999749,2738.1176470588234,67,38,3,105
2712,-8.428499999998511,2726.5263157894738,52,19,7,71
2713,-11.197999999998995,2621.2,35,23,4,58
2714,-25.691999999998796,2664.3529411764707,49,33,4,82
2715,-23.340749999998657,2509.4375,35,32,3,67
2716,-24.943749999998577,3130.842105263158,44,37,13,81
2717,-20.33149999999747,2308.3333333333335,40,31,8,71
2718,-31.72499999999719,4335.526315789473,77,36,4,113
2719,-29.212249999998754,3201.842105263158,34,49,9,83
2720,-41.233749999999276,2675.0555555555557,41,36,14,77
2721,4.491000000003032,4626.05,83,25,2,108
2722,-13.41424999999766,3804.4,60,31,4,91
2723,-14.298999999998912,2601.9411764705883,34,26,3,60
2724,-5.605499999998728,2761.6315789473683,53,16,3,69
2725,-17.54549999999794,3013.842105263158,50,27,5,77
2726,-24.20599999999953,2028.3,23,23,4,46
2727,-40.35674999999884,2931.8333333333335,38,50,1,88
2728,-47.22824999999934,2275.5555555555557,21,44,11,65
2729,-0.4594999999963207,3223.6666666666665,83,19,7,102
2730,-10.03749999999879,2594.875,41,23,2,64
2731,-28.78149999999899,2710.235294117647,40,19,13,59
2732,-14.211249999998412,2727.222222222222,53,26,6,79
2733,-17.613499999998943,2415.7368421052633,30,31,2,61
2734,-11.73224999999798,3512.5,51,31,3,82
2735,-19.116499999997433,3128.5714285714284,76,20,5,96
2736,10.102500000002417,4012.2631578947367,88,22,4,110
2737,-25.13549999999886,2548.15,30,17,9,47
2738,-15.888999999997399,4008.45,62,34,5,96
2739,-26.34075000000026,2094.777777777778,29,24,32,53
2740,-17.952749999998932,2616.8823529411766,39,18,6,57
2741,-24.99799999999948,2145.7894736842104,28,25,4,53
2742,9.102500000002625,4099.7,82,19,1,101
2743,-23.48824999999774,3160.5384615384614,58,29,4,87
2744,-24.206249999999088,2277.823529411765,32,22,14,54
2745,-23.238499999999185,2445.1666666666665,37,26,4,63
2746,-5.750999999997651,3996.6,60,32,5,92
2747,-0.38674999999823745,3645.1666666666665,69,27,4,96
2748,-30.799249999999148,2090.4444444444443,31,28,5,59
2749,-25.608749999999514,2103.7,21,25,4,46
2750,-10.966999999999208,2762.4444444444443,42,43,6,85
2751,-14.887999999998806,2500.5625,46,30,5,76
2752,-37.166249999998236,2631.0555555555557,34,37,8,71
2753,-19.004749999998374,2910.5,66,20,10,86
2754,-28.92974999999924,2106.8,27,23,0,50
2755,-14.0422499999974,4024.35,65,28,2,93
2756,-13.619999999998836,2588.764705882353,45,38,3,83
2757,10.40375000000275,4925.95,92,29,5,121
2758,-20.724749999999464,2024.25,28,23,1,51
2759,-28.55274999999973,1429.0,4,32,10,36
2760,-30.367999999997966,3354.0555555555557,63,26,13,89
2761,-9.326249999998492,3119.55,51,25,0,76
2762,-7.4319999999978235,3925.15,61,33,1,94
2763,-14.29674999999832,3333.8333333333335,59,42,9,101
2764,-21.351999999999,2755.3,29,35,1,64
2765,6.491750000002365,3431.777777777778,72,24,5,96
2766,-33.75524999999818,2093.823529411765,44,24,2,68
2767,-34.963249999998425,3652.8947368421054,50,41,10,91
2768,-10.855749999997972,3515.1052631578946,66,23,4,89
2769,-11.59524999999881,2882.3,42,23,7,65
2770,11.733500000002904,4288.7,83,26,1,109
2771,-20.108999999998332,1916.125,50,29,6,79
2772,-23.26924999999952,2032.3,22,22,4,44
2773,-11.830749999997122,4773.45,65,42,3,107
2774,6.837750000002815,4498.95,93,21,0,114
2775,-6.255999999997502,2551.470588235294,68,31,6,99
2776,-3.837749999998222,3635.4,67,17,5,84
2777,-15.395249999997706,3516.0,65,25,5,90
2778,2.8837500000020158,3953.75,70,27,3,97
2779,-24.163499999998884,2496.1666666666665,46,22,10,68
2780,-27.468749999998625,1429.0,34,36,8,70
2781,-14.994999999998324,3111.7368421052633,49,32,1,81
2782,-4.635249999998568,3043.9473684210525,48,27,5,75
2783,-1.6327499999976578,3528.4,58,23,3,81
2784,-21.995499999997897,3306.85,67,11,4,78
2785,-28.867999999999206,2714.777777777778,40,52,3,92
2786,-24.219499999998753,2089.235294117647,33,30,8,63
2787,-4.964499999997966,4557.7,79,31,4,110
2788,-20.168249999999507,2112.45,21,29,5,50
2789,-38.50474999999863,2743.9444444444443,37,42,14,79
2790,-28.40099999999863,2604.55,38,24,2,62
2791,-32.57274999999764,2745.529411764706,67,24,13,91
2792,-6.754999999998904,2544.25,42,22,1,64
2793,-7.391499999998328,3131.55,56,24,0,80
2794,-27.82774999999856,3011.6,29,40,3,69
2795,-18.803749999998207,3302.157894736842,59,27,6,86
2796,7.906250000002311,2955.6875,79,23,10,102
2797,-3.3257499999981563,4030.529411764706,70,21,2,91
2798,-16.649499999998433,2678.866666666667,44,22,5,66
2799,-10.529999999998859,2533.866666666667,37,23,2,60
2800,-28.445499999999992,2150.0526315789475,25,29,11,54
2801,-14.85699999999863,2607.1052631578946,42,20,4,62
2802,-15.75774999999829,3718.9473684210525,81,31,11,112
2803,-12.332999999997764,3936.25,62,30,2,92
2804,-42.137749999999116,1744.6470588235295,27,43,23,70
2805,-4.331999999997317,2331.875,59,25,5,84
2806,-21.726249999997428,4214.75,71,34,0,105
2807,-13.936249999998754,2333.8888888888887,41,33,5,74
2808,-19.261749999997683,3525.9473684210525,63,24,2,87
2809,-22.81924999999838,2585.5,47,18,0,65
2810,-20.959249999998995,2198.85,27,21,4,48
2811,-22.50974999999898,2508.5,37,15,8,52
2812,-16.144249999998266,2490.2631578947367,34,20,12,54
2813,10.668250000003377,4060.7368421052633,97,15,2,112
2814,-24.030499999998764,2548.15,46,17,1,63
2815,-7.101999999997825,3998.85,58,39,3,97
2816,-5.064499999998752,3083.85,52,21,3,73
2817,-19.471749999999155,2111.5263157894738,24,29,1,53
2818,-30.2542499999988,2038.8947368421052,25,21,7,46
2819,-17.173749999998854,2867.684210526316,53,31,2,84
2820,-24.758749999998262,4198.9,62,37,3,99
2821,-32.71674999999936,2324.5789473684213,19,42,0,61
2822,-11.809749999999173,2633.529411764706,40,22,3,62
2823,-3.044999999998474,2323.8125,52,29,6,81
2824,-9.99524999999788,3274.722222222222,61,30,10,91
2825,-5.322749999997749,3778.3,65,32,1,97
2826,-8.899499999997861,3873.45,68,22,3,90
2827,2.9482500000025853,4319.65,84,29,1,113
2828,-9.933999999997896,4533.526315789473,78,41,2,119
2829,-7.0489999999985695,3198.95,44,33,5,77
2830,-55.56349999999975,1429.0,8,44,21,52
2831,-21.009249999997458,1993.1176470588234,42,23,18,65
2832,-18.75999999999793,2972.3888888888887,67,18,5,85
2833,-11.731499999997238,2585.8125,61,38,3,99
2834,-10.431999999997897,3875.85,57,34,4,91
2835,-24.541999999997497,2360.625,52,31,11,83
2836,-29.808749999997662,2469.294117647059,52,26,6,78
2837,6.017250000002296,2362.625,68,31,2,99
2838,-10.885499999999007,1933.4444444444443,54,20,8,74
2839,-13.322749999998162,2881.3333333333335,43,33,4,76
2840,-49.322000000000294,1944.8333333333333,34,41,12,75
2841,6.093250000001986,3583.7894736842104,72,31,7,103
2842,7.542250000002878,4203.7,79,29,2,108
2843,-6.172499999997217,4114.8,75,24,1,99
2844,-25.853249999997054,3617.8947368421054,60,28,5,88
2845,6.0272500000033045,4854.315789473684,119,22,8,141
2846,-15.491749999997529,3820.8947368421054,71,32,4,103
2847,11.72150000000233,4671.15,86,30,2,116
2848,-22.422999999999988,1967.0526315789473,15,31,6,46
2849,-9.841499999998401,3162.777777777778,56,28,5,84
2850,-14.69274999999833,2609.9444444444443,55,25,4,80
2851,-4.771749999998282,2518.0,61,30,8,91
2852,-24.798749999999256,1949.2777777777778,32,16,4,48
2853,-21.184499999998508,3282.842105263158,52,29,7,81
2854,-35.54675000000002,1429.0,24,20,25,44
2855,-22.04999999999847,3489.9444444444443,66,36,4,102
2856,-20.35449999999868,2616.5625,73,43,4,116
2857,-14.201749999997338,3948.0,61,30,3,91
2858,2.1522500000022395,4671.1,79,33,2,112
2859,-15.921749999998758,2532.684210526316,42,22,7,64
2860,-7.261249999998304,3349.722222222222,72,32,2,104
2861,-11.347749999998943,2826.133333333333,39,20,7,59
2862,-18.45974999999719,3328.6666666666665,62,36,7,98
2863,-12.510999999999068,2668.1666666666665,36,16,8,52
2864,-0.002999999998144087,3514.2105263157896,68,23,6,91
2865,-3.15049999999722,3839.55,69,20,7,89
2866,-9.752999999998277,3175.0555555555557,57,31,7,88
2867,-18.829999999998474,2803.25,45,30,8,75
2868,-14.704999999998261,2316.176470588235,43,34,5,77
2869,-22.736999999998556,2670.3,46,18,2,64
2870,-11.723499999998078,2420.0625,61,23,5,84
2871,-9.059999999997974,3711.4736842105262,63,32,3,95
2872,3.8872500000021626,3163.6111111111113,70,27,7,97
2873,-12.946749999997763,1891.3125,48,21,10,69
2874,-25.409999999999467,2052.1,27,22,1,49
2875,-8.618499999998104,4175.85,63,36,3,99
2876,-31.314499999999146,2133.75,26,24,2,50
2877,-18.845749999998667,2583.85,39,25,1,64
2878,-5.06074999999856,2348.6875,68,22,6,90
2879,-36.34149999999933,1933.4444444444443,26,37,19,63
2880,-21.111499999997424,3952.0,71,32,3,103
2881,2.8567500000007917,3082.5789473684213,61,21,24,82
2882,-25.412999999999336,2180.65,23,22,4,45
2883,-12.91474999999799,3271.15,58,14,6,72
2884,-13.992749999998676,2560.0,39,24,4,63
2885,-3.1877499999981,4459.3,75,39,1,114
2886,-17.073249999998527,3310.3684210526317,43,35,12,78
2887,-43.957249999996804,2115.222222222222,35,26,19,61
2888,-16.363499999998957,2597.7894736842104,40,30,1,70
2889,-10.714249999997206,3733.2105263157896,68,30,6,98
2890,-22.3809999999984,3565.2105263157896,56,32,1,88
2891,-12.414749999998161,3008.5,51,22,3,73
2892,-2.944249999997353,2997.764705882353,70,29,4,99
2893,-11.78099999999748,2973.6315789473683,62,14,11,76
2894,-20.02374999999813,3004.777777777778,57,33,15,90
2895,5.880500000003272,5109.95,100,26,2,126
2896,3.663000000004041,5940.3,117,26,0,143
2897,-9.986749999997617,3623.45,58,26,2,84
2898,-17.58074999999878,2784.55,41,22,3,63
2899,-25.919499999998855,2856.7894736842104,35,40,4,75
2900,-22.72474999999841,2555.0588235294117,42,34,6,76
2901,-25.098749999999065,2391.133333333333,43,36,6,79
2902,-31.097499999999958,1429.0,0,31,6,31
2903,-2.575999999997078,4510.0526315789475,101,20,6,121
2904,-2.4854999999984893,3119.5555555555557,72,15,1,87
2905,-19.349999999998865,2875.1052631578946,45,25,14,70
2906,7.522000000003823,2421.375,87,23,4,110
2907,-30.29049999999909,2679.85,39,23,2,62
2908,-9.384999999998715,2842.6,38,31,1,69
2909,-21.03899999999934,2187.5,31,31,5,62
2910,-24.528249999998867,2533.5789473684213,25,34,7,59
2911,-21.25874999999869,2846.1111111111113,47,39,7,86
2912,-20.17274999999878,2984.6315789473683,56,27,10,83
2913,-3.542499999997849,3403.5,83,33,6,116
2914,-19.772749999999505,2389.277777777778,43,35,3,78
2915,-8.433749999998128,2467.133333333333,66,30,2,96
2916,-26.278499999999518,2215.6111111111113,23,40,12,63
2917,-22.11799999999726,2631.1111111111113,49,27,5,76
2918,11.23600000000378,3100.3529411764707,88,22,3,110
2919,-18.929249999999307,2048.1,29,18,2,47
2920,-8.186249999997951,2945.529411764706,56,32,5,88
2921,-15.258249999997853,2177.0625,55,33,6,88
2922,-26.71399999999848,1929.9444444444443,25,29,9,54
2923,-15.087249999999225,2525.2631578947367,32,28,10,60
2924,-26.91999999999893,2477.5263157894738,32,34,3,66
2925,-31.852749999999475,2564.4736842105262,42,18,19,60
2926,4.170250000002062,3942.0,80,34,1,114
2927,-0.9272499999973236,3251.8333333333335,68,20,12,88
2928,3.094000000002038,3937.15,67,20,5,87
2929,-27.1139999999995,2028.25,24,22,4,46
2930,-1.8764999999963123,2787.1666666666665,71,29,7,100
2931,-0.20899999999721963,4677.5,88,24,2,112
2932,-28.04674999999948,2127.5,26,21,5,47
2933,-43.78099999999825,2649.0,46,35,11,81
2934,-9.35674999999885,3115.55,56,22,2,78
2935,-14.189749999998458,2561.705882352941,52,23,3,75
2936,-15.658749999998397,3868.75,56,36,1,92
2937,-0.8234999999980364,3399.1111111111113,75,24,3,99
2938,-14.573749999998096,2805.6666666666665,44,31,6,75
2939,-7.36874999999843,3352.2631578947367,72,27,17,99
2940,-25.702249999995324,1572.8235294117646,70,33,8,103
2941,-23.229749999998983,2076.3888888888887,36,22,13,58
2942,-12.45799999999779,3401.4,48,35,0,83
2943,0.9567500000011753,3091.85,60,17,1,77
2944,-12.630499999998728,2597.0588235294117,50,36,1,86
2945,-18.438249999997065,3278.7368421052633,65,26,5,91
2946,-26.89249999999874,3556.0,42,45,3,87
2947,-5.273749999998918,2578.1666666666665,60,22,15,82
2948,-22.052999999999102,2669.5789473684213,37,25,9,62
2949,-15.770999999998361,2475.823529411765,48,38,5,86
2950,-12.167999999998042,3252.9,46,31,2,77
2951,-17.065749999998562,3252.9,52,26,2,78
2952,-9.162499999996951,3156.4117647058824,86,20,1,106
2953,7.711750000002178,4180.105263157895,89,23,4,112
2954,-26.973499999999785,1429.0,10,32,6,42
2955,-36.24974999999892,2044.5555555555557,25,36,7,61
2956,-0.46499999999727065,4484.65,80,30,0,110
2957,-22.381499999997555,3444.176470588235,66,42,3,108
2958,-30.84174999999899,2052.5,43,26,8,69
2959,-12.77574999999754,4374.4,74,33,1,107
2960,-14.788499999998416,2506.8333333333335,43,21,4,64
2961,-19.98699999999776,3317.15,57,17,8,74
2962,-2.394999999997828,4121.2,70,26,5,96
2963,-23.556999999997963,3664.05,51,39,0,90
2964,-32.10724999999916,1429.0,20,38,10,58
2965,5.034500000003464,4369.736842105263,91,22,3,113
2966,-12.482499999997598,3950.5,75,19,3,94
2967,-25.075749999998955,2555.222222222222,42,29,5,71
2968,-24.23524999999804,3444.9444444444443,66,28,10,94
2969,-27.833999999999566,1736.235294117647,25,38,26,63
2970,-37.37324999999914,2708.1052631578946,38,30,6,68
2971,-17.283749999998243,2616.0,54,24,6,78
2972,-0.494499999998293,3480.9473684210525,53,26,10,79
2973,-7.6672499999984,3340.15,43,33,8,76
2974,-8.573499999998056,2782.9411764705883,56,26,1,82
2975,-6.324999999996972,4268.666666666667,108,30,0,138
2976,14.130500000004115,5179.15,110,19,0,129
2977,-23.464999999998557,2225.3888888888887,30,27,8,57
2978,-26.46599999999851,2836.842105263158,33,38,5,71
2979,15.133250000002008,3836.7368421052633,84,34,9,118
2980,4.986250000001962,3576.157894736842,65,32,10,97
2981,-5.751999999997935,3560.05,57,29,4,86
2982,-17.056249999998478,2187.7368421052633,35,24,5,59
2983,-9.891749999998476,2237.6875,45,34,2,79
2984,-12.817499999998034,3571.25,57,28,3,85
2985,-20.56774999999827,1481.9333333333334,49,34,3,83
2986,-16.126249999998045,3523.4736842105262,77,31,12,108
2987,-3.0569999999985047,2841.8888888888887,49,36,1,85
2988,-9.85274999999754,4088.45,59,42,3,101
2989,-8.207499999998161,3678.0,63,37,2,100
2990,-7.254999999996592,2421.0833333333335,82,17,4,99
2991,-4.170749999998051,3421.25,57,23,3,80
2992,-19.285749999998465,2577.9375,45,17,8,62
2993,-12.261499999998884,1921.1176470588234,47,26,5,73
2994,-1.6662499999972844,4979.9,81,43,3,124
2995,-14.063999999997256,3725.1176470588234,66,27,1,93
2996,-30.789999999999303,2143.3333333333335,24,32,3,56
2997,-24.231749999999074,1840.8235294117646,37,31,5,68
2998,-23.206749999998443,2084.9473684210525,25,26,17,51
2999,-29.985749999999335,2453.2631578947367,33,26,19,59
3000,-22.775999999998756,2762.6153846153848,44,27,9,71
3001,-6.581249999997489,2689.222222222222,61,25,4,86
3002,-37.300749999997855,1942.9375,52,25,9,77
3003,-8.007499999996016,2430.2,86,22,2,108
3004,-13.89349999999828,3247.7368421052633,55,27,3,82
3005,-17.183249999998203,2748.866666666667,48,23,7,71
3006,-21.934249999998766,2679.25,48,27,2,75
3007,23.3957500000023,4446.55,92,24,0,116
3008,-6.807749999998444,3194.315789473684,49,29,6,78
3009,-12.076749999999137,2429.842105263158,43,15,6,58
3010,-9.368999999997419,4738.6,76,40,0,116
3011,-17.889249999998363,2753.7,43,29,1,72
3012,-10.381249999998172,2041.1875,78,23,9,101
3013,-25.113249999998295,3200.65,46,29,3,75
3014,-22.381999999997436,2110.4666666666667,80,24,5,104
3015,-11.7799999999975,3558.5789473684213,68,24,1,92
3016,-5.213749999997497,4866.4,71,42,2,113
3017,13.333750000003187,4958.4,95,32,3,127
3018,-11.928499999998357,3398.9,60,24,2,84
3019,-13.506249999998323,3802.1,58,34,2,92
3020,1.9575000000044778,3762.5,87,33,8,120
3021,-10.966749999997049,4202.95,70,26,6,96
3022,-18.99824999999848,3207.684210526316,59,22,3,81
3023,-1.6667499999982955,3325.85,54,30,2,84
3024,-20.01449999999932,2498.9,19,38,4,57
3025,-24.1147499999986,2726.176470588235,38,24,4,62
3026,-23.917999999998408,2608.222222222222,42,30,10,72
3027,-27.505499999998648,3001.35,33,35,5,68
3028,-20.960499999998937,2500.157894736842,38,25,2,63
3029,-14.354249999997341,2141.5555555555557,47,29,9,76
3030,-33.90799999999952,1429.0,21,39,5,60
3031,-14.264749999998418,1871.5,54,22,5,76
3032,-2.408749999998264,3091.85,50,17,9,67
3033,-22.72524999999948,1959.4736842105262,26,25,3,51
3034,-18.681499999997538,3464.3888888888887,57,40,5,97
3035,-7.713999999997904,4364.8,76,33,2,109
3036,-17.619999999998782,2214.5833333333335,50,23,5,73
3037,9.97425000000447,3564.8888888888887,103,19,6,122
3038,-22.71424999999915,2406.05,24,31,3,55
3039,-22.201999999998918,2532.25,35,18,7,53
3040,-26.870499999998458,2564.529411764706,39,29,5,68
3041,-23.288749999999325,2593.529411764706,36,22,22,58
3042,-20.804999999998508,2080.684210526316,23,27,10,50
3043,-45.64999999999827,1429.0,6,37,18,43
3044,-24.788249999999536,2124.35,25,25,0,50
3045,-11.823749999998912,2534.25,47,23,6,70
3046,-2.144749999995265,2922.1176470588234,85,31,8,116
3047,-0.27749999999784525,3670.35,64,26,2,90
3048,10.169000000003095,5089.45,96,26,1,122
3049,-12.776749999997914,2467.3529411764707,58,27,7,85
3050,-30.405999999999334,2493.4210526315787,36,27,17,63
3051,-21.570249999998126,2156.6666666666665,37,33,3,70
3052,-26.208999999998063,2429.0,65,40,6,105
3053,-11.659749999997782,4204.5,52,49,2,101
3054,-24.360999999999173,1621.5,30,32,26,62
3055,-26.309249999999587,1980.421052631579,20,32,2,52
3056,-5.036499999993789,2742.6875,118,18,8,136
3057,-10.45574999999877,2701.133333333333,41,22,3,63
3058,-14.500749999999092,2491.5625,37,37,6,74
3059,-19.478249999998187,3312.45,43,43,1,86
3060,-9.440749999997045,4012.0,94,31,4,125
3061,-15.285749999997341,1903.25,39,28,15,67
3062,-2.4962499999984042,2624.0555555555557,44,32,10,76
3063,-18.36024999999844,2610.176470588235,47,23,10,70
3064,-15.191749999998885,2871.9,34,32,4,66
3065,-10.839499999998276,2079.8823529411766,40,26,5,66
3066,-31.007999999998685,3435.4,46,37,4,83
3067,-3.4527499999975917,4925.9,81,39,3,120
3068,-1.9789999999970749,3284.470588235294,73,30,5,103
3069,-42.35824999999785,1438.5333333333333,36,51,8,87
3070,-13.791499999998953,2528.4,38,23,1,61
3071,1.9030000000024976,4221.15,70,30,5,100
3072,-2.2917499999964854,3511.1111111111113,89,17,6,106
3073,-11.759749999998187,2937.0526315789475,52,11,13,63
3074,-24.85599999999969,2052.1,19,25,4,44
3075,-19.418249999998512,2960.4736842105262,35,40,2,75
3076,-27.054499999999745,2054.7894736842104,22,30,10,52
3077,-2.5957499999962876,3843.705882352941,89,30,6,119
3078,-15.854749999998646,3113.3333333333335,58,38,5,96
3079,-3.9447499999967457,3905.315789473684,86,23,9,109
3080,-6.427749999998264,2855.8823529411766,61,29,3,90
3081,-24.962999999999443,2075.85,18,30,1,48
3082,-12.009499999999173,2562.1666666666665,58,34,16,92
3083,-16.159999999999208,2610.133333333333,41,20,4,61
3084,-10.820499999998809,3060.25,51,18,4,69
3085,-1.2234999999972556,4714.7,81,26,5,107
3086,-27.077249999997843,2573.6315789473683,38,32,14,70
3087,-21.248249999995632,2292.6666666666665,62,28,22,90
3088,-7.28424999999884,3081.6315789473683,57,18,6,75
3089,-8.017249999998182,3290.2,62,17,4,79
3090,-29.77124999999912,2118.3684210526317,21,34,3,55
3091,-9.605749999997366,3979.1,74,20,7,94
3092,-14.097749999998788,2548.2,47,14,2,61
3093,-12.047249999998263,3324.5789473684213,60,33,6,93
3094,-40.95274999999869,2223.75,38,34,10,72
3095,-6.75424999999819,3529.0,58,31,1,89
3096,-0.6029999999977746,2293.6,74,32,3,106
3097,-8.43924999999846,2860.7,41,29,5,70
3098,-32.537499999998985,2718.1052631578946,25,43,6,68
3099,-23.88549999999703,3240.470588235294,59,41,9,100
3100,-6.375999999997475,3572.75,66,14,7,80
3101,-20.098999999998334,2425.0625,43,23,5,66
3102,-26.743749999997693,2270.3684210526317,33,33,9,66
3103,-19.52124999999791,2337.277777777778,40,28,7,68
3104,-43.9919999999997,1957.388888888889,28,24,17,52
3105,-8.639249999997771,3772.0,70,24,0,94
3106,9.18850000000153,3269.4736842105262,57,29,2,86
3107,-5.6472499999977295,3016.3888888888887,70,15,4,85
3108,-15.134749999999329,2597.842105263158,40,25,11,65
3109,-1.084999999998281,2817.5263157894738,53,24,3,77
3110,-29.424749999999335,2024.3,29,10,10,39
3111,-34.85249999999769,3742.65,51,32,6,83
3112,-16.29099999999853,2636.2631578947367,42,18,8,60
3113,-24.98599999999959,1997.157894736842,17,33,1,50
3114,-7.586749999998922,3193.5263157894738,55,26,9,81
3115,-9.429249999998287,3146.6,51,24,3,75
3116,-1.1069999999979743,3876.7,71,25,3,96
3117,-5.524749999997302,4174.3,71,28,0,99
3118,-12.316999999998224,2566.722222222222,42,23,3,65
3119,-18.208499999999102,2480.3888888888887,40,25,7,65
3120,-13.70699999999886,2555.95,43,7,13,50
3121,-28.151249999998292,3722.2631578947367,62,30,7,92
3122,-40.33524999999924,1429.0,18,30,7,48
3123,-8.664499999998863,2567.95,42,24,0,66
3124,-21.25899999999915,2373.5555555555557,24,46,2,70
3125,-6.41299999999737,4233.0,75,28,4,103
3126,-10.518499999997916,3200.6,55,23,2,78
3127,-19.01849999999935,2024.3,27,16,6,43
3128,-15.271499999998,3203.4444444444443,54,36,4,90
3129,-6.104499999998372,3132.4736842105262,55,25,5,80
3130,-2.382749999996617,4975.2,96,21,4,117
3131,-36.31074999999988,1429.0,3,36,5,39
3132,-15.729749999998006,2647.777777777778,49,31,6,80
3133,-12.99199999999747,4662.315789473684,81,44,6,125
3134,-28.896249999999366,2106.8,26,21,2,47
3135,-11.964749999998904,2589.6315789473683,42,20,6,62
3136,-38.13524999999903,2266.777777777778,31,33,7,64
3137,-10.445499999997939,3624.684210526316,63,31,1,94
3138,-26.465999999999536,1987.8947368421052,22,22,11,44
3139,-0.4682499999981509,3081.6,66,8,5,74
3140,1.8267500000023407,2991.5625,76,39,4,115
3141,10.902500000003428,4827.5,94,18,6,112
3142,-9.988749999998433,3455.842105263158,68,23,12,91
3143,-13.298999999997983,2514.375,77,40,11,117
3144,-28.600999999998685,2566.0,31,31,5,62
3145,-10.674499999998886,3091.65,50,25,2,75
3146,-8.479999999998373,2915.4210526315787,35,35,5,70
3147,-35.911749999999245,2008.35,20,25,3,45
3148,-26.995749999996814,1961.235294117647,78,16,7,94
3149,-20.60699999999836,2907.55,36,31,1,67
3150,-30.037499999999028,2751.866666666667,30,34,0,64
3151,-20.471499999998873,1872.4,57,25,8,82
3152,-24.863499999998567,2658.4444444444443,37,23,16,60
3153,-1.4499999999979238,4121.1,65,28,9,93
3154,-28.262749999998043,2619.5333333333333,44,26,11,70
3155,-17.503249999999117,2712.866666666667,42,26,10,68
3156,1.8647500000014503,3021.5263157894738,52,20,7,72
3157,-17.762249999998378,3269.4736842105262,58,27,8,85
3158,-37.974999999998765,1963.1764705882354,36,27,5,63
3159,-15.583749999997602,3380.777777777778,58,25,12,83
3160,-23.34574999999841,2605.315789473684,41,25,3,66
3161,-29.59799999999938,2132.3,24,22,6,46
3162,-12.45799999999877,3299.7,53,27,3,80
3163,-5.6042499999984745,3153.0,47,27,5,74
3164,-3.762749999996913,2661.3125,74,25,5,99
3165,-19.662999999999315,2668.3125,38,18,9,56
3166,-22.51449999999915,2092.5,24,26,2,50
3167,-32.979249999999446,2058.9473684210525,21,32,12,53
3168,-11.936249999998244,2436.222222222222,41,29,13,70
3169,-22.424749999998582,1912.764705882353,35,36,11,71
3170,-4.290999999997942,3718.7,66,24,3,90
3171,-19.576499999998983,2406.5882352941176,46,27,4,73
3172,-17.850499999998434,2495.9473684210525,42,18,8,60
3173,-17.209999999997365,4184.0,68,27,6,95
3174,-18.26199999999831,2094.75,49,28,7,77
3175,-17.196499999998444,2631.8333333333335,48,29,4,77
3176,-18.275249999999023,2387.0588235294117,52,29,2,81
3177,-14.134249999997607,3904.45,52,42,2,94
3178,-20.83899999999824,1951.8823529411766,45,25,9,70
3179,-28.52500000000014,1891.1764705882354,31,28,21,59
3180,-10.646999999997073,3018.9444444444443,65,40,8,105
3181,-22.431999999998137,2032.25,52,34,4,86
3182,-34.000249999998765,2524.2,33,19,8,52
3183,-23.569249999997968,3741.7,53,30,4,83
3184,-12.790249999998967,3201.9473684210525,58,27,19,85
3185,-19.96799999999666,2433.705882352941,78,18,15,96
3186,-3.9037499999969802,4291.210526315789,97,22,0,119
3187,-13.764749999998276,2536.25,54,28,0,82
3188,-15.011499999997904,2994.6315789473683,51,24,8,75
3189,-32.072499999998634,3530.2105263157896,58,34,11,92
3190,-31.247499999998343,2467.0,38,23,7,61
3191,-23.887249999998144,2694.8,52,26,7,78
3192,-17.512999999997263,3611.157894736842,67,37,6,104
3193,-28.177499999998552,2731.4210526315787,44,27,4,71
3194,-9.65649999999895,2556.0,39,26,3,65
3195,-17.8912499999983,2625.5,67,35,2,102
3196,-18.35274999999725,3895.2105263157896,65,34,4,99
3197,0.1180000000019568,3206.9,54,23,1,77
3198,-10.039499999997902,3591.75,61,23,4,84
3199,-8.904999999996974,4183.95,81,21,3,102
3200,1.1957500000030508,5171.15,87,43,1,130
3201,-12.769249999998998,2992.0526315789475,54,23,10,77
3202,-17.80999999999913,2196.875,42,38,5,80
3203,-9.220999999998686,3481.55,50,29,3,79
3204,15.883750000003179,4957.65,98,22,5,120
3205,-8.943749999998863,2964.294117647059,43,24,3,67
3206,2.033750000002251,4229.2,86,22,1,108
3207,-17.421249999999247,1946.3529411764705,57,40,10,97
3208,-23.61249999999884,2063.9411764705883,35,11,10,46
3209,0.42775000000262275,3064.0,89,19,8,108
3210,-22.980999999997888,3339.3,46,24,6,70
3211,-27.67824999999928,1612.5625,21,26,7,47
3212,-12.408499999997712,3752.85,52,34,8,86
3213,-13.51249999999799,2936.0555555555557,60,22,6,82
3214,0.2882500000029934,3737.176470588235,98,23,4,121
3215,-27.407999999997884,2118.722222222222,41,27,7,68
3216,-2.1299999999974837,4175.15,81,18,3,99
3217,-13.056999999998155,3933.15,60,33,5,93
3218,-10.997749999997769,3168.529411764706,71,42,2,113
3219,-17.176999999999207,2556.1,32,30,2,62
3220,-2.330249999997865,3824.157894736842,93,19,7,112
3221,-22.597999999998482,2638.842105263158,39,24,5,63
3222,-32.56799999999991,1429.0,0,33,2,33
3223,-36.569249999998625,2768.4375,69,56,2,125
3224,-0.586249999997631,4089.8947368421054,83,28,13,111
3225,-22.83149999999882,2925.05,30,38,2,68
3226,-23.782999999999305,2044.1,28,14,7,42
3227,-20.463749999998214,3407.75,47,33,5,80
3228,-17.51524999999863,2072.294117647059,47,31,4,78
3229,-7.882749999997861,3294.1666666666665,78,24,16,102
3230,-21.068249999998464,2228.6875,42,28,6,70
3231,-21.767499999997593,4227.45,66,40,0,106
3232,-18.080249999999815,2096.6315789473683,32,28,14,60
3233,-13.900499999997837,3709.3,59,27,3,86
3234,-16.69474999999901,3033.0,38,36,3,74
3235,-15.74699999999883,2698.157894736842,40,27,0,67
3236,-19.756249999998367,3651.315789473684,81,29,5,110
3237,-17.519499999998764,2532.3,39,21,2,60
3238,-22.060999999998117,3337.8,35,36,9,71
3239,-6.647749999998849,2495.733333333333,52,37,6,89
3240,-17.704249999996655,2418.705882352941,79,18,1,97
3241,-27.39224999999875,2831.684210526316,49,29,17,78
3242,-14.693499999998881,2509.4375,41,23,3,64
3243,-14.408499999998593,2485.9473684210525,36,28,3,64
3244,-1.942249999998419,3536.1052631578946,64,34,3,98
3245,-13.669499999997253,2722.294117647059,69,23,3,92
3246,-21.52899999999874,2457.6666666666665,43,42,2,85
3247,-14.62149999999852,3079.85,33,36,4,69
3248,-11.556249999998979,2643.5,41,28,6,69
3249,-17.51824999999875,2651.4210526315787,44,21,8,65
3250,-17.90874999999766,2708.294117647059,67,29,6,96
3251,-24.98199999999746,2018.1764705882354,39,23,17,62
3252,-5.204749999997103,3631.1111111111113,86,24,3,110
3253,-18.473249999999478,2117.5263157894738,21,31,3,52
3254,-20.395749999999076,2462.5882352941176,54,33,11,87
3255,-13.077749999997815,3194.25,62,19,0,81
3256,-13.548249999997742,3225.3333333333335,89,25,4,114
3257,-27.801249999998866,2802.0555555555557,55,36,14,91
3258,8.81450000000296,4733.05,94,21,5,115
3259,-41.099499999999566,2019.6315789473683,30,17,12,47
3260,-15.893999999999224,1857.6875,36,47,0,83
3261,-12.298499999997714,3745.7368421052633,75,27,5,102
3262,-22.338249999998606,2833.8888888888887,49,27,6,76
3263,-26.169999999999543,2008.8823529411766,26,29,15,55
3264,-11.782499999996691,4498.2,84,24,4,108
3265,-24.336499999998637,2058.9375,43,22,7,65
3266,8.046000000001982,3709.25,69,23,3,92
3267,-14.060749999998043,2457.235294117647,51,21,10,72
3268,-0.10724999999875942,2992.6666666666665,59,32,2,91
3269,-4.158249999998768,2959.6315789473683,51,18,10,69
3270,-21.696999999997775,4180.894736842105,77,40,10,117
3271,-25.855499999998962,1963.7894736842106,25,22,5,47
3272,-29.607999999999386,2158.35,28,24,1,52
3273,-29.595499999999628,2025.7058823529412,20,42,3,62
3274,-23.250499999999143,2532.222222222222,39,34,8,73
3275,-23.602499999998887,2082.6470588235293,38,24,5,62
3276,-30.535999999998374,2862.8333333333335,45,35,3,80
3277,-18.44724999999884,2610.3529411764707,39,16,9,55
3278,-5.581749999997026,3400.0,75,22,6,97
3279,-15.883499999997667,4182.25,59,37,3,96
3280,-16.3202499999991,2619.6,36,39,1,75
3281,-19.16299999999916,2024.3,22,28,0,50
3282,-20.900499999998015,2543.0,42,41,9,83
3283,-10.547999999998229,3656.1,55,30,4,85
3284,-9.742749999997802,4046.6,68,29,3,97
3285,-11.183249999998791,2833.85,44,25,2,69
3286,-10.09574999999747,3600.222222222222,80,18,13,98
3287,-24.46699999999875,2585.875,45,13,9,58
3288,-18.797499999998685,2608.0,42,28,6,70
3289,5.302000000002977,4303.789473684211,99,22,3,121
3290,-1.8132499999978358,3384.0,69,16,2,85
3291,-9.242999999998556,3184.7,50,21,5,71
3292,-6.665999999998594,3647.3,61,32,1,93
3293,-14.393249999997511,3056.5263157894738,61,18,13,79
3294,-16.10624999999838,2715.9375,41,23,4,64
3295,2.8582500000012336,3294.1111111111113,79,28,3,107
3296,-28.052499999998822,3127.5263157894738,43,41,4,84
3297,0.3920000000016316,3591.95,71,18,1,89
3298,-36.69124999999854,1986.2105263157894,26,22,4,48
3299,-21.90499999999832,2737.2,35,31,4,66
3300,-24.678999999999046,2746.55,38,29,3,67
3301,-22.80974999999848,3594.05,54,31,1,85
3302,-33.970499999998786,2321.8125,51,32,9,83
3303,-11.679749999997876,3243.4,55,21,8,76
3304,-16.053749999999138,2294.95,28,25,2,53
3305,-22.64124999999786,4693.4,84,29,6,113
3306,-10.854499999999403,2452.9444444444443,54,30,7,84
3307,-12.342999999999977,1965.4736842105262,25,29,15,54
3308,13.805500000001945,3828.5,77,18,0,95
3309,-27.93824999999901,2113.529411764706,36,27,9,63
3310,-28.43824999999892,3316.3,41,39,3,80
3311,-6.446749999997239,2585.9375,73,29,3,102
3312,-22.34499999999921,2137.05,23,24,3,47
3313,-31.893999999997693,2556.0,50,26,10,76
3314,-18.99099999999904,2521.529411764706,39,21,7,60
3315,4.118250000002145,4407.6,86,18,5,104
3316,-4.190249999996855,3412.3684210526317,70,25,8,95
3317,-11.852249999997003,2072.875,73,16,6,89
3318,-21.296499999998566,2046.4736842105262,26,22,13,48
3319,-19.77074999999828,2410.0666666666666,56,32,0,88
3320,8.816250000002299,4128.368421052632,91,20,6,111
3321,-7.050999999998153,2248.5,67,17,15,84
3322,-13.634749999999352,2400.0555555555557,30,32,7,62
3323,-16.962999999999344,2225.3888888888887,48,32,9,80
3324,-16.54399999999866,2727.1176470588234,31,26,3,57
3325,-19.658999999996503,2620.470588235294,81,25,7,106
3326,-30.934249999999743,1885.9444444444443,28,26,11,54
3327,-7.787999999996607,4717.1,100,12,4,112
3328,-9.269499999997393,2920.1875,73,26,1,99
3329,-9.391999999999003,2433.5555555555557,44,25,5,69
3330,0.8865000000018568,3522.65,67,19,2,86
3331,-26.9059999999981,2455.5555555555557,39,22,10,61
3332,-14.361999999998286,2879.235294117647,76,22,12,98
3333,6.289500000002399,3124.0,66,35,5,101
3334,-12.267499999996913,4430.789473684211,81,32,5,113
3335,-11.051749999998528,2611.153846153846,55,34,3,89
3336,-21.110999999998825,2578.25,34,26,0,60
3337,-3.4527499999977445,3628.842105263158,77,21,6,98
3338,-33.504249999999075,2008.764705882353,33,30,5,63
3339,2.3185000000013254,2643.823529411765,63,16,17,79
3340,-9.744999999998061,2694.3529411764707,54,29,10,83
3341,-18.08924999999777,3618.05,56,31,3,87
3342,-25.655249999998524,2648.5882352941176,38,23,3,61
3343,-12.60424999999778,2664.3125,51,22,14,73
3344,-11.039499999998457,2257.222222222222,42,26,8,68
3345,-6.88399999999764,3923.0555555555557,88,22,5,110
3346,-20.66249999999865,2785.3888888888887,43,33,7,76
3347,-22.120749999997724,3551.1052631578946,66,27,4,93
3348,-21.042999999999378,2068.2631578947367,24,20,8,44
3349,-10.07174999999851,3618.7,55,30,3,85
3350,-12.387999999997689,3649.7368421052633,64,28,6,92
3351,-3.2067499999978453,3710.8,65,28,1,93
3352,-20.330499999998626,2954.45,37,31,5,68
3353,-22.2874999999983,3582.0526315789475,57,37,5,94
3354,-13.422249999998673,2576.0526315789475,42,17,7,59
3355,-24.764999999998523,2638.0,49,36,12,85
3356,-4.1032499999979315,3675.222222222222,71,27,2,98
3357,-17.92674999999871,2319.764705882353,44,36,2,80
3358,-30.923999999998948,2305.35,22,31,4,53
3359,-6.838999999997599,4798.95,85,29,3,114
3360,-7.388999999997274,4060.9,68,30,3,98
3361,-24.846999999998694,2383.1052631578946,24,33,5,57
3362,-9.422249999998778,2881.5555555555557,60,22,4,82
3363,2.898250000002839,4679.2,86,24,5,110
3364,-25.61299999999884,2670.846153846154,41,25,9,66
3365,-23.522249999999183,2542.0526315789475,43,20,15,63
3366,-18.054499999998466,2798.764705882353,72,43,6,115
3367,0.44825000000197057,3719.6,68,22,3,90
3368,-28.176249999999904,1889.3333333333333,26,25,9,51
3369,-2.7497499999979658,2557.0,69,28,12,97
3370,-3.702249999997737,3910.1,59,32,5,91
3371,-20.379249999998805,2564.0555555555557,49,29,13,78
3372,-17.870499999998014,2825.823529411765,65,24,6,89
3373,-5.997499999994834,3499.8333333333335,103,24,8,127
3374,0.39275000000231797,3774.1052631578946,65,28,5,93
3375,-7.532249999998295,2861.470588235294,66,29,9,95
3376,-32.0914999999989,3217.1,34,40,5,74
3377,4.301250000002063,3629.6315789473683,65,29,2,94
3378,-28.56649999999859,2731.875,34,22,8,56
3379,-16.798499999998786,2429.0,44,29,5,73
3380,0.46250000000177993,2318.0,67,21,3,88
3381,-26.683749999998337,2554.4736842105262,32,25,10,57
3382,-19.017249999997745,4350.6,71,35,3,106
3383,-10.697249999998146,2508.4117647058824,49,25,7,74
3384,-36.71649999999856,2563.9444444444443,43,34,3,77
3385,-16.04749999999781,3810.0,72,19,5,91
3386,-20.47449999999886,2634.5789473684213,44,24,3,68
3387,8.20625000000177,3295.0,59,21,3,80
3388,4.932000000001851,3511.0526315789475,79,18,5,97
3389,-15.64599999999885,2556.0,38,22,4,60
3390,-8.099249999998225,3302.15,47,37,2,84
3391,-29.162249999999215,2008.4,24,16,6,40
3392,-21.962249999998733,2858.0,47,37,4,84
3393,-30.580749999998595,1898.2777777777778,32,30,3,62
3394,-26.909999999997744,1967.8823529411766,49,22,6,71
3395,-45.956250000000075,2055.6315789473683,23,23,27,46
3396,-21.020249999997393,2688.3333333333335,57,28,3,85
3397,-10.451249999998298,2191.823529411765,60,32,9,92
3398,3.105500000002401,2845.529411764706,102,20,1,122
3399,-24.409249999998043,3394.95,39,32,9,71
3400,-7.7339999999981845,2443.9411764705883,63,26,4,89
3401,-20.866999999998743,2196.875,43,32,7,75
3402,-8.764749999998292,2457.6666666666665,64,24,7,88
3403,-13.474749999999105,2937.0,32,50,3,82
3404,-33.85524999999925,2183.3684210526317,29,23,2,52
3405,-5.640999999998529,3208.4,54,25,3,79
3406,-32.50449999999942,2159.235294117647,31,34,17,65
3407,-18.693499999998984,2492.684210526316,38,23,15,61
3408,-2.9424999999983847,2955.5,64,18,8,82
3409,8.652500000002124,3460.777777777778,81,21,7,102
3410,-26.051749999998947,2387.1176470588234,60,37,4,97
3411,-31.249249999999698,2003.1666666666667,40,31,18,71
3412,-21.783499999997208,2853.277777777778,60,31,4,91
3413,-26.138249999998948,2512.5789473684213,41,21,4,62
3414,-15.861999999998721,2521.529411764706,37,19,6,56
3415,-29.601249999999464,2028.25,19,25,3,44
3416,-9.632999999998145,3974.35,72,22,2,94
3417,-12.499749999998174,2173.1875,58,16,4,74
3418,-28.27299999999868,2462.5882352941176,43,33,9,76
3419,-22.911749999997717,3551.9473684210525,49,40,8,89
3420,4.1680000000023245,4391.85,66,43,5,109
3421,-32.39774999999983,2403.157894736842,30,26,21,56
3422,-16.021499999997726,2499.722222222222,51,25,5,76
3423,-20.73974999999971,2192.684210526316,46,25,16,71
3424,-8.270999999998558,3321.315789473684,56,30,6,86
3425,-8.692499999997914,2901.4117647058824,58,24,6,82
3426,-15.722499999998949,2495.733333333333,40,31,7,71
3427,-5.225249999998121,2392.764705882353,51,16,8,67
3428,-13.692749999997119,3777.4736842105262,78,21,10,99
3429,-20.423249999998408,2095.6666666666665,55,22,7,77
3430,-28.033999999997775,2869.823529411765,68,32,7,100
3431,0.42375000000301116,4835.4,91,26,4,117
3432,-26.319249999999023,2408.777777777778,33,31,9,64
3433,-31.76124999999911,2328.176470588235,34,46,3,80
3434,-36.928999999999974,1952.1052631578948,14,23,26,37
3435,-6.342249999998329,4073.45,62,32,3,94
3436,-25.635249999998713,2653.714285714286,40,24,6,64
3437,-6.296249999997498,2501.9411764705883,57,27,6,84
3438,-9.546749999998122,3354.3333333333335,69,24,7,93
3439,-12.561499999997658,2829.6470588235293,60,33,9,93
3440,-17.173999999998312,3345.5263157894738,55,30,1,85
3441,-0.7114999999967393,2923.1875,87,24,9,111
3442,-19.785999999999124,2558.0,44,19,3,63
3443,-29.12299999999889,2175.9473684210525,26,29,3,55
3444,-9.57049999999686,4603.7,91,23,3,114
3445,-10.848249999998123,3799.75,72,19,2,91
3446,7.591500000002808,3986.2631578947367,85,18,3,103
3447,-27.766749999999227,1949.2777777777778,27,25,3,52
3448,2.075250000002414,3562.35,75,11,2,86
3449,-4.751499999997589,4113.15,74,28,2,102
3450,-3.6854999999977727,4044.1,68,23,6,91
3451,-16.700499999999202,1889.375,33,26,16,59
3452,-1.2082499999983836,3659.0555555555557,87,39,3,126
3453,-28.9607499999987,2475.823529411765,39,27,8,66
3454,-22.754249999999026,2587.75,38,20,3,58
3455,-48.86400000000072,1429.0,0,28,34,28
3456,20.560000000004948,2226.75,98,24,8,122
3457,-16.614249999997575,3130.277777777778,47,44,6,91
3458,-30.108999999998737,2529.9411764705883,51,28,7,79
3459,-32.615499999997816,3564.0,53,29,5,82
3460,-9.784749999997349,3550.470588235294,68,33,5,101
3461,-20.672999999999465,1967.0526315789473,33,19,3,52
3462,-11.223749999998796,2482.235294117647,46,25,5,71
3463,-7.646249999998534,3016.4444444444443,59,23,5,82
3464,-3.4004999999986594,3461.6315789473683,72,34,6,106
3465,4.028750000002634,3861.8947368421054,89,16,7,105
3466,-25.823749999999592,1959.5263157894738,21,29,2,50
3467,-7.544999999998248,3475.1,60,23,5,83
3468,-24.989499999999396,2111.6,22,22,5,44
3469,-26.653249999999353,2028.25,25,20,4,45
3470,-12.518249999998359,2948.95,40,28,4,68
3471,-24.85449999999937,2572.0,44,32,25,76
3472,-12.49024999999907,2612.8571428571427,44,28,10,72
3473,9.862750000002682,4586.15,89,20,3,109
3474,6.394750000002587,3154.6470588235293,82,24,1,106
3475,-24.64299999999823,2094.9444444444443,28,24,10,52
3476,-28.792749999999376,2087.0,20,25,3,45
3477,-15.600999999999337,2643.842105263158,43,25,8,68
3478,9.602500000002735,4787.9,99,17,4,116
3479,-30.29674999999957,2380.6315789473683,30,31,19,61
3480,-8.366249999998299,3317.85,54,24,2,78
3481,-17.402499999998703,2138.705882352941,30,31,5,61
3482,-6.990249999997296,2278.3125,74,24,2,98
3483,-13.796499999998707,2591.0666666666666,43,29,4,72
3484,-0.08774999999772434,3861.5,73,24,2,97
3485,-8.196499999998968,2631.45,37,23,4,60
3486,-0.9997499999959413,5086.1,92,28,5,120
3487,-30.80749999999934,1950.0,41,22,15,63
3488,-15.815249999997794,4230.7,72,31,4,103
3489,-24.336249999997953,2507.5555555555557,57,25,5,82
3490,-18.949999999998166,3311.7,47,29,4,76
3491,-8.49624999999848,3175.2631578947367,53,21,6,74
3492,-2.0032499999972813,3801.7368421052633,65,37,6,102
3493,13.320000000003262,4373.0526315789475,119,16,4,135
3494,-9.139249999997059,4636.15,87,30,3,117
3495,-24.687749999999316,2114.05,18,32,1,50
3496,-24.198499999998734,1871.5,53,30,14,83
3497,-15.94924999999902,2638.8,43,18,13,61
3498,-24.476999999998814,2703.3333333333335,61,30,7,91
3499,-10.226999999997284,2687.785714285714,58,22,10,80
3500,-13.187249999998851,2243.3529411764707,53,27,4,80
3501,15.443000000003599,4011.1111111111113,112,33,6,145
3502,-6.399749999998854,3037.157894736842,56,23,8,79
3503,-20.626499999998984,2338.0,36,31,3,67
3504,-7.475999999997454,4119.666666666667,84,37,1,121
3505,-13.729499999997518,2269.3125,66,19,10,85
3506,-26.090749999999286,2215.7,22,24,8,46
3507,-15.498249999996995,2988.222222222222,62,24,5,86
3508,-12.974249999998193,2848.75,56,39,4,95
3509,-25.894499999998146,3019.1666666666665,44,38,6,82
3510,-29.55524999999688,2175.125,52,46,4,98
3511,-36.319499999998634,1546.125,14,31,13,45
3512,-15.564749999998515,3360.9,54,29,0,83
3513,-45.45874999999673,2480.277777777778,40,30,20,70
3514,-20.436499999998997,2339.45,27,24,10,51
3515,-21.3112499999974,2402.9411764705883,86,35,5,121
3516,-34.78324999999917,2535.9473684210525,38,19,16,57
3517,-19.591999999997963,3207.6,39,40,0,79
3518,-10.075249999998594,3132.6315789473683,72,22,7,94
3519,-26.4614999999982,2103.625,46,28,6,74
3520,-23.67074999999798,4073.2631578947367,71,36,17,107
3521,-3.492249999998473,3132.4,53,21,2,74
3522,-12.546249999998226,3764.8,59,30,2,89
3523,-24.180999999998043,3012.45,54,17,2,71
3524,-2.1807499999977202,3882.7894736842104,77,23,4,100
3525,-4.424499999997472,4179.85,84,18,3,102
3526,-4.393249999997907,3810.842105263158,99,18,11,117
3527,-27.810499999999138,2345.0,25,31,5,56
3528,-27.830999999999655,2075.3888888888887,50,28,4,78
3529,-12.990749999998886,2496.294117647059,39,22,2,61
3530,-11.255999999997965,3221.15,59,18,4,77
3531,-6.141999999997798,3876.9473684210525,79,16,3,95
3532,-30.378999999999156,1920.0625,37,40,4,77
3533,-11.901749999998122,3283.8,48,34,2,82
3534,-30.232749999999264,2117.25,23,26,0,49
3535,-12.640749999998157,3079.3,58,15,4,73
3536,-19.697749999998074,2520.722222222222,48,31,7,79
3537,-29.44099999999919,2106.05,30,20,0,50
3538,3.5785000000018443,3802.5789473684213,80,23,3,103
3539,-29.872499999997377,2166.125,38,39,11,77
3540,-18.409749999999214,2810.0555555555557,51,31,5,82
3541,-10.958999999997875,3618.8,70,16,4,86
3542,-19.93324999999854,2966.4,42,27,2,69
3543,-15.389249999998757,2259.5625,46,42,4,88
3544,-45.8834999999986,2265.705882352941,21,42,5,63
3545,-22.115249999998728,2508.4210526315787,39,18,5,57
3546,-15.157749999998774,2500.5,42,26,1,68
3547,-12.2587499999984,3420.35,54,23,8,77
3548,-12.49174999999846,3301.15,57,25,0,82
3549,-30.511499999999664,1925.611111111111,27,32,12,59
3550,-12.773749999998776,2504.705882352941,35,21,5,56
3551,-15.847999999999237,2868.7,32,40,2,72
3552,-28.821499999996497,2355.6875,67,27,11,94
3553,-19.001749999999298,2568.6315789473683,38,32,5,70
3554,-11.395749999998717,2929.9,37,34,2,71
3555,-25.301999999999513,2726.9166666666665,39,42,5,81
3556,10.255750000002696,4702.9,84,30,2,114
3557,-17.47024999999862,2062.9375,38,33,4,71
3558,-28.807499999996743,2541.9444444444443,60,28,7,88
3559,-7.816749999999028,2603.764705882353,40,22,0,62
3560,-20.384749999998107,3927.5,57,34,2,91
3561,-26.721249999997788,3050.0588235294117,59,36,5,95
3562,-39.71974999999954,1429.0,31,37,6,68
3563,-2.7122499999978595,3618.7368421052633,69,25,2,94
3564,-9.049999999997095,2072.4666666666667,89,28,5,117
3565,-0.743999999997909,2723.75,84,32,3,116
3566,-16.79249999999872,3633.8,53,31,3,84
3567,-6.298499999998752,3033.157894736842,51,30,8,81
3568,-7.59799999999738,2829.3888888888887,62,19,13,81
3569,-5.280749999997026,2764.5,84,11,7,95
3570,-18.83249999999793,3138.315789473684,57,29,0,86
3571,-23.600249999999257,2536.375,38,38,1,76
3572,-20.313999999998856,2522.5263157894738,38,25,6,63
3573,-26.702249999999292,1967.0,27,23,2,50
3574,-14.610249999998459,3415.6,45,38,3,83
3575,-3.6097499999978773,3248.2,57,24,0,81
3576,14.398750000002611,4335.45,82,24,2,106
3577,-14.124499999998761,2539.277777777778,38,25,2,63
3578,-21.360999999999237,2646.777777777778,60,33,8,93
3579,-20.93224999999851,2274.1176470588234,56,37,11,93
3580,1.6765000000020032,4250.55,71,30,4,101
3581,-25.280249999998766,2134.0,36,16,5,52
3582,-37.08324999999888,2906.8947368421054,50,28,19,78
3583,-23.60025000000042,1984.6666666666667,40,34,12,74
3584,-6.50699999999893,2639.45,36,29,1,65
3585,-8.716999999997816,3209.6470588235293,69,25,3,94
3586,4.590250000002946,4317.25,87,16,4,103
3587,-30.048249999997164,4317.95,67,34,3,101
3588,-7.1819999999986495,3135.3333333333335,67,33,0,100
3589,-19.10499999999885,2528.45,37,25,1,62
3590,-3.5419999999977776,3963.8947368421054,77,30,4,107
3591,-12.967749999999182,2658.8947368421054,44,24,9,68
3592,3.7932500000030855,4837.9,90,26,2,116
3593,-29.037999999999442,2099.7,20,26,4,46
3594,-12.538749999997469,2427.0625,66,17,5,83
3595,-17.79649999999886,2275.9411764705883,50,29,4,79
3596,-6.221999999997587,4097.35,73,26,3,99
3597,-11.792749999997156,4855.25,96,20,4,116
3598,-21.875749999998884,2476.6666666666665,47,26,7,73
3599,-12.718749999998716,2590.3684210526317,41,26,3,67
3600,-7.43899999999835,3079.95,44,32,1,76
3601,-24.976749999999647,1959.5263157894738,24,19,9,43
3602,-40.1027499999986,2919.55,28,35,7,63
3603,-2.568249999998211,3328.294117647059,78,27,5,105
3604,-10.206999999999162,2544.35,35,23,2,58
3605,-24.098499999999046,2425.5555555555557,56,21,12,77
3606,-8.440249999998276,2596.4,54,16,8,70
3607,-30.420499999999453,2012.0,43,29,17,72
3608,-12.655249999997455,4282.35,78,30,2,108
3609,-6.29874999999813,3498.9,67,19,3,86
3610,13.238500000001995,4159.15,83,23,2,106
3611,-26.156749999997707,3073.157894736842,52,29,1,81
3612,-21.577999999999285,2581.6,38,25,16,63
3613,-29.751749999998793,2129.5333333333333,46,27,7,73
3614,-26.23649999999764,3613.6315789473683,71,23,4,94
3615,8.793500000001607,3698.1,72,19,1,91
3616,-25.727749999997894,2936.1111111111113,49,40,2,89
3617,-2.106499999998404,3055.7368421052633,49,32,2,81
3618,-8.677499999998052,2615.764705882353,52,27,2,79
3619,-17.216499999998387,2741.8125,47,24,3,71
3620,-19.97149999999889,1871.4375,45,30,3,75
3621,-25.241749999998902,2477.5263157894738,28,32,5,60
3622,-1.7937499999972513,4049.0,84,11,3,95
3623,2.686250000001933,3007.9411764705883,78,22,3,100
3624,-9.422749999998612,3176.7894736842104,57,26,2,83
3625,-21.728999999997022,1983.7222222222222,49,25,12,74
3626,-8.367999999998307,3584.0,70,18,4,88
3627,5.555500000000937,3092.0,54,27,3,81
3628,-6.17074999999768,4544.15,85,31,2,116
3629,-15.455249999998253,2228.294117647059,43,25,6,68
3630,-20.04774999999884,2499.722222222222,54,36,12,90
3631,-33.916499999998734,2876.842105263158,53,30,10,83
3632,-9.189999999998943,2663.777777777778,39,23,1,62
3633,-2.3952499999978514,3643.7368421052633,68,31,6,99
3634,-2.673999999997428,4253.7,77,19,1,96
3635,-11.18974999999791,3230.2105263157896,51,39,2,90
3636,-3.3754999999982354,2541.3125,51,30,2,81
3637,-26.416249999999195,2058.4,19,28,1,47
3638,-25.22649999999932,2008.45,23,22,2,45
3639,-2.6824999999984067,3224.25,60,21,2,81
3640,-14.889249999999226,2615.8823529411766,38,30,5,68
3641,-8.012249999998128,2832.1666666666665,65,26,3,91
3642,-22.34324999999812,2103.777777777778,38,28,9,66
3643,-20.838999999998265,3368.0,51,24,2,75
3644,-6.958999999998392,3194.4210526315787,56,26,0,82
3645,-17.165249999999066,2500.157894736842,39,29,3,68
3646,-17.422749999998686,2680.0,49,33,8,82
3647,-14.920249999998486,2677.4117647058824,45,37,2,82
3648,-27.62749999999942,2059.0526315789475,23,27,4,50
3649,-36.28325000000003,1429.0,0,29,10,29
3650,-14.644499999997617,3776.8,53,36,4,89
3651,-1.441249999997956,3926.75,78,20,3,98
3652,-18.303499999999648,2071.9444444444443,26,29,5,55
3653,2.9272500000027004,4285.6,93,9,2,102
3654,-14.773749999997865,2121.5625,49,24,6,73
3655,5.9145000000028265,4095.8,84,21,1,105
3656,-6.125249999998275,3016.4444444444443,55,25,0,80
3657,-26.287499999999092,2028.6666666666667,39,27,9,66
3658,-23.028499999998935,2616.8823529411766,40,23,6,63
3659,-10.800499999998545,2875.05,41,30,1,71
3660,-7.472749999995926,4219.421052631579,87,23,10,110
3661,-10.782749999998554,3114.0,50,20,8,70
3662,5.973750000001635,3636.315789473684,74,27,4,101
3663,-10.163749999997567,4081.4,76,26,0,102
3664,-24.115749999998634,2030.2941176470588,49,27,3,76
3665,-16.235249999998757,2885.45,40,29,2,69
3666,-14.351999999998881,2013.4705882352941,47,24,5,71
3667,-16.14049999999905,1871.5,50,23,6,73
3668,-15.391249999998772,3052.315789473684,68,25,13,93
3669,-22.214749999998347,3756.6315789473683,75,23,7,98
3670,-30.457749999999322,2024.25,24,20,4,44
3671,-21.418499999998893,2521.529411764706,36,22,3,58
3672,-17.62024999999876,2363.214285714286,40,34,10,74
3673,-22.06499999999784,3219.277777777778,61,35,15,96
3674,-23.863249999998402,2078.8125,41,30,6,71
3675,-32.054999999997406,2075.1176470588234,31,29,11,60
3676,8.077250000003193,2997.5625,95,22,3,117
3677,-7.303249999998348,2647.722222222222,52,25,10,77
3678,-15.033249999999015,2337.6875,41,32,17,73
3679,-22.286499999998394,2524.35,40,21,1,61
3680,-27.1717499999992,2114.7,27,20,4,47
3681,-25.528249999998852,2031.235294117647,33,23,2,56
3682,-12.760499999998725,2695.5,42,36,9,78
3683,-40.137000000000015,1429.0,9,25,11,34
3684,-24.078499999999188,2194.2,24,27,1,51
3685,5.070250000003697,4786.3,102,16,1,118
3686,-10.901499999999189,2544.3,42,18,3,60
3687,-40.55750000000006,2000.388888888889,20,36,12,56
3688,-28.742749999999393,2076.1176470588234,32,37,9,69
3689,-23.029249999998747,1429.0,32,34,5,66
3690,-4.250749999997899,3691.8,67,25,1,92
3691,-23.214749999998777,2570.3,36,26,2,62
3692,-14.831499999997465,3947.35,61,40,0,101
3693,-17.930749999998977,2759.4666666666667,30,34,3,64
3694,-2.2389999999985797,3089.1052631578946,55,20,9,75
3695,-0.4009999999985168,3916.25,68,27,2,95
3696,-29.246999999999076,2099.157894736842,23,24,4,47
3697,-23.717749999999036,2252.7894736842104,28,25,4,53
3698,-26.259499999997235,2504.1111111111113,51,28,9,79
3699,-15.36949999999714,2546.6,70,20,3,90
3700,-12.99424999999793,4139.210526315789,72,40,3,112
3701,-11.536999999998386,3496.4,46,39,0,85
3702,-17.20524999999891,2747.6875,35,28,2,63
3703,-20.243749999996787,2345.2727272727275,54,25,10,79
3704,-24.060999999997485,2399.842105263158,37,26,12,63
3705,-20.41524999999887,2050.6315789473683,24,25,6,49
3706,2.118500000003489,5077.55,106,15,2,121
3707,-29.98474999999842,2610.6666666666665,36,29,6,65
3708,-6.058499999996263,3773.0555555555557,85,22,6,107
3709,-13.767999999998088,3533.05,64,18,8,82
3710,-24.3417499999983,2427.125,54,24,6,78
3711,6.709250000002198,3798.3684210526317,78,25,3,103
3712,-10.87499999999923,2659.1666666666665,55,31,2,86
3713,-14.344249999999004,2724.294117647059,36,22,5,58
3714,-14.442999999998303,3254.684210526316,65,25,7,90
3715,-3.663999999998184,4955.3,81,33,5,114
3716,-5.248999999998327,3074.157894736842,55,24,2,79
3717,-12.713499999999172,2714.85,41,20,2,61
3718,-20.609499999997976,3982.0526315789475,75,28,5,103
3719,3.1877500000030308,5279.9,85,46,1,131
3720,-1.913999999997453,3435.8571428571427,78,22,3,100
3721,-3.176249999998299,3613.7368421052633,70,23,8,93
3722,-33.239749999998295,3381.4,43,42,2,85
3723,-1.450499999997791,3978.3,70,25,3,95
3724,-11.879499999998208,2983.7894736842104,54,19,2,73
3725,-10.88449999999868,2846.7894736842104,44,35,4,79
3726,-31.266499999999418,2267.0526315789475,27,28,2,55
3727,-9.812249999998727,3119.8947368421054,54,30,2,84
3728,-34.56124999999949,2110.0,31,18,13,49
3729,-27.178249999998616,2631.5,31,28,5,59
3730,1.5870000000015998,3426.7,70,13,2,83
3731,2.3145000000026608,3982.35,76,19,3,95
3732,-0.24274999999720115,4372.75,80,32,0,112
3733,-27.061249999999426,2455.7894736842104,38,28,16,66
3734,6.303000000002585,3312.3529411764707,86,15,3,101
3735,-9.761249999998013,2372.0666666666666,72,24,4,96
3736,-10.341249999998386,3223.5,60,18,1,78
3737,-32.71074999999926,2709.2,32,32,2,64
3738,17.65975000000323,5302.05,118,17,3,135
3739,-5.251249999998338,3331.2105263157896,64,32,4,96
3740,-15.812749999998127,3036.9,61,11,3,72
3741,-7.666999999998666,2519.4736842105262,37,26,3,63
3742,-12.447249999998993,2353.3529411764707,57,30,3,87
3743,3.6232500000027024,3856.95,59,36,3,95
3744,-23.32749999999871,2830.65,40,28,0,68
3745,-6.300499999998425,2514.866666666667,72,32,2,104
3746,-26.53050000000013,2050.722222222222,30,28,22,58
3747,-26.319249999999265,2468.722222222222,44,30,4,74
3748,-23.0994999999991,2471.0588235294117,38,27,9,65
3749,-10.669999999997982,2855.8333333333335,74,31,4,105
3750,-17.094999999998173,2441.5,66,34,13,100
3751,-15.173249999998609,2528.25,40,14,8,54
3752,-10.536999999997327,3184.4210526315787,61,32,3,93
3753,-3.027749999995986,3033.1666666666665,97,20,1,117
3754,-20.793249999997837,3340.15,53,28,3,81
3755,3.544750000002049,4015.4736842105262,94,26,1,120
3756,-23.85974999999977,2000.5555555555557,24,41,4,65
3757,-16.604749999998262,2883.823529411765,63,27,5,90
3758,-12.62674999999847,2429.3125,52,26,1,78
3759,-21.32349999999888,2524.235294117647,38,32,5,70
3760,-20.174499999998915,2608.4117647058824,36,28,4,64
3761,-16.430249999997617,2453.5333333333333,61,35,19,96
3762,-16.583749999998663,3004.7368421052633,67,29,2,96
3763,-6.5769999999975965,2855.75,71,22,0,93
3764,-24.65899999999928,2008.55,23,23,2,46
3765,-21.241249999998566,2696.6153846153848,49,33,4,82
3766,-0.45574999999806687,2981.1666666666665,72,21,3,93
3767,-4.4934999999992415,2525.1111111111113,51,40,6,91
3768,-15.918749999998264,2785.3333333333335,57,27,4,84
3769,-22.652749999998328,3023.55,41,28,4,69
3770,7.55225000000208,3668.2105263157896,87,21,0,108
3771,-9.94399999999709,2110.823529411765,61,30,4,91
3772,-26.578499999998076,2067.9375,59,28,18,87
3773,-9.10399999999892,2603.705882352941,49,28,12,77
3774,-18.829749999998537,2362.75,42,32,3,74
3775,-23.96674999999869,2553.0,33,28,1,61
3776,-8.56024999999909,2921.0,60,27,1,87
3777,-22.205999999998497,2560.5,33,35,3,68
3778,-21.77824999999818,3265.55,45,35,1,80
3779,-8.761749999997258,2496.3529411764707,57,29,4,86
3780,-12.687249999997615,2729.8823529411766,58,30,2,88
3781,0.05650000000232236,3981.5,67,33,1,100
3782,-14.511749999997557,1942.6470588235295,58,27,5,85
3783,-13.717499999998761,2642.7,42,25,3,67
3784,-16.484249999999275,2686.4,38,22,7,60
3785,-31.868249999999318,2067.3684210526317,23,25,0,48
3786,-32.46449999999987,2657.4375,30,30,24,60
3787,-17.187749999998317,2342.8125,72,24,3,96
3788,-21.59174999999946,2311.6,22,32,2,54
3789,-25.726749999999345,2043.8947368421052,22,26,3,48
3790,-13.240749999998751,3248.1,60,18,5,78
3791,-4.114749999997934,3537.6315789473683,66,32,4,98
3792,-22.897499999998555,2500.8947368421054,44,20,3,64
3793,-13.22924999999851,3209.15,52,28,2,80
3794,-21.19674999999763,2881.8947368421054,49,25,12,74
3795,-8.250249999997711,4620.3,80,30,0,110
3796,-23.078749999999324,2356.4736842105262,28,32,10,60
3797,-8.184999999998052,3739.35,47,42,5,89
3798,-15.895249999997882,2773.0,58,27,3,85
3799,-29.662249999997606,3141.6666666666665,56,39,3,95
3800,-13.97674999999873,2908.4,35,35,3,70
3801,-19.192249999997273,3623.55,67,17,4,84
3802,10.068250000004301,3092.0588235294117,100,19,5,119
3803,-5.073749999996131,2628.3333333333335,73,23,12,96
3804,-22.468499999997757,2666.315789473684,46,28,5,74
3805,-3.3432499999975507,3591.4444444444443,72,31,2,103
3806,-23.344749999998918,2807.5,45,29,14,74
3807,-7.788999999997505,3024.3333333333335,59,23,8,82
3808,-7.838249999998349,3364.0,47,37,3,84
3809,-18.016749999998602,2616.75,76,36,3,112
3810,-17.848749999999473,1944.0,47,31,11,78
3811,-22.435999999997893,2723.9285714285716,39,39,4,78
3812,-8.949249999997777,2493.5882352941176,63,20,4,83
3813,-2.6589999999971545,4227.166666666667,97,39,0,136
3814,-7.598249999998245,3383.1,57,26,1,83
3815,-28.57374999999853,2409.6111111111113,35,31,3,66
3816,5.075250000002055,3450.0,68,22,4,90
3817,1.144750000001805,2358.2,71,24,3,95
3818,-8.471249999998323,3104.45,55,21,3,76
3819,-22.315499999998945,2485.842105263158,37,26,8,63
3820,1.4975000000023109,3338.277777777778,68,32,4,100
3821,-6.981249999997668,3952.9473684210525,85,25,5,110
3822,-15.412499999997802,3533.1,59,26,4,85
3823,-1.6024999999970855,4289.473684210527,90,20,1,110
3824,-17.661749999997873,3041.705882352941,54,37,3,91
3825,6.910000000003241,2294.764705882353,70,30,3,100
3826,-21.33549999999892,2688.842105263158,38,27,5,65
3827,3.688500000002308,3393.8333333333335,85,18,7,103
3828,-8.464749999998109,2328.875,65,25,6,90
3829,-29.137749999998693,1996.5,32,32,4,64
3830,-31.236999999998886,2937.0,56,34,16,90
3831,-0.7022499999980434,3936.2105263157896,84,23,0,107
3832,-26.90974999999827,2549.8888888888887,38,34,6,72
3833,-28.407749999998902,2777.5,39,31,0,70
3834,-6.127749999999105,2695.125,38,23,0,61
3835,-10.180999999998292,3517.684210526316,57,29,4,86
3836,-10.400749999998299,4036.3,53,40,3,93
3837,-17.62149999999863,2957.8947368421054,45,30,6,75
3838,-3.4959999999988085,2410.470588235294,55,31,6,86
3839,2.6930000000026784,3807.7,77,17,2,94
3840,-19.320249999998687,2528.25,35,21,7,56
3841,-5.378749999998059,1902.4705882352941,49,26,4,75
3842,-19.407749999997716,2616.214285714286,59,31,5,90
3843,-19.78999999999829,2326.4117647058824,53,25,6,78
3844,-20.708499999998402,2528.0,70,19,6,89
3845,-8.55424999999871,2917.6666666666665,51,37,12,88
3846,-26.142999999999507,2086.25,20,27,2,47
3847,-0.10199999999795732,4128.2,76,28,3,104
3848,-10.265249999997831,3594.2,60,26,2,86
3849,-13.42149999999875,2362.4,62,34,1,96
3850,-31.685249999998263,3029.6666666666665,48,47,4,95
3851,-18.216249999998666,2948.1,43,31,1,74
3852,0.5332500000013971,3129.05,57,19,1,76
3853,-2.941249999998907,3443.315789473684,69,32,3,101
3854,-26.12974999999907,2556.0555555555557,34,40,1,74
3855,4.62275000000172,3862.7368421052633,75,38,3,113
3856,-24.569999999998515,3942.55,57,30,2,87
3857,-11.01574999999826,3507.75,56,30,1,86
3858,6.4892500000011015,3081.6315789473683,58,24,4,82
3859,-26.61274999999846,2674.6315789473683,33,35,3,68
3860,5.7957500000027276,3685.777777777778,90,21,2,111
3861,-16.04349999999823,3496.55,54,30,3,84
3862,-15.050499999998763,2608.3571428571427,35,28,0,63
3863,-29.08124999999827,2894.85,29,38,2,67
3864,-23.330249999999317,2028.2,29,19,1,48
3865,-28.31674999999877,3056.75,38,33,1,71
3866,-32.79749999999889,2690.2,31,29,6,60
3867,-25.346999999999184,2452.9444444444443,35,40,0,75
3868,-5.043749999998306,2143.375,59,28,1,87
3869,-10.594499999998693,2738.55,52,18,1,70
3870,-20.031499999998665,2432.1875,37,32,1,69
3871,-21.480749999999055,2583.8,32,26,2,58
3872,-30.046749999998745,2031.3684210526317,22,32,3,54
3873,-14.240749999999249,2562.277777777778,37,19,10,56
3874,-20.015999999998712,2561.842105263158,36,27,2,63
3875,5.089250000002714,4303.7,84,21,1,105
3876,-0.94299999999849,2567.294117647059,76,34,6,110
3877,-10.596749999998767,2488.3333333333335,38,31,0,69
3878,13.466500000002195,4205.2,85,24,1,109
3879,-4.111249999997495,3576.1052631578946,73,21,1,94
3880,-20.37349999999698,2175.1875,76,32,12,108
3881,-25.439249999999376,2434.0526315789475,29,30,5,59
3882,-22.241249999998125,2139.133333333333,47,33,4,80
3883,-17.382249999998336,2531.7894736842104,38,27,6,65
3884,-13.49124999999872,2472.3684210526317,37,26,4,63
3885,-7.5004999999987465,2962.2631578947367,52,24,5,76
3886,-20.236749999998818,2525.2105263157896,37,29,1,66
3887,-27.863499999998293,2521.7894736842104,38,24,5,62
3888,-3.422749999997907,3102.4210526315787,57,29,4,86
3889,-23.31749999999837,3205.0,78,20,18,98
3890,-25.539499999999315,2285.4210526315787,27,30,12,57
3891,20.38775000000192,3886.0526315789475,84,23,6,107
3892,-16.906749999998897,2546.764705882353,46,30,4,76
3893,-19.462749999998916,2513.0,41,34,14,75
3894,-4.871749999997829,3769.65,77,21,0,98
3895,-26.57249999999658,1976.235294117647,52,30,12,82
3896,-7.032249999998426,3318.1111111111113,70,31,3,101
3897,-14.47824999999852,3175.0526315789475,52,22,13,74
3898,4.1060000000022985,4179.2,80,24,0,104
3899,3.090000000003373,4702.1,103,12,2,115
3900,-7.680499999998167,2798.4210526315787,44,23,4,67
3901,-7.549999999998103,3333.842105263158,54,33,3,87
3902,-21.224499999998446,3381.5555555555557,57,41,1,98
3903,-8.185999999997941,3942.6,70,26,2,96
3904,1.6805000000022197,4531.0526315789475,104,26,1,130
3905,-39.8439999999983,3672.7,40,48,0,88
3906,-18.307999999998607,3056.1666666666665,47,42,2,89
3907,-34.57599999999957,2145.8947368421054,24,28,7,52
3908,3.4190000000019607,3068.05,54,26,2,80
3909,-7.0974999999991395,2708.7894736842104,47,16,17,63
3910,-23.42199999999849,4027.2105263157896,77,37,8,114
3911,3.6175000000020434,3575.8,74,20,1,94
3912,-16.859249999998283,2819.4,30,36,2,66
3913,-20.794499999998926,2847.25,34,34,2,68
3914,-1.1407499999972213,3085.7368421052633,60,26,3,86
3915,-16.419749999996867,3121.3333333333335,67,32,4,99
3916,-14.472999999998581,2930.315789473684,49,28,4,77
3917,-23.50674999999821,3727.6,54,33,3,87
3918,-17.479249999998707,2853.5789473684213,32,44,1,76
3919,-30.61174999999917,2066.5555555555557,24,31,4,55
3920,-23.921999999998825,2403.705882352941,42,33,3,75
3921,-16.57849999999878,2391.823529411765,38,43,5,81
3922,4.970250000002121,3760.05,65,27,4,92
3923,-22.99799999999619,2818.846153846154,67,36,7,103
3924,-0.7594999999987652,2877.0526315789475,44,27,8,71
3925,-21.353999999998717,2658.3125,35,30,3,65
3926,-5.707499999997854,2965.1176470588234,59,26,4,85
3927,-4.217999999997238,2362.5333333333333,91,45,4,136
3928,-9.111249999997273,5020.3,91,30,2,121
3929,-20.840249999999035,2647.9473684210525,46,21,6,67
3930,-16.11649999999781,2944.470588235294,65,23,4,88
3931,-8.532499999998603,2329.875,57,32,5,89
3932,-18.575999999998896,2737.0,34,22,7,56
3933,-23.648999999998313,2478.3684210526317,42,25,7,67
3934,-13.637249999998627,3181.0,53,33,2,86
3935,-6.0647499999987105,3294.277777777778,66,34,2,100
3936,-25.18674999999933,2040.111111111111,30,22,6,52
3937,-17.417749999996364,3957.222222222222,92,28,12,120
3938,-3.8637499999974727,4225.8,77,28,0,105
3939,-19.221749999998444,2441.5555555555557,41,28,13,69
3940,-3.4122499999968823,3909.722222222222,90,25,2,115
3941,-5.281499999997808,3355.45,47,34,4,81
3942,-6.190749999997495,2723.625,82,31,2,113
3943,-11.67899999999673,4355.2,82,21,1,103
3944,-28.226749999998304,2265.6470588235293,40,42,7,82
3945,-14.089249999999073,2765.5,44,25,1,69
3946,-23.125249999998168,3138.315789473684,53,30,5,83
3947,-5.71899999999891,2865.6666666666665,56,33,3,89
3948,-19.0709999999989,2304.5833333333335,38,28,2,66
3949,-17.343749999998806,2524.35,34,31,2,65
3950,2.7670000000021204,2551.294117647059,61,24,4,85
3951,-14.625749999997902,3405.3,60,22,1,82
3952,-2.1252499999990544,3044.0,58,28,6,86
3953,-17.00149999999925,2420.6470588235293,43,39,5,82
3954,-2.5884999999972744,3454.722222222222,75,21,2,96
3955,-27.637749999997304,3891.8947368421054,73,28,5,101
3956,1.3910000000019067,3810.2,70,22,1,92
3957,-8.537499999998387,3248.9,46,36,1,82
3958,-16.03399999999865,2548.05,39,27,1,66
3959,-28.566499999997983,2966.2105263157896,49,26,2,75
3960,-7.853749999998664,2536.15,42,21,0,63
3961,-2.9514999999983624,3034.8333333333335,56,30,5,86
3962,-16.600499999997993,3750.6315789473683,64,30,4,94
3963,-4.828499999997862,3703.8947368421054,80,20,2,100
3964,-14.081249999998771,2686.25,40,29,0,69
3965,-8.78424999999854,2708.1428571428573,55,30,3,85
3966,-5.679999999998498,2907.235294117647,60,27,8,87
3967,7.903500000002748,3324.9444444444443,68,26,4,94
3968,-34.356249999999385,2217.2,29,22,4,51
3969,-12.733249999998545,3241.8,51,27,0,78
3970,-10.682999999997085,2762.529411764706,63,29,6,92
3971,-2.330499999997584,3756.1,77,17,1,94
3972,-15.230749999998963,3206.0526315789475,57,42,3,99
3973,-14.49249999999883,2556.75,35,26,2,61
3974,-2.7454999999978673,3998.1,65,33,2,98
3975,-19.961749999999284,2430.777777777778,45,30,18,75
3976,-11.447249999998608,2943.45,38,34,1,72
3977,-13.445249999998916,2656.95,35,32,0,67
3978,-7.229249999995922,2485.4444444444443,87,28,4,115
3979,7.863750000002514,3818.8333333333335,105,27,4,132
3980,-23.079999999999853,1944.888888888889,33,29,3,62
3981,-4.116249999998821,2747.2,47,24,0,71
3982,-29.23699999999915,2453.777777777778,36,43,5,79
3983,-7.320249999997934,3361.7,67,14,2,81
3984,-11.517749999998792,2905.5,59,20,4,79
3985,2.2157500000024077,3744.25,67,27,1,94
3986,-53.153750000000116,1429.0,7,33,18,40
3987,-15.427749999998884,2520.842105263158,33,30,2,63
3988,-7.611999999998881,2999.842105263158,57,20,7,77
3989,2.087500000002122,3750.5,63,27,5,90
3990,-18.53949999999818,3250.2631578947367,54,29,0,83
3991,-35.509749999999194,1988.4117647058824,37,30,17,67
3992,9.993750000002969,5126.7,94,32,0,126
3993,-23.94724999999943,2036.25,21,27,3,48
3994,-26.58299999999942,2156.75,21,30,1,51
3995,13.33375000000531,3488.764705882353,120,21,3,141
3996,11.23625000000384,4657.210526315789,111,23,3,134
3997,-9.986999999998538,2557.0,65,31,7,96
3998,-31.155249999999775,1429.0,17,33,9,50
3999,-30.233999999999277,2328.176470588235,36,39,4,75
4000,10.161500000003386,4391.85,88,19,3,107
4001,-6.556249999996706,3482.8333333333335,72,37,1,109
4002,-10.082749999998796,3490.1052631578946,73,30,14,103
4003,-2.049749999998466,3126.85,51,27,1,78
4004,-20.55074999999686,2094.8333333333335,58,22,14,80
4005,-5.5164999999980715,3121.0,62,36,1,98
4006,-32.95249999999892,2825.842105263158,38,27,15,65
4007,-9.460499999998861,2921.0555555555557,53,35,0,88
4008,-18.433249999999372,2008.4,24,24,0,48
4009,-10.428749999997084,3093.9411764705883,71,26,1,97
4010,-8.814999999995393,2421.764705882353,98,25,5,123
4011,-12.09549999999796,3245.6666666666665,60,35,2,95
4012,-31.075749999999932,1429.0,1,33,2,34
4013,-13.712999999998363,2348.6875,57,30,1,87
4014,-32.76749999999866,3184.7,38,39,2,77
4015,0.14275000000191057,3579.8,69,24,1,93
4016,-23.59149999999918,2445.0555555555557,38,35,1,73
4017,15.060000000002404,4320.3,81,25,1,106
4018,-34.778499999999596,2047.95,20,29,1,49
4019,-22.908499999999243,1967.0526315789473,25,26,5,51
4020,-14.740749999997126,4170.105263157895,81,34,3,115
4021,-6.707249999997957,3996.5,58,34,1,92
4022,3.036750000002201,3897.0526315789475,82,15,9,97
4023,-26.177249999998104,3217.842105263158,62,31,4,93
4024,-16.017499999998446,2778.4117647058824,56,24,15,80
4025,-17.55599999999721,4192.736842105263,73,38,7,111
4026,-12.64199999999816,2567.8,53,34,7,87
4027,-21.223249999998227,2465.470588235294,40,29,6,69
4028,-2.5624999999970783,4202.631578947368,89,27,1,116
4029,-11.062499999996204,5264.75,103,23,0,126
4030,3.0612500000013094,3599.7,65,23,1,88
4031,-11.488499999999254,2392.8333333333335,55,28,9,83
4032,-4.55899999999754,4352.85,75,31,1,106
4033,-19.03274999999929,2125.15,23,29,0,52
4034,-15.76124999999973,2052.6666666666665,38,31,15,69
4035,-33.73449999999955,2672.6666666666665,46,23,25,69
4036,-13.328249999998295,3245.315789473684,75,13,5,88
4037,-15.346499999998278,3324.35,55,26,4,81
4038,-8.423749999998366,3226.7,66,17,2,83
4039,-12.354999999998169,3200.1052631578946,69,21,4,90
4040,-16.937249999998095,3378.0526315789475,57,28,6,85
4041,-40.78849999999897,2097.5882352941176,34,43,17,77
4042,-16.86849999999884,2722.05,40,27,3,67
4043,-13.180749999999103,2729.0526315789475,52,29,13,81
4044,-11.77149999999855,3028.4,44,25,1,69
4045,-5.233749999998002,3983.842105263158,96,23,3,119
4046,-16.468249999998076,3028.3,52,22,2,74
4047,-12.414999999998257,3755.7368421052633,61,45,3,106
4048,-24.428249999998044,1835.8125,43,32,1,75
4049,-13.884499999998283,3284.6,55,31,0,86
4050,-22.44874999999838,2560.6666666666665,38,33,3,71
4051,-22.085999999998677,2497.7894736842104,41,15,7,56
4052,-2.323749999998165,3998.1,68,31,1,99
4053,-18.156749999998922,2610.85,45,23,0,68
4054,-22.56199999999886,1925.5555555555557,25,40,3,65
4055,-22.75124999999842,2846.5,33,31,4,64
4056,-8.143999999997988,3772.75,66,32,0,98
4057,-24.95099999999918,2065.6,20,28,3,48
4058,-31.705999999999072,2108.9444444444443,46,47,7,93
4059,9.922750000001937,3147.1176470588234,84,27,3,111
4060,-29.440249999999093,1839.75,44,27,2,71
4061,-14.561249999999086,2794.315789473684,45,31,1,76
4062,-9.547249999997167,4681.45,78,39,0,117
4063,-23.057749999999338,1933.4444444444443,58,23,10,81
4064,-5.324749999997099,4786.15,77,40,0,117
4065,-20.493749999998062,2291.125,44,34,7,78
4066,-20.315999999999505,2052.85,22,25,2,47
4067,-20.89974999999801,3243.7368421052633,62,21,0,83
4068,-3.516999999997612,3648.722222222222,70,34,2,104
4069,-18.8912499999977,2293.2727272727275,55,34,4,89
4070,-29.519999999999236,2044.15,22,24,3,46
4071,6.320500000003595,2952.8823529411766,97,19,2,116
4072,-21.39399999999815,2157.294117647059,46,27,2,73
4073,-43.93349999999877,2235.764705882353,21,45,2,66
4074,1.868250000002197,2634.5625,69,23,7,92
4075,-17.182749999998414,2699.842105263158,39,28,4,67
4076,-31.465249999999322,2017.3529411764705,28,31,5,59
4077,-25.575249999999418,2032.3,23,26,1,49
4078,-12.655249999999207,2552.3,33,24,4,57
4079,-8.78449999999874,3386.25,50,27,4,77
4080,-32.93149999999964,2050.722222222222,25,26,13,51
4081,23.805500000003427,5214.8,118,16,2,134
4082,-31.499499999998342,3510.85,55,27,4,82
4083,-11.93149999999874,3017.5714285714284,47,29,10,76
4084,-21.168499999998946,2211.470588235294,33,30,1,63
4085,-27.046749999998518,2592.3333333333335,39,32,1,71
4086,-18.047999999998687,2840.8823529411766,60,29,2,89
4087,-22.116499999997842,2740.6153846153848,80,29,3,109
4088,-16.934249999997995,3020.235294117647,52,34,2,86
4089,-15.737999999998241,2929.9444444444443,58,26,2,84
4090,-27.51149999999941,2055.684210526316,23,31,2,54
4091,-2.796249999998376,3023.2105263157896,52,20,13,72
4092,-19.944249999998053,4009.2,55,36,8,91
4093,-22.178999999999185,2087.1,26,22,4,48
4094,1.596500000002071,2986.875,66,21,5,87
4095,9.580750000002457,4746.5,91,22,3,113
4096,-20.693999999999114,1973.111111111111,36,24,6,60
4097,-0.23924999999874816,2348.6875,70,30,5,100
4098,-8.75874999999837,3201.25,56,20,2,76
4099,0.23950000000250968,3988.65,83,15,2,98
4100,6.773750000002427,3136.0,74,21,3,95
4101,-10.289249999998091,3638.55,62,24,3,86
4102,9.903500000002552,4302.1,81,24,2,105
4103,-27.460999999998798,1930.875,27,28,7,55
4104,-8.976499999997293,3141.6666666666665,62,29,3,91
4105,-7.556749999996812,3886.8947368421054,84,28,3,112
4106,-19.21924999999862,2634.5625,40,15,7,55
4107,-10.528499999997063,3487.9411764705883,96,12,2,108
4108,-1.840999999998391,3119.5555555555557,61,23,2,84
4109,-17.36499999999896,2649.0,46,28,10,74
4110,7.9490000000029655,4602.05,96,19,2,115
4111,-17.137999999998694,2639.9444444444443,57,30,18,87
4112,-13.520999999998589,2610.0,51,29,5,80
4113,-9.459999999998452,3176.294117647059,52,20,5,72
4114,-2.4747499999972034,4483.95,69,38,2,107
4115,-20.326499999998,1987.5625,60,39,5,99
4116,-27.434999999999615,2103.8,20,27,1,47
4117,-0.953249999997643,3732.35,70,18,4,88
4118,0.8300000000012655,3823.55,61,34,0,95
4119,-26.884499999997388,2652.294117647059,70,41,11,111
4120,-13.334499999998462,3401.3,45,38,1,83
4121,-6.62024999999835,3698.9,66,25,0,91
4122,-32.64800000000025,1429.0,15,36,28,51
4123,12.459750000002682,4087.4210526315787,91,16,4,107
4124,-3.4632499999981095,3476.6,50,33,2,83
4125,9.446750000003213,3898.222222222222,97,25,0,122
4126,-11.360749999997903,2134.1176470588234,50,24,3,74
4127,-9.211999999998854,2470.9473684210525,39,18,4,57
4128,-22.37849999999811,3379.05,47,39,0,86
4129,-23.310499999997838,2859.5882352941176,73,35,5,108
4130,-30.737499999997244,1429.0,48,32,7,80
4131,-13.75324999999761,4041.85,62,34,3,96
4132,-21.290249999998913,2263.8823529411766,36,24,3,60
4133,-17.428499999998756,2656.05,39,29,0,68
4134,4.862000000003753,5087.95,102,21,1,123
4135,-16.985499999998364,2561.785714285714,59,38,2,97
4136,-16.94224999999838,3634.65,52,38,1,90
4137,-21.593999999998026,2844.4444444444443,43,31,4,74
4138,-18.47849999999893,2656.0,40,22,4,62
4139,-5.8672499999979815,3086.684210526316,62,18,1,80
4140,6.413500000001998,3826.8,63,28,3,91
4141,-10.068249999999544,2580.9375,59,35,10,94
4142,-19.004499999998416,2580.2631578947367,37,29,0,66
4143,-24.93374999999821,2421.1666666666665,51,21,2,72
4144,-24.769749999998425,3027.9473684210525,43,39,2,82
4145,-29.319749999998443,2521.6111111111113,35,33,1,68
4146,-17.76799999999833,2457.6666666666665,65,36,8,101
4147,-17.930499999998112,2586.866666666667,51,27,6,78
4148,-4.015499999997373,4298.95,79,25,4,104
4149,-21.03274999999835,2563.5789473684213,42,23,4,65
4150,3.2675000000022023,4316.4,86,19,1,105
4151,-12.194999999999137,3180.2105263157896,80,28,8,108
4152,-23.278249999998344,3238.5789473684213,46,39,3,85
4153,-15.530249999998967,2561.0526315789475,47,27,5,74
4154,-6.806999999998463,3171.15,55,25,1,80
4155,-30.53524999999853,2596.8125,43,35,8,78
4156,-33.02324999999816,2828.5555555555557,43,34,7,77
4157,-14.814499999997462,2519.375,59,23,7,82
4158,-5.668249999997545,3193.5263157894738,68,21,0,89
4159,-6.083999999997895,3591.7,61,25,5,86
4160,-24.66349999999888,2167.15,25,27,1,52
4161,9.321750000002014,3615.6,76,17,1,93
4162,-27.622499999997792,3999.65,61,35,0,96
4163,-23.703749999998347,2709.3,39,24,4,63
4164,-25.767249999999365,2008.4,26,22,0,48
4165,-3.7364999999981614,2358.3333333333335,68,25,3,93
4166,-12.105249999998161,2484.176470588235,55,27,5,82
4167,-15.63099999999881,2907.7368421052633,43,41,0,84
4168,-18.598999999998938,2005.5,68,20,1,88
4169,0.3585000000033089,4666.45,81,31,4,112
4170,-3.867749999998529,3567.2,55,25,3,80
4171,-21.212999999998758,3037.2105263157896,47,30,5,77
4172,-21.025249999999172,2454.176470588235,52,51,3,103
4173,-6.768749999996817,4443.3,85,25,2,110
4174,-29.884749999999563,2028.3,21,21,3,42
4175,-16.549749999997417,4698.95,92,21,2,113
4176,-10.799249999998663,2438.6666666666665,44,26,5,70
4177,-15.444499999998252,2695.7,42,24,1,66
4178,-10.783999999999157,2503.222222222222,44,30,2,74
4179,-16.72349999999846,2521.0,45,34,5,79
4180,-7.9349999999987615,2631.9444444444443,61,19,5,80
4181,-8.051749999996876,4902.2,100,21,1,121
4182,7.338000000002009,2949.3333333333335,76,22,2,98
4183,-8.866999999997692,3077.235294117647,66,24,3,90
4184,-14.39749999999891,2649.0,45,33,0,78
4185,-37.71824999999945,2372.2105263157896,23,37,12,60
4186,-12.035999999998404,3104.4,52,24,1,76
4187,-1.0192499999974012,3682.9473684210525,71,26,4,97
4188,-0.0932499999972558,4469.55,80,28,0,108
4189,-4.123499999998518,3064.15,60,13,0,73
4190,15.519250000003307,5171.2,108,21,1,129
4191,-34.50749999999755,2366.529411764706,39,33,7,72
4192,6.426750000002393,3779.1111111111113,83,30,1,113
4193,-24.533249999998876,2005.4375,46,30,7,76
4194,-21.89824999999917,2690.764705882353,31,25,1,56
4195,-16.91649999999809,2425.235294117647,51,25,6,76
4196,-20.876749999997276,3409.785714285714,58,27,8,85
4197,-29.651499999999096,1937.9411764705883,32,32,7,64
4198,-15.509499999997235,4161.736842105263,82,27,3,109
4199,-32.83749999999852,2846.0833333333335,45,40,5,85
4200,-27.953999999998377,2104.8947368421054,34,25,4,59
4201,-19.862999999998422,3318.05,52,26,3,78
4202,-5.349499999999219,3049.0526315789475,55,38,6,93
4203,-2.5594999999985055,2670.125,65,26,2,91
4204,-6.706749999997884,3500.8947368421054,63,29,3,92
4205,-18.85749999999926,2028.7222222222222,35,22,5,57
4206,-20.486999999997902,2965.222222222222,60,30,10,90
4207,-2.6299999999970174,3979.7368421052633,81,26,4,107
4208,-4.431499999997448,4427.55,72,40,1,112
4209,-26.79649999999929,2028.25,27,17,5,44
4210,-15.219499999996819,3639.8333333333335,77,39,5,116
4211,-21.303749999999802,2305.4736842105262,38,34,14,72
4212,-12.751249999998002,2374.375,55,42,1,97
4213,-13.960749999999203,1862.2941176470588,38,22,3,60
4214,-29.4944999999988,2307.764705882353,51,24,8,75
4215,-13.38374999999839,2579.777777777778,50,23,5,73
4216,-39.305749999999726,1429.0,16,51,6,67
4217,-26.083249999999374,2042.5,26,21,4,47
4218,-35.307249999998895,2079.842105263158,27,19,2,46
4219,-10.377249999999382,1989.0555555555557,29,26,12,55
4220,-6.055499999998449,3079.95,51,23,2,74
4221,1.6072500000030039,4979.9,89,32,3,121
4222,-25.426499999998793,2627.0526315789475,36,32,2,68
4223,-12.854249999998824,2349.764705882353,46,27,10,73
4224,-16.691999999997996,2650.5263157894738,45,28,1,73
4225,-17.500999999998147,2489.6470588235293,60,30,4,90
4226,16.596500000003644,4871.25,98,17,5,115
4227,-4.55749999999895,2507.4375,49,25,6,74
4228,-8.076499999996601,3740.7894736842104,82,13,6,95
4229,-18.581249999998,3859.2631578947367,66,38,5,104
4230,19.574000000002403,2813.0625,82,13,5,95
4231,-34.472499999998824,1603.625,38,44,6,82
4232,-20.080749999997444,3206.9473684210525,58,27,5,85
4233,-35.000999999999166,2008.3,26,15,5,41
4234,-7.7444999999980295,3695.85,73,18,0,91
4235,1.6160000000033619,4764.8,94,22,0,116
4236,-24.121749999997792,3740.95,58,27,6,85
4237,-9.09999999999857,1981.2666666666667,66,23,4,89
4238,-43.36799999999949,2637.5,46,34,19,80
4239,0.43425000000202585,2529.1875,55,32,1,87
4240,-7.744749999997931,3682.2,62,28,1,90
4241,21.358000000004413,5008.5,109,15,4,124
4242,-11.385749999999026,2804.2631578947367,50,34,4,84
4243,-23.665499999998605,2400.5333333333333,59,26,2,85
4244,-20.44724999999828,2616.705882352941,69,35,10,104
4245,12.464750000002184,4373.55,85,28,0,113
4246,-16.21949999999847,3103.7,49,24,2,73
4247,-28.936999999999237,1908.1176470588234,31,35,2,66
4248,-14.795249999998997,2468.722222222222,43,29,2,72
4249,-21.76199999999678,2512.722222222222,62,28,6,90
4250,-22.758999999997304,2673.277777777778,66,16,8,82
4251,5.520000000002688,4675.85,95,24,2,119
4252,-11.76649999999891,2619.5263157894738,43,27,1,70
4253,-19.02499999999813,2381.6,68,36,3,104
4254,-23.573749999999148,2244.1,25,22,7,47
4255,-5.436999999998056,4127.6,66,29,5,95
4256,-15.523499999997501,4117.15,68,30,4,98
4257,-9.38924999999786,4382.3,81,26,2,107
4258,-5.381249999997709,3037.0,59,29,4,88
4259,-21.569249999999094,2711.4736842105262,38,30,12,68
4260,7.6372500000026005,4706.85,96,18,1,114
4261,-25.817749999998547,2022.9473684210527,23,19,19,42
4262,-7.212749999998993,2544.4,40,27,1,67
4263,-19.67949999999858,2798.375,38,29,0,67
4264,5.645000000002715,5047.4,105,21,1,126
4265,-21.66874999999812,2110.6470588235293,33,28,6,61
4266,10.949750000002727,4792.55,94,25,0,119
4267,-14.09399999999901,2385.8333333333335,62,24,5,86
4268,-9.310999999997968,3684.7368421052633,64,38,3,102
4269,-5.619999999998987,2748.2631578947367,46,30,17,76
4270,-21.744749999999115,2459.15,26,34,2,60
4271,-26.521749999999578,2190.9473684210525,30,28,12,58
4272,-13.625749999998664,3095.7,46,27,2,73
4273,-6.1754999999977995,3568.3333333333335,78,31,5,109
4274,-7.85499999999732,3310.1111111111113,71,22,1,93
4275,-10.642249999998095,3368.75,51,27,3,78
4276,-12.992499999998739,2466.9444444444443,43,27,1,70
4277,-21.251499999998337,2595.3684210526317,47,29,2,76
4278,-21.21749999999882,2654.5789473684213,39,29,1,68
4279,-4.07399999999798,2984.6470588235293,56,38,5,94
4280,0.6310000000018249,2221.6,68,24,1,92
4281,-49.75325000000019,1429.0,10,48,7,58
4282,-9.054999999996937,3038.823529411765,102,24,2,126
4283,-9.09924999999826,3186.2,60,18,0,78
4284,-9.208749999998428,2581.4,48,33,2,81
4285,-10.397749999997968,2928.764705882353,65,19,3,84
4286,-17.15199999999882,2706.15,39,33,1,72
4287,-7.69299999999686,3926.2105263157896,82,25,2,107
4288,-11.94599999999851,2184.0625,54,25,3,79
4289,-20.816999999998643,2587.7894736842104,39,24,5,63
4290,-26.181749999999386,2013.7894736842106,24,23,3,47
4291,-5.225999999997799,3703.65,65,20,5,85
4292,-37.17549999999961,1982.8333333333333,24,28,15,52
4293,2.766750000003143,2787.1875,80,27,6,107
4294,6.306000000002517,2728.625,111,21,6,132
4295,-0.9399999999969829,4613.2,94,19,0,113
4296,-5.353749999997662,4181.55,76,24,1,100
4297,-29.540499999998566,2241.1052631578946,29,30,4,59
4298,-9.780749999997932,2453.4,55,30,3,85
4299,-25.944749999998912,2714.05,30,34,3,64
4300,0.3820000000021972,3100.1666666666665,79,32,6,111
4301,-17.545749999998584,2039.0,33,30,3,63
4302,-16.84449999999823,2120.5,43,26,4,69
4303,-17.52949999999823,2114.4117647058824,55,32,3,87
4304,-4.3584999999992675,2018.375,69,35,2,104
4305,-2.1139999999974117,3077.0588235294117,77,25,1,102
4306,-19.445499999998784,2679.15,32,34,0,66
4307,-33.26899999999954,1911.125,46,43,12,89
4308,-32.62249999999941,2109.705882352941,25,50,4,75
4309,-14.403999999997268,4805.8421052631575,102,37,7,139
4310,-24.77699999999866,2434.6,26,23,7,49
4311,-3.9977499999951407,2026.764705882353,95,24,9,119
4312,-15.601999999998672,2521.0,40,28,3,68
4313,-7.9754999999978535,3937.2,67,25,4,92
4314,-11.862249999998173,3115.6,54,22,1,76
4315,-0.719749999998986,2919.6,38,36,3,74
4316,4.1952500000026465,4471.3,90,19,2,109
4317,-18.37200000000001,1913.1666666666667,28,28,19,56
4318,-20.1632499999994,2214.4117647058824,59,36,3,95
4319,-23.723749999998542,2679.5555555555557,57,35,5,92
4320,14.704500000003682,3086.0,88,27,5,115
4321,-36.77124999999988,1877.9444444444443,21,29,15,50
4322,-17.787499999999206,2560.4210526315787,34,27,6,61
4323,-12.475249999998981,2560.0,36,26,2,62
4324,-11.780499999998309,3578.4736842105262,56,39,2,95
4325,-12.599249999998227,3357.85,55,23,6,78
4326,-1.3307499999970056,2608.5625,88,25,3,113
4327,-30.73474999999892,2038.8947368421052,27,13,11,40
4328,-4.497249999997031,4174.3,85,17,2,102
4329,-15.699249999999301,2135.5,30,30,1,60
4330,-9.653999999999114,2286.0625,50,32,1,82
4331,1.5432500000019425,3897.35,73,21,1,94
4332,-5.477749999998418,3056.0,50,24,2,74
4333,-12.778749999997839,3211.4444444444443,61,28,6,89
4334,-31.354999999999478,1965.1666666666667,47,25,12,72
4335,-18.329749999999002,2726.1666666666665,60,42,3,102
4336,-26.534749999999367,2107.6,21,29,3,50
4337,-6.712749999997955,3864.85,74,23,0,97
4338,-10.009499999998074,2436.125,57,26,5,83
4339,-27.248249999996155,1877.7333333333333,73,34,8,107
4340,-16.324249999998962,2007.0588235294117,34,33,6,67
4341,-5.748999999998118,3761.55,72,20,1,92
4342,-12.500499999997873,3718.75,56,33,3,89
4343,-20.08974999999779,3821.15,65,29,3,94
4344,-22.3969999999987,2792.55,40,20,6,60
4345,-25.76049999999885,2688.1875,36,26,2,62
4346,-26.321749999997724,1946.4117647058824,47,31,5,78
4347,-4.5879999999988845,2633.285714285714,42,26,4,68
4348,-49.681999999998844,1429.0,8,31,7,39
4349,5.19725000000283,5018.05,106,15,2,121
4350,-11.649499999998794,2457.4444444444443,37,31,2,68
4351,-22.21749999999831,2571.875,41,36,2,77
4352,-2.304999999998403,2943.222222222222,62,20,3,82
4353,-3.403249999997604,3864.75,74,20,2,94
4354,-37.887499999999356,1429.0,23,38,9,61
4355,1.4530000000016523,3575.2105263157896,63,32,1,95
4356,-9.973749999996981,3737.8333333333335,86,20,2,106
4357,-15.011249999997602,3240.3684210526317,50,35,7,85
4358,-29.359749999999302,2015.55,19,28,1,47
4359,-6.589999999996938,2695.6428571428573,76,21,3,97
4360,-6.787999999997554,4407.7,93,13,3,106
4361,-0.016499999997498273,4948.9,88,35,1,123
4362,-11.352499999998757,3074.8947368421054,53,27,6,80
4363,-22.429499999998217,3513.2,59,27,1,86
4364,-8.024999999997979,3871.2,61,30,2,91
4365,8.766500000002116,4159.25,85,19,2,104
4366,-7.277499999997195,3984.75,81,17,2,98
4367,-31.992749999998626,2881.4444444444443,46,43,3,89
4368,-18.71499999999809,2388.0,41,29,5,70
4369,-35.158999999997924,1966.8235294117646,37,29,13,66
4370,-29.521749999999276,2008.5,25,22,2,47
4371,-9.434749999999491,1975.235294117647,44,33,9,77
4372,-15.48624999999831,2657.8,47,30,5,77
4373,-14.846499999998281,2483.777777777778,41,32,2,73
4374,-31.497749999998483,2476.8125,46,40,15,86
4375,-8.327749999997879,2741.6875,70,29,1,99
4376,-9.97874999999884,3177.35,49,26,3,75
4377,8.447500000002163,3439.6666666666665,80,22,4,102
4378,-9.363499999998178,2803.0625,73,21,6,94
4379,-19.681499999998533,2387.375,56,37,9,93
4380,-17.383249999998807,2768.0,41,33,2,74
4381,-2.5072499999961275,4608.55,89,19,5,108
4382,-17.110999999998143,2542.9411764705883,72,39,13,111
4383,-29.83024999999959,2040.7058823529412,31,34,16,65
4384,-19.37049999999831,4545.05,62,40,4,102
4385,-1.0984999999971936,3571.9473684210525,74,22,3,96
4386,-7.803749999998667,2523.5,51,25,5,76
4387,-27.585749999995425,2636.3333333333335,63,20,21,83
4388,-10.46249999999905,2622.0526315789475,37,34,4,71
4389,-8.38424999999721,3766.7368421052633,69,37,2,106
4390,-16.35249999999835,2871.5714285714284,45,29,1,74
4391,-6.718499999999222,2761.65,40,28,4,68
4392,-8.59524999999795,2697.8333333333335,52,34,5,86
4393,-29.192999999999568,1959.578947368421,21,21,11,42
4394,-15.568499999998881,3001.3684210526317,48,32,6,80
4395,10.22850000000307,5238.65,108,26,0,134
4396,-13.633999999997886,2430.0588235294117,80,25,7,105
4397,-13.359499999997501,4246.5,66,37,4,103
4398,-10.940249999998255,2973.842105263158,65,16,3,81
4399,-1.4994999999975671,4379.8,80,26,4,106
4400,3.2580000000024354,3548.277777777778,74,24,1,98
4401,-5.49374999999873,2350.529411764706,59,16,2,75
4402,-4.227749999998041,3612.0526315789475,64,31,3,95
4403,-20.84724999999836,2507.529411764706,45,26,5,71
4404,-18.941999999998632,3810.0,62,29,1,91
4405,-30.205999999998983,2027.25,24,34,5,58
4406,-26.70299999999919,2434.0526315789475,27,33,8,60
4407,1.986500000002789,4237.9,93,13,0,106
4408,-0.11824999999808998,3428.2,64,19,2,83
4409,-29.03349999999769,4385.45,54,54,3,108
4410,-20.95499999999883,3132.5263157894738,48,43,14,91
4411,-23.817249999996996,2163.125,62,31,7,93
4412,0.6397500000026215,5143.4,94,25,4,119
4413,-30.52149999999882,2123.315789473684,24,22,9,46
4414,-14.224749999999002,2640.35,43,24,1,67
4415,-11.72224999999923,2564.0,38,23,5,61
4416,-16.9797499999991,2195.85,26,26,1,52
4417,-19.458749999998894,2587.85,38,25,2,63
4418,-13.059749999998946,3027.2631578947367,54,28,10,82
4419,-20.23624999999809,2376.764705882353,51,33,3,84
4420,-11.424749999998639,2383.235294117647,57,26,2,83
4421,-10.214749999998073,3666.3684210526317,76,24,8,100
4422,-3.4577499999988426,2960.8888888888887,55,30,3,85
4423,-9.798749999998055,2602.714285714286,66,32,2,98
4424,2.3252500000017307,3455.7368421052633,66,22,2,88
4425,5.167000000002071,4932.3,96,23,3,119
4426,-37.63299999999926,2087.15,19,26,3,45
4427,-3.3137499999981292,3047.3333333333335,57,37,1,94
4428,-16.22949999999886,2709.7368421052633,42,33,3,75
4429,-10.845499999999104,3317.85,56,21,4,77
4430,-8.86524999999859,2384.5,60,39,3,99
4431,-10.38499999999782,3142.6315789473683,57,23,3,80
4432,0.26000000000171425,3555.2,67,21,0,88
4433,-36.9127499999981,1528.25,34,32,6,66
4434,-26.592000000000006,1997.1052631578948,22,20,26,42
4435,-1.4887499999975007,4471.2,80,28,3,108
4436,-31.802249999998416,2309.9166666666665,32,25,5,57
4437,-19.144249999999026,1909.6666666666667,47,35,8,82
4438,-34.37224999999973,2770.0,43,34,17,77
4439,-13.930999999998605,2735.0666666666666,38,28,1,66
4440,5.712500000002166,2413.2,63,20,3,83
4441,-17.74074999999806,3084.3888888888887,61,23,3,84
4442,-21.201749999999,2099.0526315789475,28,27,1,55
4443,-10.27749999999808,3401.25,44,38,1,82
4444,-9.565249999998219,4294.05,78,27,1,105
4445,-22.63124999999889,2538.3333333333335,36,30,1,66
4446,-21.54849999999889,2411.3125,50,39,14,89
4447,-19.177999999999503,2136.3,24,27,2,51
4448,-26.009749999998576,2038.9473684210527,24,30,5,54
4449,-21.07374999999801,2291.125,54,32,4,86
4450,-2.0664999999983005,1920.0666666666666,73,18,9,91
4451,-10.457499999999191,2027.1875,36,31,2,67
4452,-22.114749999999056,2803.7,37,24,7,61
4453,-16.275999999998728,2544.2,40,24,1,64
4454,-17.20074999999887,3044.2,40,34,2,74
4455,-3.809499999997864,2956.705882352941,73,28,3,101
4456,-21.68124999999963,2495.0526315789475,52,26,13,78
4457,-0.17224999999807417,2457.6,64,28,7,92
4458,0.7350000000017405,3186.4,57,24,1,81
4459,-19.1592499999987,2999.0,36,38,1,74
4460,17.25400000000159,2372.133333333333,80,25,2,105
4461,-20.058999999998985,2581.5333333333333,39,39,4,78
4462,-18.03274999999774,2681.1111111111113,48,20,9,68
4463,9.722750000003149,5003.55,94,34,1,128
4464,-5.140749999998102,2718.6470588235293,69,31,2,100
4465,-8.898499999998906,2803.0,37,24,7,61
4466,-2.6994999999983778,3663.2,64,23,4,87
4467,-1.9217499999982208,2711.0588235294117,62,27,4,89
4468,-19.64174999999893,2654.5263157894738,43,26,3,69
4469,-34.274749999998335,2831.7368421052633,39,28,8,67
4470,-1.5977499999981486,3679.8,79,12,1,91
4471,-14.81824999999788,2280.8333333333335,51,20,4,71
4472,11.867250000003523,4953.85,104,18,3,122
4473,3.4490000000016856,3910.75,69,25,2,94
4474,-0.138999999998771,2459.277777777778,42,24,8,66
4475,-24.196499999998856,2939.6923076923076,44,31,3,75
4476,-8.282749999998277,3181.45,50,26,3,76
4477,-12.10424999999835,2857.6666666666665,59,30,4,89
4478,-14.635749999999188,1904.2941176470588,40,25,1,65
4479,-40.48924999999757,4640.25,49,49,4,98
4480,-8.996499999999521,2423.777777777778,44,39,12,83
4481,-28.11874999999978,2059.842105263158,29,31,11,60
4482,-21.82824999999872,2686.8823529411766,36,24,2,60
4483,-8.597499999998101,2718.6153846153848,46,43,3,89
4484,-16.264249999998373,3590.15,57,35,1,92
4485,15.931500000003178,3084.5882352941176,103,20,0,123
4486,-5.41399999999828,2320.3846153846152,44,17,4,61
4487,-7.062749999997784,3756.05,62,21,8,83
4488,-13.173749999997293,4395.65,75,29,5,104
4489,-7.6804999999991965,2196.9375,68,42,2,110
4490,-32.527499999997914,2352.25,40,23,6,63
4491,-9.847499999998531,3056.15,55,21,0,76
4492,-12.642999999998638,2546.705882352941,44,34,1,78
4493,-28.22974999999831,4037.05,55,39,2,94
4494,-20.24424999999889,3515.2631578947367,63,33,12,96
4495,-16.24449999999836,2486.2,56,28,6,84
4496,-15.262499999998806,3225.05,51,25,4,76
4497,-14.020499999998785,2614.0,42,25,0,67
4498,-7.844499999997254,3298.4444444444443,84,12,4,96
4499,-0.22249999999882375,2658.8947368421054,40,30,5,70
4500,-20.196249999997985,2599.8823529411766,69,37,4,106
4501,-25.10674999999889,3177.5263157894738,66,37,6,103
4502,-26.96049999999811,2579.4117647058824,50,23,5,73
4503,4.236250000001826,3840.8947368421054,69,37,7,106
4504,-14.17774999999888,2559.85,36,25,1,61
4505,-26.80599999999898,2017.9473684210527,23,28,4,51
4506,-29.724249999999387,1946.9375,56,40,9,96
4507,-31.11799999999938,1857.6875,44,33,12,77
4508,-13.995749999998711,2536.25,65,38,3,103
4509,-11.766749999998613,1916.1875,42,24,5,66
4510,-17.336999999998746,2762.6666666666665,37,28,2,65
4511,2.8342500000037414,2764.3529411764707,87,25,5,112
4512,-2.078749999996372,3020.0,79,20,5,99
4513,-22.287749999998773,2463.3888888888887,41,27,2,68
4514,-29.895499999999014,1895.8823529411766,25,34,5,59
4515,-15.692249999998442,2776.75,43,23,2,66
4516,-17.853499999998746,3253.5789473684213,55,28,5,83
4517,-29.075999999999333,2143.294117647059,36,39,1,75
4518,7.329750000001701,3631.45,69,16,3,85
4519,15.067000000002945,3542.8333333333335,96,28,4,124
4520,-16.857249999999212,2126.529411764706,38,38,2,76
4521,-15.622499999997924,2762.315789473684,46,26,6,72
4522,-23.902999999997952,3341.7,46,32,5,78
4523,8.414500000003105,3741.7368421052633,87,12,5,99
4524,3.5177500000038733,5175.15,99,30,3,129
4525,15.871000000003045,4523.578947368421,102,26,2,128
4526,-45.478749999997504,1964.75,64,53,9,117
4527,2.24750000000216,4144.9,77,26,1,103
4528,-26.107749999999662,2018.0526315789473,20,19,10,39
4529,0.9617500000031773,2518.4375,69,24,12,93
4530,-22.365999999998714,2515.4375,49,33,11,82
4531,1.670250000002122,3118.0,83,41,6,124
4532,-32.28674999999958,2159.2105263157896,23,34,13,57
4533,-8.898749999998186,3867.95,72,25,2,97
4534,5.438250000002237,3809.35,62,32,4,94
4535,-24.922499999999026,2562.0,30,36,11,66
4536,-8.293249999997906,3432.3684210526317,60,28,2,88
4537,-9.000999999998571,2747.923076923077,48,24,0,72
4538,-27.859249999998646,2181.764705882353,45,35,7,80
4539,-19.594499999997982,3209.3684210526317,54,29,5,83
4540,0.8980000000017523,3042.529411764706,68,22,1,90
4541,-21.04074999999865,2608.684210526316,35,31,3,66
4542,-28.13524999999894,2741.1176470588234,33,19,6,52
4543,-5.479999999998128,2575.133333333333,68,29,5,97
4544,-24.739499999999317,2008.45,23,24,0,47
4545,-14.225249999998336,4272.75,69,28,1,97
4546,-4.577999999997855,3879.0,69,27,2,96
4547,-36.12649999999833,2907.0,36,40,9,76
4548,-3.123499999997997,3790.95,71,23,3,94
4549,-37.8752499999975,4184.65,62,29,8,91
4550,0.9430000000016859,1826.9375,89,29,0,118
4551,-3.5884999999977554,3898.2,64,32,1,96
4552,7.189250000001922,4498.15,73,34,3,107
4553,-8.018499999998632,3097.45,49,26,2,75
4554,-23.907499999998496,3235.6875,30,36,1,66
4555,-7.56749999999837,3095.8,49,22,6,71
4556,-21.228249999998802,2757.7,32,32,6,64
4557,-5.527499999997637,3628.8947368421054,71,24,4,95
4558,-5.297499999997868,4618.736842105263,105,24,2,129
4559,-4.9222499999974785,3979.95,66,32,2,98
4560,-15.841999999997,2297.777777777778,38,29,22,67
4561,10.770000000002637,4094.3,77,26,0,103
4562,-11.239749999998981,2580.9375,38,22,2,60
4563,-20.596999999998182,2475.8333333333335,35,27,10,62
4564,-34.11949999999908,2165.842105263158,27,30,0,57
4565,-25.563499999999298,2028.25,23,22,2,45
4566,9.044500000001754,2381.5333333333333,87,27,1,114
4567,4.631250000002129,3820.55,75,19,2,94
4568,0.7210000000017637,2604.6470588235293,55,28,5,83
4569,-14.606749999998542,2793.45,42,20,6,62
4570,-25.216499999998526,1956.157894736842,21,28,6,49
4571,-11.61024999999892,2825.9444444444443,46,43,4,89
4572,-12.554999999997596,3214.777777777778,59,30,4,89
4573,-15.643749999997969,2519.705882352941,65,38,2,103
4574,-16.813999999998984,2425.5555555555557,66,26,11,92
4575,-25.404749999997318,2471.6875,71,24,3,95
4576,-17.714999999998746,2544.2,37,24,3,61
4577,-33.56349999999869,2128.4210526315787,24,26,8,50
4578,-22.364999999998766,2780.7,40,27,2,67
4579,-18.573249999997888,3871.7894736842104,84,22,6,106
4580,-5.801749999997824,4948.95,87,25,8,112
4581,-26.635249999998546,3164.05,47,32,2,79
4582,-32.04099999999938,2040.15,27,17,4,44
4583,-2.1394999999982165,3649.7368421052633,90,17,4,107
4584,-27.450249999998693,2540.1,39,22,1,61
4585,-22.69124999999814,3158.45,48,25,2,73
4586,-9.286249999998997,2556.0,38,27,2,65
4587,-12.19499999999882,2682.05,34,26,5,60
4588,-7.333249999998595,2709.842105263158,41,26,9,67
4589,-19.978749999998918,2532.3,34,29,3,63
4590,-18.689499999998816,2833.0714285714284,38,22,5,60
4591,-10.366749999998559,2328.5,37,23,3,60
4592,-20.865999999999367,1848.625,49,46,4,95
4593,5.399500000004212,2298.4117647058824,106,19,1,125
4594,-12.339499999997951,4047.25,73,24,1,97
4595,-12.554999999996966,2921.176470588235,75,26,2,101
4596,-16.07599999999928,2417.6111111111113,51,25,11,76
4597,9.382500000004157,2137.4375,92,23,8,115
4598,-31.400999999999833,1987.8947368421052,32,28,10,60
4599,-18.939999999998868,2460.777777777778,38,27,1,65
4600,4.36750000000299,3442.0,112,27,3,139
4601,14.764750000003184,3240.4117647058824,91,32,4,123
4602,-26.683249999997695,2640.9411764705883,56,30,7,86
4603,-21.8872499999987,1890.2222222222222,33,28,2,61
4604,-11.209249999997827,3385.153846153846,66,30,1,96
4605,-21.031749999998798,2076.5263157894738,21,30,6,51
4606,-24.24499999999856,2640.176470588235,40,24,5,64
4607,-8.136499999998055,2548.3888888888887,44,31,2,75
4608,-9.874499999998864,2339.4117647058824,60,28,7,88
4609,-30.58174999999925,2020.8333333333333,24,30,11,54
4610,2.6535000000021056,2406.529411764706,90,30,7,120
4611,-11.226499999997289,4294.25,78,28,0,106
4612,-9.903999999998216,3303.6,51,26,1,77
4613,-23.715999999999067,2135.4,24,28,0,52
4614,-17.659499999998918,2506.7368421052633,41,22,2,63
4615,-6.534999999998144,3468.7,62,26,1,88
4616,-7.668999999998357,2431.764705882353,66,37,3,103
4617,-18.982999999998743,2468.0555555555557,39,24,6,63
4618,11.448750000002086,4119.55,80,20,3,100
4619,-0.984249999998751,3802.4210526315787,76,28,2,104
4620,-26.244249999999102,2509.3684210526317,28,32,6,60
4621,-21.07424999999908,2607.6,40,25,1,65
4622,-23.844499999999137,2664.529411764706,58,38,7,96
4623,-7.159749999998539,2916.705882352941,56,36,1,92
4624,-8.427499999997885,2570.866666666667,81,35,6,116
4625,-10.756499999998265,3168.8,58,19,2,77
4626,-25.30149999999911,2059.7368421052633,25,31,1,56
4627,18.771000000003,3640.722222222222,86,15,3,101
4628,7.106750000002447,2427.0666666666666,105,20,5,125
4629,-24.850749999998904,2014.3125,30,27,0,57
4630,-16.583249999999087,2810.85,37,28,3,65
4631,-8.366249999998319,3118.1176470588234,71,33,3,104
4632,-19.37874999999773,4111.6,64,32,1,96
4633,-20.65599999999896,2419.4444444444443,42,27,2,69
4634,8.073000000001622,2893.4375,89,21,1,110
4635,-28.963999999999242,2145.75,26,23,2,49
4636,2.1692500000044164,2189.0,101,22,3,123
4637,-3.3542499999980024,3713.1,66,23,2,89
4638,-26.68849999999869,2606.8,33,23,5,56
4639,-4.428249999998428,3475.85,56,34,0,90
4640,-37.793749999999484,1840.764705882353,56,42,2,98
4641,-14.162249999999213,2652.9,34,26,6,60
4642,-11.547249999996785,2532.277777777778,65,26,5,91
4643,-17.844749999998275,3480.0526315789475,64,33,0,97
4644,-26.33224999999926,1958.9444444444443,38,27,2,65
4645,-27.48199999999803,2534.8888888888887,54,24,0,78
4646,-14.877499999998387,3601.4,63,23,3,86
4647,-12.864999999998073,2958.1111111111113,58,20,4,78
4648,-12.066249999998158,1995.5625,59,33,2,92
4649,-0.5404999999984847,3439.4,57,29,2,86
4650,-25.455749999999114,2175.9473684210525,27,22,7,49
4651,-38.38149999999969,2151.277777777778,32,39,12,71
4652,-8.37549999999843,2627.0,72,44,1,116
4653,11.184250000002582,3214.0,94,18,0,112
4654,-17.30999999999884,2548.25,36,27,1,63
4655,-0.1224999999971101,2596.4,92,36,4,128
4656,-10.293749999999273,2685.5789473684213,46,21,5,67
4657,-9.697749999998049,4148.85,66,35,2,101
4658,-24.459499999998496,3858.3,49,39,6,88
4659,-17.832499999998966,2353.3529411764707,45,28,2,73
4660,-15.371249999998117,2072.8333333333335,41,28,1,69
4661,-23.467249999999453,2093.2105263157896,18,33,1,51
4662,17.93650000000242,3921.2631578947367,86,24,4,110
4663,-33.05499999999954,2110.0,25,28,3,53
4664,-17.775749999998336,2733.277777777778,45,27,3,72
4665,-0.9117499999978141,3977.0526315789475,83,38,0,121
4666,8.122750000004089,2313.0,97,26,6,123
4667,-16.321999999999484,2493.315789473684,41,26,4,67
4668,-25.345499999999078,2098.85,26,25,2,51
4669,-12.131999999998904,2738.8333333333335,67,44,2,111
4670,1.269000000002653,4108.55,80,20,0,100
4671,-24.431499999999385,2235.705882352941,42,44,10,86
4672,-5.410749999998468,4573.5,75,37,1,112
4673,-18.328499999998805,2543.684210526316,40,22,4,62
4674,-3.7814999999985175,3674.684210526316,95,21,4,116
4675,-15.973749999997006,4603.05,79,31,3,110
4676,-12.380749999998724,2429.25,47,37,5,84
4677,0.9022500000035437,2632.214285714286,82,23,2,105
4678,-6.994749999998113,3655.2,67,26,2,93
4679,-20.268749999998892,1910.8235294117646,48,24,1,72
4680,-9.660499999997466,2797.0,90,24,3,114
4681,-12.623249999996926,2619.6428571428573,76,33,2,109
4682,-27.077499999998366,2891.8,42,28,0,70
4683,-18.311749999999503,2542.722222222222,41,28,20,69
4684,-14.257749999998698,1943.0,37,28,4,65
4685,-0.0479999999977184,4318.7,88,21,1,109
4686,-20.713749999998747,3693.157894736842,65,33,4,98
4687,-6.068249999998626,3075.9,55,26,0,81
4688,-33.41024999999924,2245.75,24,28,1,52
4689,-1.5037499999983819,3008.9473684210525,66,11,4,77
4690,0.7202500000016144,3113.1,60,16,1,76
4691,-24.050999999998847,1921.1176470588234,41,25,2,66
4692,-24.445749999998892,2861.6,38,27,1,65
4693,-18.406749999997555,3385.9444444444443,72,28,0,100
4694,-9.270999999998029,2670.0,47,40,2,87
4695,-13.779249999998871,2450.222222222222,44,24,0,68
4696,-27.331499999998847,2509.5625,48,35,9,83
4697,-23.019749999999163,2630.6,38,22,1,60
4698,-8.976999999998075,3005.176470588235,81,32,3,113
4699,-20.45674999999904,2170.125,33,29,0,62
4700,-28.75124999999857,2498.6666666666665,40,31,6,71
4701,5.35025000000189,3321.2,63,17,1,80
4702,-13.992249999998737,2643.9411764705883,42,21,1,63
4703,-14.761999999999622,2087.722222222222,50,26,4,76
4704,-6.319749999998559,2434.4666666666667,82,30,6,112
4705,5.813250000001572,3834.315789473684,88,31,0,119
4706,3.330000000002123,3699.7368421052633,78,18,4,96
4707,-7.977249999997373,3464.470588235294,87,34,2,121
4708,-2.925249999998047,3458.4210526315787,78,10,3,88
4709,-27.172499999999086,2023.8947368421052,17,33,2,50
4710,-22.566749999997917,2778.235294117647,56,35,2,91
4711,-24.409249999999112,2064.0588235294117,33,32,2,65
4712,4.904500000002466,3561.3333333333335,88,24,3,112
4713,-12.349249999998875,2944.5789473684213,53,24,10,77
4714,-19.183499999999007,2232.5625,70,32,6,102
4715,6.986000000002396,3826.0526315789475,85,20,1,105
4716,-6.8449999999985085,2328.5,56,22,1,78
4717,0.931000000001718,2542.9411764705883,65,26,2,91
4718,-19.992749999998242,2610.133333333333,78,38,2,116
4719,-26.07174999999837,2632.0,36,33,5,69
4720,-11.790249999998698,2533.866666666667,55,31,1,86
4721,-24.485999999998878,1986.2631578947369,18,33,2,51
4722,-2.72324999999839,3120.4,55,23,0,78
4723,-21.360749999999193,2570.222222222222,41,27,7,68
4724,-10.941499999997964,2959.684210526316,57,23,1,80
4725,-37.34099999999882,2294.6470588235293,34,40,1,74
4726,-12.098749999999015,3005.5789473684213,48,29,3,77
4727,3.3440000000015417,3546.0526315789475,84,33,1,117
4728,10.150500000002554,3388.6111111111113,85,33,1,118
4729,21.279500000004738,5297.45,115,17,3,132
4730,-20.72224999999899,2738.5555555555557,43,52,2,95
4731,-8.953749999998767,3010.5263157894738,62,26,1,88
4732,-23.243499999999187,2187.85,21,31,2,52
4733,-16.54674999999856,2695.9333333333334,57,24,2,81
4734,-14.599249999998648,2482.625,41,25,4,66
4735,-26.40399999999937,2124.8947368421054,30,27,12,57
4736,-29.44949999999954,2286.176470588235,37,31,11,68
4737,-3.445499999998058,3514.2631578947367,69,25,4,94
4738,-17.96074999999903,2246.1052631578946,31,31,1,62
4739,5.001250000002381,2866.6111111111113,71,21,2,92
4740,-16.562999999999,2650.4736842105262,42,26,2,68
4741,-8.550249999997767,3950.55,62,33,1,95
4742,-7.652999999998864,2728.0,73,24,1,97
4743,7.055000000002461,3614.0,95,41,1,136
4744,-30.921499999999003,2592.7368421052633,40,29,10,69
4745,-9.897999999998408,3285.5789473684213,48,41,1,89
4746,-38.43099999999974,2026.4736842105262,19,32,2,51
4747,3.3002500000030777,4176.65,88,17,0,105
4748,-5.756249999998139,2646.8571428571427,69,28,4,97
4749,-17.75774999999871,2463.4444444444443,40,28,1,68
4750,-3.9614999999990324,2432.8823529411766,73,25,2,98
4751,-30.528499999999354,2032.15,19,28,4,47
4752,-2.0149999999977894,2855.8823529411766,85,26,2,111
4753,-5.337749999997685,3367.157894736842,74,23,0,97
4754,-24.789749999999465,1773.5294117647059,35,30,6,65
4755,-16.004999999998844,2676.75,42,25,1,67
4756,15.323000000002526,5409.25,118,23,1,141
4757,-25.174749999998753,2753.6,37,24,3,61
4758,-18.940999999999377,2395.3529411764707,47,46,4,93
4759,-11.254249999998775,2895.6111111111113,64,31,1,95
4760,-16.59574999999682,2103.6666666666665,50,36,12,86
4761,-23.933249999998516,2473.1111111111113,50,17,6,67
4762,-15.926499999999018,2062.9375,39,32,3,71
4763,-20.424499999998673,2562.277777777778,35,27,2,62
4764,-22.845499999999582,2096.55,16,36,0,52
4765,3.677500000002045,3595.85,68,15,2,83
4766,-20.975999999998614,1963.1176470588234,30,34,2,64
4767,-13.164249999997278,3529.9,60,27,2,87
4768,-6.052499999997776,3767.2,62,33,0,95
4769,-12.899499999998872,2496.277777777778,50,22,4,72
4770,-18.35424999999869,2528.3,38,26,1,64
4771,-16.590249999998296,2223.6875,54,34,1,88
4772,-25.027999999998432,3575.05,55,27,2,82
4773,-11.397249999999085,2548.15,41,18,0,59
4774,-5.364249999998125,4328.3,83,29,0,112
4775,-26.53424999999814,3003.75,43,31,0,74
4776,-14.070999999998893,2387.0588235294117,39,33,4,72
4777,3.6380000000031436,4092.3684210526317,92,33,2,125
4778,8.671500000003034,4165.6,83,21,1,104
4779,-24.462499999998915,2404.4444444444443,42,24,3,66
4780,-30.873999999999803,1903.5555555555557,39,28,14,67
4781,-20.623499999998486,1481.9333333333334,51,35,2,86
4782,8.144000000003555,4494.3,90,18,5,108
4783,-13.16824999999904,2638.733333333333,31,27,4,58
4784,-10.30524999999864,2582.9473684210525,40,24,3,64
4785,-24.555999999999294,2040.1,21,28,2,49
4786,-24.708999999999033,2531.7894736842104,40,23,4,63
4787,-16.25149999999804,3641.0,58,26,4,84
4788,-17.129999999998564,3226.8947368421054,70,25,4,95
4789,0.2900000000021219,3294.1111111111113,73,29,2,102
4790,-13.98324999999806,3691.1,62,27,1,89
4791,-22.483499999999164,2180.1052631578946,27,31,3,58
4792,-25.997749999999503,2025.6470588235295,33,39,4,72
4793,-14.774999999997968,3407.6,56,31,0,87
4794,-17.531749999998702,2524.45,40,22,1,62
4795,-25.642499999999565,2008.5,21,26,3,47
4796,-14.258499999998426,2873.4444444444443,69,28,3,97
4797,4.574500000001989,3277.4444444444443,71,27,3,98
4798,-15.981749999998836,2863.5714285714284,37,33,7,70
4799,-15.52099999999894,2613.8823529411766,50,33,2,83
4800,-18.671249999999596,2032.3,23,25,2,48
4801,-9.187249999997947,3506.0,80,22,4,102
4802,3.030000000002134,4783.05,87,32,0,119
4803,-26.756499999997875,2154.8888888888887,39,34,2,73
4804,-3.908249999997472,3819.2105263157896,74,33,1,107
4805,0.07300000000324758,4200.315789473684,97,26,1,123
4806,-21.472249999999235,3522.7,50,31,2,81
4807,-18.969999999998155,2688.4444444444443,44,25,1,69
4808,-13.717499999998532,2589.875,48,29,1,77
4809,-15.2534999999986,2518.4375,40,36,0,76
4810,-8.935999999998469,3004.7894736842104,63,23,1,86
4811,-7.700999999997651,2798.3125,68,19,2,87
4812,-29.60999999999918,2166.45,19,34,0,53
4813,-27.261249999999215,2008.4,24,25,0,49
4814,14.523500000002263,3892.0,113,19,3,132
4815,-9.76749999999694,2479.6875,81,22,3,103
4816,-4.029499999997055,4969.55,101,23,0,124
4817,-13.21599999999735,2386.777777777778,64,26,0,90
4818,-9.147999999999167,2591.85,41,20,1,61
4819,-6.911499999998313,2813.266666666667,49,27,0,76
4820,-24.83274999999892,2738.6,35,32,0,67
4821,-15.039749999999103,3024.3333333333335,79,35,0,114
4822,-16.209249999998427,3059.0526315789475,61,23,10,84
4823,-35.17599999999888,2744.2,26,38,3,64
4824,-24.075249999999354,1949.2777777777778,32,24,5,56
4825,-5.350749999998449,3348.15,60,22,1,82
4826,-12.423999999998198,3819.55,65,30,0,95
4827,-23.423749999998105,1996.5,53,33,1,86
4828,-14.605749999999139,2420.1875,63,39,3,102
4829,-16.549249999997823,2516.3333333333335,54,29,2,83
4830,-19.689249999997926,3232.95,49,26,1,75
4831,-15.46399999999888,2564.0,38,19,4,57
4832,-15.610249999997658,3412.3529411764707,71,49,0,120
4833,-23.074249999999164,2008.35,25,20,4,45
4834,-22.38299999999908,2433.2631578947367,44,17,6,61
4835,-1.7679999999986582,3148.15,48,30,0,78
4836,-17.43374999999855,3220.2631578947367,51,19,0,70
4837,-9.013749999998053,2891.3529411764707,77,32,2,109
4838,-19.4592499999993,2097.4,26,24,4,50
4839,2.1572500000019708,4095.0,73,29,0,102
4840,-6.6147499999983195,3120.5555555555557,72,36,8,108
4841,-8.701999999998899,2954.45,43,25,0,68
4842,-25.153249999999723,2448.315789473684,40,25,29,65
4843,-12.384749999997949,3974.4,72,25,1,97
4844,-34.44649999999912,2106.7368421052633,22,31,2,53
4845,-5.050249999996387,4805.35,95,25,0,120
4846,-11.890749999998445,3159.3,51,28,0,79
4847,-12.782999999998317,2532.6470588235293,56,22,2,78
4848,-19.987249999999342,1528.25,17,34,2,51
4849,-23.303249999998403,3111.5555555555557,53,38,2,91
4850,-26.906249999999098,2011.3684210526317,27,26,3,53
4851,-3.9314999999985027,3032.25,52,23,0,75
4852,-9.222249999998436,1883.8235294117646,47,23,4,70
4853,-6.373749999997226,4825.2,96,26,0,122
4854,1.4550000000027439,4181.45,87,17,1,104
4855,-16.471499999999402,1954.7058823529412,52,30,9,82
4856,-10.988499999998037,4449.105263157895,91,37,2,128
4857,2.6017500000016547,3261.8,55,26,0,81
4858,-17.158249999998183,3747.35,62,25,1,87
4859,-28.537999999998704,2847.35,39,29,0,68
4860,-10.430249999999322,2648.266666666667,31,27,1,58
4861,-26.058999999998132,2411.5,49,32,0,81
4862,-28.443249999998244,2403.3888888888887,38,39,4,77
4863,-3.849749999997948,5061.55,89,33,2,122
4864,-3.754249999998907,3515.0526315789475,81,31,6,112
4865,-11.226249999999162,2112.4444444444443,27,28,1,55
4866,-18.29624999999924,2437.0,39,31,2,70
4867,-17.672249999997966,3328.25,58,26,0,84
4868,-28.831749999999097,1875.4375,31,45,1,76
4869,-1.1122499999977142,3845.157894736842,84,18,1,102
4870,-13.264249999997588,4215.315789473684,98,19,5,117
4871,-18.85674999999843,3345.0,52,27,1,79
4872,-17.707999999998272,3083.15,36,37,3,73
4873,-24.790749999998873,2721.95,33,30,1,63
4874,-24.273749999999048,2643.5714285714284,51,56,1,107
4875,-9.948499999998361,3205.25,54,28,0,82
4876,-4.171249999999,2147.9411764705883,40,29,3,69
4877,15.615000000002391,4277.894736842105,113,24,0,137
4878,-13.806249999999,2733.9,41,24,2,65
4879,6.596250000002636,3209.5882352941176,93,21,0,114
4880,-41.436750000000025,2490.0,36,25,22,61
4881,2.3452500000021415,4225.05,82,16,6,98
4882,-8.253249999997752,3196.842105263158,65,18,2,83
4883,8.315750000001753,2922.1176470588234,76,34,0,110
4884,-9.442749999997234,2894.0588235294117,71,43,1,114
4885,-25.58174999999916,2117.15,23,26,1,49
4886,-25.910249999999444,2024.2,19,29,0,48
4887,5.849500000001937,2932.470588235294,94,23,8,117
4888,-18.282749999998998,2421.1111111111113,34,34,4,68
4889,-24.731249999999285,2711.65,39,26,3,65
4890,-9.672499999998584,3339.35,54,29,0,83
4891,-12.807999999998694,2464.75,42,24,0,66
4892,-13.389499999998534,2550.0625,87,21,3,108
4893,-1.779499999998432,3297.8947368421054,57,30,1,87
4894,-14.809999999999869,1952.7777777777778,37,28,2,65
4895,-10.67349999999821,2371.1176470588234,47,24,2,71
4896,14.469750000002065,4267.3,81,29,1,110
4897,-13.466249999999127,2518.4375,57,32,3,89
4898,-41.682499999999706,2040.111111111111,29,38,4,67
4899,3.1200000000010206,2622.3529411764707,74,35,2,109
4900,-11.329999999998977,2444.8888888888887,34,34,0,68
4901,-15.524249999998691,3160.0,56,30,2,86
4902,-42.26874999999963,2579.4210526315787,34,32,18,66
4903,-16.597749999998445,2038.764705882353,46,37,1,83
4904,-14.941249999998789,3235.3,54,27,0,81
4905,-8.289249999998855,2700.0,40,22,1,62
4906,-3.3082499999973587,3037.0,96,35,2,131
4907,-35.612499999999514,1448.0666666666666,27,38,1,65
4908,-18.749249999998362,3020.294117647059,59,28,7,87
4909,-5.839749999997363,2782.125,83,25,3,108
4910,-24.576749999999187,2171.3529411764707,40,35,4,75
4911,-13.288749999998743,2586.25,37,28,1,65
4912,-18.258499999997923,3794.157894736842,79,26,0,105
4913,-9.44374999999768,3594.0,73,41,3,114
4914,-17.50324999999756,2128.5,69,34,1,103
4915,-0.3559999999981189,3068.1,63,14,1,77
4916,-11.372999999998038,2982.8823529411766,91,32,3,123
4917,-9.753249999997685,3548.15,74,9,1,83
4918,-14.13074999999923,2504.315789473684,38,32,2,70
4919,-34.2027499999989,2262.1666666666665,30,35,1,65
4920,-10.304999999995195,2222.75,88,30,2,118
4921,-20.790499999999636,2664.0,61,46,3,107
4922,-6.539249999998701,2762.4117647058824,60,23,15,83
4923,-27.684999999999157,2216.8947368421054,28,34,2,62
4924,-17.699249999999125,1878.1764705882354,32,38,8,70
4925,-2.724249999997738,2201.9375,87,28,5,115
4926,-20.080249999998518,3023.5,54,22,7,76
4927,-17.390999999998414,2506.722222222222,57,30,0,87
4928,-15.015749999998334,2967.9444444444443,47,33,2,80
4929,-37.43399999999834,2549.529411764706,49,28,3,77
4930,-11.051999999998841,2717.2631578947367,46,34,2,80
4931,-19.16199999999907,2022.8,23,30,0,53
4932,-30.801749999999032,2073.294117647059,39,30,1,69
4933,-5.718999999998233,3994.9,69,32,0,101
4934,-33.927999999999386,1989.0555555555557,28,39,23,67
4935,7.674500000002522,3154.375,79,38,2,117
4936,-1.3742499999978588,2306.764705882353,53,22,2,75
4937,-14.254249999998237,3804.5,61,31,1,92
4938,-13.023999999998583,3087.95,51,28,0,79
4939,-9.119499999998407,3155.3,61,17,1,78
4940,-26.19449999999921,1996.8333333333333,20,32,5,52
4941,-26.82674999999898,2551.0526315789475,28,33,5,61
4942,-10.563499999998566,2607.6,45,18,2,63
4943,-1.656499999997823,3411.5,80,31,2,111
4944,-11.281249999998254,3114.0,49,26,1,75
4945,-3.257749999998237,3105.4,60,14,1,74
4946,-4.260749999998553,3089.9473684210525,60,27,1,87
4947,-6.5532499999973535,4371.05,87,23,2,110
4948,-21.92249999999832,2266.25,38,38,0,76
4949,-7.898249999997441,2094.9444444444443,61,30,3,91
4950,-14.347999999998473,3445.0,53,33,1,86
4951,7.853250000003125,5341.75,112,20,1,132
4952,-1.1897499999985048,3147.3,56,22,1,78
4953,-3.7814999999973145,4077.45,71,31,0,102
4954,-32.47699999999928,2583.85,31,30,1,61
4955,4.60400000000193,3611.65,73,14,0,87
4956,-14.809499999998994,3037.157894736842,60,21,4,81
4957,-17.441499999998367,3089.722222222222,62,26,0,88
4958,-18.76824999999856,2429.0588235294117,42,31,0,73
4959,-17.40849999999886,2630.75,42,22,0,64
4960,5.132750000003066,3447.6111111111113,98,22,1,120
4961,-10.572249999998707,2524.4,36,27,1,63
4962,-22.894249999998827,2551.5714285714284,57,28,3,85
4963,-30.76099999999995,2566.842105263158,43,30,21,73
4964,-15.828999999998663,2554.3888888888887,32,30,1,62
4965,-29.317499999999164,2087.0,19,28,3,47
4966,-29.66724999999933,2019.6842105263158,22,27,0,49
4967,-0.22399999999876902,3345.75,52,28,7,80
4968,2.9150000000024976,3564.1,76,15,0,91
4969,-17.114499999998802,2804.866666666667,34,34,0,68
4970,-14.599999999999207,2913.277777777778,61,32,12,93
4971,-23.08824999999915,2428.294117647059,30,37,6,67
4972,-22.626999999997956,2383.235294117647,57,28,4,85
4973,-17.430999999998846,2613.15,40,18,3,58
4974,-3.9879999999976263,1917.1875,58,29,4,87
4975,-17.269499999999336,2063.9411764705883,50,19,3,69
4976,-11.395499999998933,2583.8,38,28,0,66
4977,-21.210749999998576,1914.111111111111,34,26,5,60
4978,7.560750000003196,3157.25,117,22,1,139
4979,-13.191749999998805,2385.8888888888887,39,28,2,67
4980,9.639000000002195,4370.35,77,29,0,106
4981,-21.670749999996968,4709.95,75,42,0,117
4982,-26.426749999999394,2028.25,23,22,4,45
4983,-21.470999999998526,2089.9473684210525,37,27,4,64
4984,7.886250000003858,3606.3888888888887,96,33,0,129
4985,-19.48599999999845,2867.35,40,32,1,72
4986,-7.008749999999212,2683.05,35,34,0,69
4987,-13.676499999997938,3503.684210526316,67,26,1,93
4988,-7.342249999997715,3219.222222222222,79,25,1,104
4989,-10.272249999998298,1943.0,71,30,3,101
4990,-22.919749999999116,2022.8,24,23,2,47
4991,-17.402749999999234,2008.4,22,29,0,51
4992,4.180500000002277,4242.5,81,22,4,103
4993,2.6222500000016384,4214.368421052632,90,24,3,114
4994,-10.967749999997832,2754.9411764705883,60,30,6,90
4995,-22.1417499999987,2547.6315789473683,37,29,1,66
4996,-30.924249999999386,2092.55,24,20,1,44
4997,1.651250000002019,3818.05,73,23,1,96
4998,-12.894499999999368,1875.5,49,32,2,81
4999,-6.760249999998268,2437.9375,72,29,0,101
5000,-5.646249999998309,3006.5263157894738,56,23,1,79
