Episode,Average Reward,Average Lifespan,True Location Count,False Location Count,Explore Actions,Target Actions
1,-29.021249999999288,2501.3,16,27,3,43
2,-32.89624999999927,2553.5789473684213,17,26,11,43
3,-31.262499999999523,2623.5,11,29,4,40
4,-27.0789999999992,3548.9,20,28,4,48
5,-38.24849999999931,2807.5,20,28,3,48
6,-33.8507499999999,2305.4210526315787,13,22,11,35
7,-44.21674999999978,2159.2631578947367,13,30,5,43
8,-48.41949999999979,2299.4444444444443,20,28,9,48
9,-44.88874999999992,2185.4,7,24,5,31
10,-46.21074999999966,2888.5263157894738,15,36,6,51
11,-37.44499999999856,2393.6470588235293,21,30,6,51
12,-34.37974999999982,2242.1666666666665,15,28,10,43
13,-44.78249999999943,2498.722222222222,12,21,11,33
14,-37.21449999999951,1957.3333333333333,13,24,9,37
15,-33.42499999999986,2042.4705882352941,18,32,8,50
16,-37.54749999999951,2032.3,7,27,9,34
17,-36.79299999999948,2305.4736842105262,17,22,5,39
18,-45.558999999999806,1877.888888888889,10,24,7,34
19,-43.015250000000606,2738.5555555555557,23,45,7,68
20,-37.46924999999964,2318.75,13,26,6,39
21,-25.98699999999897,2854.222222222222,39,20,9,59
22,-35.79574999999917,3254.4,21,26,8,47
23,-36.298249999998895,3375.684210526316,29,33,8,62
24,-43.129249999999516,2764.1052631578946,26,29,10,55
25,-30.88999999999936,2289.4,14,27,7,41
26,-27.759999999999927,2039.2777777777778,28,19,9,47
27,-34.14924999999967,1811.8823529411766,18,23,10,41
28,-45.95174999999983,2322.4444444444443,10,22,13,32
29,-39.923249999999456,2177.9411764705883,14,30,2,44
30,-38.01699999999925,2931.2105263157896,23,31,5,54
31,-36.636499999999366,2368.277777777778,15,29,6,44
32,-47.90824999999972,2223.75,21,29,12,50
33,-35.6387499999993,2678.842105263158,18,26,9,44
34,-37.0172499999993,2613.842105263158,14,24,5,38
35,-34.12399999999981,2011.0555555555557,13,25,4,38
36,-47.89999999999965,2457.5263157894738,12,36,7,48
37,-39.34174999999992,2059.95,5,21,11,26
38,-30.645249999999415,2478.315789473684,21,22,4,43
39,-29.767749999999797,2723.235294117647,24,35,8,59
40,-39.712749999999346,2445.7894736842104,15,31,2,46
41,-32.29274999999945,3177.5,21,26,8,47
42,-37.967249999999666,2189.315789473684,6,28,12,34
43,-41.88824999999938,2631.9444444444443,20,32,5,52
44,-39.191249999999556,2644.6315789473683,14,26,9,40
45,-49.13250000000007,1778.235294117647,5,25,8,30
46,-39.1702499999995,3587.95,19,26,7,45
47,-45.26849999999929,3545.7,17,30,10,47
48,-40.483249999999956,1909.6666666666667,10,23,6,33
49,-21.67249999999985,2726.4736842105262,17,27,8,44
50,-39.994500000000194,1921.111111111111,14,29,10,43
51,-34.86449999999955,2036.25,9,26,7,35
52,-37.318749999999554,2429.0588235294117,22,34,8,56
53,-34.78674999999954,2080.823529411765,17,18,8,35
54,-25.113999999999553,3297.9473684210525,28,28,4,56
55,-33.81749999999899,3464.0,23,29,11,52
56,-44.16024999999944,2399.842105263158,10,28,4,38
57,-39.58824999999938,3169.3684210526317,17,28,8,45
58,-38.362249999999754,1778.2941176470588,11,30,8,41
59,-33.86249999999943,3279.5789473684213,22,22,12,44
60,-31.624749999999302,2568.05,17,20,7,37
61,-22.51849999999939,2694.7894736842104,18,28,5,46
62,-27.8694999999992,3066.4,20,22,7,42
63,-30.660499999999445,2911.5,27,25,6,52
64,-20.40349999999934,2966.2631578947367,24,28,4,52
65,-35.3522499999993,2738.6111111111113,22,28,8,50
66,-46.040000000000084,2100.1666666666665,12,26,6,38
67,-36.838999999999494,3165.4444444444443,23,40,4,63
68,-26.65099999999943,2575.4444444444443,18,25,5,43
69,-43.65874999999944,2325.05,13,24,4,37
70,-32.41224999999933,2466.6315789473683,15,28,6,43
71,-58.043750000000145,1917.611111111111,15,29,19,44
72,-44.563499999999785,1731.5,4,23,7,27
73,-25.545999999999545,3745.8,25,22,8,47
74,-41.8947499999994,2403.157894736842,10,25,11,35
75,-33.03174999999999,1669.0,14,28,9,42
76,-39.17149999999918,4096.578947368421,27,37,11,64
77,-39.56099999999921,2588.764705882353,26,26,8,52
78,-44.56799999999997,2405.277777777778,11,28,7,39
79,-36.85749999999935,2582.9473684210525,16,23,5,39
80,-26.81499999999852,2686.764705882353,24,33,7,57
81,-50.28025000000001,2235.823529411765,18,31,12,49
82,-31.430499999999785,2393.8888888888887,25,24,6,49
83,-29.37349999999916,2841.7894736842104,17,26,9,43
84,-48.24074999999922,2833.4736842105262,10,38,4,48
85,-28.630499999998836,2452.9444444444443,25,27,6,52
86,-36.32649999999956,2308.842105263158,14,22,6,36
87,-30.84124999999898,3457.05,17,29,9,46
88,-37.49599999999945,2413.1111111111113,16,36,11,52
89,-33.049999999999656,2762.4117647058824,29,32,12,61
90,-43.6427499999993,3292.55,17,28,9,45
91,-38.068499999999446,2251.764705882353,15,30,5,45
92,-41.52924999999997,1936.9473684210527,7,24,5,31
93,-32.32949999999912,3550.55,20,26,7,46
94,-40.47749999999943,3711.5789473684213,24,29,8,53
95,-48.531499999998985,2728.25,18,24,8,42
96,-46.64224999999968,2144.9,6,27,10,33
97,-41.37699999999976,2157.5789473684213,12,25,9,37
98,-28.084999999999003,2480.277777777778,24,26,5,50
99,-23.663749999999645,3102.2,17,30,6,47
100,-17.605249999999895,3556.7894736842104,30,31,6,61
101,-29.65424999999932,2473.4736842105262,17,25,6,42
102,-24.08124999999933,3129.2105263157896,21,24,6,45
103,-39.496749999999615,2763.294117647059,31,20,9,51
104,-20.997999999999234,2383.294117647059,21,27,8,48
105,-45.41374999999973,1952.0526315789473,14,24,9,38
106,-34.53099999999945,2325.777777777778,15,23,14,38
107,-23.074499999999475,3221.2,24,27,9,51
108,-37.072749999999694,1954.7058823529412,17,32,7,49
109,-27.890249999998314,3594.5263157894738,26,30,8,56
110,-48.03074999999919,3022.8947368421054,20,29,14,49
111,-35.75599999999953,2445.0,10,24,4,34
112,-30.09074999999972,2703.3888888888887,30,34,11,64
113,-30.937749999999276,3313.5555555555557,28,26,6,54
114,-31.260999999998916,3083.9,22,27,4,49
115,-34.15949999999953,3532.25,30,22,6,52
116,-48.94599999999899,2131.9444444444443,15,30,10,45
117,-36.800249999999494,3651.315789473684,25,23,11,48
118,-33.26249999999943,3079.8947368421054,16,26,4,42
119,-39.36874999999951,2711.4736842105262,17,24,8,41
120,-44.428999999999824,2727.1111111111113,22,22,7,44
121,-37.386499999998705,3016.4210526315787,18,28,9,46
122,-40.189999999999,3434.65,22,27,3,49
123,-41.65024999999932,2516.4444444444443,16,22,6,38
124,-30.905749999999045,2899.4210526315787,22,26,8,48
125,-31.987749999999256,3415.684210526316,17,30,11,47
126,-36.46949999999967,2189.4,10,20,7,30
127,-38.43299999999845,3676.65,25,30,4,55
128,-38.3002499999991,3687.85,21,31,6,52
129,-17.77099999999971,4124.1578947368425,31,34,9,65
130,-43.30449999999974,1936.111111111111,17,25,9,42
131,-13.7179999999998,1987.625,24,28,5,52
132,-24.59374999999921,3546.55,21,21,11,42
133,-41.20725,1532.1875,8,25,7,33
134,-29.820499999999633,3156.842105263158,23,22,7,45
135,-48.049249999999795,2591.7,8,25,6,33
136,-31.913499999999544,2544.6666666666665,16,20,9,36
137,-24.522749999999,2956.3684210526317,23,29,6,52
138,-26.74174999999919,2975.9,21,25,7,46
139,-35.70799999999902,2458.9411764705883,19,26,3,45
140,-27.107749999999527,2394.8947368421054,17,26,6,43
141,-26.201249999999042,3141.684210526316,20,31,8,51
142,-27.126749999999554,2438.8888888888887,19,25,5,44
143,-22.427500000000187,2092.222222222222,23,25,7,48
144,-33.73749999999924,2114.1052631578946,14,25,5,39
145,-30.595749999999235,3120.3,21,25,4,46
146,-29.30024999999921,3118.85,19,31,3,50
147,-28.365749999999583,2166.823529411765,20,21,6,41
148,-30.608500000000003,2484.6111111111113,13,31,11,44
149,-25.1319999999994,2735.1111111111113,24,25,7,49
150,-37.49074999999973,2764.05,11,28,5,39
151,-50.98824999999982,1711.0,5,18,8,23
152,-44.81099999999973,2637.9473684210525,24,22,7,46
153,-31.215999999999134,3201.35,23,24,6,47
154,-28.402749999999408,3960.05,31,27,3,58
155,-38.851749999998454,2390.3888888888887,22,25,6,47
156,-27.458499999999823,3060.15,23,17,3,40
157,-43.71849999999916,2576.3333333333335,21,22,8,43
158,-44.173999999999225,2449.9473684210525,12,21,6,33
159,-36.01799999999952,2693.6666666666665,16,28,8,44
160,-38.71049999999896,2892.1111111111113,23,31,3,54
161,-31.632499999999844,3123.3684210526317,25,25,6,50
162,-36.42824999999955,2570.3684210526317,14,27,5,41
163,-37.15924999999992,2080.823529411765,32,31,8,63
164,-55.45774999999959,3575.2105263157896,15,36,9,51
165,-31.704499999999797,2580.294117647059,28,28,12,56
166,-38.091999999999345,2275.3684210526317,19,28,2,47
167,-36.64524999999924,1981.8235294117646,19,25,8,44
168,-32.907499999999295,2225.15,12,22,7,34
169,-38.33774999999913,2092.0588235294117,18,32,6,50
170,-26.13800000000013,1648.25,30,32,10,62
171,-34.115999999999886,1950.0588235294117,28,33,8,61
172,-36.126249999999956,2707.7,15,25,5,40
173,-37.91424999999973,2134.0,14,24,7,38
174,-32.98849999999925,2987.277777777778,19,28,7,47
175,-41.186249999999674,2720.222222222222,18,24,4,42
176,-28.034999999999712,2248.9411764705883,17,23,8,40
177,-34.60624999999974,2623.0555555555557,16,25,7,41
178,-36.85774999999952,3278.3,19,29,6,48
179,-38.06649999999926,3018.05,13,27,6,40
180,-37.325499999999685,2261.5555555555557,13,24,7,37
181,-41.25724999999992,2333.8888888888887,16,28,12,44
182,-38.3749999999991,3100.5,15,28,5,43
183,-24.26225000000028,2353.470588235294,32,38,2,70
184,-44.457999999999636,2016.5,5,25,7,30
185,-38.647249999999644,3047.2631578947367,20,26,7,46
186,-38.881249999999895,3570.2631578947367,22,35,6,57
187,-15.096749999999755,2705.1666666666665,35,26,8,61
188,-16.45774999999943,3183.9,23,28,7,51
189,-34.21449999999879,2925.6666666666665,27,32,10,59
190,-35.324499999999446,2952.9473684210525,22,24,7,46
191,-35.55274999999894,2342.6666666666665,18,21,9,39
192,-30.6222499999994,2529.3684210526317,21,18,5,39
193,-41.02974999999934,2064.0,22,27,6,49
194,-31.098249999999922,3075.9,13,27,7,40
195,-40.77549999999941,3095.722222222222,27,43,5,70
196,-25.62749999999928,2987.3333333333335,26,27,6,53
197,-31.60250000000006,2044.5555555555557,22,25,12,47
198,-37.43099999999963,2629.1,17,22,6,39
199,-41.9249999999996,2135.0,11,22,11,33
200,-49.09649999999963,1959.5263157894738,9,27,6,36
201,-32.94074999999968,3043.722222222222,20,31,4,51
202,-34.23049999999981,2774.8333333333335,22,22,11,44
203,-33.10299999999994,2219.0,16,25,6,41
204,-37.25349999999965,2824.2631578947367,23,31,6,54
205,-29.03124999999962,2155.777777777778,14,25,7,39
206,-32.23874999999948,1966.8235294117646,17,24,7,41
207,-39.63499999999955,3364.8,20,19,8,39
208,-25.361999999998893,4206.9,26,35,8,61
209,-34.31875000000018,1631.8333333333333,9,28,8,37
210,-27.857749999999577,2400.1176470588234,18,24,8,42
211,-32.54249999999902,3215.6,18,32,6,50
212,-34.50224999999933,2587.842105263158,18,19,9,37
213,-35.86925000000014,1941.6470588235295,19,29,9,48
214,-35.98724999999937,3564.85,24,30,4,54
215,-40.588499999999684,1991.6666666666667,10,23,9,33
216,-34.7149999999995,2546.0526315789475,19,21,7,40
217,-37.51424999999939,2539.3684210526317,12,23,9,35
218,-39.14574999999919,2703.3333333333335,18,29,8,47
219,-40.660499999999985,1988.842105263158,10,28,8,38
220,-46.417249999999164,1906.1666666666667,11,29,1,40
221,-46.542499999999094,2669.1176470588234,19,32,6,51
222,-22.923499999998956,4444.1,33,30,5,63
223,-32.99449999999941,2769.157894736842,14,30,4,44
224,-33.95749999999936,2591.85,17,24,5,41
225,-48.484749999999224,2480.9473684210525,14,23,14,37
226,-35.5182499999994,2085.222222222222,12,27,2,39
227,-22.016999999999285,2228.3529411764707,20,27,5,47
228,-36.50924999999968,4000.4736842105262,25,30,9,55
229,-47.32899999999991,2466.294117647059,14,31,4,45
230,-25.49824999999951,2806.5,27,29,9,56
231,-25.99224999999958,3276.157894736842,19,28,6,47
232,-35.68974999999949,3691.3684210526317,28,30,2,58
233,-40.37499999999797,2524.3333333333335,20,30,9,50
234,-35.45099999999999,1851.7368421052631,10,27,7,37
235,-41.04749999999934,1916.1875,29,28,10,57
236,-36.97499999999898,2928.684210526316,28,26,5,54
237,-43.389250000000054,3370.5789473684213,17,32,6,49
238,-43.72199999999995,2530.1052631578946,25,31,7,56
239,-43.864249999998876,1623.235294117647,13,22,10,35
240,-34.13474999999979,2998.0,20,32,6,52
241,-30.727499999998862,4263.2,28,26,9,54
242,-52.52774999999938,2086.8888888888887,10,28,3,38
243,-43.62625000000007,1429.0,9,26,3,35
244,-54.47875000000008,1696.9375,14,31,9,45
245,-39.78474999999971,2177.722222222222,12,29,3,41
246,-35.54174999999932,2175.0588235294117,22,32,9,54
247,-36.95024999999958,2088.65,13,24,3,37
248,-29.22699999999885,2307.705882352941,22,32,5,54
249,-33.06074999999842,2051.823529411765,19,25,9,44
250,-30.729499999999195,2911.5,23,27,10,50
251,-36.915249999998984,4040.95,24,37,5,61
252,-39.97374999999995,2248.8823529411766,19,27,7,46
253,-18.71575000000017,2874.470588235294,26,38,3,64
254,-25.65649999999902,3036.6666666666665,30,34,8,64
255,-42.81574999999936,2113.2631578947367,8,30,7,38
256,-36.44224999999817,2993.7368421052633,25,26,10,51
257,-43.07574999999978,2060.5789473684213,6,25,3,31
258,-29.373499999998433,3155.722222222222,28,27,7,55
259,-36.7552499999996,3079.9473684210525,21,29,5,50
260,-33.82049999999936,2947.3,17,27,8,44
261,-35.79749999999916,3170.0526315789475,24,29,6,53
262,-46.14099999999989,1429.0,2,28,6,30
263,-32.732749999999314,2307.0526315789475,14,26,7,40
264,-33.418250000000285,1972.9473684210527,12,25,7,37
265,-41.088249999998936,2939.45,20,30,6,50
266,-42.41149999999944,2895.0,18,37,5,55
267,-34.573750000000324,1541.125,20,29,4,49
268,-31.988749999998646,2842.722222222222,24,23,11,47
269,-37.724749999999666,3014.0,17,29,1,46
270,-36.71199999999972,2330.0,8,24,7,32
271,-38.826249999999455,1741.5625,13,27,10,40
272,-28.86199999999966,3325.4736842105262,26,35,12,61
273,-39.16349999999981,1944.0555555555557,9,30,5,39
274,-29.873499999997826,4020.5263157894738,40,30,2,70
275,-45.49774999999933,2574.3,15,27,3,42
276,-39.708250000000135,2185.470588235294,17,34,10,51
277,-29.22024999999922,2028.0526315789473,16,26,8,42
278,-27.90674999999941,2532.35,13,29,5,42
279,-38.269499999999255,2405.0,15,23,5,38
280,-32.8547499999993,2684.7,15,32,5,47
281,-51.96524999999963,2663.6666666666665,23,28,6,51
282,-41.7437499999993,2676.8333333333335,19,25,4,44
283,-40.64274999999979,2798.3684210526317,14,24,10,38
284,-31.019499999999304,3054.277777777778,28,25,7,53
285,-39.82924999999954,4516.4,18,28,7,46
286,-37.818749999999284,2168.05,13,25,4,38
287,-42.4912499999987,2486.5,19,25,7,44
288,-22.13199999999929,3516.0,25,22,8,47
289,-41.07525000000103,1802.0555555555557,20,47,6,67
290,-30.457500000000078,2358.1176470588234,28,28,10,56
291,-24.152499999999755,2171.5555555555557,16,23,7,39
292,-38.98550000000013,1655.7222222222222,8,31,3,39
293,-43.47199999999921,2393.8333333333335,14,31,5,45
294,-45.39749999999872,2505.9473684210525,20,28,4,48
295,-26.120499999999556,3090.2,19,26,4,45
296,-37.75600000000007,2528.722222222222,27,32,4,59
297,-33.23774999999886,2632.6470588235293,19,24,13,43
298,-26.232249999999226,2789.2105263157896,18,24,6,42
299,-40.21649999999946,1846.111111111111,9,27,7,36
300,-34.52399999999848,2210.529411764706,19,29,12,48
301,-35.66524999999966,2032.25,7,26,3,33
302,-27.81149999999935,2972.8947368421054,17,30,6,47
303,-29.059749999999553,2453.65,14,23,6,37
304,-43.47949999999949,2484.6666666666665,18,34,5,52
305,-33.73024999999957,2936.157894736842,24,28,8,52
306,-35.181749999999035,3480.65,25,25,4,50
307,-32.13149999999941,2711.277777777778,33,31,10,64
308,-38.286749999999074,2305.6111111111113,15,34,6,49
309,-50.85575000000013,2277.8823529411766,21,38,4,59
310,-35.517000000000095,1571.875,8,30,10,38
311,-35.35749999999966,2437.0,21,28,4,49
312,-31.946999999999292,2835.45,18,27,6,45
313,-30.68974999999968,2075.05,13,19,9,32
314,-40.53249999999947,2568.05,24,22,2,46
315,-45.844999999999324,2442.222222222222,20,28,2,48
316,-35.1529999999995,2341.4117647058824,24,26,12,50
317,-24.713499999999534,2503.85,18,23,6,41
318,-47.18924999999925,2236.764705882353,15,30,4,45
319,-24.464749999999338,2751.6315789473683,21,25,5,46
320,-36.632749999999525,2959.6315789473683,16,26,8,42
321,-22.53574999999868,2318.0,31,32,5,63
322,-38.54349999999933,2680.6,15,28,4,43
323,-36.359999999998976,2683.0555555555557,20,25,9,45
324,-21.1427499999989,2950.714285714286,24,24,7,48
325,-27.002499999999237,2339.684210526316,19,20,9,39
326,-51.16774999999963,2866.0,32,30,3,62
327,-42.76074999999978,1429.0,6,29,8,35
328,-36.68049999999947,1505.4375,12,24,11,36
329,-30.595749999999537,2532.4,14,25,2,39
330,-38.77449999999932,2876.0,26,22,7,48
331,-37.631249999999,2651.315789473684,20,26,4,46
332,-32.736999999998645,2942.842105263158,25,22,6,47
333,-26.13149999999955,2440.842105263158,20,22,7,42
334,-36.398249999999635,1576.875,8,26,9,34
335,-32.54474999999961,2325.0,18,27,6,45
336,-41.53949999999948,1903.6315789473683,6,29,5,35
337,-40.180499999998894,2899.8888888888887,21,25,9,46
338,-39.58074999999991,2370.235294117647,20,34,5,54
339,-33.76950000000035,3328.0,22,31,13,53
340,-30.632999999999395,2572.8,16,22,5,38
341,-29.097499999999815,2179.823529411765,22,23,5,45
342,-34.019999999999726,2182.25,12,16,10,28
343,-40.74024999999937,2756.222222222222,14,29,5,43
344,-40.070499999999235,2454.294117647059,23,28,8,51
345,-45.0504999999999,2883.1,15,29,9,44
346,-32.60400000000024,2734.4117647058824,34,24,12,58
347,-38.009500000000344,2254.4444444444443,23,26,7,49
348,-29.811999999999376,2421.705882352941,21,18,8,39
349,-5.788249999999385,3027.3684210526317,29,24,9,53
350,-32.57924999999963,2403.157894736842,16,22,3,38
351,-13.658499999999586,3944.5789473684213,39,25,7,64
352,-36.25499999999925,3264.0,20,30,9,50
353,-23.122499999999864,1946.875,33,34,4,67
354,-37.35574999999959,1952.0526315789473,8,23,7,31
355,-24.69625000000002,2695.4444444444443,31,26,7,57
356,-31.918249999999563,2346.75,22,29,6,51
357,-35.184999999999505,2692.55,18,24,3,42
358,-19.58674999999898,2268.4375,37,35,4,72
359,-16.54674999999919,3195.0,25,29,6,54
360,-31.516499999999564,2708.0526315789475,17,22,11,39
361,-38.18524999999954,2151.7894736842104,15,22,4,37
362,-32.76249999999938,3001.35,18,21,7,39
363,-38.724249999999536,2624.5263157894738,20,26,4,46
364,-47.26474999999916,3010.05,12,29,6,41
365,-33.33149999999976,2155.157894736842,19,19,5,38
366,-28.86099999999857,2821.9,24,28,7,52
367,-33.22274999999963,2205.9411764705883,22,22,2,44
368,-32.88399999999912,2544.15,20,23,5,43
369,-25.756749999999823,2541.0526315789475,24,28,9,52
370,-34.719499999998945,3706.75,24,26,4,50
371,-17.968499999999977,2618.6470588235293,29,24,4,53
372,-36.13250000000007,1889.4444444444443,10,33,8,43
373,-29.843499999999523,2643.823529411765,29,29,12,58
374,-45.0304999999995,1962.1052631578948,7,26,7,33
375,-37.37099999999922,3066.684210526316,24,25,5,49
376,-46.29774999999872,2068.764705882353,23,25,6,48
377,-40.08749999999908,2469.722222222222,18,23,4,41
378,-50.169499999999786,2723.235294117647,17,35,7,52
379,-42.244500000000336,1631.8333333333333,8,22,8,30
380,-39.09499999999955,2503.315789473684,22,22,5,44
381,-37.4382499999994,2232.1176470588234,17,26,8,43
382,-48.47599999999962,2050.8823529411766,14,36,9,50
383,-35.223999999999464,3190.15,18,29,2,47
384,-29.55899999999936,3253.7,25,23,4,48
385,-27.151499999999565,1701.875,9,27,8,36
386,-24.83774999999929,2630.222222222222,23,28,5,51
387,-38.10749999999964,2262.0,10,30,5,40
388,-37.29774999999934,3305.3,15,31,8,46
389,-37.57624999999945,2132.4210526315787,11,26,7,37
390,-30.668749999999164,2008.55,16,28,2,44
391,-33.23799999999944,2554.4210526315787,11,27,8,38
392,-43.45199999999919,2396.4444444444443,12,28,5,40
393,-29.298999999999317,2918.5,29,27,7,56
394,-21.62474999999957,3212.5,27,17,7,44
395,-23.81449999999962,2808.222222222222,25,20,9,45
396,-14.396999999999949,3328.0,47,24,12,71
397,-43.45774999999908,2348.9473684210525,17,26,2,43
398,-54.02625000000031,2050.8823529411766,19,46,4,65
399,-38.15024999999988,2022.0,23,27,2,50
400,-35.4662499999992,2345.3333333333335,22,27,7,49
401,-29.029499999999906,2441.3888888888887,28,29,13,57
402,-43.530249999999754,2185.4117647058824,21,40,6,61
403,-40.49024999999976,1429.0,6,25,3,31
404,-31.204499999998603,2390.3333333333335,29,21,5,50
405,-22.10324999999923,3553.4736842105262,27,30,9,57
406,-39.90224999999959,2888.5263157894738,23,31,6,54
407,-24.649999999999245,2869.222222222222,28,24,4,52
408,-38.0779999999999,1429.0,13,34,6,47
409,-28.212749999999108,3563.4736842105262,27,29,5,56
410,-39.77324999999936,2122.277777777778,22,15,8,37
411,-36.15299999999933,3757.3684210526317,25,35,4,60
412,-37.60749999999925,2947.5555555555557,19,26,8,45
413,-44.530249999999576,2125.0,12,30,5,42
414,-30.547499999999882,2012.888888888889,18,30,5,48
415,-30.61499999999911,3502.95,27,19,9,46
416,-34.47874999999922,2008.5,12,25,6,37
417,-33.60074999999978,2460.777777777778,21,33,6,54
418,-23.461499999999667,2962.3,26,19,6,45
419,-32.12624999999967,2755.2,19,26,4,45
420,-38.33774999999966,2074.5555555555557,20,26,1,46
421,-38.159249999998366,3294.6315789473683,32,27,5,59
422,-40.84624999999978,2405.684210526316,14,28,7,42
423,-7.714499999998298,4116.45,41,23,6,64
424,-12.417750000000028,4356.85,23,20,6,43
425,-32.41324999999918,2744.95,19,24,6,43
426,-22.426749999999416,2257.4375,31,24,4,55
427,-32.49924999999957,2063.9444444444443,18,26,7,44
428,-40.76949999999922,3285.5,22,24,8,46
429,-36.197749999999445,2534.529411764706,37,30,4,67
430,-30.013999999999175,2519.3684210526317,25,18,6,43
431,-26.912749999999598,1870.0,14,25,4,39
432,-28.71549999999968,2307.823529411765,16,30,8,46
433,-19.366999999999884,2160.1176470588234,24,28,8,52
434,-32.60274999999887,2461.823529411765,26,27,6,53
435,-29.583999999999868,2202.176470588235,19,36,8,55
436,-2.9637499999995347,3395.7368421052633,43,29,8,72
437,-37.942749999999165,2179.95,10,25,6,35
438,-29.259499999999036,3342.1052631578946,27,29,7,56
439,-37.855999999999554,1925.125,21,29,3,50
440,-35.43649999999834,3318.0526315789475,32,22,6,54
441,-33.61274999999892,1993.4444444444443,17,28,5,45
442,-20.624499999999717,2349.705882352941,29,27,3,56
443,-31.55474999999917,3298.5555555555557,35,20,2,55
444,-33.23499999999911,2548.1,28,19,2,47
445,-34.050749999999574,2072.8,13,23,4,36
446,-25.47724999999996,1874.4705882352941,17,26,4,43
447,-35.775249999999744,3563.470588235294,33,46,3,79
448,-38.04124999999972,2444.176470588235,28,24,4,52
449,-28.01724999999965,2432.3684210526317,19,26,3,45
450,-26.625999999999863,1959.578947368421,15,21,6,36
451,-12.060749999999928,3673.842105263158,32,29,7,61
452,-35.20524999999947,2709.5,30,21,8,51
453,-36.346499999999445,2468.722222222222,27,26,7,53
454,-6.585499999998632,3764.157894736842,38,22,6,60
455,-18.689499999998578,3237.7368421052633,40,25,4,65
456,-23.22974999999939,2895.7,20,25,6,45
457,-41.021499999999264,2652.2105263157896,15,29,2,44
458,-25.796999999999564,2743.0,29,20,1,49
459,-24.70774999999798,3708.5,29,29,5,58
460,-36.04225000000002,2403.2105263157896,14,22,6,36
461,-17.860749999998976,4302.894736842105,37,26,9,63
462,-27.630999999999098,2792.3888888888887,27,28,2,55
463,-14.546999999999263,3004.9444444444443,34,24,4,58
464,-47.02125000000053,1866.0,26,41,7,67
465,-31.128999999999053,2357.625,35,40,7,75
466,-28.03749999999897,3220.4,30,30,3,60
467,-43.83224999999957,2068.3888888888887,14,33,4,47
468,-30.644749999998425,2958.842105263158,28,24,7,52
469,-37.01999999999937,2494.3684210526317,22,18,6,40
470,-31.884999999999188,2198.4117647058824,19,29,2,48
471,-22.08299999999992,2155.722222222222,27,33,5,60
472,-26.925499999999357,2658.0526315789475,29,18,8,47
473,-15.850999999999647,2162.777777777778,25,25,3,50
474,-32.4199999999986,2947.35,27,29,5,56
475,-28.982499999998783,3242.9444444444443,22,30,7,52
476,-34.47799999999966,2050.8823529411766,20,37,2,57
477,-21.237749999999416,2556.1052631578946,27,21,4,48
478,-14.54424999999882,2961.8333333333335,37,15,7,52
479,-17.675249999999412,2157.3125,31,24,3,55
480,-21.29099999999951,2251.0555555555557,28,23,2,51
481,-40.33599999999842,2478.6875,32,28,11,60
482,-25.163249999998946,2621.277777777778,28,28,4,56
483,-23.330499999999503,2028.25,23,20,3,43
484,-34.5109999999986,2522.5789473684213,24,29,5,53
485,-27.664749999999703,2228.75,31,25,7,56
486,-33.71599999999968,1670.125,11,41,4,52
487,-28.53124999999908,3713.25,35,22,6,57
488,-38.499249999999634,1429.0,16,29,4,45
489,-24.26999999999922,2833.4736842105262,29,24,4,53
490,-34.17774999999967,3606.2105263157896,28,30,5,58
491,-16.940999999998393,3763.277777777778,42,30,6,72
492,-18.256749999999652,2397.3529411764707,31,13,4,44
493,-55.34249999999961,2314.3888888888887,12,40,9,52
494,-25.97074999999948,2146.176470588235,26,19,4,45
495,-13.21349999999946,2697.1666666666665,32,23,1,55
496,-18.169249999998765,2950.55,34,17,3,51
497,-25.26024999999897,2379.764705882353,29,26,3,55
498,-26.98924999999924,2512.0,31,26,2,57
499,-32.666499999998535,2862.1111111111113,38,25,2,63
500,-21.448499999998706,2533.5263157894738,32,18,5,50
501,-45.15049999999944,2952.8,14,35,5,49
502,-24.625499999999548,2718.8125,24,20,2,44
503,-22.91449999999959,2583.7368421052633,29,17,4,46
504,-27.12599999999991,1875.4375,23,34,5,57
505,-11.008999999998297,3258.9444444444443,43,29,4,72
506,-27.28474999999903,1698.9411764705883,15,28,6,43
507,-20.151249999999436,2013.5882352941176,31,16,8,47
508,-29.654749999999797,2253.6111111111113,18,20,7,38
509,-11.686249999999067,4030.5263157894738,43,31,2,74
510,-21.15874999999907,3002.05,26,29,6,55
511,-30.910999999999838,2181.3888888888887,31,17,5,48
512,-31.317499999999193,2737.75,28,24,0,52
513,-15.083999999999117,2483.777777777778,34,17,4,51
514,-31.00299999999938,2273.1176470588234,25,34,8,59
515,-26.894249999999136,2078.9444444444443,30,19,4,49
516,-11.71874999999832,3038.1052631578946,29,29,5,58
517,-29.520249999999514,2290.6666666666665,26,28,10,54
518,-21.61749999999966,2487.625,38,30,6,68
519,-34.12924999999973,3175.1111111111113,29,40,3,69
520,-22.573250000000186,2803.2631578947367,26,36,4,62
521,-34.70924999999912,2076.8125,29,34,4,63
522,-20.657249999999166,2469.157894736842,34,17,2,51
523,-20.609249999999427,2307.7,25,18,2,43
524,-28.203499999999686,2150.5,18,31,4,49
525,-32.218249999999614,2113.95,26,15,2,41
526,-42.11149999999989,2109.705882352941,35,38,2,73
527,-36.38999999999967,3320.3,19,39,2,58
528,-30.780499999999556,2032.25,13,27,1,40
529,-20.505499999999078,2891.9473684210525,23,33,4,56
530,-23.050749999998743,3168.5263157894738,38,26,4,64
531,-24.075749999998536,2352.25,28,21,6,49
532,-9.88849999999938,2555.1176470588234,36,24,1,60
533,-39.443249999999935,2733.8,12,35,2,47
534,-17.31224999999956,2617.8888888888887,35,23,3,58
535,-18.30424999999908,2939.722222222222,53,30,6,83
536,-12.993749999999276,3178.3684210526317,34,23,2,57
537,-23.3212499999999,2028.7777777777778,21,24,6,45
538,-3.6744999999985155,3437.8333333333335,49,17,0,66
539,-29.169499999999697,3189.3684210526317,28,21,8,49
540,-19.073749999999286,2832.25,23,27,4,50
541,-26.528499999999543,2146.7368421052633,18,20,4,38
542,-26.172249999999316,2352.529411764706,29,25,1,54
543,-34.77900000000007,1567.9375,11,33,3,44
544,-5.609499999998461,4378.3,45,19,3,64
545,-14.82224999999957,1982.625,38,35,6,73
546,-12.294749999998894,3116.0555555555557,49,22,3,71
547,-34.73599999999932,1956.3157894736842,16,28,0,44
548,-15.387499999998834,4064.0,43,27,2,70
549,-18.351499999999508,2174.315789473684,24,18,4,42
550,-7.902249999999141,3676.3684210526317,47,15,8,62
551,-20.602999999999845,2087.777777777778,25,18,7,43
552,-22.31224999999956,2365.65,26,16,4,42
553,-33.14799999999959,2282.470588235294,27,34,10,61
554,-38.4999999999992,4139.35,35,27,4,62
555,-26.46074999999893,3057.2105263157896,37,26,3,63
556,-26.67749999999942,2199.8333333333335,21,23,2,44
557,-18.31749999999941,2472.4210526315787,40,13,2,53
558,-32.18149999999949,2028.25,26,16,2,42
559,-1.4842499999973378,2153.3125,47,22,9,69
560,-27.685499999999514,2024.25,23,22,0,45
561,-19.327499999999276,2475.764705882353,25,29,3,54
562,-1.5807499999975452,4335.55,53,34,1,87
563,-17.839999999999012,3134.1052631578946,25,34,4,59
564,-29.95624999999918,3776.65,32,33,2,65
565,-26.592749999999477,2028.25,26,16,2,42
566,-31.356749999999558,2002.9473684210527,24,15,3,39
567,-18.071499999998586,3314.0,45,15,2,60
568,-13.034749999999729,2698.8888888888887,42,25,2,67
569,-16.306249999999302,2377.8888888888887,29,23,7,52
570,-11.282999999999497,3391.9444444444443,39,45,3,84
571,-16.52899999999912,3379.15,40,19,3,59
572,-32.52549999999922,2249.0,16,27,2,43
573,-26.327249999999133,2586.9411764705883,36,11,0,47
574,9.567500000001873,4849.85,58,30,1,88
575,-13.473999999999876,2978.842105263158,18,34,4,52
576,-11.839249999998875,3655.777777777778,48,19,4,67
577,-22.252249999999623,2325.1111111111113,14,30,4,44
578,-12.988749999999422,3062.35,37,24,2,61
579,-30.175499999999527,1963.4444444444443,31,21,1,52
580,-40.86499999999899,2057.0,19,25,8,44
581,-15.709249999999788,2488.4210526315787,32,20,5,52
582,-24.048249999999314,2544.2,25,30,1,55
583,-16.078249999999002,3308.842105263158,28,38,3,66
584,-15.32149999999957,1975.2941176470588,29,30,0,59
585,-39.428749999999845,1429.0,14,34,2,48
586,-20.91624999999963,2719.5882352941176,31,22,2,53
587,-20.665499999999106,2847.8333333333335,42,19,4,61
588,-28.111749999999574,2165.1052631578946,21,25,2,46
589,-19.43849999999921,2570.1111111111113,28,29,1,57
590,-24.172749999998846,3720.3,28,30,3,58
591,-20.477249999999078,2507.6111111111113,36,14,3,50
592,-28.220999999999645,2215.2105263157896,23,21,2,44
593,-9.039750000000122,2032.25,40,17,4,57
594,-24.905749999999802,3304.4736842105262,18,38,3,56
595,-26.686999999998978,2196.5882352941176,26,27,2,53
596,-32.580499999999645,1959.5263157894738,21,21,1,42
597,-2.1294999999987896,2580.875,47,19,3,66
598,-42.05024999999953,2062.35,10,29,4,39
599,-4.897749999998957,3190.2631578947367,38,26,1,64
600,-22.915749999998827,3025.85,34,24,0,58
601,-15.781749999999239,2887.0,35,24,1,59
602,-9.646249999999803,2598.75,52,43,7,95
603,-18.70624999999965,2052.5,29,19,2,48
604,-20.798249999999047,2175.9473684210525,31,15,6,46
605,-18.338249999998837,2831.4,49,14,1,63
606,-1.9009999999987328,3409.25,39,28,3,67
607,-16.749999999999105,2068.6470588235293,33,16,4,49
608,-22.864249999999423,2206.0,32,21,4,53
609,-42.95799999999945,1967.0,22,16,12,38
610,-14.816749999999113,3450.7368421052633,44,24,1,68
611,-18.32724999999917,2723.0588235294117,44,21,5,65
612,-16.382749999999344,3835.1052631578946,43,25,5,68
613,-8.845499999998808,3012.6,40,17,1,57
614,-14.585499999999314,2367.2,34,17,2,51
615,-32.15299999999961,2066.5263157894738,28,14,3,42
616,-24.307749999999608,3110.7894736842104,24,41,2,65
617,-12.956000000000136,2981.1111111111113,43,25,4,68
618,-30.37924999999934,2210.85,25,20,0,45
619,-22.565749999999767,2195.4444444444443,34,22,8,56
620,-15.025499999999052,3155.8888888888887,31,36,4,67
621,-20.150249999999083,2244.722222222222,33,22,3,55
622,-17.514749999999555,2633.6470588235293,36,17,1,53
623,-23.839250000000234,1942.2777777777778,39,23,15,62
624,-19.583999999999627,2144.15,29,14,2,43
625,-28.305999999999244,2008.5,17,30,3,47
626,-11.760999999999935,2782.722222222222,44,32,9,76
627,-23.394499999999145,3104.45,26,30,0,56
628,-4.754999999999471,2371.6875,35,27,2,62
629,-24.653249999999666,2583.9,35,18,1,53
630,-7.815999999998726,3285.277777777778,50,20,5,70
631,-1.823499999997016,3641.5,68,19,6,87
632,-17.470999999999,2344.4,35,19,4,54
633,-11.330499999998802,2712.1666666666665,42,19,3,61
634,-47.17674999999989,1429.0,0,27,4,27
635,-3.1074999999997206,3030.470588235294,43,30,4,73
636,-10.555749999999708,2443.1666666666665,51,19,11,70
637,-9.870249999999427,2629.2,38,23,4,61
638,-26.613999999999542,2552.15,27,21,1,48
639,-22.966999999999814,2057.4117647058824,33,20,4,53
640,-15.972500000000522,2689.5882352941176,37,32,4,69
641,-26.23974999999992,2303.7368421052633,29,33,2,62
642,-17.08024999999925,2331.315789473684,32,17,3,49
643,-2.343999999998348,3592.7,46,25,1,71
644,-23.305749999999968,2655.8823529411766,43,23,4,66
645,-12.458999999998483,2539.176470588235,39,31,4,70
646,-26.843749999999535,3067.3684210526317,32,30,1,62
647,14.95375000000127,3714.75,55,25,1,80
648,-12.82749999999985,2365.6666666666665,45,20,6,65
649,-20.995499999999915,2126.5882352941176,21,40,5,61
650,-23.085499999999673,2127.4444444444443,25,21,4,46
651,-18.15849999999877,4054.5,45,19,4,64
652,-6.462999999998556,2965.3888888888887,42,31,5,73
653,-31.505249999999712,2449.3888888888887,23,36,6,59
654,-22.177749999998845,2717.2631578947367,30,27,3,57
655,-6.900749999999536,2897.7368421052633,36,16,4,52
656,-22.053999999999597,2008.45,21,19,5,40
657,-28.109999999998866,2627.0588235294117,37,27,2,64
658,-9.183249999998228,2922.0555555555557,39,29,4,68
659,-29.450500000000325,2183.0,19,48,7,67
660,-10.299999999999413,2560.05,32,24,3,56
661,-28.38624999999904,1546.125,23,28,7,51
662,-28.40324999999931,2125.5,22,41,2,63
663,-23.53299999999947,2040.1,26,17,2,43
664,-2.9849999999982044,2072.9375,44,29,4,73
665,-18.292500000000036,1567.9375,16,37,2,53
666,-35.124500000000026,2749.0526315789475,19,35,9,54
667,-7.511749999998784,2594.875,35,21,2,56
668,4.694750000000853,4115.6,39,28,4,67
669,-0.33124999999832944,4414.75,49,28,2,77
670,-10.365749999999824,2531.0,45,15,11,60
671,-37.564749999999535,1951.9444444444443,10,38,5,48
672,-20.201999999999344,2135.0,30,16,3,46
673,-1.4884999999994164,3719.0526315789475,54,21,7,75
674,-15.372249999999465,2561.157894736842,25,21,3,46
675,-19.362499999999592,3012.1052631578946,33,25,9,58
676,-10.871249999999211,2495.842105263158,29,25,2,54
677,1.0892500000018683,4030.0,50,23,3,73
678,21.13700000000115,5015.6,51,31,2,82
679,-13.379249999999166,2687.2631578947367,34,19,1,53
680,-40.787499999999405,2272.0526315789475,9,40,6,49
681,-27.885749999999256,2114.2105263157896,18,29,2,47
682,-27.181499999999566,2028.25,26,13,4,39
683,-13.829249999998984,2937.8888888888887,32,32,3,64
684,-4.687249999998563,2728.8125,55,25,7,80
685,-21.953999999999503,2706.4210526315787,32,16,5,48
686,-21.6247499999996,2158.5,21,23,2,44
687,-19.39799999999908,2419.6,44,21,1,65
688,-16.396249999998965,1945.8333333333333,33,19,4,52
689,-20.58324999999955,2042.2631578947369,19,30,1,49
690,-14.96724999999969,1870.7058823529412,33,20,5,53
691,-11.79974999999919,2255.3529411764707,32,24,2,56
692,-7.565999999998882,3017.9,48,17,2,65
693,-13.65849999999953,2820.6666666666665,33,26,3,59
694,-27.647499999999052,2070.684210526316,33,18,0,51
695,-21.72299999999941,3537.5,38,31,4,69
696,-7.653999999999408,2685.823529411765,48,23,3,71
697,-15.343499999999656,3276.5555555555557,38,31,2,69
698,-24.599749999999027,2150.25,30,23,5,53
699,-27.47849999999944,2477.4736842105262,14,36,6,50
700,-25.33449999999952,3103.2631578947367,19,44,2,63
701,-11.497499999999626,2637.470588235294,25,29,1,54
702,-30.55949999999953,2093.4,20,31,0,51
703,-13.61099999999928,2827.823529411765,28,32,2,60
704,-5.363999999999213,3940.2,41,29,3,70
705,1.3105000000014644,4458.55,48,31,2,79
706,-11.25924999999998,2844.4444444444443,42,20,6,62
707,-13.598749999999256,2726.0,49,29,5,78
708,-19.994249999999717,3279.85,24,34,4,58
709,-10.089249999999033,3083.8,35,25,2,60
710,-37.143999999999494,2073.6111111111113,19,41,4,60
711,-13.921749999998477,2704.45,43,19,3,62
712,-36.570749999999876,1429.0,0,35,3,35
713,0.2992500000008006,2769.4444444444443,42,16,0,58
714,-10.257499999999117,2166.1875,35,18,3,53
715,-21.464499999999,3537.85,28,33,5,61
716,-0.9627499999986868,3600.5,59,21,1,80
717,-28.447999999999475,2048.1,12,29,2,41
718,-13.024749999999367,2912.7894736842104,44,19,2,63
719,-12.609749999999487,2176.0,27,20,4,47
720,-8.365249999999929,2330.875,56,27,7,83
721,-21.090999999999376,2085.4117647058824,36,19,8,55
722,-17.95974999999974,2740.0588235294117,51,23,0,74
723,4.959250000001765,3174.277777777778,47,32,5,79
724,-18.933749999999186,2229.6875,31,18,4,49
725,-22.06649999999998,1505.4375,17,29,4,46
726,-9.043499999999657,2561.157894736842,34,25,3,59
727,-9.823499999999141,2461.684210526316,33,20,3,53
728,2.1585000000013466,3808.3684210526317,52,25,1,77
729,-20.67124999999907,2376.823529411765,29,25,3,54
730,-14.674999999999546,2008.45,20,19,2,39
731,-1.8617499999981715,3988.65,49,19,6,68
732,-8.771749999999448,2533.866666666667,33,21,1,54
733,-3.069000000000084,2924.823529411765,45,28,13,73
734,-20.97549999999945,2811.6,32,21,6,53
735,-10.02374999999877,2481.625,40,23,2,63
736,-20.071250000000084,1921.0,32,26,14,58
737,-37.567749999999606,2415.7368421052633,10,42,2,52
738,-14.348499999999607,3048.1666666666665,36,24,6,60
739,-0.6517499999988791,2932.0625,56,32,8,88
740,-14.651249999999854,2045.1875,40,30,4,70
741,-23.506249999999813,2380.7,20,28,3,48
742,-7.9397499999993,3349.7,38,15,3,53
743,-25.093499999999803,2021.8823529411766,37,20,21,57
744,-17.56149999999965,1971.5294117647059,37,18,4,55
745,-19.616999999999447,2586.9473684210525,27,30,6,57
746,-19.8534999999993,2202.1176470588234,42,27,5,69
747,-0.9814999999985197,3167.2,54,10,4,64
748,-1.0127499999985807,3489.0555555555557,52,28,4,80
749,-3.9699999999987376,4773.55,40,38,4,78
750,-21.6199999999991,2698.1052631578946,30,26,9,56
751,-6.131249999999612,4430.75,41,27,6,68
752,22.629500000000746,3611.157894736842,65,20,4,85
753,-15.168249999999437,2454.6111111111113,33,29,3,62
754,10.957500000001291,3373.0588235294117,55,18,4,73
755,-8.321999999998955,2469.5555555555557,27,32,1,59
756,13.382750000001105,3662.5,52,18,1,70
757,-11.182249999999083,4329.8,50,19,1,69
758,-3.608749999998909,4328.736842105263,37,49,4,86
759,11.490750000000904,4283.9,54,36,3,90
760,-23.219499999999183,2008.4,30,21,0,51
761,-12.700249999999514,2406.222222222222,28,25,6,53
762,3.1727500000025803,2201.6,53,14,8,67
763,-20.03899999999936,2743.285714285714,35,20,9,55
764,-29.67024999999947,2040.1,22,21,2,43
765,-2.632749999999324,3350.6666666666665,42,34,2,76
766,-12.424749999998951,3877.6,36,30,5,66
767,3.5780000000022683,4213.631578947368,64,12,6,76
768,-7.505499999999428,2508.55,40,15,2,55
769,-4.936249999999059,2591.133333333333,46,28,6,74
770,24.288250000001486,4530.8,61,30,3,91
771,-16.842999999999392,2466.1666666666665,27,27,2,54
772,10.731500000001937,4781.4,60,34,3,94
773,-15.908249999999644,1986.3157894736842,30,19,2,49
774,-12.066749999998894,2927.8947368421054,46,19,6,65
775,-7.33824999999928,2292.8947368421054,30,24,0,54
776,-0.2794999999991722,3622.842105263158,42,39,2,81
777,14.269000000001506,4316.35,57,24,3,81
778,-25.76450000000001,2095.722222222222,17,39,11,56
779,-25.31349999999962,2683.0,41,38,4,79
780,-22.397749999999863,1983.5882352941176,33,17,5,50
781,-9.571749999998564,4383.05,41,37,2,78
782,-31.473999999999513,2024.25,23,15,4,38
783,-15.524499999998998,2142.4444444444443,30,19,7,49
784,-2.2174999999988967,3064.842105263158,38,22,3,60
785,-1.124999999999066,2135.5,39,20,6,59
786,-6.136499999999144,3378.777777777778,41,26,8,67
787,-21.69225,1898.25,39,32,10,71
788,-5.632249999999177,2536.25,30,23,3,53
789,-18.845249999999588,2157.5263157894738,34,20,7,54
790,-6.888749999999577,2591.75,39,19,9,58
791,-7.020749999999147,2694.4117647058824,35,28,6,63
792,-3.3642499999993474,2657.55,44,15,2,59
793,-10.464499999999303,2743.6,33,22,3,55
794,-21.207749999999585,2032.2,23,23,2,46
795,-13.721999999998966,2917.9,28,27,4,55
796,-22.96849999999929,2216.0,28,20,3,48
797,-10.84474999999917,2616.0,42,30,5,72
798,-18.246749999998936,2109.6470588235293,33,22,2,55
799,-19.543499999999785,2206.8333333333335,30,27,11,57
800,-24.749749999999615,2086.25,19,21,6,40
801,-27.79149999999974,2096.8125,30,36,16,66
802,-17.340999999999127,3653.9444444444443,35,41,4,76
803,-7.115249999999362,2446.0588235294117,34,27,6,61
804,1.7672500000013265,3008.5,43,17,4,60
805,-13.431749999998138,3111.6470588235293,42,35,8,77
806,-5.641499999999178,2072.777777777778,30,18,6,48
807,-14.615249999998284,3383.3333333333335,38,38,7,76
808,-17.478499999999375,2149.8,25,17,5,42
809,-0.9562499999993224,3688.8947368421054,54,24,5,78
810,-16.230499999999022,2694.733333333333,34,24,6,58
811,-11.35599999999917,2569.0,46,18,6,64
812,-19.897999999999737,2273.0555555555557,28,18,3,46
813,-29.92374999999938,3594.1,16,36,5,52
814,-40.30224999999981,1429.0,0,34,3,34
815,5.882500000001199,4220.3,38,30,4,68
816,-25.778249999999026,2010.4736842105262,27,17,8,44
817,-11.609749999999504,2518.375,34,15,6,49
818,-19.055999999998917,2320.5555555555557,26,27,5,53
819,-5.201749999999175,2335.75,38,28,8,66
820,7.50650000000105,2944.1666666666665,44,35,6,79
821,-4.7359999999989135,3203.3333333333335,41,24,2,65
822,-4.964749999999091,2533.866666666667,40,36,5,76
823,-7.233999999999597,2321.875,43,22,5,65
824,-7.889249999999402,2903.5789473684213,38,25,7,63
825,-45.082999999999394,2524.2105263157896,20,31,3,51
826,2.3937500000008596,4613.736842105263,50,27,6,77
827,-6.884749999999227,3024.684210526316,41,26,7,67
828,-20.68249999999993,2210.5882352941176,26,27,11,53
829,8.442000000001192,3135.4444444444443,56,20,3,76
830,-24.699249999999758,2172.0,14,29,2,43
831,2.140500000001293,3437.05,39,22,7,61
832,-21.069499999999795,2032.25,24,19,2,43
833,-31.763499999999464,2028.25,20,20,2,40
834,-18.69074999999985,3134.6,37,25,2,62
835,17.725250000002312,4698.15,63,27,3,90
836,-5.801999999999618,2395.5,34,21,4,55
837,-9.126499999998979,2871.0,40,22,7,62
838,-29.42249999999955,2576.3888888888887,27,25,6,52
839,-11.174249999999462,2375.5,55,26,10,81
840,-28.111749999999297,2031.388888888889,26,21,4,47
841,-21.146749999999763,2032.25,21,15,7,36
842,-9.208999999999186,2449.875,46,28,12,74
843,-31.399249999999576,2126.529411764706,34,34,8,68
844,-8.409249999998302,2335.8125,46,11,11,57
845,-22.97399999999987,2110.0,25,24,6,49
846,-3.832499999999159,3823.5,43,24,4,67
847,-35.49674999999981,2128.95,12,30,1,42
848,2.9395000000016585,4746.55,53,32,2,85
849,22.844250000001598,4267.95,56,18,8,74
850,-16.579249999999256,2638.7894736842104,40,26,3,66
851,-29.029499999998865,1429.0,12,31,9,43
852,-10.948749999999295,2081.9333333333334,39,35,7,74
853,-23.806249999999295,2425.5555555555557,41,20,5,61
854,12.62425000000071,2751.294117647059,49,17,1,66
855,5.2840000000010665,3762.4736842105262,51,33,2,84
856,-21.240000000000034,2038.8235294117646,31,22,12,53
857,14.179750000001231,4581.6,52,37,2,89
858,-19.046749999999832,3262.0,20,37,12,57
859,-35.07799999999968,1429.0,9,39,3,48
860,-10.644749999998735,2717.875,46,37,8,83
861,-15.376249999998478,2353.5833333333335,40,20,3,60
862,-17.143249999999483,2045.3529411764705,41,24,9,65
863,-0.1297499999989343,4447.25,55,24,5,79
864,-9.449749999999721,2322.5555555555557,31,18,4,49
865,-0.29324999999910134,2830.5,38,22,5,60
866,-18.036749999999827,2300.3333333333335,26,25,17,51
867,-12.288999999998918,2524.235294117647,43,38,6,81
868,-8.770249999998956,2584.9411764705883,40,24,6,64
869,-1.1302500000000637,4028.157894736842,50,19,7,69
870,-12.609999999999276,2375.625,36,38,6,74
871,-17.11874999999929,2153.4210526315787,28,20,6,48
872,-3.52624999999892,2806.785714285714,40,27,2,67
873,-10.47499999999907,2573.764705882353,30,27,3,57
874,-1.9007499999986994,4028.4,59,17,1,76
875,-24.248999999999494,2219.315789473684,27,17,3,44
876,13.874250000000538,2958.714285714286,52,34,7,86
877,-11.937249999998524,2315.0,38,28,5,66
878,8.887750000000882,3406.5263157894738,40,32,3,72
879,17.662000000001413,5057.65,68,29,7,97
880,-12.621249999999272,3375.9,50,14,3,64
881,6.0292500000010385,3274.5789473684213,41,28,6,69
882,-22.91324999999869,2819.4117647058824,38,33,9,71
883,-21.84124999999884,3097.4444444444443,34,28,4,62
884,-17.26474999999931,2434.0,34,23,5,57
885,-13.969499999999186,3506.842105263158,46,32,11,78
886,-14.490749999998465,2317.9375,47,20,6,67
887,7.168500000001352,4524.3,59,25,2,84
888,-19.18799999999933,2217.3888888888887,31,23,4,54
889,-1.492749999998863,3552.95,39,24,7,63
890,6.945750000002549,3834.315789473684,61,28,4,89
891,-9.43624999999887,3201.9473684210525,48,21,9,69
892,9.173000000001526,3892.5,48,22,4,70
893,-19.66499999999921,2418.0,30,24,3,54
894,1.7540000000004219,3576.7,35,36,4,71
895,8.98950000000097,3587.95,55,18,3,73
896,19.835000000001397,4623.55,63,26,5,89
897,-20.898999999999813,2715.6315789473683,41,20,1,61
898,-29.823749999999773,2009.6842105263158,20,17,9,37
899,-8.991749999998222,4252.85,44,26,6,70
900,-13.45549999999956,2215.777777777778,24,35,6,59
901,1.068000000000574,2842.6111111111113,36,28,5,64
902,-31.55524999999981,2060.4444444444443,26,20,10,46
903,-5.440999999998217,3632.0,54,25,4,79
904,-7.978499999999213,2818.85,24,35,0,59
905,-1.8407499999991042,3373.4444444444443,68,34,8,102
906,-26.06149999999952,1945.8333333333333,17,25,3,42
907,-29.169999999999753,2440.7368421052633,13,26,11,39
908,-27.45949999999984,1963.6315789473683,21,23,9,44
909,-1.3872499999990748,3549.8333333333335,44,32,3,76
910,-7.094249999999124,3263.15,39,20,2,59
911,-13.220749999998322,3128.4444444444443,44,28,1,72
912,6.491500000001774,4234.7,56,25,3,81
913,-2.4744999999982284,4432.368421052632,61,27,7,88
914,-1.3297499999989786,3344.4444444444443,40,28,5,68
915,-17.833749999999448,2191.842105263158,21,28,6,49
916,-22.943999999999285,2161.65,28,22,1,50
917,5.654500000000995,4073.157894736842,56,26,9,82
918,-25.380999999999794,2042.5294117647059,26,44,4,70
919,1.7795000000004542,3215.2105263157896,52,31,12,83
920,-23.390249999999984,1429.0,17,32,6,49
921,-1.9134999999981503,3637.1,49,16,7,65
922,-22.31024999999951,2080.8125,35,23,3,58
923,-6.5899999999994465,2005.1176470588234,37,24,7,61
924,2.459250000001257,3786.25,37,29,5,66
925,-22.227749999999602,2059.8947368421054,22,24,5,46
926,5.020750000001018,2957.8947368421054,49,20,1,69
927,-11.83574999999966,2556.0,32,20,3,52
928,9.461750000000768,2534.25,46,21,3,67
929,-22.524499999998962,2741.75,32,23,7,55
930,-16.067499999999043,2381.4210526315787,29,26,5,55
931,-22.48599999999874,2982.8333333333335,41,26,10,67
932,6.325250000001276,2224.6470588235293,41,18,6,59
933,9.979750000001284,2822.5,48,20,3,68
934,-23.443249999999516,2008.4,23,23,2,46
935,-12.885749999999565,2146.176470588235,31,24,2,55
936,-22.21399999999944,3643.7894736842104,39,35,3,74
937,-3.8742499999987707,3706.4736842105262,56,29,2,85
938,-10.705499999999356,2794.95,30,18,5,48
939,-24.238999999999262,2029.85,25,17,5,42
940,-8.040749999998406,4129.263157894737,50,35,3,85
941,22.552750000001573,3292.0,57,20,6,77
942,-18.183249999999834,2442.235294117647,29,26,12,55
943,-12.249249999999105,3339.842105263158,37,31,4,68
944,-32.821999999999534,2024.25,24,14,5,38
945,-10.96274999999947,2384.375,40,15,13,55
946,9.034500000001975,4241.8,57,14,5,71
947,-7.1059999999990735,2912.0526315789475,32,27,4,59
948,-4.248749999998637,4438.6,57,25,3,82
949,6.122750000001222,3091.8,49,19,2,68
950,4.252750000001148,4060.5555555555557,44,36,4,80
951,3.3565000000014087,3970.35,41,36,5,77
952,-3.504999999999312,3008.5555555555557,37,36,0,73
953,-8.115999999999502,2589.4736842105262,33,25,4,58
954,-15.943499999999608,2274.777777777778,37,24,13,61
955,-7.0777499999992886,2783.2631578947367,44,23,12,67
956,-33.885249999998635,4535.45,36,31,4,67
957,13.915750000001562,5669.6,75,22,5,97
958,-18.71624999999896,2117.235294117647,32,27,8,59
959,-16.74024999999924,2017.2222222222222,25,24,7,49
960,-24.461249999999193,3814.8,28,32,3,60
961,-28.005249999998945,2408.529411764706,33,26,7,59
962,-6.5569999999992445,2758.9444444444443,41,24,2,65
963,-44.69175,3053.9473684210525,24,50,17,74
964,15.45924999999998,2348.75,50,24,7,74
965,-14.743999999999698,2198.8888888888887,32,24,8,56
966,12.822750000000891,4779.95,39,41,1,80
967,-23.115249999999328,1987.5,33,25,6,58
968,13.688000000000864,3789.9473684210525,49,30,3,79
969,-13.686249999999792,2693.8,37,19,11,56
970,6.406750000002289,4212.684210526316,49,42,5,91
971,-27.7727500000002,2147.5263157894738,27,30,29,57
972,-3.1324999999995127,2247.0,40,21,3,61
973,6.386500000001446,3703.8947368421054,62,20,4,82
974,-11.932749999999672,2711.5263157894738,26,23,7,49
975,-9.271749999999912,1874.3529411764705,41,29,8,70
976,10.300750000000855,3622.8,54,17,3,71
977,-23.81274999999961,2303.1428571428573,36,17,8,53
978,-34.63375000000009,1429.0,13,38,13,51
979,-13.747249999998928,3305.35,36,28,7,64
980,4.320750000000788,3193.764705882353,62,31,6,93
981,-38.90224999999976,1429.0,0,28,9,28
982,-18.13324999999889,2386.1176470588234,38,28,6,66
983,-12.537499999999751,3161.6,41,18,4,59
984,34.93550000000258,5076.578947368421,80,14,9,94
985,2.789500000000987,2200.294117647059,33,31,7,64
986,0.3672500000011693,3987.1,34,37,0,71
987,-9.151499999999546,2782.3,39,17,1,56
988,-28.610999999999535,2036.25,19,23,4,42
989,-19.871999999999318,2117.3684210526317,27,22,1,49
990,-3.3189999999989093,4121.9,42,39,2,81
991,-4.988499999999478,2745.6428571428573,32,30,5,62
992,-0.4504999999984592,3588.684210526316,66,12,4,78
993,-15.823999999999282,2563.470588235294,40,32,2,72
994,7.225500000000925,3958.55,45,24,3,69
995,-32.99749999999968,2078.157894736842,29,23,13,52
996,5.518250000000441,2750.8333333333335,51,20,4,71
997,-3.681499999999108,3265.7,51,13,2,64
998,-7.440999999999578,2481.8888888888887,37,18,2,55
999,-17.201999999999938,2294.1666666666665,30,40,3,70
1000,-16.761749999999303,2139.777777777778,26,20,4,46
1001,20.594250000001423,4581.9473684210525,68,15,2,83
1002,-21.33174999999869,2350.5882352941176,34,26,8,60
1003,-23.854249999999297,2436.5263157894738,26,22,8,48
1004,-7.138499999999087,2447.0,40,31,7,71
1005,-1.1844999999990757,2337.875,40,21,6,61
1006,1.6602500000017848,4256.85,44,42,1,86
1007,-17.672249999999483,1904.235294117647,27,20,4,47
1008,-10.014249999999674,2223.705882352941,35,24,8,59
1009,-11.130499999999499,2902.684210526316,26,30,6,56
1010,-2.276249999998318,4067.95,60,26,5,86
1011,-19.706499999999433,2094.8333333333335,24,21,6,45
1012,-9.11024999999901,2411.4117647058824,34,25,5,59
1013,16.791000000000594,3756.5789473684213,68,23,13,91
1014,-6.764249999998161,2580.315789473684,41,23,11,64
1015,-13.79299999999925,2309.3846153846152,29,21,4,50
1016,-28.949499999999524,2028.25,23,22,3,45
1017,10.83350000000073,2944.529411764706,44,27,1,71
1018,12.199500000001088,2637.5625,52,20,6,72
1019,-3.6574999999985467,4749.65,56,25,6,81
1020,-14.735750000000014,2333.714285714286,29,19,15,48
1021,-35.275249999999765,2088.176470588235,14,36,8,50
1022,9.412750000001061,3061.235294117647,44,25,7,69
1023,-6.791999999999128,2650.4117647058824,36,28,5,64
1024,-13.25324999999938,2275.3684210526317,24,28,4,52
1025,-7.318249999999675,2622.7894736842104,28,31,1,59
1026,-13.779749999999035,3990.1,26,36,3,62
1027,-5.219999999999283,4644.2,44,30,5,74
1028,-5.7702499999991135,2661.0,41,28,7,69
1029,-5.7159999999979,3741.0,44,32,2,76
1030,-17.14499999999954,2198.9444444444443,38,24,5,62
1031,8.174000000001389,3570.2105263157896,53,17,5,70
1032,-47.045000000000215,1429.0,0,26,7,26
1033,-14.9592499999995,2499.315789473684,27,29,2,56
1034,-10.618999999999065,2328.5,36,23,2,59
1035,-25.886999999999112,2319.6,27,25,2,52
1036,6.556500000000945,2476.733333333333,51,39,2,90
1037,-6.082999999999613,2132.0,18,33,8,51
1038,-24.755999999999734,3357.6666666666665,31,42,10,73
1039,-5.73749999999946,3775.842105263158,36,44,5,80
1040,-18.28924999999908,2637.05,28,24,8,52
1041,-17.30699999999892,2461.722222222222,36,25,4,61
1042,3.445750000001066,4195.1578947368425,43,39,6,82
1043,-20.64974999999981,2056.1,18,28,2,46
1044,-26.556249999998776,2047.2777777777778,22,30,7,52
1045,-1.774749999999085,2814.75,36,22,5,58
1046,8.503000000001482,3328.6111111111113,44,29,4,73
1047,-3.854999999999561,3034.842105263158,46,23,10,69
1048,-11.002499999998843,3617.95,39,39,0,78
1049,10.42925000000129,4174.3,56,26,0,82
1050,-2.5622499999988015,2823.1666666666665,36,38,5,74
1051,-22.871999999999545,2127.4736842105262,26,17,5,43
1052,-1.1194999999994824,3336.2,38,24,5,62
1053,10.337250000001237,4125.8421052631575,52,27,3,79
1054,-11.71949999999924,2772.7,39,19,1,58
1055,-26.464999999999236,1904.2941176470588,31,20,2,51
1056,4.04575000000058,3567.2,41,30,2,71
1057,2.0150000000016095,3175.2105263157896,53,23,2,76
1058,-13.113749999999238,3821.684210526316,33,42,8,75
1059,-11.469499999999293,3314.85,47,20,1,67
1060,-11.51524999999916,3067.1,36,27,5,63
1061,-24.198999999999764,2028.25,23,21,1,44
1062,0.06450000000107244,2220.0,34,23,12,57
1063,-26.18349999999982,2006.3157894736842,29,19,7,48
1064,-9.050249999999616,3024.3333333333335,45,23,5,68
1065,-0.045999999998860994,3352.3333333333335,39,32,9,71
1066,-9.945249999999513,3368.1052631578946,26,37,5,63
1067,-19.67249999999972,2174.0,34,24,7,58
1068,-1.5644999999987899,3285.315789473684,47,26,4,73
1069,-10.893499999999019,2580.875,38,22,4,60
1070,1.70250000000119,3079.9,43,21,3,64
1071,-21.263000000000297,1848.625,37,28,11,65
1072,5.577500000002285,5050.6,63,28,6,91
1073,-1.5409999999995496,2521.470588235294,47,24,2,71
1074,12.537250000002341,2373.5625,54,21,6,75
1075,-0.0837499999993212,3257.7368421052633,52,20,5,72
1076,-9.998999999999423,2065.9375,38,17,13,55
1077,-20.364499999999495,2139.1052631578946,27,22,1,49
1078,-14.00149999999841,4107.55,53,29,1,82
1079,-22.989999999999505,2081.5,23,21,4,44
1080,-5.562249999999389,2584.277777777778,30,27,8,57
1081,-1.0327499999995706,2129.6,49,20,12,69
1082,-33.24299999999963,2148.15,16,25,2,41
1083,4.630000000000836,3136.2,48,10,4,58
1084,-16.35424999999963,2050.8823529411766,35,25,8,60
1085,-18.174749999999964,2187.85,23,18,5,41
1086,5.590000000000811,3315.5263157894738,63,18,9,81
1087,-22.31425000000001,2119.5,34,24,8,58
1088,-1.920499999999759,2084.277777777778,46,26,10,72
1089,-12.074249999999127,2062.277777777778,41,15,19,56
1090,-5.156999999998758,3009.153846153846,35,26,9,61
1091,-1.221999999998085,3463.6111111111113,51,36,5,87
1092,-28.32024999999951,2168.4117647058824,21,31,9,52
1093,0.6842500000008764,2651.294117647059,44,22,6,66
1094,-24.725749999999977,2311.470588235294,29,23,16,52
1095,-17.237249999999516,2915.5,34,21,6,55
1096,-13.906999999999403,3531.7894736842104,35,29,8,64
1097,3.7747500000021206,4738.7,65,21,8,86
1098,-13.518749999999297,2410.1875,34,20,8,54
1099,-27.307749999998542,2207.705882352941,27,34,7,61
1100,-19.931999999999032,2085.8125,39,27,15,66
1101,-1.0427499999993433,3312.6666666666665,56,31,13,87
1102,2.478250000000613,2427.125,51,19,7,70
1103,9.345250000001332,2453.8125,49,22,5,71
1104,-22.17049999999928,2491.5625,35,30,4,65
1105,-1.3617499999983118,4967.15,51,36,8,87
1106,9.642250000000633,3698.222222222222,68,31,12,99
1107,5.663250000000853,2623.222222222222,35,21,6,56
1108,-21.55099999999864,2342.722222222222,30,19,13,49
1109,-1.669749999998185,3939.6315789473683,64,28,2,92
1110,-15.940749999999364,2202.1176470588234,31,37,6,68
1111,2.3457500000013822,2875.4375,44,34,4,78
1112,-7.011749999999344,2846.7894736842104,34,24,6,58
1113,-19.99924999999974,1965.2222222222222,30,17,8,47
1114,16.430750000001325,3603.65,64,11,3,75
1115,15.734000000000563,2980.684210526316,44,21,8,65
1116,-7.596749999999497,2597.1176470588234,41,18,8,59
1117,-15.891249999999449,2583.9,26,22,8,48
1118,-2.459749999999512,3478.315789473684,35,33,15,68
1119,-4.4027499999994,3071.9444444444443,41,29,12,70
1120,-11.929499999999319,2666.375,28,23,4,51
1121,-15.115999999999108,3198.1111111111113,37,39,7,76
1122,-16.02549999999939,2114.470588235294,33,23,5,56
1123,-0.8189999999996296,3041.8888888888887,38,31,9,69
1124,-2.609999999999386,3834.6,47,25,3,72
1125,-4.149249999999357,3795.7894736842104,39,31,6,70
1126,-23.07074999999974,1980.0,31,13,11,44
1127,-25.516499999999393,1978.7368421052631,23,22,4,45
1128,-20.031249999999925,2189.222222222222,38,23,21,61
1129,-19.230999999999604,2953.8947368421054,40,32,11,72
1130,-13.689749999999268,2992.1052631578946,33,25,5,58
1131,-23.704499999999847,2028.7222222222222,22,22,5,44
1132,8.830250000000692,2979.3333333333335,49,20,8,69
1133,18.266750000001046,3884.4736842105262,50,25,7,75
1134,-18.041999999999636,2072.8,22,20,6,42
1135,-29.533250000000017,1971.6470588235295,29,25,22,54
1136,-18.189249999998978,2001.4117647058824,36,15,6,51
1137,-17.253999999998857,2656.315789473684,30,24,9,54
1138,24.935750000001867,3362.625,71,20,5,91
1139,-24.333749999999526,2059.7894736842104,22,18,7,40
1140,-18.665499999999618,2615.65,20,25,6,45
1141,-7.153499999998985,3846.65,38,31,3,69
1142,4.31225000000059,2640.866666666667,42,19,5,61
1143,-9.147249999999108,2480.222222222222,37,30,6,67
1144,-0.1997499999989306,2630.4375,46,16,8,62
1145,0.5062500000012783,3312.45,49,16,5,65
1146,12.78750000000193,3851.2,60,16,5,76
1147,-8.357249999999107,2548.1875,36,22,7,58
1148,0.04600000000135056,3281.8333333333335,47,38,3,85
1149,-17.42774999999865,2157.1875,45,20,11,65
1150,5.71775000000088,4491.736842105263,64,28,13,92
1151,-0.42024999999926893,3368.9473684210525,50,28,3,78
1152,-1.1844999999985613,3044.5555555555557,61,13,15,74
1153,-12.759999999999415,2917.9,29,25,6,54
1154,-2.19249999999903,3181.45,46,19,4,65
1155,-27.713499999999577,2322.4444444444443,27,11,12,38
1156,-5.458999999998619,2845.5882352941176,47,23,5,70
1157,13.721500000001488,3095.823529411765,60,19,3,79
1158,-22.14174999999969,2036.3,18,25,7,43
1159,0.3590000000018076,2884.1666666666665,42,24,9,66
1160,-6.015749999999984,2322.3888888888887,51,27,17,78
1161,-22.051749999999593,2044.15,20,25,2,45
1162,-20.65624999999853,2893.777777777778,56,16,9,72
1163,-0.8392499999991874,3142.5263157894738,35,32,5,67
1164,-0.8852499999987362,3722.0,49,29,2,78
1165,-7.870499999999024,3612.0526315789475,44,36,5,80
1166,-12.777499999999723,2340.3529411764707,33,15,7,48
1167,-26.237499999999642,2032.3,18,22,3,40
1168,-3.54624999999918,2810.7894736842104,43,16,4,59
1169,3.1182500000007782,2005.5,39,27,5,66
1170,-19.928249999999576,2166.3,25,15,5,40
1171,5.141000000001737,3673.9473684210525,53,28,5,81
1172,19.04225000000134,4482.526315789473,59,29,4,88
1173,5.528250000001714,3297.777777777778,54,22,5,76
1174,7.612250000001296,3404.9473684210525,51,23,5,74
1175,-10.04874999999949,2552.5555555555557,37,23,5,60
1176,-18.289249999998994,2676.8888888888887,28,26,6,54
1177,-19.774249999999586,2152.705882352941,23,22,3,45
1178,-5.462999999999568,2528.3,27,22,2,49
1179,-22.901000000000057,2421.1111111111113,32,33,10,65
1180,-31.348750000000127,1597.1176470588234,5,45,5,50
1181,7.591750000000116,2530.3125,52,27,14,79
1182,-18.77974999999926,2724.6,31,25,7,56
1183,-2.055999999998709,2410.3125,47,29,4,76
1184,-24.137749999999606,2059.7894736842104,21,23,2,44
1185,-22.835749999999358,1986.2631578947369,30,12,6,42
1186,-10.4227499999988,2587.7368421052633,32,24,7,56
1187,-8.767749999999534,2912.842105263158,38,18,11,56
1188,-20.21524999999919,2467.9444444444443,27,36,4,63
1189,-5.900249999999163,2495.222222222222,33,21,10,54
1190,10.194750000000395,4183.473684210527,50,31,2,81
1191,-15.214249999998875,2513.1176470588234,37,14,5,51
1192,-30.566999999999773,1966.8823529411766,27,22,4,49
1193,-7.262749999999045,2676.3684210526317,33,32,5,65
1194,-27.683749999999414,2391.0,16,31,4,47
1195,-3.489999999998754,3299.3529411764707,50,26,5,76
1196,-15.509499999999012,2796.8888888888887,31,31,6,62
1197,-2.6849999999986123,3940.95,54,29,1,83
1198,-5.615249999999373,2684.25,34,23,7,57
1199,8.346000000001387,2428.125,43,24,7,67
1200,-13.521749999999093,2513.1176470588234,36,16,2,52
1201,-9.50799999999891,2348.8333333333335,39,23,7,62
1202,-7.429249999998724,2643.3888888888887,37,17,8,54
1203,-2.732999999999458,2453.875,35,23,3,58
1204,-20.327249999999964,2298.5,19,27,12,46
1205,-12.596999999999092,3709.25,43,21,4,64
1206,-6.572249999999434,2929.4736842105262,36,17,6,53
1207,-7.780249999999112,2531.866666666667,42,22,6,64
1208,9.909000000001987,3143.4117647058824,65,17,5,82
1209,23.165000000002124,3159.3333333333335,66,13,7,79
1210,-1.2724999999996132,3013.5882352941176,50,10,1,60
1211,-14.108250000000211,1982.5625,32,34,8,66
1212,13.78800000000144,4095.0526315789475,47,31,2,78
1213,3.0652500000008196,4094.25,43,35,0,78
1214,-7.579999999999449,2541.3571428571427,31,22,2,53
1215,7.9027500000017,2961.777777777778,57,16,6,73
1216,-24.454999999999764,1865.5555555555557,19,34,9,53
1217,-7.69224999999818,3340.6315789473683,43,29,5,72
1218,-10.33849999999884,3049.7368421052633,31,33,6,64
1219,-5.516749999999088,2453.470588235294,36,23,1,59
1220,-3.7332499999990683,3071.8888888888887,53,22,4,75
1221,-20.430499999999626,2028.8333333333333,20,28,9,48
1222,-0.9422499999993729,2560.823529411765,35,17,3,52
1223,-2.458249999998774,3698.2,43,24,5,67
1224,-21.84599999999965,2445.8823529411766,38,21,3,59
1225,-8.105499999997711,2112.4444444444443,34,29,17,63
1226,-24.57724999999898,2358.6111111111113,37,18,7,55
1227,-8.82624999999811,4613.15,49,28,6,77
1228,-15.464749999999665,2106.85,23,14,6,37
1229,-25.78099999999963,2008.45,25,19,2,44
1230,-9.254750000000133,2706.8888888888887,16,43,9,59
1231,-7.900250000000119,2176.0,30,28,4,58
1232,-21.970749999999352,2219.3684210526317,31,18,3,49
1233,-20.497249999999212,2121.5625,39,18,5,57
1234,-25.479249999999862,2032.3,17,21,8,38
1235,-3.1524999999987537,3520.35,45,21,5,66
1236,18.117250000001206,4240.1,60,22,4,82
1237,-21.951249999999295,2306.2631578947367,27,22,7,49
1238,-16.746999999999282,2504.764705882353,34,38,8,72
1239,13.873250000001471,3823.6,57,22,4,79
1240,-23.485749999999037,3443.35,28,38,1,66
1241,20.798500000001397,4761.7,67,30,5,97
1242,6.078250000000281,2588.764705882353,50,22,3,72
1243,-2.504999999998974,2968.777777777778,48,23,0,71
1244,-16.69149999999913,2615.0588235294117,33,20,2,53
1245,-1.905499999999374,2395.470588235294,39,19,5,58
1246,-25.620499999999538,2044.1,22,18,5,40
1247,1.9447500000010407,2465.0666666666666,43,21,5,64
1248,-15.408999999998917,2526.176470588235,45,36,9,81
1249,-1.3824999999995558,2572.0625,32,25,2,57
1250,-2.9759999999986473,3785.5,64,18,2,82
1251,20.694000000001697,4887.0,66,27,1,93
1252,5.443250000000688,2543.1875,49,14,7,63
1253,-0.6549999999988094,4668.75,54,27,6,81
1254,1.085250000000594,3497.8333333333335,46,33,4,79
1255,12.869250000001443,3902.95,44,32,7,76
1256,-22.168749999999537,2038.9473684210527,26,18,6,44
1257,-3.8257499999993714,2482.294117647059,51,21,4,72
1258,6.550250000000655,2585.0588235294117,41,22,5,63
1259,-19.735249999999464,2974.6315789473683,42,17,9,59
1260,-1.3317499999994968,4530.75,49,32,4,81
1261,-23.66400000000012,1913.1666666666667,16,40,2,56
1262,-7.485249999999331,2789.3846153846152,36,28,4,64
1263,4.372750000000741,2665.3888888888887,39,24,9,63
1264,-16.690749999999095,2762.4,39,15,2,54
1265,-2.5979999999993577,2328.176470588235,38,22,4,60
1266,-5.31599999999934,2103.625,33,21,4,54
1267,16.025000000001373,4090.2,60,14,1,74
1268,-9.919499999999747,2926.5,46,33,10,79
1269,-11.677999999999685,2696.3333333333335,34,26,3,60
1270,-6.3032499999992,2451.0555555555557,43,20,4,63
1271,-8.061249999999104,3099.85,43,24,0,67
1272,-2.878749999999259,2047.1764705882354,45,30,9,75
1273,-26.99099999999994,1959.4736842105262,29,12,18,41
1274,-10.962249999998935,3329.3888888888887,39,23,4,62
1275,4.638750000001886,3999.684210526316,59,23,3,82
1276,3.6615000000003626,2410.4117647058824,41,17,5,58
1277,-25.5017499999993,2950.5,24,28,8,52
1278,-21.257499999999634,2191.823529411765,38,30,18,68
1279,-9.9194999999991,2545.1875,33,23,2,56
1280,-1.611499999997361,2401.25,63,17,9,80
1281,-0.4484999999994429,2368.277777777778,31,29,5,60
1282,-6.66799999999905,2558.5789473684213,44,11,5,55
1283,-6.388499999999767,2538.294117647059,36,28,9,64
1284,-12.74924999999829,2413.1111111111113,50,15,11,65
1285,-6.447499999999691,2718.133333333333,36,16,11,52
1286,-1.4702499999993144,4417.1,51,30,3,81
1287,20.586250000001776,4040.5263157894738,57,29,4,86
1288,-5.880249999998781,2771.222222222222,40,36,5,76
1289,-26.471999999999145,2008.4,31,13,6,44
1290,-13.558250000000342,1821.875,37,28,12,65
1291,-15.518249999999147,2675.9444444444443,30,32,3,62
1292,-24.116249999999923,2170.157894736842,21,17,7,38
1293,18.846000000001535,3992.5,52,29,1,81
1294,-6.468999999998994,2756.823529411765,39,42,2,81
1295,5.651250000001307,3053.4444444444443,56,20,6,76
1296,-9.541999999998179,2428.1666666666665,51,17,8,68
1297,8.249000000001022,4430.0,55,27,2,82
1298,-7.149249999999091,2064.0,29,30,9,59
1299,-7.489749999999487,2546.0,38,25,2,63
1300,11.77600000000152,4853.75,64,28,4,92
1301,22.083000000000908,3872.722222222222,59,20,6,79
1302,-13.98549999999932,2668.0,30,29,6,59
1303,6.522000000002079,2692.8333333333335,49,24,12,73
1304,-2.4879999999996536,2563.95,32,19,4,51
1305,-11.132749999999298,2816.45,43,13,2,56
1306,-22.820749999999485,2654.6,35,17,3,52
1307,-34.96100000000053,1429.0,21,37,31,58
1308,5.185750000000669,2587.9285714285716,50,15,4,65
1309,-2.817999999998503,3279.95,58,11,5,69
1310,-0.12024999999920763,2957.9473684210525,41,19,4,60
1311,-19.026999999999443,1953.7222222222222,31,19,4,50
1312,-23.376249999998862,3772.4210526315787,43,33,7,76
1313,9.39950000000064,2205.875,48,28,5,76
1314,7.8382500000020014,4559.3,60,19,5,79
1315,-19.675249999998766,3144.1,36,22,7,58
1316,-5.268999999999345,3721.1,47,20,3,67
1317,-14.97749999999915,2512.076923076923,34,33,7,67
1318,-25.425000000000196,1952.8333333333333,23,19,11,42
1319,-24.07099999999957,2104.0526315789475,33,16,10,49
1320,2.8930000000010807,3056.05,37,20,6,57
1321,17.597500000001318,2608.294117647059,54,15,5,69
1322,0.8902500000011926,3570.1666666666665,59,21,3,80
1323,-4.200999999999646,2132.375,45,24,14,69
1324,-2.954749999998803,3130.0526315789475,39,32,2,71
1325,-20.692999999999547,2449.3333333333335,31,30,14,61
1326,-17.994249999999525,2040.15,26,19,2,45
1327,-13.891500000000061,2080.684210526316,30,21,13,51
1328,-11.307499999999601,2479.4117647058824,40,34,9,74
1329,-8.742749999998862,2733.3333333333335,42,30,3,72
1330,1.6417500000001461,2410.133333333333,42,28,3,70
1331,-6.695999999999065,2479.4117647058824,42,22,9,64
1332,-15.380749999999205,2725.214285714286,32,19,7,51
1333,-9.504249999999507,2411.25,49,21,4,70
1334,-0.5239999999984126,3456.684210526316,61,12,8,73
1335,-12.7564999999995,2085.8125,31,13,8,44
1336,4.302000000000902,2714.7368421052633,35,27,2,62
1337,-15.12499999999965,2639.8333333333335,28,29,4,57
1338,-17.413249999999525,2520.35,24,29,1,53
1339,3.3057500000003452,2743.2105263157896,36,27,6,63
1340,-0.9694999999989917,3406.95,46,23,3,69
1341,-23.379249999999686,2862.4,16,38,5,54
1342,-6.7987499999993855,2433.764705882353,34,26,13,60
1343,10.199750000000574,3516.7894736842104,51,33,7,84
1344,-6.471249999999527,2518.4375,45,29,6,74
1345,-19.911749999999966,1976.6666666666667,34,26,15,60
1346,-0.2684999999986154,3349.722222222222,56,16,3,72
1347,-15.06924999999958,2709.2,33,19,5,52
1348,-29.980249999999785,2371.4210526315787,15,27,6,42
1349,12.375250000001063,2335.875,67,17,8,84
1350,-1.729499999999269,2917.6666666666665,52,14,2,66
1351,0.8630000000010625,2952.0555555555557,42,27,1,69
1352,24.188750000001537,5071.9,66,19,2,85
1353,0.11675000000084443,2407.3125,42,24,9,66
1354,-9.900499999999724,2023.25,46,14,8,60
1355,-0.2624999999987073,4182.3,53,20,5,73
1356,9.641500000001137,3713.157894736842,56,26,3,82
1357,-2.472749999999544,2248.5625,44,23,8,67
1358,-10.392999999999038,3079.9,36,30,0,66
1359,-22.240749999998734,2471.7894736842104,36,19,10,55
1360,-7.776749999998971,2929.1111111111113,34,26,7,60
1361,8.671750000001676,3684.7368421052633,50,22,3,72
1362,29.151000000004178,2798.1875,92,15,12,107
1363,-24.510999999999143,2383.4117647058824,34,29,8,63
1364,-12.175749999999024,2332.9411764705883,45,20,4,65
1365,-0.062249999999470694,3596.9473684210525,44,27,7,71
1366,-19.242499999999282,2128.4375,32,17,7,49
1367,7.017500000000842,3761.6315789473683,56,18,5,74
1368,-12.06600000000028,1944.5263157894738,24,24,15,48
1369,-21.2707499999994,2062.222222222222,23,25,3,48
1370,-3.3592499999987226,3444.0,51,28,9,79
1371,6.408750000000699,4051.4736842105262,61,18,10,79
1372,30.620500000002597,3414.1111111111113,63,28,7,91
1373,-22.090499999999725,2158.315789473684,18,28,17,46
1374,3.7392500000005824,2170.0625,45,22,4,67
1375,2.507250000000402,3609.777777777778,52,23,9,75
1376,-36.68874999999928,2138.55,31,17,1,48
1377,-15.166249999999375,2038.8947368421052,28,19,6,47
1378,-11.210999999999563,2653.7894736842104,23,37,4,60
1379,-8.331999999999152,2517.764705882353,40,17,9,57
1380,-6.899749999998704,3034.7368421052633,32,35,3,67
1381,-5.245499999998557,2622.5625,45,14,7,59
1382,0.18575000000094155,3623.55,46,23,1,69
1383,7.443750000001347,4468.75,37,37,3,74
1384,3.5397500000014497,2805.8947368421054,52,16,4,68
1385,8.847250000001406,3478.5555555555557,62,18,5,80
1386,1.114750000000976,3511.7894736842104,40,23,4,63
1387,-2.9529999999989203,3302.0555555555557,50,27,6,77
1388,-11.794749999999382,2532.25,29,13,13,42
1389,13.8255000000019,4443.35,56,37,2,93
1390,-35.544249999999685,2084.277777777778,25,16,14,41
1391,-17.93599999999974,2582.7368421052633,26,28,5,54
1392,13.267250000001264,4247.0526315789475,57,26,4,83
1393,-21.75874999999933,2214.7,27,22,1,49
1394,-14.439999999999666,2304.0,35,29,1,64
1395,4.644250000001264,2795.25,55,30,1,85
1396,-10.847749999999266,3124.1052631578946,45,21,2,66
1397,18.567250000001348,4809.210526315789,70,24,6,94
1398,-30.75924999999964,2040.15,22,20,3,42
1399,-19.64549999999975,1997.2631578947369,26,20,11,46
1400,-11.739999999998934,2600.1666666666665,42,27,9,69
1401,2.9030000000014224,3195.5882352941176,54,21,3,75
1402,-20.42749999999942,2094.15,23,17,7,40
1403,-5.949249999999035,2852.2,44,17,2,61
1404,3.774250000001043,4313.0,70,28,13,98
1405,-17.527749999999273,3373.157894736842,34,45,3,79
1406,-21.147249999999673,2071.1,27,16,5,43
1407,-6.495749999999347,2554.3888888888887,41,19,4,60
1408,-6.478749999998546,3262.35,41,28,2,69
1409,12.96825000000131,3366.3684210526317,46,24,9,70
1410,-19.833249999999197,2820.235294117647,26,35,7,61
1411,3.0755000000012216,3099.157894736842,45,27,4,72
1412,-5.854999999998982,2471.3888888888887,28,27,11,55
1413,-8.293749999998592,3981.1111111111113,63,23,5,86
1414,-17.38124999999955,2028.2,24,24,2,48
1415,11.472750000002504,3584.3333333333335,71,16,8,87
1416,5.592250000000577,2790.294117647059,55,34,15,89
1417,-9.775999999999211,2592.4285714285716,40,20,3,60
1418,-9.28499999999933,2553.3529411764707,40,16,8,56
1419,0.07075000000086477,4094.1052631578946,37,34,3,71
1420,-28.085999999999775,1959.5263157894738,23,21,9,44
1421,2.94750000000054,2765.7894736842104,50,11,2,61
1422,-2.666999999998127,2112.4444444444443,36,27,11,63
1423,-26.39824999999928,2113.15,29,20,1,49
1424,7.993000000000562,3557.6315789473683,51,36,6,87
1425,-13.407999999999513,2629.5263157894738,22,39,3,61
1426,18.843250000001746,2676.125,57,22,6,79
1427,-21.766499999999688,1968.6666666666667,21,26,10,47
1428,-3.380499999998856,3197.35,34,31,5,65
1429,-8.39674999999979,2911.4444444444443,61,16,20,77
1430,-20.191999999999545,1909.6666666666667,31,17,8,48
1431,-16.502249999999197,1954.764705882353,44,23,9,67
1432,-10.008749999999178,2602.9,33,20,3,53
1433,-9.14624999999892,2981.2105263157896,42,19,4,61
1434,8.35725000000125,4711.6,64,18,7,82
1435,-5.428999999999586,2745.4615384615386,37,24,8,61
1436,-22.64299999999986,1841.7222222222222,20,39,2,59
1437,37.33875000000131,4902.85,73,19,6,92
1438,-6.674999999999467,2059.0,42,18,7,60
1439,-14.191999999999288,2348.6875,33,33,5,66
1440,-19.27224999999917,2258.5,26,22,9,48
1441,-3.6642499999988316,3853.75,54,14,3,68
1442,8.721500000000926,2639.4375,48,22,3,70
1443,-30.169249999999444,2183.0555555555557,21,28,1,49
1444,-2.7284999999995607,3027.2631578947367,51,25,9,76
1445,-13.053999999998547,2349.764705882353,38,18,7,56
1446,-1.3102499999992245,2403.8823529411766,49,20,3,69
1447,-24.65849999999975,2194.5,27,25,10,52
1448,-26.961999999999506,2031.4,24,22,1,46
1449,-1.6244999999974936,2274.0588235294117,45,25,12,70
1450,3.6785000000014256,3644.15,47,15,6,62
1451,-11.016999999999161,2540.15,39,13,6,52
1452,-19.489749999999653,2960.777777777778,35,30,12,65
1453,4.341000000000953,3605.315789473684,56,29,5,85
1454,6.769000000001412,2148.5333333333333,54,23,14,77
1455,-22.305749999999755,2121.95,19,22,5,41
1456,-17.551749999999302,3294.15,32,31,3,63
1457,-7.336749999998789,3047.3333333333335,55,15,1,70
1458,-14.707249999999258,3989.35,32,40,6,72
1459,-9.295249999999484,2084.1666666666665,40,21,7,61
1460,-16.296249999999915,1773.5882352941176,32,31,2,63
1461,-10.775249999999001,2410.6111111111113,34,26,4,60
1462,-1.029999999999347,3358.0526315789475,40,31,0,71
1463,22.27025000000132,3870.0555555555557,66,17,4,83
1464,-17.279499999999285,2601.9411764705883,30,16,6,46
1465,-30.35999999999948,2020.25,23,18,2,41
1466,0.12925000000161607,4324.35,57,26,3,83
1467,2.299000000000904,2469.75,47,24,7,71
1468,-27.373749999999312,2070.529411764706,24,16,12,40
1469,3.317750000001067,3732.4210526315787,48,26,12,74
1470,-2.38349999999908,2043.4117647058824,41,15,7,56
1471,-3.1224999999992487,2491.7894736842104,33,20,3,53
1472,-17.02899999999954,2191.7894736842104,25,23,2,48
1473,-16.222249999999615,2051.5263157894738,19,23,4,42
1474,-17.62524999999971,2059.8947368421054,21,24,4,45
1475,-10.166249999998458,4117.15,40,41,5,81
1476,-13.347749999998992,3043.1052631578946,45,26,3,71
1477,-26.564999999999223,2079.85,27,9,9,36
1478,-19.072249999999677,2190.25,25,25,1,50
1479,-26.813249999999567,2048.157894736842,27,20,7,47
1480,-14.355499999999859,2114.4117647058824,34,24,15,58
1481,11.325000000000879,4869.65,55,27,2,82
1482,-4.405749999999179,2491.722222222222,40,20,9,60
1483,-9.111999999999089,3269.55,39,24,3,63
1484,-8.995999999999057,2491.5625,37,22,2,59
1485,-2.0867499999986974,2208.764705882353,49,10,6,59
1486,7.445000000000509,2570.1176470588234,50,20,6,70
1487,-5.9869999999991474,2527.3125,35,18,4,53
1488,-16.02199999999986,1987.3333333333333,24,25,3,49
1489,-23.356499999999418,2044.15,27,18,3,45
1490,-12.753999999999227,2010.6470588235295,27,35,3,62
1491,-1.452249999999353,2639.176470588235,39,29,3,68
1492,1.3385000000011675,2680.8571428571427,38,22,4,60
1493,0.6392500000011412,2831.0625,61,29,0,90
1494,-18.61299999999915,2314.176470588235,35,28,7,63
1495,-4.944499999999349,3624.777777777778,60,24,3,84
1496,7.802250000001749,4735.4,68,17,5,85
1497,-6.500749999999601,2067.2,26,18,4,44
1498,-16.707249999999085,2607.470588235294,34,16,2,50
1499,-12.588999999999139,2532.15,41,16,1,57
1500,-40.3270000000001,1841.7222222222222,15,37,10,52
1501,-10.172499999999456,2921.1111111111113,37,33,1,70
1502,8.246000000002491,2289.25,55,21,7,76
1503,-12.007749999999543,2634.6,26,27,1,53
1504,-10.546499999999075,2663.9285714285716,37,12,9,49
1505,4.4835000000008165,2419.5333333333333,51,32,3,83
1506,4.347250000001094,3606.9473684210525,58,19,3,77
1507,1.2045000000011705,2705.529411764706,49,26,7,75
1508,-15.735249999999407,1993.842105263158,27,24,4,51
1509,-15.988499999999727,1899.5882352941176,38,22,6,60
1510,-18.190999999999683,2554.125,32,29,13,61
1511,-1.525749999998664,2190.9333333333334,46,32,5,78
1512,-12.164749999998513,2550.0625,51,21,3,72
1513,-0.8679999999987157,3765.9444444444443,58,40,6,98
1514,1.3222500000013144,3777.4736842105262,55,30,10,85
1515,-35.405249999999725,1429.0,0,32,5,32
1516,-8.402249999998443,3891.05,59,16,3,75
1517,4.94100000000085,2727.222222222222,47,16,1,63
1518,-9.966499999999105,3212.0526315789475,41,16,5,57
1519,-23.492249999999924,2457.6666666666665,46,37,10,83
1520,6.190250000000718,2612.625,42,16,13,58
1521,-2.2454999999986605,2719.133333333333,32,23,15,55
1522,-23.721749999999084,2379.7368421052633,22,33,7,55
1523,-22.710749999999432,2195.1052631578946,28,21,2,49
1524,-29.780499999999858,1429.0,24,38,11,62
1525,-4.188249999999458,2632.0714285714284,39,18,4,57
1526,-8.936249999998479,2467.8125,57,24,5,81
1527,8.641000000000219,2420.1875,41,25,5,66
1528,-1.5382499999989903,2937.8947368421054,40,22,3,62
1529,-2.8352499999995247,3900.4,51,23,1,74
1530,-3.0050000000001273,2218.0588235294117,25,29,1,54
1531,-9.3369999999995,2455.8947368421054,26,36,9,62
1532,-3.9969999999995323,3103.6666666666665,45,31,1,76
1533,-39.526749999999694,1429.0,8,27,8,35
1534,22.461750000002276,4375.1,73,23,0,96
1535,-5.786749999998817,2192.9375,50,28,3,78
1536,-8.402999999999357,3184.6,48,19,2,67
1537,13.512249999999934,3470.7894736842104,64,33,5,97
1538,10.053500000000685,4075.05,61,20,2,81
1539,-4.677999999998872,2273.0588235294117,36,30,5,66
1540,-16.779499999998997,2516.3888888888887,28,31,8,59
1541,11.555500000002038,4202.95,62,13,2,75
1542,2.210250000001059,3257.277777777778,49,20,3,69
1543,-12.14624999999935,4760.0,42,35,2,77
1544,-14.5657499999997,2643.3888888888887,41,16,2,57
1545,-22.59699999999944,2155.25,24,22,3,46
1546,-3.9864999999989563,2785.4444444444443,47,26,10,73
1547,5.004000000001072,2716.4444444444443,51,17,3,68
1548,-8.345249999998313,4191.0,66,18,1,84
1549,-27.94099999999952,2024.4,16,26,3,42
1550,8.168750000001422,4047.35,51,28,4,79
1551,8.327250000000829,3206.95,50,19,4,69
1552,-39.813000000000144,2109.9473684210525,24,20,15,44
1553,1.6610000000009495,3747.4736842105262,57,9,4,66
1554,-6.755249999999528,2920.277777777778,50,30,17,80
1555,7.1417500000011955,3292.55,54,15,1,69
1556,-31.586499999999226,2024.35,30,15,2,45
1557,-28.958999999999683,2588.6470588235293,33,31,13,64
1558,-19.548250000000174,2779.2105263157896,37,23,13,60
1559,-8.660499999999647,2588.705882352941,40,32,4,72
1560,-1.132249999998348,3714.0,58,28,3,86
1561,-30.309749999999447,2011.3684210526317,28,17,2,45
1562,8.903250000001037,3553.684210526316,43,33,3,76
1563,11.372000000002425,4501.4,69,15,2,84
1564,6.088000000001859,3877.45,59,26,4,85
1565,7.750250000001185,3127.5,53,24,0,77
1566,30.364750000001514,5276.75,79,13,2,92
1567,18.742250000002127,3242.294117647059,68,18,1,86
1568,-13.763249999999136,2679.294117647059,42,26,2,68
1569,-23.99024999999968,1944.9444444444443,27,19,3,46
1570,-4.615749999998361,2977.9473684210525,45,33,2,78
1571,-7.554999999999663,2612.0,32,23,6,55
1572,0.023500000001341448,3374.684210526316,50,25,0,75
1573,16.902000000000708,3585.1111111111113,57,22,2,79
1574,-13.36049999999903,2404.0714285714284,32,16,8,48
1575,-2.8987499999986293,2478.529411764706,37,21,10,58
1576,-21.212249999998082,4878.3,49,28,5,77
1577,7.46225000000166,5408.5,60,31,0,91
1578,16.69475000000171,4856.05,58,28,4,86
1579,-11.622499999999352,3680.65,34,31,3,65
1580,-5.6862499999993545,2971.75,51,22,5,73
1581,1.0527500000005434,3219.277777777778,48,14,13,62
1582,-16.586999999998415,1916.1875,50,23,6,73
1583,5.619750000001223,3337.05,55,16,3,71
1584,-4.9499999999991555,2813.823529411765,45,21,9,66
1585,-23.716499999999137,1978.625,28,24,7,52
1586,-7.386249999999198,2243.0,40,17,7,57
1587,12.562250000001361,4540.95,62,28,3,90
1588,-7.057499999999261,2745.0,35,24,1,59
1589,0.44900000000070844,2434.4666666666667,40,25,7,65
1590,9.712500000000956,4171.05,66,12,8,78
1591,2.517000000001046,3666.315789473684,49,24,6,73
1592,16.00175000000181,4738.65,66,29,3,95
1593,-3.648499999998873,3474.4285714285716,68,16,3,84
1594,-30.206500000000112,2062.222222222222,26,13,15,39
1595,-20.366749999999637,2008.5,26,18,1,44
1596,11.359000000001878,3467.0,57,29,8,86
1597,-10.443249999999159,4284.65,47,30,0,77
1598,-14.094749999999252,2219.75,43,31,11,74
1599,9.455750000000537,3948.7368421052633,40,31,4,71
1600,-27.86999999999937,2023.0,23,20,10,43
1601,28.635000000001458,4916.4,78,20,2,98
1602,-22.819999999999787,1987.9473684210527,24,23,9,47
1603,-41.287499999999326,2005.7222222222222,25,16,6,41
1604,-14.360500000000073,1968.7368421052631,21,23,8,44
1605,-12.048249999999276,4683.05,44,35,2,79
1606,-17.57574999999959,1967.0526315789473,30,20,6,50
1607,13.082000000001333,4709.15,47,33,6,80
1608,-12.734499999998667,3300.5263157894738,44,22,4,66
1609,-14.24674999999885,2704.222222222222,35,23,5,58
1610,7.0037500000007515,2085.75,41,25,9,66
1611,-10.411499999999247,2643.3333333333335,37,26,13,63
1612,-8.111999999999119,3615.65,37,21,5,58
1613,-2.075999999998309,2223.5882352941176,37,28,7,65
1614,-3.6564999999999914,1812.9375,38,37,7,75
1615,3.7635000000012644,2177.266666666667,46,35,9,81
1616,1.7782500000009187,2643.8947368421054,35,30,8,65
1617,-12.83074999999952,2941.2631578947367,35,24,0,59
1618,26.44600000000163,4713.3,70,16,3,86
1619,-33.849999999999795,1429.0,7,33,9,40
1620,-14.231499999999745,3040.1666666666665,27,42,4,69
1621,-23.364749999999667,1997.2105263157894,26,24,6,50
1622,-18.58249999999934,1978.7894736842106,24,22,4,46
1623,-40.614499999999964,1429.0,5,39,3,44
1624,-10.012249999999106,3012.1052631578946,51,22,7,73
1625,-25.19799999999916,2072.7,27,21,4,48
1626,5.668250000000702,3111.6666666666665,55,24,7,79
1627,-19.922249999999742,2058.9473684210525,25,16,7,41
1628,-17.218249999998406,3369.7894736842104,48,17,7,65
1629,32.55825000000107,5112.35,73,22,3,95
1630,-13.957749999999143,2384.375,37,27,12,64
1631,-11.431499999999051,3190.1052631578946,41,30,5,71
1632,-5.971749999998533,2527.8333333333335,42,22,2,64
1633,13.54150000000197,5156.9,62,35,3,97
1634,-11.35549999999959,2655.6666666666665,35,29,9,64
1635,-14.245499999999183,2289.3125,32,30,3,62
1636,13.364000000001038,4024.3333333333335,63,25,0,88
1637,-12.18074999999919,2518.25,40,17,7,57
1638,-19.73199999999928,2524.35,26,16,8,42
1639,1.697500000002639,2256.6428571428573,45,22,8,67
1640,6.467250000001364,3156.6111111111113,49,19,6,68
1641,-31.548499999999102,2055.5789473684213,25,23,4,48
1642,-6.9314999999996445,2032.1875,35,20,22,55
1643,0.6667500000009936,3064.05,49,12,2,61
1644,19.664250000000514,5248.15,60,24,1,84
1645,6.0842500000012265,3929.25,54,25,2,79
1646,-12.42024999999981,2641.157894736842,33,27,13,60
1647,-19.339999999999012,2594.4736842105262,31,21,4,52
1648,-36.197749999999665,1997.7777777777778,18,40,6,58
1649,6.788500000001777,2594.75,66,20,4,86
1650,-4.37599999999897,2595.8125,33,25,8,58
1651,25.638250000000777,2921.3529411764707,51,24,2,75
1652,-1.3342500000002109,2295.1875,36,33,3,69
1653,-10.582499999999321,2965.4210526315787,48,18,5,66
1654,-19.761999999999183,2068.705882352941,30,22,2,52
1655,-9.843999999999289,2425.6111111111113,37,26,5,63
1656,12.935750000001434,3389.5,58,28,6,86
1657,-4.692249999999232,3222.777777777778,47,14,3,61
1658,-11.04649999999926,2441.3888888888887,30,24,6,54
1659,-27.630249999999883,1891.1764705882354,28,26,4,54
1660,15.538250000001963,4169.0,71,26,4,97
1661,22.848500000001263,5000.421052631579,63,24,3,87
1662,4.930500000001065,3881.5555555555557,42,34,5,76
1663,-9.331749999999523,2452.8333333333335,46,31,7,77
1664,4.6690000000010246,3659.15,61,15,1,76
1665,23.46275000000069,3947.4117647058824,69,22,7,91
1666,-3.1322499999991678,2580.9375,35,15,9,50
1667,-4.712749999998282,2626.6111111111113,46,17,2,63
1668,-1.758999999998231,4083.9473684210525,70,25,2,95
1669,-20.754749999999344,2717.95,36,20,3,56
1670,1.372500000000971,3070.7894736842104,48,26,6,74
1671,-0.3717499999996681,2591.1052631578946,43,17,10,60
1672,23.643750000001457,2621.5625,56,30,3,86
1673,1.382000000000795,2442.235294117647,39,24,14,63
1674,-16.370249999999512,2330.8125,30,20,12,50
1675,-7.982999999999846,1862.3529411764705,33,25,14,58
1676,-13.404999999999921,2284.5,35,10,31,45
1677,7.9412500000011885,2843.705882352941,54,16,3,70
1678,24.136750000001847,4048.157894736842,60,35,3,95
1679,-8.155499999999464,2592.4285714285716,40,29,4,69
1680,-2.603499999999278,2952.9411764705883,42,29,9,71
1681,-1.6812499999994621,3273.6315789473683,30,32,4,62
1682,-5.2782499999989785,3259.8,49,17,3,66
1683,-1.3792499999989027,3190.15,46,27,2,73
1684,-22.512249999999888,2386.5263157894738,30,26,20,56
1685,-15.255249999999439,3007.1052631578946,43,23,14,66
1686,28.37175000000223,2385.5,55,28,7,83
1687,12.029000000000734,3824.2631578947367,51,21,3,72
1688,10.329750000001088,3890.85,54,22,2,76
1689,-14.139749999999356,1481.9333333333334,36,29,3,65
1690,-7.848999999999512,2384.5,37,47,6,84
1691,-5.145249999999134,4210.95,40,35,5,75
1692,-8.887999999998916,3343.1052631578946,47,28,6,75
1693,-2.7282499999992416,2605.529411764706,39,29,6,68
1694,-29.548999999999346,2031.45,28,16,2,44
1695,12.424250000001207,3609.35,49,23,7,72
1696,-3.2944999999990037,3742.5,39,30,1,69
1697,-7.548749999999268,2954.45,31,36,0,67
1698,7.4770000000006345,1882.3333333333333,30,22,7,52
1699,-2.364249999999226,2679.5555555555557,35,28,3,63
1700,-12.298499999999425,2491.5625,37,26,3,63
1701,-10.35874999999912,2770.4444444444443,42,27,6,69
1702,-10.549749999999579,3024.7368421052633,42,19,4,61
1703,5.024500000001643,3580.05,65,14,3,79
1704,-28.028750000000173,1429.0,8,48,7,56
1705,-20.63024999999967,2170.0625,42,41,8,83
1706,-8.358999999999028,3717.15,50,24,3,74
1707,-12.547249999999513,2594.875,26,24,3,50
1708,-13.673749999999846,3160.0526315789475,33,39,5,72
1709,25.994750000000856,3293.7894736842104,48,31,10,79
1710,-10.443000000000222,1964.6875,44,26,15,70
1711,-1.5042499999990173,3275.1,42,28,1,70
1712,-7.494999999999804,2356.176470588235,41,22,15,63
1713,-9.18224999999879,3587.95,40,37,2,77
1714,-21.081999999998914,2419.3333333333335,30,22,9,52
1715,18.609500000001514,2960.9444444444443,51,21,5,72
1716,0.659250000000548,2515.4444444444443,39,22,6,61
1717,-18.54274999999897,2300.0625,45,30,11,75
1718,-8.315749999998113,2594.8125,43,27,5,70
1719,2.916250000001857,3484.294117647059,64,20,5,84
1720,5.328000000001668,3845.75,54,17,3,71
1721,-6.985749999999484,2419.6,37,36,2,73
1722,-8.867999999998906,2518.0,38,22,5,60
1723,3.2732500000002815,2682.1875,39,20,9,59
1724,-9.09099999999948,3525.2105263157896,60,18,7,78
1725,-19.796249999999564,3140.15,21,33,5,54
1726,-0.6747499999992487,2495.866666666667,42,23,3,65
1727,-10.611249999999297,2425.0625,38,29,8,67
1728,-13.08874999999984,2019.6842105263158,27,16,21,43
1729,-3.397999999999759,2143.3125,51,27,4,78
1730,-13.55874999999908,2746.5,41,35,0,76
1731,8.627500000001067,2257.4375,57,23,3,80
1732,12.113250000000745,3005.4736842105262,54,19,5,73
1733,-8.69449999999959,2780.6,29,19,3,48
1734,-6.346499999998691,2432.0,51,28,1,79
1735,1.5235000000003545,3266.35,33,28,1,61
1736,-21.425000000000047,2057.2631578947367,28,21,9,49
1737,-9.085249999998826,2637.222222222222,42,16,6,58
1738,7.681750000000806,3255.35,56,16,3,72
1739,-15.014249999999446,2139.5882352941176,31,20,8,51
1740,5.877750000001168,2231.625,46,17,7,63
1741,-23.90999999999956,2094.95,14,35,1,49
1742,-19.160749999999503,2032.25,25,20,3,45
1743,-9.685249999999279,2328.4166666666665,32,27,5,59
1744,17.701750000001375,4118.7,52,22,2,74
1745,2.8172500000012284,4408.5,61,26,1,87
1746,-6.26049999999923,2556.0,34,21,3,55
1747,-15.257249999997976,1929.9444444444443,40,16,13,56
1748,-13.719499999999138,3695.6315789473683,40,35,8,75
1749,15.46225000000141,3588.0588235294117,53,25,6,78
1750,-31.523249999999923,2163.777777777778,22,25,9,47
1751,-23.873999999999988,2074.842105263158,19,21,12,40
1752,12.376750000001225,2719.470588235294,47,22,5,69
1753,-17.221249999999326,2276.0,34,24,9,58
1754,-11.352249999999987,1849.235294117647,16,49,7,65
1755,-2.721249999999163,2594.4117647058824,53,23,6,76
1756,-13.093999999998426,2542.1176470588234,34,28,12,62
1757,16.746000000002063,4450.5,56,22,4,78
1758,0.43475000000100295,2215.266666666667,42,20,8,62
1759,0.5885000000019223,2072.8888888888887,32,20,16,52
1760,-19.793749999999456,2008.4,22,23,3,45
1761,-1.447499999998761,3597.7368421052633,44,32,3,76
1762,0.6365000000003965,2484.722222222222,43,25,4,68
1763,-18.259499999999253,2817.5789473684213,38,27,7,65
1764,-6.932249999999087,2420.705882352941,41,19,5,60
1765,4.5490000000006585,3323.5,39,28,2,67
1766,9.804250000001137,3986.75,44,27,3,71
1767,18.166500000001854,4372.315789473684,67,16,5,83
1768,19.133500000002602,4608.45,74,15,3,89
1769,-14.616999999999123,2572.0625,39,26,8,65
1770,0.7855000000011392,4270.45,53,26,5,79
1771,0.739250000000801,3169.8333333333335,44,29,4,73
1772,13.997000000001687,4823.55,61,25,2,86
1773,7.846750000001118,3445.1111111111113,50,29,3,79
1774,-11.470499999999733,1429.0,21,25,15,46
1775,-11.059999999999434,2710.0,42,16,3,58
1776,-29.643749999999795,2112.4444444444443,17,32,7,49
1777,7.712750000001092,3707.75,36,36,4,72
1778,-2.218999999999253,2914.1,36,22,9,58
1779,7.226750000001023,3474.2631578947367,53,23,3,76
1780,-28.502249999999663,2008.4,21,18,5,39
1781,-9.791999999999032,2941.764705882353,57,20,6,77
1782,-11.606999999999518,2731.6470588235293,49,22,10,71
1783,-9.38349999999917,2413.1111111111113,34,22,2,56
1784,-5.089249999998473,3280.65,40,26,4,66
1785,-19.576249999999487,2062.4,26,24,2,50
1786,-20.60774999999993,1937.9375,35,29,4,64
1787,-21.205749999999174,2097.529411764706,26,19,3,45
1788,-2.70374999999905,3979.85,47,15,4,62
1789,-0.6859999999990676,2391.375,40,21,5,61
1790,0.8632500000004487,2652.3529411764707,48,17,7,65
1791,-5.052999999999395,3066.4736842105262,43,17,10,60
1792,2.3660000000019834,2363.285714285714,51,25,7,76
1793,22.616000000001964,2870.823529411765,59,33,2,92
1794,-4.033499999998677,3800.55,43,35,5,78
1795,10.613500000001409,2632.625,56,24,4,80
1796,-20.384749999999126,2594.8333333333335,31,26,3,57
1797,9.22700000000149,4425.684210526316,72,19,2,91
1798,-12.927749999999502,2555.157894736842,32,13,7,45
1799,-16.52149999999976,2785.8823529411766,34,35,16,69
1800,-23.422249999999703,2267.9473684210525,21,26,20,47
1801,-11.007749999998904,2705.9444444444443,37,30,6,67
1802,-23.36324999999902,2006.2631578947369,31,20,6,51
1803,6.286000000000861,2643.5,44,36,2,80
1804,-18.571749999999746,2202.235294117647,30,35,6,65
1805,-12.944249999999096,1853.625,35,22,2,57
1806,5.149500000000616,2298.1875,48,26,10,74
1807,-13.807499999999388,2562.277777777778,32,20,5,52
1808,-19.504249999999733,2020.4,21,20,1,41
1809,-13.844499999999659,2391.823529411765,42,24,9,66
1810,-7.843249999999616,2504.764705882353,32,25,11,57
1811,0.44125000000149195,4293.45,55,29,4,84
1812,-0.15574999999900835,3910.6111111111113,50,31,4,81
1813,-4.045749999999657,3906.8,43,24,7,67
1814,-8.85199999999887,2948.6111111111113,39,29,14,68
1815,12.393500000000309,3700.684210526316,56,23,9,79
1816,-11.31149999999909,3108.315789473684,48,22,4,70
1817,2.60900000000074,2536.6111111111113,35,33,13,68
1818,4.86775000000139,3938.7,64,22,1,86
1819,15.947250000001073,3727.315789473684,61,18,5,79
1820,-11.21249999999929,2048.0,43,27,1,70
1821,-10.387249999999591,3039.35,31,27,2,58
1822,0.37100000000075567,2687.85,33,21,4,54
1823,2.6640000000009727,2586.2105263157896,31,22,8,53
1824,-12.491249999999921,2101.4117647058824,27,34,5,61
1825,-14.195499999999583,2771.764705882353,51,13,11,64
1826,-14.927999999999198,2513.1176470588234,31,22,1,53
1827,-22.255999999998394,3549.7,31,41,9,72
1828,15.024500000001552,4560.1,73,28,5,101
1829,5.679750000001432,3780.0526315789475,57,18,6,75
1830,-19.78524999999965,2039.0,19,24,6,43
1831,-3.039249999999423,3206.0,42,22,4,64
1832,18.468750000001897,2511.5,55,20,8,75
1833,11.28825000000105,2525.375,74,12,8,86
1834,21.567000000001002,4347.210526315789,72,24,2,96
1835,-36.90549999999944,1987.0526315789473,24,20,4,44
1836,12.409250000001226,3607.75,63,11,2,74
1837,-30.788249999999305,2040.2,28,16,4,44
1838,-20.686499999999363,2016.25,25,21,0,46
1839,-12.289499999999396,2674.705882352941,35,19,5,54
1840,-7.1319999999990475,2402.25,40,24,7,64
1841,1.6090000000005784,3305.4210526315787,46,19,6,65
1842,-11.441999999999052,2500.5,41,20,2,61
1843,4.316500000000463,2627.0,47,17,4,64
1844,15.454000000001576,2621.470588235294,64,25,7,89
1845,-16.08349999999947,2227.1111111111113,33,24,9,57
1846,-18.291499999999203,2132.777777777778,28,22,5,50
1847,24.160750000001048,4079.9,73,10,1,83
1848,14.282500000002145,3414.1666666666665,62,19,7,81
1849,5.486000000000859,2521.470588235294,46,16,4,62
1850,-3.8792499999992978,2687.75,39,18,1,57
1851,3.221500000000605,2411.125,46,22,5,68
1852,-1.8379999999994816,2038.9473684210527,24,17,10,41
1853,-1.5059999999982359,4734.65,48,40,0,88
1854,-6.472249999999173,2472.5263157894738,35,23,4,58
1855,-11.417249999999088,2508.3888888888887,34,22,3,56
1856,0.3145000000017662,2897.764705882353,57,18,5,75
1857,7.4412500000011885,3226.85,49,21,2,70
1858,-15.281499999999166,2555.1666666666665,38,22,3,60
1859,-11.736249999999664,3374.8947368421054,37,30,8,67
1860,18.98775000000169,2197.875,51,19,5,70
1861,26.734500000001237,4168.0,61,18,4,79
1862,-14.527749999999893,2008.5,21,19,5,40
1863,4.390500000000663,4949.75,47,34,2,81
1864,-9.185999999998502,2958.9444444444443,46,26,6,72
1865,-14.657499999999505,2534.0555555555557,30,29,1,59
1866,4.319250000001587,3805.2,60,18,7,78
1867,-3.756999999998637,3277.5,49,21,5,70
1868,13.10300000000115,4187.05,56,26,1,82
1869,-19.66499999999943,3526.7894736842104,26,29,1,55
1870,16.468750000001403,4117.473684210527,77,19,7,96
1871,-30.64099999999926,2127.4736842105262,21,22,5,43
1872,-23.548999999999175,2094.2,26,21,4,47
1873,-26.947749999999484,2117.15,25,18,3,43
1874,-12.001749999999106,2249.823529411765,35,24,22,59
1875,-10.583499999999201,2082.6470588235293,52,25,11,77
1876,-20.85899999999937,2479.3333333333335,44,28,9,72
1877,20.926000000001316,4045.75,61,28,1,89
1878,-0.8322499999982961,2243.3529411764707,36,22,13,58
1879,6.6585000000029355,4344.25,65,19,10,84
1880,-39.12425000000003,1967.0526315789473,21,24,23,45
1881,-29.649999999999455,2008.45,21,21,3,42
1882,-22.707749999999635,2693.0,32,23,13,55
1883,-20.19349999999968,2059.842105263158,25,17,3,42
1884,13.696000000002105,4882.25,76,16,3,92
1885,10.220000000001015,3404.5,71,12,10,83
1886,-13.010999999999479,2428.1666666666665,36,21,5,57
1887,11.605000000001642,2943.529411764706,54,30,6,84
1888,18.65025000000116,5619.6,61,37,3,98
1889,-17.728999999999147,2572.0,36,16,11,52
1890,13.66600000000165,5340.3,76,18,2,94
1891,-35.100000000000065,1429.0,0,34,1,34
1892,6.9245000000015136,4326.7,55,30,0,85
1893,27.35250000000172,3277.823529411765,71,14,3,85
1894,-12.6524999999988,2753.6666666666665,36,34,5,70
1895,-14.936749999999375,2495.470588235294,34,20,4,54
1896,-20.258749999999466,2098.9,23,29,0,52
1897,15.92850000000108,4484.1578947368425,64,35,4,99
1898,20.83675000000182,4322.7,74,13,5,87
1899,-0.5712499999979446,3268.5555555555557,56,28,3,84
1900,-14.201749999998688,2505.157894736842,44,23,3,67
1901,-1.5489999999993742,3907.7,52,24,0,76
1902,-23.50349999999847,4437.75,34,38,8,72
1903,-4.118499999999544,1910.8235294117646,43,20,7,63
1904,-0.2067499999987435,2875.4117647058824,60,30,3,90
1905,-31.979250000000217,1429.0,8,28,8,36
1906,10.823250000000437,2653.714285714286,43,28,2,71
1907,-28.542249999999974,2245.2105263157896,23,28,10,51
1908,7.320750000001072,2801.764705882353,59,9,6,68
1909,2.936250000000628,3549.65,47,15,3,62
1910,-0.6059999999987508,2032.25,45,20,3,65
1911,-19.22724999999938,2032.3,21,30,1,51
1912,6.744750000001696,2276.9411764705883,46,21,10,67
1913,-11.402249999999505,2616.823529411765,30,24,3,54
1914,12.552500000001526,5207.7,70,24,0,94
1915,-14.86799999999954,2857.6666666666665,44,23,10,67
1916,-34.67399999999998,1429.0,6,30,15,36
1917,-16.854749999999825,2110.722222222222,31,32,5,63
1918,1.5045000000007456,3293.5,47,16,3,63
1919,-12.530249999999839,1975.235294117647,31,26,7,57
1920,-19.02149999999904,2668.1666666666665,36,15,9,51
1921,4.651750000000685,2423.0625,50,19,3,69
1922,-24.574249999999857,2057.315789473684,22,23,7,45
1923,11.847500000001473,3982.1052631578946,72,18,7,90
1924,11.412500000001156,2780.8888888888887,41,28,3,69
1925,-23.50674999999989,2171.7368421052633,27,21,10,48
1926,-9.477749999999194,2880.5625,35,25,3,60
1927,6.172500000000861,3284.5789473684213,47,28,2,75
1928,13.709500000001858,3259.8333333333335,67,19,3,86
1929,-3.2164999999988177,2205.875,43,35,0,78
1930,11.011000000000148,2572.0,47,22,2,69
1931,1.7162500000012315,3103.65,57,15,1,72
1932,9.29750000000102,4361.65,55,33,2,88
1933,-17.093499999999516,2052.5,24,22,8,46
1934,-17.1322499999998,2470.7368421052633,38,13,16,51
1935,12.594250000001972,2367.5625,59,18,0,77
1936,6.254000000000878,2744.6470588235293,49,28,6,77
1937,17.058000000000533,1816.5882352941176,34,30,2,64
1938,-14.17724999999957,2544.15,29,18,0,47
1939,-7.145999999999515,2266.777777777778,32,17,1,49
1940,11.786000000001454,3611.6,61,15,3,76
1941,2.3497500000012304,3011.764705882353,73,19,7,92
1942,-5.682999999999052,3217.4444444444443,56,18,4,74
1943,-8.700249999998874,2998.95,38,27,3,65
1944,-13.263249999999065,2700.823529411765,42,21,7,63
1945,-20.73674999999988,1997.1052631578948,27,12,17,39
1946,-11.15849999999919,2583.8,43,13,3,56
1947,-16.674999999999056,2848.9,43,11,4,54
1948,12.09625000000111,3560.1,57,15,0,72
1949,-14.954750000000212,2040.1666666666667,37,27,10,64
1950,15.654250000000719,2719.529411764706,62,23,6,85
1951,-11.130749999999258,2489.1111111111113,31,25,3,56
1952,-3.3227499999999353,3455.842105263158,48,19,16,67
1953,-30.01274999999988,1998.5882352941176,19,25,9,44
1954,-19.617249999999924,2265.9444444444443,28,25,13,53
1955,-12.02724999999941,2046.3333333333333,34,15,4,49
1956,-27.460749999999553,2128.25,24,19,4,43
1957,18.703250000001624,4089.35,70,15,3,85
1958,-5.355999999998955,2714.823529411765,47,24,1,71
1959,-15.598249999999434,2166.1875,33,23,6,56
1960,17.193500000000792,2374.9411764705883,54,26,9,80
1961,14.204250000001759,5150.65,78,19,1,97
1962,-5.343500000000046,1909.6666666666667,33,19,4,52
1963,3.4322500000013028,2362.6875,47,31,4,78
1964,-21.36324999999926,2537.6111111111113,30,35,7,65
1965,1.8272500000008958,2543.125,49,24,2,73
1966,13.790250000001262,2848.3529411764707,53,21,6,74
1967,-1.3102499999969166,1983.6875,62,20,8,82
1968,-6.323249999999155,3225.15,58,10,1,68
1969,-14.34174999999865,3010.5263157894738,40,29,1,69
1970,4.978250000001129,2759.375,58,30,7,88
1971,18.341500000000668,2895.9411764705883,56,22,6,78
1972,3.5487500000008,2610.2,43,25,3,68
1973,-24.521249999999668,2154.45,22,15,7,37
1974,-1.9684999999988797,2822.3888888888887,65,15,5,80
1975,-2.5032499999992437,2505.4666666666667,48,35,6,83
1976,-23.430750000000124,1968.6666666666667,21,40,7,61
1977,-7.07000000000006,2156.3529411764707,31,32,11,63
1978,-30.940999999998667,2039.2222222222222,29,14,13,43
1979,-26.52524999999996,3377.315789473684,40,28,7,68
1980,-16.936249999999607,2024.25,24,16,7,40
1981,-9.110999999999505,2628.3,41,9,6,50
1982,-21.110499999999526,2032.2,21,16,10,37
1983,-7.967249999999483,2334.9285714285716,35,22,7,57
1984,2.1315000000009845,3774.15,51,22,0,73
1985,10.603500000000938,3056.05,45,19,4,64
1986,-9.513749999999941,2101.3529411764707,26,36,1,62
1987,-12.63574999999981,2836.684210526316,36,30,8,66
1988,-11.435749999997839,2016.3684210526317,29,21,21,50
1989,5.364750000001293,3242.5625,61,17,4,78
1990,-20.49749999999866,1976.2941176470588,38,18,7,56
1991,0.7300000000011566,2665.3888888888887,36,22,5,58
1992,4.304750000001315,3611.2105263157896,53,28,5,81
1993,-4.359499999998993,3135.4,49,18,3,67
1994,-7.462499999998637,3370.294117647059,58,35,2,93
1995,-11.213499999999424,2495.9473684210525,31,23,7,54
1996,18.715250000001845,4456.05,72,23,1,95
1997,-12.815749999998673,2894.2,36,23,1,59
1998,-24.199999999999616,2162.45,23,20,8,43
1999,-24.657249999999344,2032.2,29,16,3,45
2000,18.990250000001772,4507.631578947368,81,23,4,104
2001,5.080750000000202,2286.235294117647,35,28,1,63
2002,-27.804750000000542,1429.0,20,40,13,60
2003,-12.188999999999549,2599.4736842105262,30,28,2,58
2004,-0.7859999999985133,3237.1,52,16,2,68
2005,-2.4217499999994585,3359.0,40,21,3,61
2006,-7.1569999999980665,3850.0526315789475,63,17,9,80
2007,-3.0442499999991957,3586.2,42,26,5,68
2008,-23.439749999999606,2013.842105263158,27,8,9,35
2009,-16.848999999999315,1978.7368421052631,31,17,3,48
2010,6.247000000001259,1429.0,36,26,7,62
2011,-17.695749999999492,2259.25,22,19,4,41
2012,-4.713499999998216,5017.15,58,26,7,84
2013,-3.0667499999987036,2714.8125,54,19,3,73
2014,4.556000000000877,4273.5,53,23,1,76
2015,22.528000000002102,3893.8888888888887,78,13,4,91
2016,-11.755999999998801,2128.3888888888887,30,20,9,50
2017,-11.316499999999241,2436.0625,38,19,6,57
2018,1.2205000000014408,3882.3,51,24,1,75
2019,-22.346499999999306,2524.35,35,15,3,50
2020,-25.886999999999393,2187.0,26,19,4,45
2021,-23.208999999999513,2638.6666666666665,38,18,7,56
2022,-25.495749999998818,2974.684210526316,48,23,14,71
2023,5.084750000001324,2749.3529411764707,47,17,9,64
2024,10.578000000001342,3739.0,62,22,4,84
2025,14.818250000000546,2095.6666666666665,60,25,5,85
2026,19.038750000001304,3725.7894736842104,60,21,3,81
2027,19.863000000000916,3647.8333333333335,66,15,3,81
2028,4.647000000000738,3990.2,46,18,5,64
2029,6.612000000001177,3735.684210526316,63,19,5,82
2030,2.7025000000010655,4035.6315789473683,56,28,2,84
2031,-6.89249999999897,2178.0,34,19,2,53
2032,24.337000000000877,2768.4375,64,31,3,95
2033,8.250249999999667,2420.705882352941,61,42,1,103
2034,-0.26399999999846474,3643.4,51,27,4,78
2035,6.732500000000728,3605.4736842105262,53,27,11,80
2036,9.612500000000928,3109.705882352941,58,26,4,84
2037,8.334000000000685,3059.3529411764707,57,21,2,78
2038,-8.899499999999541,2878.0555555555557,34,29,6,63
2039,-13.71799999999907,2675.0555555555557,53,22,7,75
2040,-21.584999999998793,2152.277777777778,28,36,4,64
2041,-15.511249999999723,2116.0,19,33,6,52
2042,-23.052749999999328,2904.5,36,28,8,64
2043,-28.491499999999633,2008.4,19,19,5,38
2044,8.321250000001172,3587.85,61,19,1,80
2045,26.62650000000216,4690.95,72,24,1,96
2046,12.717000000001297,3076.3333333333335,55,20,7,75
2047,-10.497499999999004,3350.5,42,27,2,69
2048,-3.8139999999998127,2489.2105263157896,31,17,9,48
2049,-1.7364999999993138,2566.3529411764707,41,13,8,54
2050,2.1517500000014387,3068.15,48,25,1,73
2051,-16.899749999999568,2627.5,37,17,5,54
2052,9.127750000001688,4806.8,71,23,0,94
2053,-9.667499999999796,2532.3,27,17,6,44
2054,11.362750000001343,3807.5263157894738,56,33,1,89
2055,12.70300000000131,3656.722222222222,66,16,5,82
2056,6.379250000000166,2445.9411764705883,55,32,4,87
2057,-1.4992499999990438,2459.0,41,31,6,72
2058,-19.061999999998964,2383.294117647059,33,21,7,54
2059,7.101250000000216,2578.9444444444443,45,29,8,74
2060,2.3475000000009416,2336.8125,44,20,2,64
2061,-0.3332499999993578,2652.2631578947367,35,21,3,56
2062,7.215500000000967,3175.157894736842,48,20,2,68
2063,7.666750000000993,3913.684210526316,45,35,3,80
2064,-1.6459999999993289,2606.6875,49,26,3,75
2065,-21.23024999999969,2034.6842105263158,27,18,5,45
2066,-1.519749999999084,2411.25,45,20,2,65
2067,-5.231499999998659,4360.85,56,17,2,73
2068,-26.234749999999927,2302.1666666666665,29,45,11,74
2069,-9.54924999999937,3043.8947368421054,44,23,3,67
2070,-8.782499999998766,3093.157894736842,44,18,4,62
2071,1.9075000000009243,2926.823529411765,56,24,3,80
2072,-2.098999999999102,2670.125,50,35,6,85
2073,-16.96399999999878,2190.0,42,24,7,66
2074,-16.041749999999976,2022.5,34,16,16,50
2075,36.12950000000149,5313.2,75,23,1,98
2076,-31.55099999999925,2109.1052631578946,26,27,2,53
2077,-12.795249999998159,3418.2105263157896,46,22,6,68
2078,0.8005000000009878,2527.3125,43,23,3,66
2079,-14.391999999999346,2681.55,36,20,2,56
2080,-4.019249999999429,2571.8823529411766,48,33,4,81
2081,-6.660999999999591,2617.0,31,26,5,57
2082,-13.457249999999954,1959.5263157894738,22,20,8,42
2083,1.71525000000128,3142.5789473684213,51,28,2,79
2084,22.062000000001426,4155.105263157895,67,20,3,87
2085,23.667500000001887,4784.75,73,29,2,102
2086,8.202750000000922,2351.6875,43,35,7,78
2087,-17.830499999999624,2591.75,22,32,1,54
2088,-7.36999999999949,2496.7894736842104,32,20,6,52
2089,12.089000000001644,3509.3529411764707,58,23,1,81
2090,-8.867249999999135,2339.9375,48,16,5,64
2091,-0.6682499999992978,2058.0625,36,20,1,56
2092,5.858000000000846,2697.0,46,34,4,80
2093,-32.07174999999954,2008.35,25,16,1,41
2094,4.9400000000015,5274.3,56,39,0,95
2095,-1.0414999999994048,2580.9375,33,20,2,53
2096,5.969750000000834,4170.105263157895,65,25,8,90
2097,-2.954249999999493,2516.3888888888887,47,32,6,79
2098,-5.953499999999252,2581.0,35,23,2,58
2099,4.748000000000647,3135.4,47,21,5,68
2100,12.002250000001505,2827.0,51,18,4,69
2101,-19.063249999999336,1960.75,32,20,6,52
2102,11.153500000000689,3454.722222222222,53,28,1,81
2103,11.17125000000112,3470.846153846154,56,28,4,84
2104,-22.639999999999098,2336.5882352941176,44,38,2,82
2105,-15.000749999999291,2571.9375,39,15,5,54
2106,2.6872500000011175,3052.2,35,27,3,62
2107,-3.4677499999997154,2149.823529411765,43,27,7,70
2108,-28.443249999999086,2027.2105263157894,27,26,2,53
2109,4.761000000001152,3486.3,50,26,3,76
2110,-6.3914999999994935,2654.5,31,24,4,55
2111,-14.56524999999965,1874.4705882352941,31,27,1,58
2112,0.1642500000009508,3734.0526315789475,48,26,4,74
2113,-7.593249999999026,1969.611111111111,35,19,4,54
2114,8.943250000002447,2072.9375,59,26,4,85
2115,-2.911999999998431,3263.7368421052633,52,22,3,74
2116,3.7242499999999152,3244.4736842105262,41,22,5,63
2117,-14.150749999999414,2414.176470588235,30,23,7,53
2118,-8.017999999998688,3059.235294117647,50,36,2,86
2119,-10.602750000000333,2603.6666666666665,51,26,9,77
2120,1.4122500000013105,2520.133333333333,46,17,2,63
2121,-35.821499999999844,1429.0,4,34,9,38
2122,-8.654749999999435,2743.6,37,21,3,58
2123,-19.173249999999907,2151.705882352941,35,25,15,60
2124,2.0467500000009666,3092.0,47,19,6,66
2125,-11.567999999999074,3135.3888888888887,57,34,5,91
2126,-16.66274999999957,2748.2105263157896,30,29,4,59
2127,-3.2584999999988873,2568.5789473684213,38,19,6,57
2128,-23.572249999999833,1984.6842105263158,18,23,7,41
2129,14.10625000000096,3590.315789473684,58,23,2,81
2130,-26.032999999999486,2075.05,24,21,3,45
2131,-20.25899999999938,2498.777777777778,36,26,4,62
2132,15.035250000001767,4225.15,64,16,1,80
2133,13.904000000001256,3684.65,59,16,3,75
2134,-2.9324999999992416,3219.6,35,24,6,59
2135,-0.6767499999992718,3109.705882352941,55,24,5,79
2136,-0.7797499999996711,2504.8888888888887,32,37,10,69
2137,9.577250000001758,2322.875,55,18,2,73
2138,-15.800749999999221,2795.0,44,19,5,63
2139,-9.849999999999106,2563.9444444444443,41,27,2,68
2140,-5.440499999998847,3151.764705882353,62,44,3,106
2141,15.316000000001324,2759.1428571428573,60,12,11,72
2142,-15.629249999999809,2207.684210526316,19,27,12,46
2143,0.36700000000125216,2966.9411764705883,56,40,2,96
2144,-11.863249999999425,2195.8125,30,25,9,55
2145,-20.47474999999975,2028.25,26,16,3,42
2146,-15.591999999999505,2008.45,26,26,0,52
2147,-24.070499999999548,2036.2,22,15,10,37
2148,11.170500000001232,2191.125,50,26,5,76
2149,-7.026499999998654,2177.9411764705883,35,24,4,59
2150,-32.346499999999594,1657.1875,18,34,6,52
2151,-6.531499999999267,2726.9166666666665,34,23,3,57
2152,-6.475249999998948,3083.9,43,19,2,62
2153,21.38250000000164,3024.9411764705883,66,18,5,84
2154,-26.559999999999707,1429.0,19,30,8,49
2155,-11.05749999999868,3599.5263157894738,58,13,3,71
2156,2.9562500000004848,2518.375,37,23,4,60
2157,4.04750000000122,2930.75,44,20,4,64
2158,-17.62449999999968,2055.684210526316,24,19,4,43
2159,15.890000000001569,3904.45,67,14,1,81
2160,23.39825000000127,4477.55,59,27,2,86
2161,-3.839999999999248,2215.235294117647,40,21,5,61
2162,-22.560499999999553,2345.8,23,25,3,48
2163,-17.93449999999988,2229.4736842105262,21,27,10,48
2164,-19.997249999998456,1951.0,23,19,21,42
2165,-17.80399999999917,2076.4210526315787,27,20,7,47
2166,4.2127500000032985,3032.3529411764707,74,21,8,95
2167,-8.372499999998928,3099.8,32,30,5,62
2168,1.0785000000007525,2579.9285714285716,42,23,6,65
2169,-2.486749999999111,2304.8823529411766,37,20,4,57
2170,-0.9962499999991131,3068.1,48,15,3,63
2171,-19.33224999999789,2505.705882352941,47,25,10,72
2172,-7.020749999999306,2634.375,52,21,5,73
2173,-21.41949999999951,2132.4736842105262,19,22,9,41
2174,-4.452999999999402,2873.5,40,27,5,67
2175,-5.2637499999982325,3366.5263157894738,51,23,4,74
2176,-21.689999999999248,2100.7368421052633,29,22,2,51
2177,-11.030499999999318,2286.25,48,23,1,71
2178,-5.075999999999313,2455.5,39,28,6,67
2179,-10.518999999999446,2005.5,31,22,1,53
2180,-4.115999999998758,2474.6666666666665,43,25,6,68
2181,11.314750000001442,4044.722222222222,83,14,5,97
2182,-7.066249999999263,2815.9473684210525,35,24,4,59
2183,-2.932999999999042,2670.3,37,21,3,58
2184,-13.890249999999536,2587.8,40,15,4,55
2185,12.202000000000629,3393.2631578947367,50,27,1,77
2186,17.95250000000172,4458.4,74,15,2,89
2187,-2.2817500000000206,2092.9411764705883,42,28,3,70
2188,15.394000000001387,4611.7,62,25,4,87
2189,-12.897499999999445,2418.764705882353,42,13,10,55
2190,-19.10374999999955,2241.0,24,28,3,52
2191,-8.03574999999912,2654.294117647059,35,27,8,62
2192,-1.2624999999985382,4847.4,63,26,2,89
2193,-10.491999999999504,2134.375,30,20,8,50
2194,-2.554749999999154,3073.2105263157896,46,25,8,71
2195,-0.350999999998619,3000.5882352941176,56,27,5,83
2196,-10.336249999999103,2414.5,37,13,12,50
2197,2.3747500000009363,3223.722222222222,49,19,5,68
2198,6.8077500000018105,4462.4,54,39,1,93
2199,-15.193749999999843,1997.0,27,20,4,47
2200,-10.990749999999405,2448.3684210526317,25,22,12,47
2201,5.361500000001271,2311.0625,52,18,7,70
2202,14.424500000001359,3473.222222222222,72,15,3,87
2203,-11.009999999999902,2468.6666666666665,39,28,8,67
2204,-2.1402499999990514,2570.222222222222,37,23,3,60
2205,24.237500000000942,3726.4736842105262,69,16,8,85
2206,-10.070499999998916,3144.2631578947367,50,20,3,70
2207,-11.700999999999244,3763.15,43,17,6,60
2208,-8.342749999999368,2730.8571428571427,36,18,3,54
2209,-8.001999999999782,2768.0,32,15,6,47
2210,-4.576249999999741,2660.1111111111113,37,28,6,65
2211,-5.73149999999869,2420.5384615384614,37,21,7,58
2212,-3.0784999999991802,2181.6470588235293,55,25,10,80
2213,10.104000000001742,2655.1176470588234,64,17,4,81
2214,-4.048749999999503,2062.875,36,18,9,54
2215,9.54725000000165,2821.0625,61,12,4,73
2216,-24.077499999999795,2010.4736842105262,19,17,5,36
2217,18.818000000002264,4588.6,81,15,4,96
2218,-26.757999999999193,2059.842105263158,25,19,5,44
2219,-24.0757499999995,2032.25,19,26,3,45
2220,19.735750000001264,4157.65,48,29,3,77
2221,-5.4462499999987655,2939.45,51,15,2,66
2222,17.74750000000078,3095.75,47,21,3,68
2223,8.884750000000677,2810.9,34,22,3,56
2224,-7.114249999999183,3016.315789473684,42,23,4,65
2225,-1.5214999999987548,3235.3684210526317,47,23,5,70
2226,-1.8067499999988512,2980.5789473684213,47,19,4,66
2227,-6.650999999999364,2632.5625,35,20,1,55
2228,-16.96399999999888,2620.4,42,14,2,56
2229,2.339750000001575,3981.315789473684,52,36,5,88
2230,-3.2094999999988025,2285.235294117647,42,33,10,75
2231,-12.350499999997947,3195.3333333333335,49,33,4,82
2232,15.353750000001764,2937.176470588235,60,16,4,76
2233,-6.640499999999236,2579.3684210526317,38,22,3,60
2234,1.7605000000011664,2448.8125,47,22,4,69
2235,-2.765249999998569,3145.1666666666665,38,34,2,72
2236,-10.761999999999132,2657.157894736842,40,22,3,62
2237,15.273000000000843,3964.6315789473683,56,30,3,86
2238,6.5182500000026895,3595.235294117647,68,24,6,92
2239,-25.787999999999677,2008.4,17,25,0,42
2240,-5.051749999998942,2685.823529411765,46,24,2,70
2241,-0.4624999999995742,2404.0,39,28,5,67
2242,-6.347749999999631,2592.65,29,17,8,46
2243,-9.309999999999299,2624.0,36,28,10,64
2244,12.343250000000616,3977.157894736842,57,22,3,79
2245,10.167250000001248,3333.823529411765,58,28,4,86
2246,-14.699749999999312,2480.8947368421054,31,23,4,54
2247,10.202750000002009,2120.4444444444443,54,19,3,73
2248,-16.417999999998766,2422.0,32,25,9,57
2249,-7.354999999999356,2370.0,35,24,13,59
2250,11.893750000001624,4138.6,70,17,1,87
2251,-10.171749999999255,2790.470588235294,43,28,2,71
2252,-18.818499999999872,2219.277777777778,21,21,10,42
2253,-3.487749999999653,3362.2105263157896,34,40,10,74
2254,20.787750000001875,4287.9,63,19,4,82
2255,3.6360000000007986,4118.8,53,30,1,83
2256,-0.6499999999987643,3031.4444444444443,54,23,4,77
2257,8.531000000001196,3777.55,49,35,2,84
2258,2.4195000000006006,3157.4444444444443,51,24,3,75
2259,-26.931749999999408,2567.9,23,25,2,48
2260,-3.1152499999994534,2465.222222222222,46,15,15,61
2261,-11.365499999999212,2685.722222222222,29,30,4,59
2262,0.6890000000009633,4148.1,45,33,3,78
2263,-0.06974999999880245,3905.3,57,23,2,80
2264,21.949500000001986,4786.3,63,33,0,96
2265,-12.394499999999145,2564.0,31,24,2,55
2266,-0.7267499999994818,2412.235294117647,39,36,4,75
2267,27.69800000000143,4206.0,57,23,6,80
2268,-6.487999999998979,3145.842105263158,31,41,4,72
2269,1.4702500000004983,3008.9411764705883,40,19,4,59
2270,12.70750000000177,2287.25,49,24,2,73
2271,11.517000000001946,4253.65,68,24,4,92
2272,-23.92299999999936,3800.5,29,39,6,68
2273,-5.1637499999990535,2749.222222222222,39,31,2,70
2274,-34.50200000000022,1429.0,11,43,8,54
2275,17.334750000001325,4611.6,71,26,1,97
2276,-5.108749999999342,3123.5,38,29,0,67
2277,-6.869500000000149,2066.6111111111113,32,30,14,62
2278,-4.374999999998765,3045.4444444444443,48,22,6,70
2279,9.239750000000868,2357.5625,54,28,4,82
2280,-6.858749999999065,2974.684210526316,51,18,5,69
2281,28.881000000001148,4140.789473684211,76,15,2,91
2282,-8.675749999999429,2059.7894736842104,24,26,3,50
2283,-15.4047499999998,1992.5555555555557,27,29,10,56
2284,-24.587249999999987,2195.3888888888887,30,24,14,54
2285,-7.785499999999203,4097.4,44,37,2,81
2286,13.346500000001791,2527.8333333333335,48,22,8,70
2287,-5.546999999998499,4051.5789473684213,53,34,7,87
2288,-21.744999999999656,2058.9375,22,24,6,46
2289,22.141500000000114,2000.4,51,21,6,72
2290,3.0050000000005612,4248.9,53,22,5,75
2291,-4.142249999999401,2473.1111111111113,34,27,6,61
2292,19.048000000001686,4124.35,68,21,1,89
2293,-24.125499999999597,2027.0,22,24,3,46
2294,-21.417749999999565,2024.35,20,25,4,45
2295,17.5302500000012,3155.6666666666665,76,19,9,95
2296,-2.4452499999990494,2855.8947368421054,53,19,4,72
2297,-18.29024999999913,2579.8,39,16,4,55
2298,-0.8737499999990984,2924.722222222222,43,22,6,65
2299,-0.36224999999903157,3755.25,40,35,5,75
2300,-7.600500000000011,1862.3529411764705,36,23,8,59
2301,-14.325749999999193,3133.6666666666665,50,23,17,73
2302,-2.485999999998689,2605.6875,63,29,15,92
2303,-8.429249999999577,2118.1176470588234,36,31,9,67
2304,31.209750000001275,3989.684210526316,66,26,1,92
2305,-9.630499999999405,2523.4210526315787,32,25,2,57
2306,14.322250000000755,2952.157894736842,54,18,4,72
2307,-13.358749999999313,2148.0,23,40,3,63
2308,-0.09999999999852624,2825.9444444444443,47,30,2,77
2309,4.473000000000569,2555.95,38,17,4,55
2310,16.658500000002057,2447.875,66,18,4,84
2311,-2.8712499999991317,3454.45,41,20,4,61
2312,-8.356249999999212,2738.157894736842,30,20,3,50
2313,3.421000000000897,2482.625,39,36,2,75
2314,6.5002500000014205,4833.8,62,25,1,87
2315,-9.971499999999565,2215.235294117647,41,19,8,60
2316,29.02400000000202,4548.2,73,18,1,91
2317,-15.375499999998974,2608.684210526316,33,28,8,61
2318,-7.882749999998575,3346.55,55,13,6,68
2319,-9.828749999998688,3167.1,42,24,1,66
2320,2.589250000001097,3135.5555555555557,51,30,7,81
2321,-14.19324999999938,2663.2,29,30,1,59
2322,9.289500000000604,3055.1111111111113,49,32,11,81
2323,5.613250000001843,3548.1111111111113,58,20,7,78
2324,9.514000000001882,2552.4444444444443,49,26,2,75
2325,-12.564749999999455,2700.0625,31,16,5,47
2326,-0.335999999998945,2964.75,48,34,5,82
2327,-18.193499999998924,2222.764705882353,35,34,4,69
2328,23.87750000000161,4313.894736842105,69,18,3,87
2329,-15.430249999999315,2602.8947368421054,32,24,3,56
2330,5.500750000001448,3251.1052631578946,52,22,7,74
2331,-17.338999999998947,2067.6470588235293,31,37,9,68
2332,-0.2284999999985331,4182.3,51,35,2,86
2333,-4.932499999999315,2691.125,31,23,5,54
2334,-19.344250000000034,1933.4444444444443,30,25,8,55
2335,-2.959999999998917,4058.157894736842,53,22,6,75
2336,-8.169999999998947,2508.5,29,25,5,54
2337,12.239500000001716,3551.722222222222,57,22,6,79
2338,18.320000000001762,4372.85,75,18,4,93
2339,2.617000000000044,3296.2105263157896,40,34,2,74
2340,-10.711499999999205,3435.5,39,20,10,59
2341,-27.99099999999944,2080.684210526316,24,23,5,47
2342,-3.692249999999216,2832.9285714285716,38,26,5,64
2343,8.12700000000101,3079.1111111111113,43,26,2,69
2344,-34.161000000000335,1429.0,7,28,21,35
2345,8.822750000000882,3902.0526315789475,60,33,2,93
2346,-22.72525000000045,2015.4444444444443,33,23,15,56
2347,0.5217500000008084,4089.1052631578946,58,29,2,87
2348,-6.015999999998614,3240.9,44,24,2,68
2349,-5.497999999999408,3621.2631578947367,37,25,6,62
2350,-7.396249999999346,2643.5,49,18,2,67
2351,9.907000000001142,2977.875,58,24,2,82
2352,2.882500000000653,2630.3684210526317,36,27,6,63
2353,-0.6002499999986107,2625.1176470588234,46,25,1,71
2354,10.92125000000065,2387.3125,51,27,10,78
2355,5.177250000000969,2396.4117647058824,41,22,5,63
2356,-16.648749999999602,2012.2105263157894,26,21,5,47
2357,-27.897249999999453,2024.3,18,31,1,49
2358,-36.21999999999974,2048.15,19,20,1,39
2359,-29.264249999999443,2008.4,11,26,8,37
2360,0.2945000000009502,2700.45,35,24,2,59
2361,2.313500000000958,3808.55,53,24,2,77
2362,-0.5154999999993097,2565.9375,56,28,7,84
2363,15.34474999999986,3883.6315789473683,57,22,10,79
2364,17.367250000001626,4304.35,57,29,2,86
2365,5.791500000001229,3814.9,54,23,2,77
2366,23.090500000001548,4437.421052631579,68,20,0,88
2367,-8.347999999999754,2594.5789473684213,28,21,5,49
2368,14.024750000000974,3733.05,51,21,3,72
2369,-32.33474999999946,2490.0526315789475,18,29,3,47
2370,-20.419249999999522,2032.3,18,27,1,45
2371,-17.047499999999864,2021.8823529411766,33,26,13,59
2372,1.8087500000012906,3690.25,52,27,4,79
2373,-13.971999999999388,2150.25,40,25,6,65
2374,-25.73774999999967,1973.2222222222222,19,28,3,47
2375,-3.2144999999994512,2378.6470588235293,43,29,1,72
2376,19.440750000000683,2381.5333333333333,54,30,3,84
2377,-33.45875000000005,1981.0555555555557,24,20,17,44
2378,-1.0052499999997657,2048.1666666666665,34,24,3,58
2379,-20.44899999999959,2134.55,23,21,2,44
2380,19.358750000001358,4575.95,52,32,4,84
2381,-28.032999999999856,2058.45,17,21,8,38
2382,-12.71099999999934,3245.9,31,31,2,62
2383,16.701750000001446,3821.7894736842104,74,18,1,92
2384,21.071750000001764,4451.35,65,21,3,86
2385,-8.568249999999239,3294.1,38,23,5,61
2386,5.779500000001145,2500.5,51,25,4,76
2387,7.858750000000204,2387.375,56,18,4,74
2388,21.83975000000313,2501.4375,86,11,5,97
2389,11.04650000000042,2854.0555555555557,49,20,6,69
2390,12.430500000001608,3226.3333333333335,61,24,3,85
2391,-11.119499999998984,2434.3888888888887,30,22,7,52
2392,0.569500000000817,2445.1176470588234,39,29,2,68
2393,-4.613999999998816,2148.5333333333333,45,20,2,65
2394,-0.6297499999989926,2727.1111111111113,58,15,5,73
2395,-13.04349999999971,2578.5882352941176,44,34,10,78
2396,26.91300000000303,3771.3333333333335,85,20,1,105
2397,11.581500000000604,2849.3529411764707,55,27,2,82
2398,-20.38974999999971,2093.157894736842,23,23,7,46
2399,-12.220999999999648,2101.35,22,28,1,50
2400,-2.641749999998985,2402.0588235294117,52,11,4,63
2401,2.024250000000732,3070.1666666666665,46,20,6,66
2402,16.822000000001946,3042.777777777778,64,26,3,90
2403,-18.032249999999387,2775.3333333333335,28,28,1,56
2404,11.406750000000446,3517.35,49,21,0,70
2405,13.603250000000099,2444.0588235294117,69,21,6,90
2406,-22.78699999999954,1429.0,13,31,3,44
2407,-17.86649999999941,2129.235294117647,42,29,15,71
2408,-5.107999999999193,3400.6315789473683,57,18,3,75
2409,-35.29025000000006,2034.0588235294117,16,27,9,43
2410,3.0072500000007403,3472.0,52,34,4,86
2411,-11.468499999999397,2454.157894736842,36,17,5,53
2412,-12.604749999998694,2543.4,44,22,4,66
2413,-10.015000000000162,2238.6111111111113,36,32,7,68
2414,-2.0144999999988586,3087.85,47,23,2,70
2415,10.368000000001896,4137.1,62,20,0,82
2416,-25.618999999999847,2247.7368421052633,17,29,3,46
2417,12.880500000001627,3622.8,55,17,7,72
2418,3.6127500000008355,3422.85,49,18,7,67
2419,-27.684249999999487,2203.5,32,23,9,55
2420,-11.273499999999029,2172.4444444444443,26,21,10,47
2421,5.170000000001998,2351.5625,60,28,2,88
2422,2.03575000000171,1906.4,58,18,4,76
2423,-7.861749999999188,3127.4210526315787,54,12,1,66
2424,-3.9954999999993435,2892.0555555555557,46,16,1,62
2425,-17.786249999999324,2544.15,35,17,5,52
2426,20.293000000001477,4283.9,60,23,3,83
2427,0.7157500000005338,2569.0588235294117,45,17,2,62
2428,-8.596749999998854,3580.6,44,25,2,69
2429,-23.896499999999513,2013.5882352941176,24,25,11,49
2430,-3.6669999999987204,1920.0,50,26,4,76
2431,-10.796749999999715,2262.842105263158,19,30,1,49
2432,8.935500000002108,3123.9444444444443,60,20,1,80
2433,14.002250000001387,3396.6315789473683,50,28,5,78
2434,-24.359749999999394,2094.2,20,23,3,43
2435,-21.209999999999653,2008.4,23,16,4,39
2436,4.157750000001149,2563.6470588235293,48,25,3,73
2437,-6.994999999999441,2560.0,32,21,2,53
2438,-19.599499999999686,2024.25,21,25,0,46
2439,19.183250000001923,3239.5,62,14,4,76
2440,-24.16675000000014,1429.0,20,25,8,45
2441,-13.859749999999746,2023.8947368421052,28,15,6,43
2442,-25.342999999999385,2030.2941176470588,28,23,4,51
2443,-0.23124999999777138,2953.777777777778,47,17,17,64
2444,6.4282500000004505,2900.4210526315787,41,14,5,55
2445,-10.313999999998996,2468.294117647059,34,23,7,57
2446,10.907500000000088,2984.6111111111113,60,37,2,97
2447,-4.502249999999666,3699.75,43,25,8,68
2448,-14.317749999999307,2585.35,28,24,1,52
2449,-18.81574999999922,2779.157894736842,32,28,3,60
2450,-13.118249999999787,2445.777777777778,31,31,1,62
2451,-21.572999999999514,2149.5555555555557,26,27,11,53
2452,7.936250000000937,4242.789473684211,60,33,2,93
2453,-21.889499999999725,2064.0526315789475,15,23,7,38
2454,-25.287749999999548,1991.2631578947369,21,15,11,36
2455,-8.167749999999646,2552.9333333333334,36,21,5,57
2456,-8.93249999999969,2038.764705882353,29,26,8,55
2457,-21.838000000000253,1429.0,30,38,13,68
2458,17.027750000000974,3220.2105263157896,52,20,2,72
2459,13.82625000000235,1992.5625,69,17,3,86
2460,-3.011249999999428,2629.2,28,23,7,51
2461,5.241000000001803,4663.15,65,11,1,76
2462,-7.819749999999156,3081.5263157894738,49,16,4,65
2463,16.32100000000131,3444.1666666666665,59,22,2,81
2464,-15.997749999999197,2810.85,27,34,0,61
2465,-25.537999999999602,1958.4705882352941,32,21,8,53
2466,11.064000000001288,3722.8,52,24,0,76
2467,16.53525000000097,2571.0,46,24,2,70
2468,6.911250000001419,2561.764705882353,42,27,6,69
2469,-20.26799999999843,2500.0,43,21,7,64
2470,-2.0319999999983738,2942.9473684210525,50,20,5,70
2471,-9.175249999999279,2663.9285714285716,41,17,12,58
2472,-3.5014999999986913,2434.0,49,19,9,68
2473,3.599500000001156,4423.55,62,15,2,77
2474,-16.250499999999462,1881.388888888889,31,25,13,56
2475,-20.78249999999904,2717.95,29,28,1,57
2476,-15.1869999999995,2521.529411764706,38,30,7,68
2477,-0.8857499999995916,3079.8333333333335,49,24,7,73
2478,-8.084499999999457,2470.5,27,27,3,54
2479,-4.275749999999301,3657.6,40,25,5,65
2480,16.302000000001506,4190.3,69,18,6,87
2481,2.454000000000724,2588.9333333333334,35,22,1,57
2482,-11.559499999999279,2566.6666666666665,33,15,7,48
2483,2.892500000000602,3883.1,55,22,4,77
2484,-10.500999999999772,2286.0833333333335,38,22,7,60
2485,26.233750000001926,4470.8421052631575,73,25,5,98
2486,-10.57249999999935,2035.1176470588234,30,24,1,54
2487,6.591500000001565,3016.3333333333335,60,13,5,73
2488,-12.481249999999516,2481.1111111111113,35,31,16,66
2489,-11.430499999999366,2688.7894736842104,39,14,7,53
2490,8.881500000001262,2848.8888888888887,58,21,3,79
2491,-28.326249999999767,2097.4736842105262,18,29,4,47
2492,-5.869249999999449,2790.6666666666665,50,24,8,74
2493,8.550250000000176,2757.1111111111113,57,17,10,74
2494,-22.96749999999964,2491.722222222222,34,18,7,52
2495,-2.4099999999986776,3161.7368421052633,55,16,1,71
2496,-27.510749999999422,2028.2,28,16,4,44
2497,-1.4207499999994322,3143.2631578947367,46,18,4,64
2498,-8.425499999999495,2345.0,38,27,3,65
2499,-11.065499999999787,3168.75,31,27,3,58
2500,-8.843499999999459,2591.8947368421054,33,18,5,51
2501,-23.47574999999967,2024.35,22,25,2,47
2502,-21.297999999999355,2043.0526315789473,30,16,6,46
2503,-4.614249999999009,3190.35,50,20,3,70
2504,3.289250000000949,3843.4,53,19,4,72
2505,-1.9599999999990931,3937.8,54,21,3,75
2506,23.704750000001003,5281.55,59,26,4,85
2507,-7.872999999999424,2568.0,36,21,2,57
2508,-25.452999999999513,1999.6315789473683,25,20,1,45
2509,-16.077249999999218,2294.6470588235293,32,31,7,63
2510,-9.030499999999341,2626.5555555555557,31,36,4,67
2511,4.204750000001161,3024.5,51,16,2,67
2512,-2.415499999998496,2367.470588235294,46,19,4,65
2513,-25.034999999999634,2008.4,21,20,2,41
2514,-3.1394999999990096,3713.2,47,27,2,74
2515,4.583749999999848,1964.75,55,36,7,91
2516,10.500250000000978,2487.625,45,20,4,65
2517,-8.615249999999335,3524.315789473684,41,29,3,70
2518,9.722250000001022,4321.9,61,20,2,81
2519,-5.630249999998776,3312.125,39,28,8,67
2520,-19.726749999999775,2118.1176470588234,36,25,15,61
2521,-22.608249999999657,2024.35,25,15,3,40
2522,-25.714999999999446,2028.3,23,25,1,48
2523,6.452750000001349,4183.05,57,30,2,87
2524,18.38150000000171,2577.0,64,22,0,86
2525,0.6195000000006659,3095.8,44,20,1,64
2526,16.29800000000137,3799.75,64,13,5,77
2527,-0.2339999999982573,3717.9,63,16,3,79
2528,15.907250000001008,3491.722222222222,67,37,3,104
2529,12.882750000000346,3055.9444444444443,51,28,3,79
2530,9.599500000001806,3976.2631578947367,79,10,1,89
2531,-23.341000000000047,2126.6315789473683,25,21,5,46
2532,6.193750000001359,3241.157894736842,51,28,1,79
2533,4.352750000000418,2473.625,54,30,0,84
2534,-19.300249999999906,2211.0,19,27,5,46
2535,-19.34549999999972,2032.25,23,17,7,40
2536,35.912000000001505,4742.5,86,13,2,99
2537,-10.101749999999438,2591.8,38,19,0,57
2538,2.0145000000009055,2436.5882352941176,45,17,2,62
2539,13.97700000000268,3414.1666666666665,76,12,5,88
2540,-0.9742499999980293,4498.95,76,17,0,93
2541,-0.2992499999993032,2533.866666666667,39,19,2,58
2542,-25.209999999999496,2008.5,24,20,2,44
2543,-22.455249999999342,2094.75,28,33,9,61
2544,12.04675000000161,2771.222222222222,57,19,4,76
2545,7.654250000001338,3064.1,52,19,0,71
2546,-5.7737499999998265,1429.0,33,29,3,62
2547,10.574000000000165,2849.235294117647,49,27,1,76
2548,-7.604499999999692,1879.1764705882354,43,21,6,64
2549,20.24525000000106,3908.45,56,24,2,80
2550,30.05775000000108,4476.05,86,9,1,95
2551,-20.95674999999952,2038.9473684210527,26,20,3,46
2552,-7.649999999999456,2614.75,38,16,2,54
2553,10.11875000000055,3953.0,53,25,2,78
2554,-8.591999999998933,2692.2631578947367,35,25,1,60
2555,4.98250000000111,3599.277777777778,63,33,4,96
2556,-12.03824999999917,2531.1428571428573,37,22,1,59
2557,-2.956749999999469,2411.125,54,20,3,74
2558,-4.7289999999997185,2385.8333333333335,35,13,4,48
2559,31.836750000001626,4008.4,75,7,4,82
2560,-19.671499999999305,2543.777777777778,37,28,0,65
2561,9.482500000001378,4291.8,68,24,1,92
2562,-0.7167499999977609,3063.176470588235,74,17,3,91
2563,-29.297000000000004,1429.0,18,32,1,50
2564,-12.995749999999784,1986.4705882352941,30,28,6,58
2565,11.511750000002165,4259.3,68,24,1,92
2566,-0.6369999999989966,3134.2105263157896,57,14,3,71
2567,-7.691999999999804,1866.0,44,18,1,62
2568,14.626750000000674,3120.842105263158,51,18,0,69
2569,5.678250000000108,2228.6875,62,29,3,91
2570,15.704750000000768,3076.235294117647,58,26,0,84
2571,-21.364499999999474,2013.5882352941176,25,22,6,47
2572,1.6210000000008904,2987.277777777778,59,38,4,97
2573,-20.6427499999988,2170.125,34,28,2,62
2574,-27.81299999999903,2465.5882352941176,43,30,3,73
2575,18.703250000001052,4596.6,65,26,0,91
2576,-4.788499999998991,2585.222222222222,40,14,2,54
2577,-24.925749999999077,2523.4210526315787,37,19,2,56
2578,27.379500000001627,4801.3,76,11,0,87
2579,-21.55649999999952,2108.0555555555557,27,23,1,50
2580,1.2972500000010039,2464.6875,69,14,1,83
2581,5.540250000001028,4158.35,54,21,1,75
2582,-24.742499999999673,2048.1,22,24,1,46
2583,-22.654499999999235,2552.15,33,20,1,53
2584,-10.920999999999351,2382.6153846153848,28,25,3,53
2585,-2.5947499999992796,4849.65,59,16,3,75
2586,6.171750000001013,3764.0,58,17,0,75
2587,-15.579249999999515,3158.35,25,33,8,58
2588,-7.964249999999149,2481.1111111111113,38,21,3,59
2589,6.2532500000003335,2547.277777777778,61,22,1,83
2590,-9.93324999999866,2181.6470588235293,42,18,4,60
2591,-21.248249999998936,2076.3333333333335,42,24,3,66
2592,-9.919999999999842,2286.176470588235,55,38,2,93
2593,10.224250000001167,4184.75,70,10,1,80
2594,-33.063499999999635,2074.0,22,27,4,49
2595,20.87750000000149,3968.777777777778,81,20,5,101
2596,-4.5132499999993545,3947.3,37,39,0,76
2597,-12.282999999999754,2623.0714285714284,49,30,3,79
2598,2.7287500000010403,2864.176470588235,52,26,2,78
2599,10.496000000001398,3976.8,56,14,1,70
2600,5.542500000000848,2682.0,57,37,1,94
2601,-11.611249999998597,3224.4,45,18,0,63
2602,-3.922749999999367,2565.2631578947367,38,25,1,63
2603,-13.117249999999624,2494.2631578947367,32,18,10,50
2604,17.301500000002168,3944.5789473684213,66,26,1,92
2605,10.370750000000807,2934.5789473684213,42,27,0,69
2606,-13.708999999999644,1955.875,36,37,5,73
2607,-19.54074999999901,2484.5625,40,16,4,56
2608,-6.578999999999249,2482.8333333333335,52,16,3,68
2609,10.777000000000779,3979.0,52,23,0,75
2610,6.337500000001054,2491.733333333333,52,22,3,74
2611,-5.685749999999301,2310.529411764706,28,23,0,51
2612,13.656500000001142,3860.1052631578946,54,32,1,86
2613,9.220500000000829,2830.9375,73,27,3,100
2614,16.643500000001172,3883.15,63,20,0,83
2615,-16.34149999999959,2568.05,29,27,1,56
2616,-31.155999999999512,2003.0,23,22,3,45
2617,-6.076749999999177,2196.8125,47,26,3,73
2618,1.4785000000007917,3504.65,42,24,7,66
2619,-21.04999999999977,2093.8888888888887,24,24,6,48
2620,-27.190999999999594,1980.4736842105262,24,29,1,53
2621,3.5945000000010388,3103.65,48,16,2,64
2622,-23.1869999999996,1959.5263157894738,22,27,3,49
2623,-18.064999999999625,2028.2,21,22,5,43
2624,-2.2074999999993805,2559.95,36,18,2,54
2625,-18.158999999999363,2676.866666666667,35,22,6,57
2626,-8.67349999999935,2627.0,50,27,0,77
2627,0.7937500000007685,3133.6666666666665,54,13,4,67
2628,-31.95999999999961,1901.7222222222222,35,33,8,68
2629,-9.967999999999186,2736.846153846154,33,25,2,58
2630,-35.76574999999989,1959.5263157894738,19,15,13,34
2631,-6.8672499999989585,2991.8,36,30,4,66
2632,-21.235749999999655,2448.85,18,32,3,50
2633,5.073250000001751,4241.9,69,26,1,95
2634,13.95600000000089,3871.15,60,16,3,76
2635,-5.094499999998917,2891.0,39,29,2,68
2636,3.3690000000004874,2496.235294117647,56,14,4,70
2637,-9.630749999998963,2685.9411764705883,48,18,4,66
2638,0.77800000000065,2641.866666666667,40,21,5,61
2639,1.3020000000003848,2218.9411764705883,44,27,3,71
2640,7.738000000001335,2472.0588235294117,48,25,1,73
2641,-7.790499999999248,2620.5882352941176,36,22,0,58
2642,5.409000000000551,2965.4210526315787,44,22,5,66
2643,-15.536249999999475,2718.05,33,18,0,51
2644,30.065500000002345,4615.473684210527,88,11,1,99
2645,-14.477749999999503,2657.0,35,18,1,53
2646,8.804750000001704,2315.9375,61,22,3,83
2647,6.989250000000962,3520.8947368421054,59,32,2,91
2648,-27.611499999999534,2052.4444444444443,27,18,5,45
2649,-0.2919999999988338,2743.0,44,16,7,60
2650,9.312750000000614,3245.6111111111113,47,15,2,62
2651,4.690750000000316,2854.315789473684,39,18,5,57
2652,-11.012749999999011,2474.8333333333335,41,21,5,62
2653,8.765250000001421,3627.65,62,17,1,79
2654,-15.590749999999252,1893.375,40,45,6,85
2655,2.2512500000007596,3168.4736842105262,42,29,3,71
2656,-8.027999999999613,2261.9411764705883,33,22,6,55
2657,-22.975999999999445,2089.0,23,25,1,48
2658,19.487750000001167,4040.6315789473683,82,19,2,101
2659,-12.194499999999985,2554.125,36,22,6,58
2660,-20.316499999999305,2160.7894736842104,27,23,3,50
2661,-3.492499999999718,3741.5789473684213,54,28,7,82
2662,30.5205000000008,2920.3125,72,22,3,94
2663,-21.37725000000004,1429.0,22,32,6,54
2664,5.367250000000153,1997.7777777777778,43,20,8,63
2665,4.196000000000501,2982.3684210526317,44,12,4,56
2666,-17.983249999999664,1429.0,18,33,5,51
2667,-14.296249999999281,2729.8125,38,15,5,53
2668,-5.251749999998998,2943.842105263158,38,20,4,58
2669,-15.426499999999157,2881.5,32,25,6,57
2670,-4.354249999999575,3152.5789473684213,45,22,2,67
2671,8.910250000001165,4498.1,55,27,1,82
2672,-21.167999999999694,2052.1,21,26,1,47
2673,-2.5032499999997393,2524.3333333333335,50,21,3,71
2674,9.951500000001012,3255.35,45,29,1,74
2675,2.952750000000715,3056.0555555555557,48,30,3,78
2676,-0.21299999999909636,2663.6153846153848,43,30,2,73
2677,2.906250000000683,2592.8125,56,23,7,79
2678,-4.051250000000225,2044.5,27,27,7,54
2679,4.78849999999991,2415.0588235294117,51,19,3,70
2680,-3.9119999999989106,2551.470588235294,39,23,3,62
2681,-7.280749999999765,2561.785714285714,42,22,10,64
2682,-10.22949999999964,2495.4117647058824,34,22,6,56
2683,-12.953499999999446,2890.2105263157896,56,25,3,81
2684,-14.816749999998716,2511.235294117647,50,23,3,73
2685,-4.421999999998816,3695.1,50,24,0,74
2686,4.417750000000652,2424.777777777778,33,33,2,66
2687,10.334750000002007,3400.0555555555557,64,28,0,92
2688,8.198000000000528,3564.85,48,21,1,69
2689,6.554250000001398,3222.8,57,11,7,68
2690,-7.095999999999732,2248.823529411765,43,34,5,77
2691,1.3712500000005197,2731.5789473684213,41,21,3,62
2692,-26.469749999998793,2929.4210526315787,40,19,6,59
2693,-0.8294999999984766,2340.8888888888887,40,25,2,65
2694,5.92225000000106,3943.45,55,27,0,82
2695,0.11450000000035479,2584.277777777778,34,25,1,59
2696,16.35225000000137,3061.176470588235,77,28,1,105
2697,-18.42049999999949,2688.1052631578946,33,19,2,52
2698,6.469750000000805,2558.266666666667,43,26,2,69
2699,-5.125999999998854,3716.4210526315787,54,16,5,70
2700,8.508500000001005,3434.157894736842,54,20,1,74
2701,-4.81199999999931,3004.7368421052633,58,13,19,71
2702,-16.75949999999956,2032.3,22,26,1,48
2703,-12.388249999999186,2536.2,36,18,0,54
2704,4.678750000000766,2500.5,36,26,6,62
2705,-2.5649999999987587,4714.0,64,30,0,94
2706,-8.240499999998942,2610.235294117647,39,20,4,59
2707,1.3580000000003558,1746.5,46,26,2,72
2708,17.226250000001837,2661.1875,71,27,2,98
2709,-3.6344999999991545,2469.6666666666665,43,21,5,64
2710,-2.496749999998589,2491.6,59,26,2,85
2711,-23.436749999999808,2043.8947368421052,22,26,2,48
2712,4.730500000001582,3088.6666666666665,51,28,1,79
2713,16.020250000000832,4142.6,68,8,5,76
2714,21.029750000000966,3474.9444444444443,87,23,11,110
2715,6.867000000001485,2924.125,67,25,2,92
2716,-22.5219999999998,3000.4210526315787,29,41,3,70
2717,7.182750000001297,4314.0,57,26,0,83
2718,0.8052500000008347,2684.285714285714,47,29,3,76
2719,7.554250000001062,4263.95,59,25,2,84
2720,-7.622749999998791,1993.0588235294117,36,23,10,59
2721,-9.681999999999254,2657.733333333333,37,17,2,54
2722,-6.689499999998702,2611.153846153846,41,19,6,60
2723,-23.45474999999952,2052.85,24,22,4,46
2724,-2.4699999999990276,2424.294117647059,66,22,6,88
2725,-30.108499999999673,1429.0,8,23,10,31
2726,8.989750000000846,3759.157894736842,57,22,2,79
2727,-19.89574999999937,1937.9411764705883,28,26,4,54
2728,15.746500000001172,4258.5,69,13,4,82
2729,16.699750000000357,3302.0588235294117,56,24,5,80
2730,1.6537500000004943,3235.1666666666665,56,23,5,79
2731,22.242750000000765,3008.823529411765,55,23,1,78
2732,-9.36999999999947,2439.6111111111113,43,17,3,60
2733,14.137750000001025,4083.157894736842,75,19,2,94
2734,-11.942249999998838,2478.4444444444443,36,26,5,62
2735,-0.6759999999993334,2532.3333333333335,36,21,0,57
2736,4.120000000001279,3242.55,52,18,1,70
2737,4.884750000001146,4116.4,65,23,2,88
2738,-2.568749999998739,2128.375,46,22,4,68
2739,4.128000000001058,2408.529411764706,45,20,4,65
2740,3.0350000000008577,3193.5263157894738,46,22,4,68
2741,-6.6695000000000775,1925.5,45,17,10,62
2742,-14.930749999999497,2116.1111111111113,29,27,4,56
2743,0.3640000000017186,2359.5,43,30,3,73
2744,23.560250000001542,4260.8,67,13,1,80
2745,6.52100000000065,2468.875,45,17,1,62
2746,-9.221999999999207,2537.5789473684213,35,21,4,56
2747,37.74625000000482,3517.222222222222,102,21,12,123
2748,-5.452499999999247,2589.875,38,21,3,59
2749,7.802750000001176,4225.1,65,16,2,81
2750,-13.671250000000049,2028.35,23,20,1,43
2751,10.707000000001251,3696.3684210526317,74,16,6,90
2752,-26.912749999999598,2024.3,23,18,2,41
2753,-26.335499999999662,2040.15,21,23,2,44
2754,-11.970249999999522,2568.3888888888887,32,27,6,59
2755,-20.972249999999285,2155.3,27,23,3,50
2756,-18.143249999999355,2499.9473684210525,36,21,1,57
2757,-0.8432499999997344,2611.157894736842,42,28,1,70
2758,11.888250000001015,3134.6,54,10,2,64
2759,-40.898999999999525,1893.7777777777778,21,29,6,50
2760,-29.5694999999995,2080.684210526316,25,19,4,44
2761,14.613750000001787,4457.7,66,16,4,82
2762,10.495250000001517,2655.153846153846,59,30,2,89
2763,9.866250000000694,2100.9333333333334,46,18,3,64
2764,-1.1572499999991002,3200.2631578947367,46,23,3,69
2765,-25.90874999999894,2030.388888888889,31,18,9,49
2766,14.978500000001844,2024.7333333333333,77,21,4,98
2767,0.6472500000008952,2862.1666666666665,54,30,8,84
2768,-9.531249999999822,2381.5555555555557,25,26,5,51
2769,-0.09274999999958364,2316.1176470588234,41,23,13,64
2770,-2.5049999999986414,2305.4,47,33,2,80
2771,-31.157999999999856,1899.5294117647059,31,29,10,60
2772,9.24750000000239,3307.764705882353,64,27,3,91
2773,-8.954749999998928,4053.6,60,9,6,69
2774,6.898000000001838,2526.1176470588234,58,12,6,70
2775,-20.835499999999058,1993.7368421052631,23,22,9,45
2776,-14.343249999999497,2265.6470588235293,43,23,8,66
2777,10.905000000001476,2884.5,68,20,3,88
2778,4.556250000000751,2030.4117647058824,68,24,5,92
2779,-2.4394999999993177,2552.9333333333334,38,21,4,59
2780,-11.769749999999272,2139.3125,37,22,5,59
2781,-11.24824999999987,2040.5882352941176,32,24,3,56
2782,2.759750000000492,3027.2631578947367,53,25,10,78
2783,-15.694499999999,2094.8888888888887,27,25,3,52
2784,11.423750000000002,2223.6875,62,27,0,89
2785,-39.97799999999993,1429.0,0,28,5,28
2786,-14.968749999999584,2387.235294117647,34,25,5,59
2787,-36.247249999999624,1937.1052631578948,14,28,6,42
2788,-4.228249999999397,2634.65,44,18,1,62
2789,-24.40674999999931,1981.0555555555557,26,26,2,52
2790,-26.084999999999233,2638.65,30,27,1,57
2791,21.18125000000128,4353.65,65,17,0,82
2792,-12.974749999999574,2171.5555555555557,23,29,3,52
2793,18.902000000001266,3797.6666666666665,75,28,3,103
2794,18.658250000001374,3735.1111111111113,80,23,6,103
2795,-5.503749999999296,2504.705882352941,38,15,6,53
2796,10.889250000001034,2414.1875,55,23,3,78
2797,8.985499999999764,2170.0625,61,40,1,101
2798,-25.24049999999939,2114.1052631578946,29,18,1,47
2799,-14.716249999999244,2175.0625,35,23,6,58
2800,24.623500000002316,4164.8,79,12,0,91
2801,-19.689749999999563,2018.0,25,22,3,47
2802,8.4027500000012,2097.6875,52,25,0,77
2803,24.516500000000974,4429.85,75,23,1,98
2804,-1.3984999999992875,2580.9375,37,29,0,66
2805,10.584250000001642,3251.8333333333335,67,18,2,85
2806,13.694250000000611,4007.6,54,26,1,80
2807,-3.501749999999393,3541.0526315789475,50,28,2,78
2808,-12.009249999999556,2046.3333333333333,29,28,8,57
2809,-11.53599999999882,3756.25,53,20,2,73
2810,23.348000000001257,4291.263157894737,67,18,3,85
2811,3.4935000000007603,3151.277777777778,49,32,3,81
2812,43.893750000001276,3627.176470588235,79,19,3,98
2813,5.742749999999754,2250.4375,55,37,3,92
2814,-14.724499999999562,2116.9444444444443,24,26,6,50
2815,-16.95475000000021,2048.1666666666665,35,30,4,65
2816,18.727250000002336,3241.470588235294,72,16,8,88
2817,0.1495000000008817,3410.7894736842104,48,19,2,67
2818,7.594000000000328,2815.764705882353,51,33,0,84
2819,-6.662749999998667,2892.0555555555557,45,27,5,72
2820,5.9302500000011005,3937.15,53,26,0,79
2821,-11.36299999999967,2844.3333333333335,43,30,9,73
2822,-28.303249999999554,2607.0526315789475,41,30,4,71
2823,-30.94699999999928,2028.25,25,25,1,50
2824,-14.625249999999468,2650.45,38,13,2,51
2825,-9.487749999999286,1991.5,33,22,3,55
2826,16.662250000001663,3561.277777777778,66,27,0,93
2827,-16.85324999999965,2558.35,16,32,4,48
2828,22.43150000000162,4556.7,69,21,1,90
2829,14.092250000000954,2677.153846153846,55,24,10,79
2830,16.018500000000834,2613.5625,64,14,1,78
2831,13.103500000001976,3435.222222222222,63,19,2,82
2832,7.398000000000659,3009.0,67,10,1,77
2833,2.576250000001635,3108.0588235294117,72,27,4,99
2834,5.74350000000163,3653.7,76,4,0,80
2835,16.797000000000253,2076.9375,58,29,3,87
2836,-7.857999999999055,3690.4736842105262,55,23,1,78
2837,-31.775999999999982,2060.5555555555557,19,29,8,48
2838,9.521250000001135,2340.4117647058824,45,28,1,73
2839,-4.0752499999994525,3978.7368421052633,40,36,1,76
2840,-13.460499999999339,2005.4375,33,26,4,59
2841,10.185500000000996,3415.7894736842104,55,13,2,68
2842,-7.7239999999997995,2493.4210526315787,45,20,5,65
2843,7.739500000001014,2588.705882352941,61,13,2,74
2844,-12.924249999999319,3325.9,32,25,2,57
2845,-18.012499999999562,2686.6111111111113,36,30,7,66
2846,-18.371499999998896,2142.5263157894738,26,20,10,46
2847,1.0522500000007076,2064.1176470588234,41,35,4,76
2848,-3.7534999999990952,3000.4736842105262,52,21,1,73
2849,-10.997249999999145,2977.1052631578946,45,15,2,60
2850,-11.338999999999603,2564.0,36,17,1,53
2851,7.613500000001051,3507.684210526316,65,17,10,82
2852,1.7155000000023075,2539.294117647059,60,15,9,75
2853,17.069250000001613,2645.764705882353,58,17,4,75
2854,0.5305000000007902,2413.1666666666665,35,27,0,62
2855,14.159750000000788,3103.7,52,13,1,65
2856,-0.1147499999987387,3399.235294117647,54,15,1,69
2857,0.3405000000011557,2458.8125,43,26,2,69
2858,-6.458999999999548,2764.0526315789475,30,24,4,54
2859,11.206750000001005,2488.0,49,17,4,66
2860,7.620000000001147,2534.0666666666666,51,31,2,82
2861,-6.476249999999219,2700.5789473684213,38,18,3,56
2862,-25.2075,2012.2105263157894,27,26,10,53
2863,2.9225000000009658,3057.2631578947367,54,21,1,75
2864,-7.01849999999982,2690.9444444444443,44,38,6,82
2865,-5.152749999999373,2563.470588235294,49,24,2,73
2866,-3.8372499999987886,3167.6315789473683,42,23,4,65
2867,2.880500000000551,2612.8571428571427,43,26,4,69
2868,9.530250000001843,4681.5,65,25,4,90
2869,-12.916749999998888,3175.0,41,34,2,75
2870,-1.54674999999919,2196.875,58,26,6,84
2871,-1.609499999998358,4653.6,62,34,1,96
2872,-12.684749999999848,2412.294117647059,26,31,2,57
2873,-20.217500000000015,2082.4444444444443,37,28,14,65
2874,7.679500000001118,3209.3684210526317,53,16,2,69
2875,-3.789749999999542,2112.5625,36,23,3,59
2876,39.87100000000244,4896.105263157895,79,25,1,104
2877,-16.51324999999938,2123.0,36,26,3,62
2878,-24.931999999999558,1952.1052631578948,18,28,15,46
2879,-19.117249999999345,2705.2,29,25,2,54
2880,1.1552500000007415,2589.8125,49,25,3,74
2881,4.938250000001961,5173.6,78,16,1,94
2882,0.027000000001037704,2754.6666666666665,54,29,3,83
2883,-20.65050000000032,1429.0,22,35,2,57
2884,-31.395999999999578,1998.7894736842106,18,23,2,41
2885,-18.39324999999949,3450.222222222222,39,39,3,78
2886,-8.417999999999342,2580.9375,31,22,1,53
2887,3.0322500000010377,4472.7,60,20,1,80
2888,16.84275000000127,4433.8,68,18,0,86
2889,3.3702500000008633,2990.777777777778,54,14,5,68
2890,-11.253249999998948,3358.8947368421054,41,34,4,75
2891,5.910750000000739,3374.2,52,19,1,71
2892,6.094500000001932,3069.3888888888887,51,31,3,82
2893,8.712750000001474,4299.7,53,27,0,80
2894,-0.5094999999991631,3611.75,58,18,0,76
2895,15.8812500000009,4269.45,56,31,1,87
2896,-9.233999999999588,2425.5555555555557,48,23,5,71
2897,8.323500000001609,2400.5333333333333,64,29,1,93
2898,8.512000000001754,2409.1875,46,35,4,81
2899,-2.745999999998598,3926.157894736842,70,15,7,85
2900,-11.135249999998816,2477.4736842105262,34,20,5,54
2901,-7.28924999999896,2892.6,46,16,1,62
2902,23.423750000003075,2644.4375,85,12,3,97
2903,-25.657999999999213,2008.4,18,26,2,44
2904,12.029500000000905,3711.6,62,16,3,78
2905,5.133750000001299,4214.315789473684,61,34,0,95
2906,2.179500000000587,3100.1666666666665,65,30,3,95
2907,-3.7619999999984906,2720.0555555555557,49,34,2,83
2908,4.9605000000007715,3009.7894736842104,44,28,0,72
2909,12.267000000000769,3215.2631578947367,53,23,1,76
2910,-4.670749999999235,3358.9473684210525,45,29,2,74
2911,24.74000000000196,3256.2631578947367,55,25,2,80
2912,-1.6892499999990824,3048.9473684210525,50,17,2,67
2913,4.439750000001364,2469.6875,45,27,5,72
2914,1.859500000000827,2802.0,49,24,0,73
2915,-9.740999999999785,1950.0588235294117,35,23,2,58
2916,-24.469499999999748,2325.9444444444443,16,37,1,53
2917,-9.55749999999868,2963.294117647059,55,31,3,86
2918,9.371000000001164,2184.0625,48,22,2,70
2919,14.817250000000978,3049.8333333333335,51,21,1,72
2920,1.8740000000010457,3040.222222222222,43,26,2,69
2921,-11.220249999999274,2518.4736842105262,36,22,5,58
2922,-17.749499999999628,2592.7368421052633,31,30,1,61
2923,2.8715000000003803,2923.6,34,25,0,59
2924,0.21700000000042205,3159.2631578947367,55,28,3,83
2925,-29.292499999999485,1986.2631578947369,18,24,3,42
2926,-3.428249999999257,2465.277777777778,37,27,2,64
2927,28.434750000001127,2621.4375,87,14,6,101
2928,-5.125999999999584,4751.4,36,41,0,77
2929,0.8547500000003699,2551.3529411764707,50,27,0,77
2930,-4.59249999999904,2633.6470588235293,38,17,1,55
2931,-14.284749999999192,2763.733333333333,36,34,5,70
2932,4.178000000000401,2328.5,47,26,7,73
2933,-14.964749999999489,2002.157894736842,28,22,1,50
2934,-17.634999999998946,2903.1428571428573,32,30,2,62
2935,2.3567500000011785,3611.2105263157896,58,17,0,75
2936,-22.698249999999565,2495.842105263158,31,31,0,62
2937,-8.01524999999908,2473.1666666666665,35,22,4,57
2938,5.971750000000672,2393.375,60,33,0,93
2939,15.639750000000632,3016.4444444444443,54,25,1,79
2940,-0.8382499999991128,3283.85,49,17,0,66
2941,-6.509249999998923,2568.0,38,18,2,56
2942,27.90675000000109,2929.0625,73,21,0,94
2943,1.2590000000006032,2603.6666666666665,40,19,1,59
2944,4.317000000001043,3055.7368421052633,54,13,1,67
2945,34.1082500000013,2755.6875,78,16,2,94
2946,9.540250000001498,2856.8333333333335,51,20,3,71
2947,32.96950000000154,4945.75,79,13,0,92
2948,17.214500000001244,4090.1,65,20,0,85
2949,8.746250000001801,3051.8823529411766,70,17,4,87
2950,-13.281749999999615,2251.777777777778,34,22,5,56
2951,-10.120499999999488,2057.2631578947367,29,20,2,49
2952,9.296999999999898,2387.0588235294117,47,34,0,81
2953,25.263750000000954,3764.157894736842,61,18,0,79
2954,15.51800000000093,3843.4736842105262,77,25,2,102
2955,-23.44999999999933,2102.9,25,26,1,51
2956,-12.066749999998747,2491.7368421052633,38,20,2,58
2957,21.943750000002215,2673.764705882353,65,19,2,84
2958,-10.254749999999385,2612.1176470588234,32,19,2,51
2959,-21.304749999999512,2012.4,21,24,0,45
2960,-12.160999999999648,2020.3,23,20,2,43
2961,5.786250000000817,3238.6111111111113,69,19,0,88
2962,18.464250000001602,3593.35,65,15,2,80
2963,1.3910000000004061,2387.0,47,23,1,70
2964,-27.110500000000236,2034.7368421052631,22,27,13,49
2965,23.65975000000202,5264.95,89,6,0,95
2966,13.990750000001347,4282.9473684210525,85,21,0,106
2967,-16.902999999999675,2017.2941176470588,18,32,3,50
2968,-18.111249999998883,2310.9444444444443,40,19,3,59
2969,-9.871499999999234,3693.35,49,33,1,82
2970,7.2645000000014885,3071.6315789473683,62,12,2,74
2971,2.706000000000164,1830.8125,42,24,6,66
2972,22.33700000000136,4186.95,61,25,3,86
2973,13.78200000000073,2425.4117647058824,56,23,5,79
2974,-18.332999999999217,2552.25,36,18,2,54
2975,11.342000000002445,2477.5555555555557,60,23,2,83
2976,-22.12399999999973,2124.0,19,29,5,48
2977,-9.186499999999516,2123.5,35,21,4,56
2978,7.85575000000099,2375.4375,59,39,3,98
2979,8.740250000001613,2955.875,73,22,0,95
2980,13.500000000000819,3485.0,62,23,2,85
2981,-22.05874999999984,1979.4736842105262,28,25,5,53
2982,-11.361749999999414,2537.0666666666666,38,26,2,64
2983,-24.53374999999965,2198.8888888888887,36,36,2,72
2984,-2.603749999999554,2439.235294117647,36,22,3,58
2985,-14.35474999999984,2067.85,24,23,1,47
2986,-0.9217499999992252,2236.8888888888887,32,28,0,60
2987,-2.0977499999999503,2556.0,50,30,3,80
2988,0.959000000001122,3131.45,45,23,0,68
2989,6.487500000000883,4487.9,56,24,1,80
2990,14.72900000000109,2987.222222222222,66,20,1,86
2991,-13.925999999999323,2560.923076923077,30,28,2,58
2992,24.10325000000107,3749.842105263158,63,32,1,95
2993,-6.115749999999032,3248.714285714286,46,21,1,67
2994,14.204500000000612,3067.764705882353,60,23,3,83
2995,-6.103249999999035,3125.0526315789475,56,14,1,70
2996,12.409750000001047,4714.05,62,20,0,82
2997,-3.1009999999996776,2518.375,37,25,1,62
2998,3.3242500000019732,3541.0526315789475,47,28,3,75
2999,-4.357999999999129,2518.375,37,21,1,58
3000,-3.6312499999991408,2884.2631578947367,49,21,1,70
3001,-20.028999999999296,3395.6315789473683,29,30,5,59
3002,6.618750000000597,3964.05,51,22,0,73
3003,50.61950000000161,5545.8,98,17,0,115
3004,5.282250000001926,4023.65,69,14,0,83
3005,-2.0607499999990786,3335.4736842105262,44,30,3,74
3006,7.726750000000896,2679.125,52,31,0,83
3007,16.293750000001502,2936.176470588235,54,24,1,78
3008,-16.044749999998803,3068.5555555555557,45,23,0,68
3009,-8.411999999999303,2748.733333333333,32,23,1,55
3010,13.978500000000945,4498.2,58,31,0,89
3011,-13.557249999999433,3120.35,34,28,0,62
3012,-26.784499999999646,1429.0,20,32,6,52
3013,-14.541999999999508,1952.8125,32,24,5,56
3014,-2.365499999999461,2670.25,55,37,2,92
3015,31.583000000002237,4930.1,87,14,2,101
3016,-11.376249999998835,2677.153846153846,48,27,6,75
3017,17.420750000001437,2842.8125,56,28,1,84
3018,3.049250000000961,3027.4210526315787,45,21,3,66
3019,-2.9589999999989156,2561.785714285714,40,23,0,63
3020,-1.9107499999990807,3651.315789473684,52,22,0,74
3021,-16.706749999999673,2174.1666666666665,24,31,0,55
3022,-12.757249999998722,3439.35,40,35,0,75
3023,2.384750000001545,4183.05,46,37,2,83
3024,3.098750000001211,4078.2631578947367,63,23,4,86
3025,-7.030999999998949,2631.5833333333335,44,31,2,75
3026,15.812750000000932,3631.45,51,20,0,71
3027,5.780500000002095,2450.529411764706,53,21,0,74
3028,10.944000000000733,2840.9444444444443,42,27,6,69
3029,-8.91349999999862,3674.684210526316,43,36,0,79
3030,20.601000000001665,5364.85,67,31,2,98
3031,-19.030249999999675,2044.15,19,32,0,51
3032,28.88575000000218,4958.6,78,29,0,107
3033,-11.65099999999869,3757.65,37,40,2,77
3034,2.618750000001123,3235.6,45,21,0,66
3035,-18.81824999999948,2024.3,23,17,7,40
3036,17.169000000001247,3244.3,46,22,2,68
3037,6.158250000000863,3848.95,44,24,1,68
3038,-16.498499999999915,1950.0588235294117,21,34,0,55
3039,20.656000000001292,4832.3,52,36,0,88
3040,2.227750000000902,2465.1111111111113,54,27,0,81
3041,-22.058249999999795,1959.5263157894738,23,26,7,49
3042,-3.449749999999227,2954.823529411765,40,30,0,70
3043,35.69175000000147,1974.6875,58,23,1,81
3044,-7.567249999999108,2968.7894736842104,46,19,3,65
3045,10.499250000002055,1925.3333333333333,63,19,0,82
3046,5.505250000001444,4288.6,54,36,0,90
3047,11.730500000001125,4382.15,64,19,1,83
3048,8.82025000000128,3861.842105263158,46,30,8,76
3049,3.0700000000006042,4420.35,57,25,0,82
3050,-14.246749999999357,2103.625,35,26,1,61
3051,30.848000000001168,4229.95,53,22,2,75
3052,5.869000000001048,3159.3,39,27,1,66
3053,2.0137500000007043,2598.75,54,28,0,82
3054,12.328250000001209,4368.05,50,30,0,80
3055,-7.731749999998859,3625.5625,46,23,1,69
3056,-6.386999999999576,1907.1875,43,30,6,73
3057,-11.206249999998843,2973.4,39,26,0,65
3058,16.94225000000157,4097.3,63,27,0,90
3059,26.608500000001122,3184.4117647058824,86,28,1,114
3060,-17.449249999999502,2028.25,21,19,5,40
3061,-2.446249999998872,2782.0588235294117,42,40,2,82
3062,-1.3572499999990026,3083.8,42,31,1,73
3063,1.7175000000008889,3836.684210526316,63,27,0,90
3064,-1.9224999999990593,3983.9,39,37,0,76
3065,26.645750000002106,5226.8,82,27,2,109
3066,14.525500000001546,2444.875,54,19,2,73
3067,-9.622249999999475,2616.8823529411766,31,28,0,59
3068,-5.867499999998823,2676.5833333333335,51,25,4,76
3069,4.509500000001056,2467.2,40,28,1,68
3070,6.07225000000114,4339.4,47,30,3,77
3071,42.599250000002115,5052.1,71,22,4,93
3072,-10.875249999999271,2694.4285714285716,28,30,1,58
3073,-1.256499999998545,2781.714285714286,46,33,2,79
3074,-2.852999999999361,3498.05,38,24,5,62
3075,-13.823749999999418,2062.9375,24,39,1,63
3076,8.568000000001852,4627.105263157895,69,33,3,102
3077,-17.32774999999903,2860.157894736842,30,32,3,62
3078,3.941000000001227,4799.7,54,28,0,82
3079,-1.8037499999990012,2505.3333333333335,55,33,1,88
3080,-29.585500000000412,1974.578947368421,16,24,19,40
3081,-16.351499999999643,2595.75,31,24,1,55
3082,-25.0832499999998,1967.0526315789473,16,29,3,45
3083,-18.461499999999432,2340.0,28,37,3,65
3084,-3.1387499999988524,3177.0588235294117,58,26,2,84
3085,9.928250000001466,3789.8947368421054,60,28,1,88
3086,-15.077749999999474,3515.1052631578946,39,35,2,74
3087,1.8040000000007421,3695.75,40,32,0,72
3088,1.592250000000731,2871.8333333333335,46,23,3,69
3089,24.445500000001008,4276.7,59,26,0,85
3090,13.73425000000139,4443.3,63,21,1,84
3091,5.412250000000691,2991.625,47,23,2,70
3092,-27.365249999999385,2307.0526315789475,24,29,2,53
3093,15.498250000001377,2542.9411764705883,64,24,4,88
3094,-1.4099999999985695,3808.4210526315787,57,22,2,79
3095,-8.509249999998787,1482.5625,30,28,3,58
3096,5.927750000000851,3128.3,44,21,1,65
3097,-27.16974999999939,2233.277777777778,24,26,5,50
3098,-17.64199999999942,2064.8947368421054,28,22,1,50
3099,7.174500000001103,3861.7894736842104,55,25,1,80
3100,4.57000000000045,3460.6666666666665,57,29,6,86
3101,11.86825000000158,2101.0666666666666,89,36,0,125
3102,4.510750000000899,3146.6,43,16,2,59
3103,-11.412249999998943,2052.0625,38,33,6,71
3104,14.57575000000098,4350.5,53,23,1,76
3105,1.0915000000016741,3945.05,50,32,1,82
3106,12.269500000001033,3514.3684210526317,62,22,6,84
3107,10.899250000002365,4555.210526315789,77,32,6,109
3108,8.274500000001426,3016.470588235294,62,32,4,94
3109,7.5387500000005145,4521.95,55,23,0,78
3110,28.701000000001056,4356.9,63,23,0,86
3111,-12.95624999999924,2361.277777777778,23,29,1,52
3112,-19.78550000000041,1429.0,28,41,8,69
3113,-18.110249999998892,2920.4,33,32,1,65
3114,16.03325000000192,3322.3888888888887,62,13,1,75
3115,-5.456499999999377,2567.9,30,27,0,57
3116,-0.027749999998846687,2189.315789473684,29,34,4,63
3117,-12.407249999999616,2913.5789473684213,34,40,1,74
3118,6.562750000000555,2478.6875,74,21,1,95
3119,3.963750000001378,4013.25,69,23,0,92
3120,-1.9149999999989955,3215.157894736842,36,31,1,67
3121,-16.998249999999107,2500.5,31,27,1,58
3122,-24.82274999999975,2036.25,21,27,3,48
3123,18.585250000001658,2432.8823529411766,52,26,0,78
3124,8.153250000000648,2950.5789473684213,45,23,0,68
3125,-24.96074999999984,2185.157894736842,12,30,7,42
3126,-0.9902499999992698,3733.2105263157896,44,38,0,82
3127,6.8502500000015925,2998.705882352941,59,26,0,85
3128,-21.64799999999912,2024.3,23,25,2,48
3129,-19.78524999999943,1919.235294117647,25,30,1,55
3130,-8.362749999999497,4960.85,45,44,0,89
3131,10.832250000000919,3238.6111111111113,54,26,2,80
3132,29.905000000002342,4353.0,76,25,0,101
3133,2.87200000000059,2500.5625,47,23,1,70
3134,17.377250000001407,3901.157894736842,57,30,0,87
3135,-21.143749999998906,2630.0,36,19,4,55
3136,38.00325000000262,5041.526315789473,85,17,0,102
3137,5.728000000001288,2633.4375,57,17,1,74
3138,-19.477999999999437,2013.7894736842106,24,26,4,50
3139,-2.20424999999945,3404.842105263158,37,31,4,68
3140,7.96250000000189,4157.65,63,27,3,90
3141,23.55975000000152,2887.375,69,23,1,92
3142,36.827500000002615,3219.8823529411766,79,16,3,95
3143,-14.144999999999943,1955.4444444444443,32,28,6,60
3144,-20.326999999999536,2624.3529411764707,29,25,2,54
3145,-4.2577499999995245,2548.15,29,29,1,58
3146,1.9260000000011803,3749.7,50,24,2,74
3147,15.045250000001095,3021.375,62,32,8,94
3148,18.574750000000954,2780.176470588235,47,23,2,70
3149,8.22925000000157,4343.3,61,29,0,90
3150,-26.945249999998918,2018.7894736842106,25,22,5,47
3151,-16.782499999999224,3196.7894736842104,38,39,3,77
3152,-15.802999999999079,2564.0,28,26,1,54
3153,-0.16749999999831813,3901.45,52,28,2,80
3154,-11.451999999999495,2770.25,34,25,0,59
3155,-18.06274999999917,2857.6111111111113,32,34,4,66
3156,18.903250000002096,3559.823529411765,74,19,0,93
3157,4.144750000001384,3988.55,51,30,2,81
3158,20.368250000001627,2481.9444444444443,53,22,3,75
3159,-1.8817499999991543,3159.15,39,22,1,61
3160,-28.041250000000208,1429.0,4,32,10,36
3161,9.623000000001944,4204.4,69,13,2,82
3162,-24.58549999999985,1830.2777777777778,17,33,2,50
3163,-9.80924999999927,2648.3333333333335,35,24,2,59
3164,14.785250000001142,4649.05,68,29,1,97
3165,-12.39674999999881,2751.235294117647,43,31,3,74
3166,-4.878749999997547,1883.8235294117646,44,29,8,73
3167,14.041750000001226,3754.45,47,34,0,81
3168,15.813500000001355,3704.7894736842104,62,29,3,91
3169,-13.232999999999333,3835.4,44,26,1,70
3170,-10.145249999999205,2893.4375,36,31,2,67
3171,-6.506249999998966,2030.2941176470588,43,20,8,63
3172,18.739250000001405,4383.9,68,17,1,85
3173,-8.853499999999125,3760.05,46,31,0,77
3174,-26.027749999999696,2008.45,18,27,0,45
3175,6.723500000001183,4048.2,51,30,4,81
3176,5.622000000000708,2719.133333333333,42,33,4,75
3177,11.073000000000945,2511.222222222222,41,22,7,63
3178,12.524500000000549,3055.222222222222,53,31,5,84
3179,1.019500000001877,3440.8947368421054,56,28,3,84
3180,-2.7239999999987448,3143.375,67,19,0,86
3181,-26.426749999999817,2040.1,17,25,0,42
3182,22.808250000000562,4198.578947368421,74,28,2,102
3183,23.957750000001607,4256.263157894737,79,26,2,105
3184,-14.698749999998972,2058.9375,30,32,8,62
3185,-10.666249999999604,4567.2,56,27,3,83
3186,-14.734249999999667,2209.4166666666665,23,23,3,46
3187,13.5060000000009,3767.1,50,28,0,78
3188,2.836000000000283,3301.2105263157896,48,20,4,68
3189,-21.092249999999588,1891.235294117647,26,24,3,50
3190,21.167750000002354,3127.470588235294,64,32,1,96
3191,18.580000000002407,3430.9411764705883,76,24,1,100
3192,12.481000000001051,3421.0555555555557,62,28,2,90
3193,-9.469749999999715,2429.1111111111113,36,28,2,64
3194,-10.443999999999518,2027.0,33,23,4,56
3195,-0.30199999999970545,2782.0588235294117,53,33,8,86
3196,1.3255000000015735,3683.75,54,21,0,75
3197,-21.243999999999595,2126.6111111111113,24,25,2,49
3198,-26.630499999999607,1962.0526315789473,17,31,4,48
3199,-23.6069999999995,2028.25,22,20,3,42
3200,-7.195249999999139,2163.0,41,32,2,73
3201,-1.280749999998964,2905.222222222222,49,29,1,78
3202,-25.581749999999595,2251.25,25,14,7,39
3203,6.649000000001713,3929.8,63,21,1,84
3204,-11.456999999999487,1954.7058823529412,42,22,8,64
3205,18.4540000000015,4283.9,62,24,3,86
3206,9.736000000001217,3635.65,55,28,0,83
3207,27.38000000000133,4044.6666666666665,77,20,10,97
3208,15.109250000001797,3305.823529411765,66,30,3,96
3209,-6.624249999999174,2986.3684210526317,41,30,0,71
3210,12.741000000000595,2722.6666666666665,45,26,0,71
3211,-16.006249999999532,2114.0526315789475,26,23,1,49
3212,-22.449499999999947,1975.0,25,36,2,61
3213,-1.20124999999911,2764.1052631578946,39,25,2,64
3214,16.11525000000085,2848.0,44,23,2,67
3215,16.605750000000995,2472.0,47,23,2,70
3216,-10.227499999998054,1978.5625,46,32,3,78
3217,6.756250000000908,4000.5263157894738,62,33,2,95
3218,-26.468499999999096,2791.8,33,24,3,57
3219,-0.21799999999843145,3965.3333333333335,56,32,4,88
3220,-3.1872499999990884,3083.85,47,21,0,68
3221,15.919000000001109,4719.65,63,21,0,84
3222,21.484250000001758,2454.9375,58,27,1,85
3223,-9.068499999999183,4376.65,39,35,1,74
3224,-24.877499999999245,2440.842105263158,32,22,3,54
3225,-23.525499999999724,1980.4736842105262,22,19,5,41
3226,-29.351500000000016,1429.0,15,30,7,45
3227,9.23350000000129,3933.8,56,20,0,76
3228,5.414000000000992,3315.55,43,30,0,73
3229,-11.01274999999921,2571.85,34,23,0,57
3230,-10.8204999999991,2592.3333333333335,31,25,5,56
3231,3.2645000000009574,4009.2,47,23,3,70
3232,6.010500000000983,3608.4,42,35,4,77
3233,-18.030999999999295,2309.2,25,33,1,58
3234,-20.301749999999224,2722.470588235294,32,20,2,52
3235,-10.078249999999487,2477.6470588235293,55,23,8,78
3236,30.661750000001177,5385.45,67,32,4,99
3237,-31.465750000000156,2168.8888888888887,20,36,10,56
3238,-13.849249999999127,2488.222222222222,30,34,4,64
3239,8.35875000000122,3927.45,50,31,0,81
3240,-29.752749999999946,1429.0,3,29,3,32
3241,-7.177749999999311,1429.0,36,35,8,71
3242,2.549500000001593,2854.2631578947367,63,18,3,81
3243,0.9897500000017544,2735.6875,57,19,1,76
3244,-25.27724999999956,2254.4736842105262,24,23,8,47
3245,-3.7282499999992624,2378.6470588235293,40,26,0,66
3246,-16.13574999999918,2755.25,41,17,2,58
3247,10.131500000000731,3229.0555555555557,54,25,10,79
3248,-0.26274999999876086,3673.5,51,28,1,79
3249,-26.287749999999864,2013.6470588235295,24,33,9,57
3250,-10.783499999999279,3275.9,29,30,4,59
3251,-25.131749999999677,2049.7368421052633,23,28,15,51
3252,11.744250000001271,4399.7,58,34,0,92
3253,-4.107999999999491,2628.7894736842104,28,32,4,60
3254,-6.315249999999379,2736.25,30,24,2,54
3255,21.576000000001642,4513.15,61,24,4,85
3256,0.7482500000006318,3131.6,43,26,0,69
3257,2.3337500000008973,2576.9375,54,18,3,72
3258,10.682000000001972,3703.9473684210525,74,19,6,93
3259,17.123250000001363,3641.315789473684,62,23,5,85
3260,-6.497499999999453,3383.1052631578946,35,30,4,65
3261,-2.2459999999990266,3087.7,41,20,2,61
3262,-0.09924999999828499,3425.8947368421054,64,14,5,78
3263,-10.81049999999929,2799.764705882353,37,28,1,65
3264,-6.368999999999195,3121.6315789473683,43,30,2,73
3265,22.557250000002355,4608.45,69,18,2,87
3266,13.874750000000898,4073.6,51,19,5,70
3267,-18.911749999999056,3149.8823529411766,42,25,5,67
3268,-5.855749999999651,2455.8125,35,37,3,72
3269,-16.581999999999823,2543.722222222222,33,30,2,63
3270,-0.9064999999991012,2457.6666666666665,50,30,1,80
3271,11.51175000000163,4528.35,67,14,1,81
3272,15.573750000002136,3858.55,64,17,7,81
3273,5.422750000000677,5481.45,52,38,2,90
3274,26.586250000001883,4941.75,76,24,2,100
3275,-9.898749999999378,2143.294117647059,30,35,2,65
3276,0.776750000000816,3425.7368421052633,46,28,3,74
3277,7.224500000001721,3127.5,50,28,2,78
3278,-2.5259999999992715,3201.25,40,27,0,67
3279,-12.407499999999713,2966.2631578947367,40,29,3,69
3280,21.156750000001185,4642.263157894737,80,19,0,99
3281,11.576250000001393,4957.65,67,22,1,89
3282,-30.303999999999757,1429.0,16,36,12,52
3283,-21.972749999998836,2389.0,26,33,2,59
3284,-18.211249999999655,2628.7894736842104,36,20,11,56
3285,12.043750000001186,4103.6,53,22,0,75
3286,-10.110999999999235,1773.375,35,30,3,65
3287,-12.29799999999966,2615.823529411765,38,35,1,73
3288,-4.905499999999548,2572.0,34,24,3,58
3289,-8.124499999998841,3201.8947368421054,42,29,1,71
3290,0.6712500000006495,2816.1111111111113,47,20,2,67
3291,-8.583749999999133,2544.25,27,30,4,57
3292,18.53975000000099,3912.55,56,21,0,77
3293,11.795000000001135,3878.777777777778,58,54,2,112
3294,-0.169749999998964,3340.1111111111113,50,31,0,81
3295,24.776750000002234,4152.578947368421,77,25,1,102
3296,4.3850000000010105,3619.6666666666665,51,26,0,77
3297,-28.683249999999664,1967.0,21,26,3,47
3298,-6.681999999999118,2103.6875,28,24,4,52
3299,7.394750000001741,2075.1176470588234,47,24,2,71
3300,0.584750000000725,2988.0526315789475,45,22,1,67
3301,7.277000000001476,2316.0,46,23,3,69
3302,18.557249999999915,2201.9375,46,23,7,69
3303,0.6747500000007209,3189.315789473684,47,20,3,67
3304,-34.478999999999985,1429.0,3,28,3,31
3305,11.650000000000322,2371.5,57,26,6,83
3306,-0.7242499999989424,3422.8888888888887,52,32,2,84
3307,6.4422500000014535,3751.35,58,24,0,82
3308,22.62800000000144,4214.9,68,19,2,87
3309,-2.724499999999289,3375.1,37,31,1,68
3310,-10.518999999999636,2048.15,25,25,0,50
3311,9.163750000001585,4083.2631578947367,59,33,1,92
3312,-18.161249999999896,2484.2631578947367,33,30,14,63
3313,-24.93924999999973,1949.388888888889,23,30,5,53
3314,20.10175000000129,3952.0526315789475,69,33,1,102
3315,-11.583499999999432,2476.0,35,32,4,67
3316,3.9310000000007994,2280.8333333333335,38,34,4,72
3317,19.842250000001844,4766.35,60,39,2,99
3318,-3.9947499999994873,2685.45,27,28,0,55
3319,-27.386499999999096,2020.25,24,24,2,48
3320,-8.950749999998989,2742.45,37,26,4,63
3321,-21.37274999999985,1895.8823529411766,22,28,10,50
3322,-2.596749999998939,3068.1,45,20,1,65
3323,-10.653749999999182,2913.733333333333,38,25,2,63
3324,3.1960000000005135,1826.875,47,31,3,78
3325,18.473000000000795,4655.4,60,23,0,83
3326,10.512750000002097,1760.4375,57,25,0,82
3327,3.5055000000008243,2114.3529411764707,31,26,3,57
3328,-13.677999999999662,2606.157894736842,25,27,3,52
3329,4.450750000000869,2481.5625,38,29,1,67
3330,4.333250000000866,3050.684210526316,40,24,1,64
3331,-10.740249999999074,2771.15,32,29,0,61
3332,-5.471749999999141,3083.85,38,21,0,59
3333,-18.081749999999907,2516.3888888888887,35,42,3,77
3334,-0.4614999999992898,3310.0555555555557,47,29,1,76
3335,9.972500000000538,2996.4736842105262,44,20,3,64
3336,-6.927249999999406,2487.277777777778,29,32,1,61
3337,0.8622500000002372,2390.823529411765,46,23,2,69
3338,-20.298749999999238,2166.125,39,31,9,70
3339,5.491250000002512,4868.7,79,16,0,95
3340,-27.603749999999557,2013.842105263158,15,23,5,38
3341,-22.761749999999243,2322.4444444444443,25,31,2,56
3342,-18.36999999999981,1914.6470588235295,39,34,21,73
3343,-0.4017499999984954,3087.85,47,25,0,72
3344,-0.9602499999992729,2729.95,34,27,0,61
3345,33.36600000000198,4558.4,82,15,0,97
3346,-0.21149999999896849,2759.375,52,26,2,78
3347,8.070250000001154,4059.3,43,33,1,76
3348,-8.723749999999535,3095.722222222222,40,26,0,66
3349,44.65875000000382,5678.3,102,20,1,122
3350,-7.391249999998877,2567.294117647059,31,31,1,62
3351,9.401250000000484,3648.2,49,18,0,67
3352,15.814500000001393,4116.45,63,28,2,91
3353,-5.750249999999097,3376.7,41,22,0,63
3354,-5.868999999998683,3008.4,47,17,4,64
3355,9.027250000000402,2925.5555555555557,40,36,7,76
3356,-10.514249999998885,1892.1764705882354,33,28,2,61
3357,-38.426749999999984,1429.0,0,27,6,27
3358,5.797750000000363,2724.6923076923076,44,30,5,74
3359,2.502250000000726,3728.2105263157896,59,23,2,82
3360,-13.23449999999938,1931.4117647058824,36,24,1,60
3361,18.240250000001613,4833.8,64,18,3,82
3362,-11.302249999999635,2063.9411764705883,36,27,10,63
3363,-5.254749999999698,2328.5,37,17,7,54
3364,9.150000000001025,3494.15,45,26,1,71
3365,-1.0664999999983429,3087.85,48,22,0,70
3366,1.911750000001104,2938.6666666666665,45,34,3,79
3367,-1.3547499999990866,2674.6153846153848,31,33,0,64
3368,1.205250000000594,2049.8333333333335,38,24,1,62
3369,-11.60874999999914,2485.8947368421054,29,28,0,57
3370,-16.666499999999548,2159.222222222222,38,33,1,71
3371,-29.964249999999662,2024.2777777777778,21,35,1,56
3372,7.806750000001337,4283.0,59,28,0,87
3373,20.696750000002165,4981.4,83,20,1,103
3374,-10.45199999999901,2680.3888888888887,47,28,2,75
3375,-19.366500000000283,1759.375,22,41,4,63
3376,22.342250000000917,2978.0588235294117,82,23,3,105
3377,20.54125000000081,4735.4,61,25,1,86
3378,20.687500000001286,4313.0,66,19,5,85
3379,15.756500000001244,4165.9473684210525,61,28,0,89
3380,1.801250000000777,2294.6470588235293,38,26,0,64
3381,19.04025000000049,3017.3529411764707,55,26,0,81
3382,6.991500000000779,3607.0,44,23,2,67
3383,-5.830999999999687,1837.0588235294117,26,30,1,56
3384,3.514000000000941,3174.3,47,26,0,73
3385,21.192500000002568,4571.9,82,12,3,94
3386,-2.211499999999605,3027.55,32,31,0,63
3387,26.22475000000087,3304.722222222222,66,25,1,91
3388,6.888500000001665,3318.7,54,17,1,71
3389,-0.38374999999784976,2608.294117647059,62,31,2,93
3390,10.074000000000456,2744.5882352941176,34,28,3,62
3391,-8.95799999999853,2238.5625,42,35,1,77
3392,13.745250000001036,3179.4444444444443,54,27,1,81
3393,-3.5617499999987237,2659.222222222222,34,37,2,71
3394,23.828250000001244,4319.65,71,19,1,90
3395,16.78900000000139,3809.2,55,23,0,78
3396,5.224250000001268,4984.65,45,35,3,80
3397,-5.32299999999927,2751.3571428571427,32,33,3,65
3398,-1.7844999999992996,2258.8888888888887,33,32,1,65
3399,-3.5917499999988336,2755.133333333333,41,22,4,63
3400,-25.614499999999726,1995.421052631579,22,27,1,49
3401,7.256000000001502,4328.3,58,30,0,88
3402,10.236750000002411,4148.15,61,21,5,82
3403,-9.705749999998982,2576.157894736842,34,25,0,59
3404,-25.960749999999603,2040.1,23,24,0,47
3405,-19.837249999999376,2852.684210526316,35,37,8,72
3406,5.463250000001086,3413.2105263157896,53,28,3,81
3407,10.237250000001076,2640.3076923076924,47,21,0,68
3408,-13.968249999999248,2952.8947368421054,39,27,6,66
3409,-4.905749999999022,2561.785714285714,44,31,0,75
3410,24.16000000000199,3212.75,64,24,0,88
3411,-12.034749999999828,1764.375,33,32,8,65
3412,-9.618999999998977,3037.153846153846,34,31,0,65
3413,-16.395749999999616,2163.95,24,26,1,50
3414,-17.460999999999867,2008.8823529411766,30,29,0,59
3415,10.211250000000716,3830.7,58,19,0,77
3416,-27.707250000000062,1429.0,20,40,3,60
3417,-13.448749999999938,1966.9411764705883,27,34,5,61
3418,9.367500000001874,3923.5263157894738,68,23,1,91
3419,-22.33374999999935,2503.4736842105262,32,24,7,56
3420,-9.419249999999076,2076.875,39,24,4,63
3421,-6.25374999999898,2657.0714285714284,49,23,1,72
3422,12.947750000000772,3354.9444444444443,48,27,0,75
3423,10.139750000001342,4268.1,59,26,2,85
3424,-13.058500000000418,1924.6666666666667,37,28,3,65
3425,15.61325000000125,4542.6,61,27,0,88
3426,33.495000000001106,4814.7,74,17,1,91
3427,-1.0229999999991335,3160.3125,59,19,4,78
3428,-5.2259999999989475,2912.3333333333335,59,21,4,80
3429,12.715750000002467,3891.8,72,19,1,91
3430,10.264250000002248,4633.05,71,28,0,99
3431,-13.499500000000207,2059.3529411764707,26,45,1,71
3432,5.064000000001185,2791.25,56,19,0,75
3433,10.514000000003556,3003.470588235294,78,21,5,99
3434,-4.652249999999151,2571.1176470588234,35,32,1,67
3435,-21.890249999999426,2047.1764705882354,47,32,15,79
3436,8.233750000001415,3057.315789473684,46,24,1,70
3437,-0.8717499999999649,2532.277777777778,42,34,1,76
3438,-13.45524999999995,1955.5,27,27,1,54
3439,4.578500000001541,2915.6470588235293,60,20,2,80
3440,13.490000000000979,2103.6875,47,24,4,71
3441,-10.852249999998966,3032.25,39,23,0,62
3442,8.422999999999979,2268.3125,51,27,0,78
3443,-15.801999999999342,2205.9444444444443,30,32,3,62
3444,12.06125000000121,4488.315789473684,66,27,4,93
3445,2.2950000000014197,2412.133333333333,73,18,1,91
3446,8.393750000001,3452.85,50,29,0,79
3447,-21.427999999999926,2045.235294117647,29,23,9,52
3448,0.4352500000015668,2453.777777777778,47,20,1,67
3449,-14.104749999999077,2745.705882352941,36,16,3,52
3450,-5.108999999999552,2786.1666666666665,45,19,1,64
3451,-3.5067499999992107,3463.2631578947367,35,36,3,71
3452,-19.99374999999896,2647.35,34,25,4,59
3453,1.9350000000010739,2106.0,54,33,3,87
3454,-1.0524999999991962,3252.9,45,23,0,68
3455,15.608250000000606,3395.7368421052633,67,21,5,88
3456,-3.930749999999427,2629.2,47,31,4,78
3457,-15.100249999999676,2520.6666666666665,32,23,4,55
3458,-10.800749999998756,3060.1,47,20,3,67
3459,-6.310249999999719,2708.6,35,17,2,52
3460,14.941250000000178,2321.875,53,30,2,83
3461,3.6935000000010616,3410.684210526316,56,17,3,73
3462,0.8865000000014073,4563.15,62,17,2,79
3463,2.677250000000633,3043.9473684210525,45,28,2,73
3464,-7.62824999999921,2527.684210526316,37,21,0,58
3465,5.270750000000893,3210.85,47,25,2,72
3466,9.711000000000901,3891.1052631578946,50,40,0,90
3467,-19.835749999999702,1952.7222222222222,22,27,1,49
3468,0.3177500000006446,2473.6875,44,33,3,77
3469,6.697500000001154,3487.5789473684213,57,17,2,74
3470,-16.34824999999939,2649.0,39,33,13,72
3471,14.716750000001923,4178.3,64,18,1,82
3472,-2.8202499999993917,2528.3,34,20,2,54
3473,11.99275000000186,2539.294117647059,59,27,0,86
3474,22.639000000001516,2320.9375,60,18,1,78
3475,-35.52374999999977,2008.5,16,21,8,37
3476,7.66100000000125,4320.35,62,31,1,93
3477,7.705250000000954,2435.6470588235293,57,21,1,78
3478,-8.036499999999153,1906.2222222222222,23,26,10,49
3479,-9.303999999998805,4394.95,63,34,2,97
3480,-6.347999999999425,2480.9473684210525,33,24,5,57
3481,24.280500000001442,4742.55,84,21,3,105
3482,21.046750000000664,2514.4375,62,23,13,85
3483,-16.05999999999861,4067.95,48,15,8,63
3484,-10.2977500000001,1959.0,42,24,4,66
3485,-13.448499999999118,3068.8,38,24,1,62
3486,8.168500000001721,2317.8571428571427,42,18,11,60
3487,1.413250000001281,2910.764705882353,52,22,1,74
3488,-1.1877499999987793,3117.3684210526317,50,19,9,69
3489,12.451250000001119,3782.5789473684213,56,19,2,75
3490,11.005750000000706,2866.3888888888887,48,27,2,75
3491,8.383750000000319,2509.470588235294,60,24,6,84
3492,-13.369249999999335,2506.842105263158,37,21,3,58
3493,0.015750000000567345,2619.625,37,26,2,63
3494,3.486250000000812,2753.0,51,19,5,70
3495,32.67325000000254,2884.4375,87,14,0,101
3496,-5.393499999999575,2008.375,41,24,1,65
3497,17.086000000001928,4672.85,74,20,0,94
3498,1.5007500000012306,3403.7,47,21,1,68
3499,13.369000000001893,4362.6,59,27,2,86
3500,-7.531749999999822,2744.95,24,23,3,47
3501,0.25850000000053386,2836.4444444444443,51,23,3,74
3502,2.1557500000010377,4446.55,55,28,3,83
3503,-2.731249999999279,3598.7894736842104,49,27,0,76
3504,6.281000000001287,2014.375,61,23,4,84
3505,-6.1947499999988676,2221.823529411765,37,23,2,60
3506,16.51250000000059,2019.4,59,27,1,86
3507,14.404500000002452,5028.4,71,30,3,101
3508,13.903750000001045,4220.4,55,23,0,78
3509,30.450000000002014,2678.125,63,24,0,87
3510,29.816750000001786,3447.6666666666665,70,20,0,90
3511,21.789500000000846,2554.0625,68,35,4,103
3512,28.968250000001525,4664.85,78,17,6,95
3513,7.3147500000019745,4872.7,62,39,0,101
3514,19.02000000000189,4924.25,73,25,1,98
3515,10.370000000000879,3090.5,56,16,3,72
3516,-13.296749999999253,2009.3125,38,30,2,68
3517,-16.522750000000023,2928.6315789473683,36,37,3,73
3518,-6.522999999998907,2500.842105263158,42,28,3,70
3519,9.694250000001194,3605.25,54,23,1,77
3520,-4.258749999999506,2836.3529411764707,37,22,2,59
3521,15.40875000000079,3009.375,53,22,1,75
3522,-16.246749999998805,2634.5789473684213,38,21,2,59
3523,2.547500000001158,3107.75,52,20,4,72
3524,-4.8152499999992155,3812.45,47,17,1,64
3525,-9.02625,2510.1666666666665,46,22,7,68
3526,-6.817999999999065,2401.777777777778,45,21,6,66
3527,20.371000000001168,2262.4375,45,36,2,81
3528,17.612500000001724,4290.25,73,14,0,87
3529,-1.6179999999995858,2478.4444444444443,49,30,8,79
3530,-20.08249999999955,2028.25,20,27,2,47
3531,-3.301749999999553,2820.0,35,23,1,58
3532,11.880500000000234,2756.823529411765,52,19,4,71
3533,-2.2564999999987334,2818.8333333333335,46,27,0,73
3534,24.892750000000966,4241.05,65,21,1,86
3535,-25.85099999999988,1429.0,15,32,7,47
3536,-13.067999999998653,2868.6315789473683,45,25,1,70
3537,-0.00449999999956936,2552.0,30,27,0,57
3538,18.45375000000096,4002.1,59,21,0,80
3539,-11.473499999999074,2536.25,36,22,0,58
3540,1.7720000000006402,3866.35,40,37,0,77
3541,-21.016999999999154,2839.315789473684,35,28,1,63
3542,-16.928249999999707,2050.684210526316,23,30,0,53
3543,-21.485499999999575,1980.3684210526317,21,28,1,49
3544,-19.550999999999462,2479.8947368421054,34,22,2,56
3545,-19.35224999999955,1996.7058823529412,31,26,3,57
3546,16.195500000001395,4195.85,65,20,3,85
3547,-11.128999999999746,2714.722222222222,45,27,2,72
3548,23.060500000001838,4559.421052631579,77,15,1,92
3549,-4.38899999999829,2949.6315789473683,51,24,4,75
3550,-52.32849999999978,2042.3157894736842,10,33,10,43
3551,17.50550000000156,4203.8,68,17,1,85
3552,-4.449999999999819,2375.4375,44,27,3,71
3553,-21.69199999999916,2498.4210526315787,32,23,3,55
3554,7.483000000000817,3827.5,54,21,3,75
3555,-9.300249999999078,2536.1,31,29,1,60
3556,16.084000000000508,2908.0588235294117,76,34,2,110
3557,-37.35450000000005,1959.5263157894738,22,20,21,42
3558,13.284250000001236,4323.45,65,20,1,85
3559,13.390250000001824,3094.823529411765,58,34,1,92
3560,52.971000000001176,4777.421052631579,101,15,3,116
3561,-7.483499999999116,2831.7894736842104,41,19,4,60
3562,-31.18024999999953,2016.3157894736842,23,14,7,37
3563,-11.908999999999995,1933.2941176470588,31,35,0,66
3564,4.687750000000991,2604.6875,61,12,8,73
3565,1.9415000000007363,2568.3888888888887,55,23,9,78
3566,22.782000000001716,4266.35,75,27,1,102
3567,-15.482999999998384,2283.6111111111113,29,32,6,61
3568,24.056500000001677,4320.45,65,26,0,91
3569,-13.943999999999932,1857.5882352941176,36,31,4,67
3570,20.674250000001447,3895.0,67,20,0,87
3571,-14.25199999999885,2687.9375,47,35,4,82
3572,7.1475000000010835,2944.5263157894738,45,25,2,70
3573,8.101000000000756,3676.2631578947367,51,21,2,72
3574,-8.478499999998935,3408.157894736842,57,24,10,81
3575,2.885750000000797,3634.7,57,14,0,71
3576,14.057500000003014,3041.0555555555557,73,23,7,96
3577,-0.3172499999991512,3215.6,41,20,1,61
3578,25.163250000000872,5104.4,57,32,1,89
3579,-12.816249999999723,2516.0,32,18,21,50
3580,9.445250000001312,4587.736842105263,68,17,3,85
3581,2.7907500000001266,2436.9444444444443,45,25,2,70
3582,12.321500000000789,3690.95,46,26,1,72
3583,10.352250000001558,4248.631578947368,84,14,3,98
3584,1.7255000000015408,2599.214285714286,48,21,3,69
3585,-11.13699999999896,3304.45,34,31,2,65
3586,14.006250000001828,4099.75,54,31,1,85
3587,-12.779499999999675,1933.2941176470588,34,30,5,64
3588,1.9400000000012547,3615.6,52,19,1,71
3589,-3.816749999999054,2748.5882352941176,44,26,1,70
3590,18.75575000000109,3825.2,62,14,1,76
3591,11.493250000001378,3004.375,59,17,2,76
3592,-5.948249999999384,2554.277777777778,39,30,0,69
3593,-4.015749999999503,3392.3684210526317,47,32,1,79
3594,-12.079999999999565,2736.470588235294,30,21,1,51
3595,-11.156749999999054,2567.95,33,28,2,61
3596,12.92025000000211,3183.8333333333335,76,12,1,88
3597,3.8930000000010714,3470.6666666666665,42,33,0,75
3598,7.4195000000007765,2691.0625,52,20,5,72
3599,17.18600000000142,4405.35,66,20,1,86
3600,-1.7154999999991847,2579.5263157894738,34,25,2,59
3601,-0.35599999999893067,3045.684210526316,50,21,6,71
3602,-3.1367499999989517,3079.95,44,20,0,64
3603,1.292000000000964,2559.764705882353,54,18,3,72
3604,16.357500000001853,2664.133333333333,56,25,0,81
3605,-0.5444999999984612,3302.0,54,18,1,72
3606,-2.639000000000153,2651.3333333333335,60,36,2,96
3607,-17.516249999999918,2060.05,15,27,1,42
3608,-16.80849999999942,2048.1,23,22,4,45
3609,0.5300000000009595,2450.6470588235293,40,25,5,65
3610,-7.482749999999508,2660.25,46,35,11,81
3611,-0.10874999999938381,2540.1,30,23,2,53
3612,-1.167249999999231,2546.764705882353,45,39,2,84
3613,19.378500000002106,4993.55,79,25,0,104
3614,-5.3522499999986906,3129.85,51,18,0,69
3615,16.526750000001844,3964.4444444444443,66,19,0,85
3616,-14.677499999999043,2508.5555555555557,36,29,1,65
3617,-23.869999999999912,2072.777777777778,15,42,3,57
3618,-4.4657499999989785,2214.75,40,32,3,72
3619,-2.415249999999336,2202.176470588235,43,38,1,81
3620,19.60025000000185,4754.894736842105,65,35,1,100
3621,-30.596999999999944,1429.0,14,42,4,56
3622,-14.186749999998904,2961.6,39,21,2,60
3623,24.399250000001743,2753.4375,71,14,1,85
3624,-10.486749999998008,3027.2105263157896,53,23,0,76
3625,-3.967749999998597,3195.75,50,20,1,70
3626,-13.745999999999395,2196.875,31,27,1,58
3627,-1.0857499999993907,2072.3529411764707,42,29,0,71
3628,-18.534249999999727,2595.5555555555557,36,25,13,61
3629,-16.03549999999898,1845.5294117647059,31,32,3,63
3630,22.8322500000014,3633.0,59,20,0,79
3631,-3.142749999998513,3005.684210526316,53,20,2,73
3632,14.313250000001233,4131.45,56,25,1,81
3633,-25.428249999998936,2577.0555555555557,36,23,0,59
3634,23.75675000000153,3184.1875,67,27,5,94
3635,8.204250000001085,3595.85,59,13,0,72
3636,6.564000000000197,3320.4210526315787,49,37,3,86
3637,-5.6992499999988855,2500.5,39,21,2,60
3638,25.44150000000146,4191.1,73,22,0,95
3639,25.76575000000157,3365.705882352941,76,19,3,95
3640,7.003000000001039,2950.222222222222,53,20,7,73
3641,-11.905249999999459,2544.823529411765,32,26,13,58
3642,-0.9032499999991621,1781.4666666666667,50,32,1,82
3643,-8.324249999998631,2877.0555555555557,49,20,4,69
3644,16.687750000001373,4212.684210526316,64,32,2,96
3645,-38.565749999999625,1946.2941176470588,19,14,11,33
3646,11.622250000000921,3071.1111111111113,52,21,1,73
3647,16.517000000001254,3630.65,53,21,1,74
3648,16.960250000001356,3785.0526315789475,65,16,1,81
3649,-35.76424999999951,1967.0,23,20,8,43
3650,0.49375000000079217,2511.222222222222,36,28,0,64
3651,-13.908999999999287,2551.0,32,23,4,55
3652,34.78000000000315,5734.75,97,18,0,115
3653,12.558000000000405,2442.9375,74,22,9,96
3654,-6.501999999999373,2622.222222222222,45,31,5,76
3655,-13.937999999999317,2466.9444444444443,34,26,0,60
3656,23.40675000000182,4504.55,68,27,1,95
3657,-28.93024999999953,2122.75,19,30,2,49
3658,-26.941749999999963,1429.0,17,54,0,71
3659,11.509250000000716,3376.4736842105262,46,31,1,77
3660,-19.40174999999902,2548.0,31,22,6,53
3661,14.090500000000745,3317.2,46,26,3,72
3662,7.348000000000643,3367.277777777778,56,38,5,94
3663,11.804500000001907,3652.235294117647,67,28,1,95
3664,0.13275000000031315,3989.6315789473683,50,39,0,89
3665,6.631750000001328,4390.9,54,32,0,86
3666,7.124000000000805,3706.9,48,20,6,68
3667,-15.963750000000022,1795.125,31,38,3,69
3668,-6.2017499999992785,2987.8947368421054,43,27,4,70
3669,-22.52374999999964,2109.6470588235293,28,34,3,62
3670,-14.296999999999382,2366.5,36,25,3,61
3671,-20.571749999999003,3770.684210526316,48,45,4,93
3672,4.798250000000777,3275.3684210526317,41,31,0,72
3673,-0.7029999999988769,3961.65,53,29,1,82
3674,17.21450000000126,3835.4,64,19,0,83
3675,-6.476499999999855,2850.1052631578946,38,23,11,61
3676,2.637750000001836,2300.294117647059,51,22,6,73
3677,-7.291999999998913,3863.25,41,27,3,68
3678,9.49275000000089,3101.294117647059,51,24,2,75
3679,16.2082500000014,4183.15,65,20,0,85
3680,24.07050000000076,5050.6,65,31,2,96
3681,-5.711499999998857,3506.05,53,17,2,70
3682,-16.572749999999637,2468.315789473684,36,22,21,58
3683,9.309250000001796,3659.1666666666665,73,27,2,100
3684,2.516250000001093,3014.6666666666665,49,28,2,77
3685,-22.28074999999903,2567.95,32,26,0,58
3686,7.7677500000009205,3482.8888888888887,64,28,9,92
3687,-1.8229999999980788,3912.0,75,29,4,104
3688,14.593500000000947,2509.5,68,30,3,98
3689,10.728250000001024,3116.777777777778,49,23,1,72
3690,17.65350000000089,4084.157894736842,60,33,1,93
3691,19.101000000000624,3036.3125,66,28,3,94
3692,-19.50274999999932,2054.125,26,36,4,62
3693,-5.2897499999987865,2692.3529411764707,43,28,1,71
3694,-7.093999999998782,3044.25,43,23,2,66
3695,-31.67074999999979,2138.6,15,32,0,47
3696,3.957250000001421,3814.1052631578946,66,36,6,102
3697,-23.88524999999934,2124.0,19,35,6,54
3698,1.752250000001029,3248.15,50,21,1,71
3699,-11.389499999999199,3114.0,35,28,1,63
3700,-10.543749999999642,1973.75,35,27,3,62
3701,-15.404499999999183,2374.8823529411766,42,30,5,72
3702,12.340500000001603,4147.526315789473,70,21,2,91
3703,-11.246249999999039,2622.8947368421054,43,19,5,62
3704,-6.063749999999452,2617.2,27,27,1,54
3705,1.1512500000011832,3603.8,47,19,1,66
3706,21.803000000001198,2952.0,62,18,2,80
3707,-2.4999999999995133,2457.4736842105262,39,22,4,61
3708,6.328000000001332,3257.9473684210525,49,24,4,73
3709,-27.711499999999575,2048.1,19,19,6,38
3710,6.943000000000474,2824.0555555555557,53,21,8,74
3711,11.643000000001663,2411.1875,61,30,4,91
3712,11.701250000002172,1815.2666666666667,58,36,2,94
3713,18.84975000000178,2848.6875,66,28,3,94
3714,-25.024749999999568,2008.45,19,24,2,43
3715,12.116750000001062,4061.7,57,25,0,82
3716,-31.67399999999957,2013.842105263158,20,20,1,40
3717,-2.793249999998502,3068.1,46,28,0,74
3718,4.572000000000757,2906.8947368421054,49,27,2,76
3719,-10.305249999999173,2403.8823529411766,38,28,0,66
3720,11.679750000002539,2711.8125,58,31,1,89
3721,-0.3482499999989506,3178.25,49,20,5,69
3722,-14.64074999999942,2059.0,29,28,6,57
3723,3.8690000000007183,2592.4285714285716,54,35,1,89
3724,-9.622249999999427,2550.777777777778,32,24,4,56
3725,11.165000000001728,4382.3,60,32,1,92
3726,3.2792500000002924,2632.3333333333335,44,26,10,70
3727,-6.640999999999252,2703.0833333333335,39,40,0,79
3728,4.24375000000267,3439.842105263158,60,29,1,89
3729,10.462250000001193,3457.277777777778,54,27,2,81
3730,24.78225000000139,3753.05,70,11,0,81
3731,19.710250000001988,5488.65,74,23,2,97
3732,30.92725000000089,3224.4444444444443,65,20,3,85
3733,9.663500000001385,2263.3888888888887,44,22,8,66
3734,18.75425000000006,2184.4117647058824,51,25,1,76
3735,25.49175000000188,3821.25,66,20,1,86
3736,11.670500000001429,3618.75,55,20,1,75
3737,4.546500000000544,2725.214285714286,37,22,1,59
3738,-11.239499999999495,2472.5263157894738,27,32,1,59
3739,13.076250000001513,5386.2,60,39,1,99
3740,14.896000000000848,4895.0,56,30,2,86
3741,26.227250000000662,4506.85,63,18,0,81
3742,19.552750000001698,3528.722222222222,68,27,1,95
3743,-21.800499999999676,2048.1,17,30,2,47
3744,22.38200000000099,3865.5555555555557,74,28,3,102
3745,-1.080499999999102,3016.3333333333335,47,33,0,80
3746,-17.04399999999974,1937.9375,22,33,1,55
3747,6.984000000001837,3679.7368421052633,71,18,2,89
3748,15.866250000001068,3651.3333333333335,71,31,0,102
3749,-6.3984999999985135,4589.4,55,26,5,81
3750,26.420000000001135,4206.9473684210525,72,17,1,89
3751,20.639500000000886,4175.0,61,24,2,85
3752,0.3945000000000499,2024.3333333333333,39,35,1,74
3753,12.238250000001134,3560.2105263157896,57,25,0,82
3754,26.718750000002057,4087.5263157894738,68,27,0,95
3755,-1.7147499999991447,4244.2,57,27,0,84
3756,-23.694999999999258,2529.5555555555557,33,33,1,66
3757,30.851250000001393,4275.526315789473,82,25,0,107
3758,-1.9422499999990683,2649.0,46,35,1,81
3759,22.569500000001387,4389.0526315789475,81,28,0,109
3760,13.759000000000878,2381.5333333333333,56,34,1,90
3761,9.352750000000501,1988.2941176470588,51,34,3,85
3762,-12.60974999999969,3149.2105263157896,43,24,2,67
3763,8.614750000001111,3690.2,55,18,0,73
3764,-2.2649999999987616,3877.0,50,31,0,81
3765,-8.878749999998991,2070.7894736842104,31,22,3,53
3766,-10.119999999999212,2759.2,35,25,0,60
3767,3.7387500000011507,3079.157894736842,54,20,1,74
3768,1.555000000000455,2503.5,35,33,3,68
3769,4.121500000001315,4842.55,66,22,3,88
3770,21.241750000001964,2725.75,67,14,2,81
3771,-7.961249999998953,3553.5789473684213,44,22,5,66
3772,-17.170499999999386,2076.5263157894738,21,26,5,47
3773,18.02225000000171,4169.315789473684,62,29,3,91
3774,-33.55475000000005,1429.0,0,33,1,33
3775,-18.90599999999897,2912.45,23,35,7,58
3776,21.32025000000137,4706.9,72,13,2,85
3777,17.179250000001126,3790.842105263158,55,21,0,76
3778,-37.650999999999854,1429.0,0,33,4,33
3779,17.3117500000012,3848.95,53,22,1,75
3780,16.49950000000127,2810.1176470588234,51,23,0,74
3781,30.55025000000186,4940.25,76,25,0,101
3782,4.35025000000049,2128.5,43,27,1,70
3783,-11.782749999997923,2017.2222222222222,41,28,3,69
3784,-19.753499999999477,2170.35,19,28,3,47
3785,0.003500000001158199,2210.8125,35,34,8,69
3786,-2.8317499999999898,2076.3888888888887,41,25,4,66
3787,-5.236749999998626,3612.1052631578946,61,22,3,83
3788,2.442500000000147,2482.8888888888887,43,14,2,57
3789,-1.6582499999974343,2915.3125,60,30,1,90
3790,-21.903499999999497,1980.3684210526317,24,30,1,54
3791,-14.858749999999265,2676.733333333333,34,33,0,67
3792,-25.09200000000015,1941.5882352941176,30,46,10,76
3793,-3.3724999999991025,3107.6,43,26,0,69
3794,-4.165499999999711,1904.3529411764705,23,36,4,59
3795,-5.475499999998846,2518.3125,43,34,2,77
3796,-7.134249999999308,2501.4444444444443,32,25,4,57
3797,4.969250000001438,3774.9473684210525,72,23,1,95
3798,-6.457749999999379,2864.2631578947367,36,37,3,73
3799,-1.2342499999995844,3771.684210526316,49,44,4,93
3800,17.660500000001285,3706.4210526315787,69,34,1,103
3801,-4.177249999999871,3032.222222222222,47,33,1,80
3802,20.381500000002337,3158.3529411764707,71,28,0,99
3803,9.102500000001376,2484.625,61,27,2,88
3804,-5.879249999999639,2627.5,30,26,1,56
3805,-0.9807499999986995,2861.4117647058824,47,33,1,80
3806,-29.757249999999736,1893.3125,21,31,5,52
3807,7.690250000001605,3703.75,64,18,0,82
3808,-24.952249999999474,2048.1,22,21,0,43
3809,-15.002999999999172,2090.5555555555557,32,27,3,59
3810,18.884750000001972,4397.35,74,30,0,104
3811,-42.479500000000186,1897.3333333333333,17,45,4,62
3812,21.65125000000214,5367.25,68,33,0,101
3813,-10.366749999999408,2699.0666666666666,31,29,2,60
3814,-3.780499999998861,3097.4,37,31,0,68
3815,-18.571999999998912,3277.55,46,23,0,69
3816,15.266500000000917,2478.5625,59,19,1,78
3817,-5.647749999999529,2050.6666666666665,45,27,3,72
3818,13.062250000003313,5859.3,86,30,2,116
3819,-3.681749999998997,2521.3125,53,37,5,90
3820,-3.064249999998318,4337.95,46,42,1,88
3821,-23.125499999999626,2028.25,20,24,1,44
3822,11.674249999999795,3600.315789473684,56,37,2,93
3823,-27.422749999999667,2044.1,21,28,1,49
3824,-26.055249999999774,2089.0526315789475,26,27,9,53
3825,17.80325000000145,4173.5,65,24,0,89
3826,3.4442500000025804,2454.75,62,25,1,87
3827,-7.717499999999172,3302.1052631578946,42,30,1,72
3828,-0.15424999999888786,3398.2631578947367,49,33,1,82
3829,-4.630749999999395,2616.9411764705883,34,23,1,57
3830,1.6990000000011858,4348.95,64,22,4,86
3831,7.9372500000010335,2358.0588235294117,68,20,3,88
3832,18.72800000000094,3039.4444444444443,55,20,1,75
3833,-11.894249999999502,2223.625,34,28,2,62
3834,0.15200000000149308,2995.5263157894738,54,21,2,75
3835,2.954750000001051,3756.85,47,30,0,77
3836,-31.735749999999733,2008.45,12,23,1,35
3837,15.469000000000744,3827.6111111111113,66,25,3,91
3838,-33.520749999999765,1429.0,15,31,4,46
3839,-20.540999999999705,2323.222222222222,22,38,1,60
3840,28.378000000002782,5777.5,104,24,0,128
3841,17.13675000000145,4099.75,67,15,0,82
3842,1.7235000000015215,4390.15,55,35,0,90
3843,5.838500000000927,3076.0,53,21,0,74
3844,17.75525000000139,3846.8125,64,20,1,84
3845,9.459000000001055,3041.3684210526317,56,15,1,71
3846,-7.276499999999446,2646.0,43,23,3,66
3847,-6.300249999999047,2554.3333333333335,35,23,1,58
3848,-5.431499999998144,3317.8947368421054,53,20,4,73
3849,-14.487999999998493,4185.9473684210525,48,35,3,83
3850,-4.963499999999565,2421.1666666666665,31,28,0,59
3851,10.973500000001142,3808.45,59,15,2,74
3852,-21.671250000000015,1824.0588235294117,21,38,0,59
3853,18.28550000000142,3494.5882352941176,97,27,1,124
3854,-19.218249999999834,2602.0,32,27,5,59
3855,-22.976499999999355,1994.578947368421,23,24,1,47
3856,-29.115499999999816,2114.1052631578946,15,33,1,48
3857,-22.65249999999976,2691.1666666666665,29,30,0,59
3858,-5.593749999998378,1992.625,47,25,0,72
3859,-5.45799999999966,2623.3529411764707,26,27,1,53
3860,1.8775000000016697,4560.85,79,31,0,110
3861,3.5877500000012077,3734.6,52,30,0,82
3862,-44.72350000000022,1429.0,5,32,7,37
3863,5.591000000000777,3036.3,43,19,1,62
3864,-0.02874999999919812,2529.8823529411766,51,20,0,71
3865,6.1867500000009645,3392.0,60,23,1,83
3866,-10.678499999998982,2498.3684210526317,39,17,0,56
3867,20.125750000000906,3914.05,54,24,1,78
3868,-21.886499999999874,1429.0,18,28,1,46
3869,1.3770000000010363,3006.4736842105262,53,21,5,74
3870,-6.4084999999985595,1951.0,42,26,2,68
3871,14.17100000000097,2966.8823529411766,68,35,0,103
3872,6.759000000001042,2487.625,48,27,1,75
3873,-31.157249999999713,2032.35,17,27,1,44
3874,13.203750000001637,4226.105263157895,67,38,3,105
3875,1.7997500000006368,3034.176470588235,60,24,2,84
3876,0.42825000000161123,3669.684210526316,59,31,0,90
3877,5.140750000001097,3248.6315789473683,49,23,0,72
3878,18.99750000000093,3019.1176470588234,65,22,0,87
3879,5.051999999999988,2507.529411764706,52,26,5,78
3880,-8.786999999999434,2561.785714285714,35,26,1,61
3881,3.1882500000011165,3994.05,48,24,2,72
3882,-3.1399999999983548,3633.0,59,28,0,87
3883,-2.344999999998818,2968.0,47,28,2,75
3884,1.5405000000011226,3017.4117647058824,46,25,0,71
3885,19.202250000002124,4676.75,86,14,2,100
3886,-10.363249999999502,2092.9411764705883,36,33,1,69
3887,-0.1714999999989138,2599.8125,37,25,1,62
3888,-4.528999999998642,2550.777777777778,49,23,0,72
3889,-7.252249999999236,3167.1,49,20,1,69
3890,3.686250000000605,3522.5789473684213,52,36,3,88
3891,-27.846499999999715,2028.3,19,30,0,49
3892,-22.024249999999302,1983.7222222222222,27,23,3,50
3893,-24.483499999999516,2008.35,15,28,1,43
3894,6.794250000001125,3655.25,45,29,0,74
3895,-9.733249999999192,2839.5,34,27,0,61
3896,-15.979999999998835,2707.8125,38,21,0,59
3897,0.4255000000004891,2639.0555555555557,45,26,3,71
3898,-1.1362499999985585,2582.214285714286,46,20,1,66
3899,-9.439249999999738,2062.9375,41,23,1,64
3900,28.317250000001064,4259.25,78,14,0,92
3901,-28.478000000000105,1971.388888888889,25,22,12,47
3902,15.127250000001643,2667.294117647059,62,35,1,97
3903,-16.78249999999965,1845.5294117647059,29,24,2,53
3904,33.79475000000245,2957.875,87,8,0,95
3905,7.3350000000012425,2505.4375,49,26,1,75
3906,12.973250000000737,3005.235294117647,58,19,2,77
3907,-20.157749999999076,2478.4210526315787,35,21,9,56
3908,7.365500000000798,3168.0,48,24,1,72
3909,2.8492500000009504,2373.4375,49,22,4,71
3910,-0.12699999999892492,2507.5625,51,27,3,78
3911,5.728000000001015,4042.65,60,21,3,81
3912,5.302500000000299,2521.4375,48,30,2,78
3913,-4.093749999998606,3111.6315789473683,51,25,0,76
3914,-28.745999999999498,2492.6111111111113,41,33,1,74
3915,-19.524749999999262,2259.230769230769,32,26,3,58
3916,-41.28024999999982,1977.1052631578948,14,30,7,44
3917,-20.337749999999986,1921.0588235294117,26,26,3,52
3918,9.934000000001651,3735.4,68,20,0,88
3919,-4.965249999998889,3047.176470588235,49,19,2,68
3920,16.202500000001148,4652.95,75,20,3,95
3921,39.58925000000287,4368.894736842105,89,14,0,103
3922,17.523500000000872,3385.8333333333335,68,15,0,83
3923,-16.309499999999023,2675.1666666666665,42,23,1,65
3924,-6.774249999999251,2558.5789473684213,29,24,2,53
3925,-32.62699999999924,2567.8947368421054,22,33,4,55
3926,11.689750000000926,3365.6666666666665,53,35,0,88
3927,16.025500000000083,2412.235294117647,47,37,3,84
3928,11.306500000001204,3052.15,54,20,1,74
3929,23.23275000000195,4230.368421052632,69,27,1,96
3930,-8.799749999999644,2502.5263157894738,27,27,1,54
3931,-23.122749999999492,2044.1,15,35,0,50
3932,16.17125000000176,3898.1,63,25,1,88
3933,16.07525000000181,2512.375,59,27,0,86
3934,-7.555999999999029,2612.1176470588234,41,18,2,59
3935,29.82475000000082,3226.529411764706,72,19,0,91
3936,-7.8727499999995745,2605.3,28,25,0,53
3937,-0.1902499999993446,2569.9333333333334,58,26,1,84
3938,11.366000000000689,2870.0,71,22,8,93
3939,7.717000000000875,2700.285714285714,44,23,1,67
3940,-10.087499999999348,2591.8,30,29,1,59
3941,29.75425000000079,5031.35,73,31,0,104
3942,10.982250000001642,3801.25,66,18,1,84
3943,1.0422500000001822,3742.55,40,22,0,62
3944,2.941250000000454,3167.1666666666665,57,18,3,75
3945,-7.700249999997996,2549.8888888888887,39,30,6,69
3946,-9.144499999999628,1933.388888888889,26,26,2,52
3947,-6.9229999999989555,2180.764705882353,34,27,0,61
3948,5.718250000001637,4225.85,52,37,0,89
3949,-12.096249999999406,2815.7894736842104,36,33,0,69
3950,-4.1892499999988955,3326.65,45,27,0,72
3951,-25.647749999999302,1999.6842105263158,20,31,2,51
3952,1.8482500000004187,2330.875,44,34,0,78
3953,-15.241499999999458,2625.235294117647,31,23,0,54
3954,-10.960749999999152,2536.15,40,14,4,54
3955,-16.24699999999914,2035.7777777777778,28,30,0,58
3956,-24.571249999999505,2048.05,22,25,0,47
3957,13.154250000001062,3107.4210526315787,50,25,0,75
3958,25.99200000000108,3720.1666666666665,68,20,0,88
3959,-3.253999999999313,2551.5714285714284,49,24,1,73
3960,-11.83799999999897,2425.5,50,26,4,76
3961,-11.007499999999185,2201.875,35,22,3,57
3962,15.91175000000078,3833.1,51,28,0,79
3963,-9.386749999998617,3094.9444444444443,52,21,0,73
3964,-5.788749999998913,3569.55,47,36,1,83
3965,-13.765749999998548,2077.1666666666665,31,26,4,57
3966,-21.015749999999617,2032.3,22,26,0,48
3967,-16.414999999999374,2119.0,27,23,1,50
3968,20.069250000001567,3094.8125,80,19,2,99
3969,18.439000000001776,4141.8421052631575,68,27,1,95
3970,38.85800000000142,5477.55,92,15,1,107
3971,18.57125000000076,2795.3125,58,17,0,75
3972,7.90350000000107,3983.05,50,23,0,73
3973,-9.778999999999556,1898.25,42,36,5,78
3974,2.756000000000969,2816.45,40,23,0,63
3975,-19.123249999999256,2476.6315789473683,45,29,20,74
3976,-9.866999999999083,2598.842105263158,37,21,0,58
3977,8.051500000001294,2248.625,45,24,1,69
3978,-28.265500000000024,1925.5,24,22,6,46
3979,5.133750000001031,3791.7368421052633,55,27,0,82
3980,5.4045000000009376,3491.684210526316,53,33,2,86
3981,-28.027999999999583,2040.15,15,30,0,45
3982,-5.204499999997999,2446.875,45,26,1,71
3983,10.22175000000122,3392.3846153846152,56,20,0,76
3984,-15.78799999999896,2532.7368421052633,36,20,0,56
3985,11.288500000002088,4647.1578947368425,70,28,1,98
3986,20.728500000002327,4734.6,87,10,0,97
3987,-20.04975000000004,2279.5263157894738,22,35,2,57
3988,-23.01099999999922,2540.05,31,21,1,52
3989,0.3472500000011678,2313.875,53,13,2,66
3990,7.735249999999958,2657.6666666666665,57,36,0,93
3991,-19.58474999999984,2048.1111111111113,34,29,0,63
3992,11.617000000000978,3027.315789473684,58,10,2,68
3993,8.284500000000154,2488.9444444444443,70,24,4,94
3994,5.701500000001077,3825.2,47,33,0,80
3995,-42.00550000000027,1429.0,0,34,10,34
3996,-35.382749999999504,1429.0,13,28,1,41
3997,-25.870749999999724,2544.315789473684,23,26,10,49
3998,2.5245000000004287,2377.4375,43,23,1,66
3999,3.9905000000006163,2646.8571428571427,48,28,1,76
4000,26.723500000001014,2958.4117647058824,72,24,0,96
4001,5.080500000000315,1990.235294117647,52,25,1,77
4002,-20.081499999999703,2008.45,16,27,1,43
4003,16.012500000000916,3716.5,63,27,0,90
4004,-14.419249999999277,2552.05,32,24,2,56
4005,-7.775499999999394,2548.15,36,19,0,55
4006,3.823500000000915,2091.4666666666667,45,21,1,66
4007,-20.128249999999102,2663.722222222222,37,15,2,52
4008,-10.723499999999408,2580.3529411764707,43,25,4,68
4009,-6.05024999999918,3582.3,39,41,0,80
4010,-24.051500000000033,1973.7894736842106,24,28,12,52
4011,30.713000000001045,3198.470588235294,92,15,0,107
4012,2.1052500000011904,2459.8823529411766,46,18,1,64
4013,-10.64074999999929,2783.8,34,22,0,56
4014,-15.73599999999944,2593.35,33,12,8,45
4015,-16.438499999999323,2100.684210526316,29,21,5,50
4016,9.93550000000106,3688.0526315789475,51,28,0,79
4017,-2.4214999999986206,3205.2,53,22,1,75
4018,33.279250000001255,4734.55,90,5,1,95
4019,7.343750000000897,3199.0,51,18,0,69
4020,20.42775000000091,3893.8333333333335,84,12,5,96
4021,3.1020000000011896,2563.5263157894738,40,24,0,64
4022,26.176250000001676,4241.05,67,23,0,90
4023,24.401500000001224,3301.176470588235,62,24,0,86
4024,9.199750000000915,2555.0,62,25,0,87
4025,-20.598750000000024,1992.157894736842,19,30,5,49
4026,7.383750000001124,3787.1111111111113,66,22,1,88
4027,-33.52874999999986,1429.0,0,37,2,37
4028,19.77150000000104,3856.85,59,17,1,76
4029,-14.825999999998725,2050.0625,32,31,2,63
4030,-15.401250000000024,2227.294117647059,29,29,3,58
4031,-20.574999999999335,2677.9473684210525,35,26,3,61
4032,18.07175000000084,2600.75,48,19,0,67
4033,15.212250000001555,4867.2,78,18,0,96
4034,-10.302999999999452,2078.8125,54,20,2,74
4035,13.073000000001509,2539.25,60,22,1,82
4036,-1.2017499999993393,2437.6470588235293,34,35,1,69
4037,-3.3547499999992825,2339.75,45,27,1,72
4038,-24.045999999999065,2429.176470588235,28,35,3,63
4039,-7.405499999998957,3425.2,49,15,1,64
4040,-22.568749999999167,2139.4375,30,28,5,58
4041,8.880750000001296,2780.4375,54,17,0,71
4042,10.5712500000004,2490.3571428571427,37,30,0,67
4043,1.632000000000336,3101.684210526316,51,23,1,74
4044,11.856000000001409,3314.235294117647,70,24,3,94
4045,-43.817499999999896,1429.0,0,34,1,34
4046,-26.137499999999687,2131.4,18,27,1,45
4047,-26.37925000000028,1429.0,8,30,6,38
4048,-11.322249999999523,2600.315789473684,34,19,1,53
4049,-5.33899999999924,2781.9411764705883,51,34,2,85
4050,4.951250000002536,2030.2941176470588,57,23,3,80
4051,5.591000000001747,4337.8,65,28,1,93
4052,27.999250000001854,4655.3,68,29,1,97
4053,-7.908999999999646,2731.5882352941176,48,37,0,85
4054,-9.329499999999234,2532.2,36,16,1,52
4055,-7.213249999999722,2488.4210526315787,29,30,10,59
4056,-1.0577499999981086,4850.45,71,27,0,98
4057,-11.3547499999986,2796.5333333333333,40,29,4,69
4058,6.188250000000738,3028.3,45,16,1,61
4059,9.853250000000688,2869.1666666666665,49,23,0,72
4060,-1.5479999999990819,2523.5,45,27,0,72
4061,-5.765499999998908,2545.1875,38,23,2,61
4062,23.33875000000152,4909.15,88,18,2,106
4063,-9.738999999999434,2312.9375,43,31,0,74
4064,22.19025000000074,3687.05,67,12,0,79
4065,3.2447500000010336,3991.05,47,27,0,74
4066,37.73300000000272,3204.0588235294117,90,19,0,109
4067,-23.34424999999917,3478.4736842105262,58,22,2,80
4068,-4.116749999998985,2359.8823529411766,47,23,0,70
4069,-4.633499999999441,2496.294117647059,38,22,2,60
4070,-9.489999999999386,2666.375,32,23,0,55
4071,-34.02799999999934,2040.1,26,24,0,50
4072,12.875250000000984,2437.6666666666665,63,18,0,81
4073,-3.138499999999536,2638.8,35,20,3,55
4074,2.628500000000647,2498.5,55,29,4,84
4075,-4.540499999999681,2997.157894736842,53,21,12,74
4076,7.825250000001245,3952.15,59,21,1,80
4077,7.7830000000003805,2900.0555555555557,58,15,2,73
4078,-20.298499999999727,2008.5,17,22,5,39
4079,-11.275749999999446,4086.15,36,30,2,66
4080,21.4355000000014,2885.5625,64,14,2,78
4081,-10.208249999999751,2589.4210526315787,40,21,11,61
4082,13.376000000001316,2910.823529411765,58,26,0,84
4083,8.467500000000452,2194.6470588235293,57,21,2,78
4084,7.574500000000794,2836.4444444444443,47,33,4,80
4085,1.6502500000005385,2321.875,52,34,1,86
4086,15.358250000000666,2795.6153846153848,48,24,2,72
4087,22.89325000000307,2483.6875,72,22,2,94
4088,-6.030749999998776,2578.0555555555557,35,31,3,66
4089,-9.44074999999875,2509.375,55,21,1,76
4090,2.864000000000895,3083.9,42,21,0,63
4091,41.420750000002606,5523.6,119,3,2,122
4092,-4.270999999999345,3206.9444444444443,57,34,0,91
4093,-5.390250000000178,2044.5,43,24,9,67
4094,31.121250000001602,2408.529411764706,69,26,0,95
4095,6.5772500000012055,4008.45,58,24,0,82
4096,-28.120750000000193,1429.0,26,44,2,70
4097,-19.697249999999393,2772.315789473684,31,28,1,59
4098,-32.664999999999964,1429.0,11,48,0,59
4099,0.3265000000010125,3186.25,47,19,1,66
4100,-16.155999999999434,2649.6315789473683,35,23,6,58
4101,7.6680000000018085,4064.7894736842104,61,26,3,87
4102,-3.7552499999982354,3322.6,46,26,2,72
4103,20.718250000001568,5586.1,91,21,0,112
4104,49.49875000000209,5148.95,105,14,1,119
4105,-8.006499999998788,2774.5882352941176,49,27,1,76
4106,1.049500000000211,2900.529411764706,63,27,4,90
4107,9.472750000000632,2873.769230769231,37,28,0,65
4108,2.072000000000147,2447.0,35,40,8,75
4109,-17.224499999999654,2135.0588235294117,25,37,0,62
4110,0.9467500000009273,3801.35,49,29,0,78
4111,-10.783499999999531,2572.0,28,22,0,50
4112,-0.48199999999886184,2580.2631578947367,38,21,6,59
4113,-32.73499999999942,1893.375,34,36,3,70
4114,-12.685749999999405,2599.7,30,26,0,56
4115,-10.040749999999358,2699.0666666666666,52,24,3,76
4116,-6.343249999999289,2561.764705882353,36,26,2,62
4117,-7.748249999999386,2638.733333333333,37,31,1,68
4118,13.801250000000332,2384.3125,57,22,0,79
4119,-34.9790000000002,1429.0,13,47,0,60
4120,-5.341749999998899,2524.3333333333335,47,33,0,80
4121,-12.640499999999726,2273.684210526316,24,29,5,53
4122,-27.15799999999926,2044.1,17,32,0,49
4123,-3.2567499999987968,3385.777777777778,46,31,0,77
4124,-11.463249999999436,2498.4736842105262,33,33,4,66
4125,-7.212249999999534,2533.866666666667,26,26,0,52
4126,-4.644999999998775,2388.0588235294117,39,28,3,67
4127,10.514250000001228,3747.25,55,23,0,78
4128,21.510000000001245,3762.25,59,16,0,75
4129,11.17025000000135,3551.9,54,17,2,71
4130,12.225750000000733,3910.85,55,25,2,80
4131,0.2462500000021109,4491.7,57,31,8,88
4132,-20.46699999999938,2418.2105263157896,19,29,11,48
4133,-19.23324999999973,2917.7894736842104,37,27,2,64
4134,28.12725000000075,4499.0,70,21,0,91
4135,-5.490249999999085,2504.9444444444443,30,29,0,59
4136,-10.53649999999921,2517.823529411765,42,18,2,60
4137,5.826000000001449,2929.470588235294,55,27,3,82
4138,-7.73799999999922,2604.45,34,18,1,52
4139,-11.301249999999516,2566.6666666666665,44,31,1,75
4140,16.8647500000034,2810.0588235294117,80,22,1,102
4141,-11.143499999999865,2572.0,45,33,2,78
4142,-4.5687499999993095,3511.0526315789475,45,33,0,78
4143,17.406000000001043,3072.4117647058824,67,25,2,92
4144,12.09675000000096,4339.45,48,33,1,81
4145,3.9757500000008212,3837.8,43,28,1,71
4146,12.077000000001936,4373.5,61,27,2,88
4147,8.906500000001044,3622.842105263158,77,27,5,104
4148,17.58975000000096,3412.4210526315787,53,27,0,80
4149,4.407250000000715,2840.823529411765,51,30,0,81
4150,-4.4934999999990195,3851.2,41,33,0,74
4151,24.278500000001625,4107.6,65,18,1,83
4152,0.7330000000005821,2814.5,42,32,9,74
4153,-36.69674999999974,2040.15,13,30,0,43
4154,34.2565000000003,2845.529411764706,75,21,1,96
4155,15.785000000000547,3657.2631578947367,63,18,0,81
4156,-12.424499999999263,2582.842105263158,32,23,3,55
4157,17.867750000001056,4720.4,70,19,0,89
4158,17.959000000000536,3919.277777777778,69,30,3,99
4159,-12.519999999999715,1924.764705882353,42,26,2,68
4160,-25.218749999999353,1978.7368421052631,18,25,4,43
4161,-8.017749999999642,2511.0526315789475,33,30,13,63
4162,-30.108999999999952,2107.625,30,46,1,76
4163,-9.681749999999623,2604.5789473684213,47,25,2,72
4164,-9.397249999999413,2771.684210526316,49,20,7,69
4165,-3.235249999999545,2478.2631578947367,35,26,9,61
4166,-15.228999999998809,3239.35,44,23,2,67
4167,3.410000000000545,2621.1,39,16,1,55
4168,11.024500000001746,4934.65,63,22,2,85
4169,-14.221999999999692,2005.235294117647,27,24,6,51
4170,19.038500000001157,4658.45,73,26,1,99
4171,-0.6067499999986201,3499.3684210526317,55,28,0,83
4172,-24.508249999999585,2024.35,19,22,4,41
4173,-13.804749999999228,2663.0,37,20,3,57
4174,-21.505999999999776,2343.0526315789475,27,27,8,54
4175,-2.030249999999831,2841.722222222222,52,22,5,74
4176,-2.61574999999878,2740.2,42,23,1,65
4177,-27.855999999999845,1905.2222222222222,23,27,6,50
4178,36.12450000000278,3477.705882352941,100,23,2,123
4179,20.371000000001136,3770.3333333333335,65,26,2,91
4180,-6.557999999999382,2630.65,33,23,0,56
4181,-9.457249999998917,2842.684210526316,32,31,2,63
4182,12.928500000001474,4201.25,71,27,2,98
4183,-8.675999999999268,2598.684210526316,36,28,4,64
4184,-15.259999999998879,2651.2631578947367,35,28,1,63
4185,8.304750000001004,3446.153846153846,52,21,1,73
4186,8.843250000000728,1903.3125,44,19,4,63
4187,32.59525000000171,3886.0,88,23,1,111
4188,7.884250000000508,2641.866666666667,67,28,1,95
4189,-22.388999999999648,2028.3,20,20,3,40
4190,-11.212749999999499,3148.4736842105262,56,21,14,77
4191,1.0365000000004791,3160.8947368421054,54,28,0,82
4192,-9.531999999998893,2552.1,29,32,2,61
4193,-5.253249999999053,3067.3684210526317,36,22,2,58
4194,1.2957500000010644,3940.25,50,24,1,74
4195,-12.600250000000084,2026.888888888889,27,22,11,49
4196,22.25425000000175,3973.5,73,19,0,92
4197,37.96275000000257,5175.2,92,18,1,110
4198,4.370250000000233,2585.875,59,24,7,83
4199,-6.160749999999165,2572.0,40,33,0,73
4200,15.711250000001755,4861.55,79,19,2,98
4201,1.87325000000056,2882.8823529411766,59,31,1,90
4202,-6.988499999999445,2054.0,36,24,1,60
4203,-10.524249999999363,2587.0526315789475,41,19,2,60
4204,-2.4587499999988838,3179.85,39,27,0,66
4205,-4.396999999998821,3774.35,55,23,1,78
4206,0.26200000000087964,3596.5,50,32,2,82
4207,-6.244249999999534,2677.2105263157896,32,25,3,57
4208,12.890500000000893,3328.0,62,20,3,82
4209,9.233000000001063,2476.6875,51,24,8,75
4210,-8.797999999999579,2621.157894736842,37,31,3,68
4211,-4.289499999999744,2616.0,42,30,4,72
4212,-9.210499999999097,2634.470588235294,41,27,3,68
4213,-2.4409999999985006,2638.0,55,31,1,86
4214,2.153750000001239,3064.0,52,18,1,70
4215,-22.406249999999368,1987.5,24,27,1,51
4216,-8.496999999999334,2518.375,31,17,7,48
4217,25.32500000000123,3242.3529411764707,74,21,2,95
4218,14.229750000000871,4554.45,57,30,0,87
4219,15.432750000002315,2562.0625,65,19,1,84
4220,4.947750000001589,2912.8823529411766,53,27,2,80
4221,19.032500000000645,2516.0588235294117,49,30,1,79
4222,1.2142500000013325,2403.823529411765,54,24,1,78
4223,16.20575000000085,4445.85,65,23,0,88
4224,44.22475000000152,4734.65,82,19,1,101
4225,-22.356749999999852,1925.5,27,23,4,50
4226,3.9155000000009723,2339.4117647058824,58,24,6,82
4227,-10.288249999999504,2657.2105263157896,39,20,1,59
4228,0.5822500000007436,2921.1111111111113,46,22,0,68
4229,8.525250000000607,2152.3125,54,33,0,87
4230,-0.5927499999985001,3048.2105263157896,52,25,1,77
4231,4.0437500000009825,3576.2105263157896,55,16,1,71
4232,-15.569750000000022,2029.5555555555557,18,35,1,53
4233,30.5862500000028,5329.9,98,15,2,113
4234,-22.909249999999957,1912.6470588235295,34,37,6,71
4235,-10.702749999999115,2536.15,39,24,0,63
4236,2.6227500000010893,3449.75,50,23,2,73
4237,-1.1567499999996897,2420.6470588235293,44,24,2,68
4238,2.2052500000011808,3182.1111111111113,50,20,1,70
4239,-6.5099999999989535,2555.0,46,20,5,66
4240,-29.196249999999395,2008.4,21,23,3,44
4241,30.42900000000219,4005.294117647059,82,18,4,100
4242,11.859750000001444,4567.15,68,17,0,85
4243,31.92775000000167,4421.526315789473,91,26,6,117
4244,-21.837999999999635,2237.0,18,30,3,48
4245,4.399750000002205,4413.95,65,30,1,95
4246,4.179750000001209,3406.4736842105262,60,16,1,76
4247,17.906500000001,4425.789473684211,62,37,0,99
4248,-23.171999999999407,2721.05,31,23,0,54
4249,27.129750000002723,4067.5555555555557,75,20,0,95
4250,-5.726999999998591,4181.5,62,29,1,91
4251,-6.295499999998979,2707.6923076923076,47,26,2,73
4252,-25.71099999999955,2008.388888888889,22,29,2,51
4253,6.565000000001068,3615.65,57,18,2,75
4254,1.7730000000011237,2860.529411764706,59,31,8,90
4255,0.5450000000005127,2559.95,35,22,0,57
4256,23.300500000001794,4226.9,72,18,4,90
4257,-0.5992499999990538,3127.5,46,18,0,64
4258,5.492750000000052,2770.277777777778,49,30,1,79
4259,1.7982500000010204,3366.45,57,16,1,73
4260,-1.7999999999992664,2808.277777777778,46,31,0,77
4261,4.120750000000585,2063.9411764705883,44,29,4,73
4262,11.267750000000179,2656.0,56,23,0,79
4263,0.6475000000011054,3003.0,46,27,3,73
4264,5.587000000001231,3129.222222222222,53,30,1,83
4265,18.6050000000021,4457.65,69,28,0,97
4266,-21.79474999999934,2795.75,31,30,1,61
4267,8.339750000003013,3805.470588235294,71,34,1,105
4268,-31.827999999999456,2068.9473684210525,23,27,2,50
4269,-26.38224999999961,2048.15,16,30,1,46
4270,-17.51624999999928,3225.15,33,38,4,71
4271,20.488750000001314,4558.45,65,18,1,83
4272,24.352000000001237,4122.578947368421,69,18,0,87
4273,37.619250000002445,5217.3,93,15,2,108
4274,-21.03674999999931,2694.15,37,24,5,61
4275,-8.853749999998893,3097.5555555555557,48,24,0,72
4276,3.5215000000015406,2957.7894736842104,55,16,4,71
4277,-4.15099999999917,3286.2,46,20,0,66
4278,4.388250000001036,3701.5555555555557,60,25,0,85
4279,2.681750000000905,3177.684210526316,49,25,0,74
4280,-12.329999999999202,2518.3684210526317,36,23,3,59
4281,26.661500000002206,4635.55,75,28,1,103
4282,26.667500000001468,2358.266666666667,64,26,2,90
4283,3.513250000000601,2072.9375,37,36,2,73
4284,-17.97074999999944,2680.5263157894738,29,29,3,58
4285,9.274250000001642,3652.15,61,21,1,82
4286,-18.196749999999728,2008.45,16,23,3,39
4287,-9.63899999999993,2503.4210526315787,24,27,6,51
4288,12.826250000000574,2571.823529411765,65,33,1,98
4289,14.74325000000268,2674.0714285714284,66,27,2,93
4290,22.43175000000171,6064.85,83,12,1,95
4291,9.544250000001261,2475.764705882353,46,29,8,75
4292,9.326250000001043,2464.875,44,28,2,72
4293,13.891250000002026,4179.0,63,29,1,92
4294,-1.6004999999997032,2555.1176470588234,41,27,1,68
4295,1.6230000000020515,3523.4736842105262,63,29,0,92
4296,-22.219749999999273,2698.95,37,18,4,55
4297,-4.593749999999737,1968.764705882353,40,28,4,68
4298,14.688250000000698,2954.764705882353,59,25,1,84
4299,13.469250000001256,4169.5,53,15,3,68
4300,3.393750000000767,2861.9473684210525,55,26,5,81
4301,25.82200000000149,4068.85,63,19,1,82
4302,-4.8117499999987725,2536.25,54,29,4,83
4303,16.651500000001896,4414.8,68,29,2,97
4304,5.544500000001596,3961.7,64,21,1,85
4305,19.77825000000113,3860.2105263157896,68,30,2,98
4306,-7.386249999999374,2545.125,53,37,2,90
4307,-17.679499999999244,2077.9411764705883,32,21,14,53
4308,-11.864999999999167,2539.3333333333335,31,33,7,64
4309,-3.7674999999989325,2956.5555555555557,40,32,2,72
4310,-4.134249999999108,3400.6315789473683,43,27,5,70
4311,-4.22949999999994,2473.1666666666665,46,34,4,80
4312,-7.582749999998953,2709.5555555555557,39,30,5,69
4313,-17.706249999999162,2064.875,32,20,4,52
4314,-26.65674999999972,2092.315789473684,14,30,5,44
4315,-13.193500000000293,1429.0,21,31,7,52
4316,-31.67424999999996,1955.5,21,28,14,49
4317,-8.236499999999264,2638.5,38,22,3,60
4318,18.61775000000122,2685.9411764705883,66,27,3,93
4319,-40.29199999999996,2000.4444444444443,15,29,5,44
4320,29.610000000001996,4829.9,82,26,0,108
4321,17.14875000000132,2971.875,69,20,4,89
4322,2.1232500000008327,4358.45,57,23,0,80
4323,12.853000000000733,2873.529411764706,53,27,10,80
4324,21.260500000001038,3147.722222222222,57,30,0,87
4325,6.919500000000734,2798.6111111111113,48,19,16,67
4326,-5.024249999998379,3085.7894736842104,46,25,0,71
4327,-2.6649999999987806,4782.15,63,28,1,91
4328,16.6300000000008,3168.5882352941176,69,29,1,98
4329,-2.02574999999948,2984.6666666666665,57,32,4,89
4330,-3.751749999998757,3198.6315789473683,59,24,6,83
4331,21.75100000000157,4239.5,66,16,6,82
4332,19.757250000001847,4190.9,74,19,0,93
4333,-3.9929999999994883,2656.733333333333,37,26,7,63
4334,-0.0952499999993623,2992.5,54,24,1,78
4335,-11.479999999999993,1777.25,31,30,4,61
4336,-11.516499999999056,2739.25,39,23,0,62
4337,-10.245999999999878,2581.6,39,34,0,73
4338,9.601000000000653,4477.5,57,21,2,78
4339,31.456000000001275,4132.421052631579,84,18,2,102
4340,0.42700000000099114,3794.95,59,16,4,75
4341,10.710250000000794,4430.0,59,38,0,97
4342,-20.8994999999995,2506.7368421052633,29,30,0,59
4343,4.24050000000103,3091.85,44,22,2,66
4344,37.802000000001485,4295.7,84,19,1,103
4345,13.337500000001205,3619.6666666666665,70,22,0,92
4346,5.571500000002191,3910.2631578947367,71,24,5,95
4347,11.474500000001878,2568.0,71,23,4,94
4348,32.03700000000121,4269.55,69,12,2,81
4349,5.6172500000019285,3899.4736842105262,79,10,3,89
4350,4.629750000001691,4467.95,64,27,1,91
4351,16.816750000000553,2558.0,44,28,2,72
4352,3.6420000000013433,3945.0,55,20,2,75
4353,7.447000000001433,4163.578947368421,51,40,0,91
4354,-32.95599999999978,1959.578947368421,20,16,11,36
4355,-23.556999999999867,2016.388888888889,29,39,3,68
4356,9.359749999999707,1946.875,41,34,4,75
4357,-6.6237499999992675,2528.25,32,20,5,52
4358,-2.8952499999983567,4037.05,57,24,1,81
4359,3.84625000000065,5526.75,56,30,0,86
4360,-3.5967499999990786,2467.75,49,22,3,71
4361,8.535500000001083,3142.55,48,29,0,77
4362,1.1310000000014941,3380.5263157894738,50,25,4,75
4363,-6.603249999999387,2556.1,38,14,4,52
4364,-20.506499999999694,2024.25,23,22,3,45
4365,-11.07499999999994,1925.0625,42,16,7,58
4366,13.419750000001187,2587.866666666667,63,28,3,91
4367,-6.412750000000003,2036.611111111111,45,29,5,74
4368,-5.160249999998995,2152.6470588235293,35,29,1,64
4369,54.540750000002674,5254.45,104,24,0,128
4370,-16.742249999998858,1965.9411764705883,53,31,3,84
4371,10.610000000001325,3790.157894736842,60,20,0,80
4372,15.010500000001333,2946.0625,51,25,1,76
4373,1.9887500000011251,3667.25,56,22,1,78
4374,-9.684749999999182,2125.5,38,46,0,84
4375,-9.835500000000014,1941.3333333333333,30,21,12,51
4376,1.623500000000592,2929.0625,57,23,0,80
4377,-6.633249999999242,2422.4736842105262,35,18,1,53
4378,13.117250000000155,3048.1111111111113,52,27,1,79
4379,-0.2679999999993153,3453.0,56,29,1,85
4380,12.370250000001139,3740.3333333333335,64,21,5,85
4381,0.5820000000013351,2554.3333333333335,45,26,2,71
4382,-21.699499999999666,2028.7222222222222,54,36,10,90
4383,-2.565499999999341,3017.315789473684,44,27,2,71
4384,1.7697500000007333,2868.6923076923076,53,31,1,84
4385,-0.5212499999992779,3460.8,37,29,4,66
4386,4.5650000000008575,2952.8888888888887,47,25,2,72
4387,4.2792500000006735,1955.75,40,35,2,75
4388,9.805750000000518,3092.2631578947367,75,24,4,99
4389,10.053500000001263,2964.8125,54,26,1,80
4390,-2.866999999998293,3180.6,48,21,1,69
4391,-12.430249999999564,2563.5789473684213,32,30,5,62
4392,-17.407000000000348,1429.0,17,39,8,56
4393,12.547000000001123,3663.2,58,19,0,77
4394,-11.10249999999925,2892.0,33,28,3,61
4395,-30.865249999999815,1429.0,13,26,10,39
4396,-7.249499999999037,3025.5789473684213,49,21,3,70
4397,26.04750000000204,3018.4375,81,26,0,107
4398,19.127000000000958,4544.15,67,30,0,97
4399,35.44025000000178,4690.95,75,20,2,95
4400,-8.808749999998042,3185.3529411764707,56,45,0,101
4401,-4.302749999999835,2082.6470588235293,46,19,4,65
4402,-39.62524999999959,2019.7368421052631,15,25,2,40
4403,-4.480249999999008,3227.277777777778,61,27,5,88
4404,-5.524749999999218,3901.35,47,25,1,72
4405,-19.443999999999225,2683.05,31,29,1,60
4406,31.142000000000742,5476.75,71,33,0,104
4407,18.685750000001246,3861.65,59,32,2,91
4408,12.184000000002326,1872.4666666666667,71,35,1,106
4409,6.765750000000679,2448.2,57,27,3,84
4410,-5.068749999999274,2479.470588235294,39,19,0,58
4411,15.295250000000632,2433.764705882353,74,18,1,92
4412,-3.183999999999993,1920.1875,29,21,2,50
4413,19.516250000000763,4217.15,49,25,3,74
4414,2.6342500000006135,3343.3,38,29,0,67
4415,-9.511749999998731,2012.8333333333333,28,23,14,51
4416,-18.937249999999345,1429.0,34,32,2,66
4417,13.997500000001377,2914.6470588235293,58,19,0,77
4418,-14.41749999999961,2554.125,31,36,2,67
4419,-23.570999999999398,2008.45,19,27,1,46
4420,-14.742999999999558,2556.8888888888887,26,36,0,62
4421,-25.68499999999945,1429.0,22,33,4,55
4422,-1.80449999999952,2548.15,36,20,1,56
4423,-6.619999999999111,2772.3684210526317,34,22,1,56
4424,-0.6674999999986881,3796.684210526316,57,31,1,88
4425,4.736000000001063,4202.95,47,29,1,76
4426,-3.9959999999993414,2582.214285714286,46,20,6,66
4427,9.442250000001954,2324.8125,52,28,2,80
4428,15.214750000002198,3412.277777777778,72,15,1,87
4429,3.864500000000666,2534.6470588235293,64,24,2,88
4430,14.641750000001394,4249.65,70,19,0,89
4431,6.969500000000939,3201.4,52,19,1,71
4432,-28.881999999999664,1959.5263157894738,13,31,2,44
4433,9.970750000002337,2489.0,53,34,1,87
4434,-4.076499999999582,2991.4210526315787,31,33,1,64
4435,-20.470749999999345,2564.0,30,26,3,56
4436,-7.596249999999391,2528.25,29,21,6,50
4437,4.762000000000332,1891.3125,49,28,2,77
4438,-4.585499999999553,2500.5,33,22,1,55
4439,10.389000000003096,2564.470588235294,76,21,1,97
4440,-4.6509999999992875,2377.9444444444443,45,22,4,67
4441,-3.623999999998997,2906.9473684210525,39,28,2,67
4442,-26.508999999999617,2003.7894736842106,15,30,3,45
4443,-11.445999999999234,2607.1052631578946,31,26,0,57
4444,7.308000000001366,2935.769230769231,61,29,7,90
4445,-13.172499999999129,2759.8947368421054,35,29,0,64
4446,24.602500000001367,5328.35,76,24,0,100
4447,-17.04224999999944,2020.4,22,26,0,48
4448,-10.179249999999447,2647.705882352941,35,36,0,71
4449,6.723750000001156,2728.6875,60,20,9,80
4450,-0.6244999999986423,3011.4736842105262,55,17,0,72
4451,33.4422500000014,5373.55,85,26,0,111
4452,14.012000000000935,4441.8,65,23,0,88
4453,-15.193499999999096,2506.7894736842104,26,33,3,59
4454,24.339000000001697,2478.866666666667,67,22,0,89
4455,13.158250000000479,2542.9411764705883,60,30,1,90
4456,11.273250000002237,2226.277777777778,46,35,2,81
4457,-1.5842499999994,2881.4444444444443,47,34,0,81
4458,31.147750000002436,5144.210526315789,82,23,2,105
4459,35.33925000000143,5114.0,79,17,0,96
4460,-1.7992499999993492,2559.95,42,18,2,60
4461,3.976250000001065,3658.0,48,34,0,82
4462,-4.094499999999028,2506.7894736842104,34,29,1,63
4463,-21.368999999999822,1429.0,10,32,3,42
4464,-14.908249999998906,2487.5789473684213,35,28,2,63
4465,-13.061250000000049,1839.75,31,33,5,64
4466,-22.56550000000023,2511.0,38,31,25,69
4467,-25.680249999999614,2076.5263157894738,21,28,1,49
4468,2.631750000001174,4221.2,70,26,0,96
4469,12.563000000001303,3577.842105263158,71,22,2,93
4470,-23.39999999999955,1902.25,37,38,2,75
4471,-26.219000000000165,1952.1052631578948,18,34,20,52
4472,-31.341499999999712,2165.0526315789475,17,30,4,47
4473,24.75500000000109,4034.842105263158,72,28,0,100
4474,-10.64524999999987,2657.6666666666665,40,28,2,68
4475,9.398500000001311,4150.8421052631575,65,22,0,87
4476,4.739750000001083,3079.85,51,18,1,69
4477,-11.231999999999138,2483.4210526315787,38,22,4,60
4478,4.97050000000079,3676.75,56,22,0,78
4479,-10.017749999999154,2429.1176470588234,45,24,2,69
4480,-13.353499999998771,2152.6470588235293,30,30,4,60
4481,25.707250000002063,2548.6666666666665,86,19,1,105
4482,-25.460999999999746,1934.0,24,24,6,48
4483,18.6107500000013,4266.35,65,24,0,89
4484,-18.078999999999873,2008.55,12,31,2,43
4485,-2.3544999999997644,2080.75,50,34,2,84
4486,-30.439749999999805,2004.6842105263158,23,23,10,46
4487,22.326000000001276,3714.7,50,32,0,82
4488,-16.24749999999939,1895.9411764705883,27,27,2,54
4489,7.841750000001253,2776.5555555555557,42,32,0,74
4490,-34.65499999999966,2028.2,10,28,0,38
4491,24.86850000000172,1996.5625,64,26,1,90
4492,-19.50499999999962,1943.1666666666667,25,27,1,52
4493,17.176250000000902,4444.4,58,24,0,82
4494,-27.5802499999994,1996.9444444444443,18,23,4,41
4495,-3.317499999999277,2146.375,53,26,5,79
4496,22.79200000000187,4765.5,85,16,0,101
4497,8.520750000001039,3790.7894736842104,49,29,1,78
4498,21.67425000000164,4244.2,68,19,0,87
4499,19.874750000001292,4204.45,75,22,0,97
4500,-1.6727499999990247,4064.0,55,29,1,84
4501,-15.776749999999325,2146.684210526316,26,23,7,49
4502,-17.71624999999913,2588.764705882353,43,33,3,76
4503,6.650000000000681,3998.842105263158,66,23,4,89
4504,9.974000000001578,4656.1,71,15,1,86
4505,3.568250000000623,2330.875,52,31,3,83
4506,22.98550000000144,2441.0,77,30,6,107
4507,-4.071249999999208,3460.8,45,24,0,69
4508,-22.291749999999237,2636.3529411764707,37,25,0,62
4509,5.544500000000517,3570.2631578947367,45,30,0,75
4510,11.946250000001148,3303.294117647059,54,29,0,83
4511,13.731250000000662,3046.176470588235,58,14,0,72
4512,-5.890749999999373,1979.8823529411766,47,29,2,76
4513,-21.591249999999214,2544.15,37,20,1,57
4514,-3.1084999999989726,3254.5,49,34,6,83
4515,22.89375000000212,4489.45,79,19,0,98
4516,-15.958999999999147,2443.315789473684,35,26,1,61
4517,-13.187749999999728,2014.3125,42,26,9,68
4518,-13.4547499999997,1891.1764705882354,27,36,0,63
4519,10.12400000000044,3764.0526315789475,74,19,3,93
4520,14.435250000001611,3699.0,75,19,1,94
4521,-0.36049999999958676,2526.0555555555557,50,28,2,78
4522,14.612500000000892,4788.55,72,24,0,96
4523,-16.761499999999366,3452.05,24,41,0,65
4524,37.386000000000514,4230.263157894737,73,25,1,98
4525,-24.059249999999793,2204.4,18,24,3,42
4526,-13.490749999999712,2127.5,26,33,4,59
4527,-10.84749999999946,2455.842105263158,45,21,7,66
4528,-8.879749999999191,2547.842105263158,34,23,1,57
4529,-10.865999999999058,2562.277777777778,34,23,1,57
4530,-1.1702499999989981,3716.4,46,26,2,72
4531,12.182250000000748,3169.0,51,20,0,71
4532,-22.668999999999457,2032.25,20,24,1,44
4533,-21.1992499999997,2019.0,24,24,2,48
4534,26.12275000000148,4359.25,81,15,0,96
4535,-2.7874999999988797,2721.294117647059,49,25,0,74
4536,10.620250000001505,4877.5,63,16,2,79
4537,-7.6374999999989255,1881.9411764705883,32,30,0,62
4538,-4.3147499999996555,3419.6,33,34,1,67
4539,-10.82124999999924,2668.222222222222,33,22,0,55
4540,-7.084999999999775,2176.9411764705883,49,25,2,74
4541,-16.416499999999704,2090.2,17,28,1,45
4542,18.047500000001783,3623.45,61,21,1,82
4543,-3.8487499999994212,2462.5882352941176,44,22,1,66
4544,-31.143999999999476,1949.2222222222222,19,17,14,36
4545,-31.06474999999976,2203.6,13,32,1,45
4546,-19.441999999999428,2573.6315789473683,37,27,5,64
4547,-4.970249999999517,2769.4285714285716,37,26,4,63
4548,-3.7562499999989525,3426.5789473684213,60,16,3,76
4549,24.54350000000134,4183.368421052632,58,27,3,85
4550,5.033000000000769,3294.222222222222,53,24,0,77
4551,-23.24199999999899,2503.5263157894738,33,24,1,57
4552,-9.469749999999328,3476.7,38,30,0,68
4553,13.420500000002153,2561.0,58,25,0,83
4554,-0.6064999999990632,3079.0,49,26,1,75
4555,20.71050000000094,3930.65,66,19,0,85
4556,-7.177499999999048,2617.8333333333335,43,20,2,63
4557,0.8430000000008551,2175.0,41,25,6,66
4558,26.53175000000227,5163.3,82,20,2,102
4559,-0.5142499999999138,2499.9411764705883,52,26,6,78
4560,22.946500000001016,2561.785714285714,71,26,0,97
4561,-4.0934999999986,3290.3,51,17,0,68
4562,-3.494499999999359,2646.1666666666665,34,23,3,57
4563,-0.07924999999978581,2030.235294117647,47,28,3,75
4564,-3.03274999999886,2463.823529411765,38,28,3,66
4565,1.418250000000599,2518.4375,52,39,1,91
4566,16.95475000000127,3715.55,66,19,0,85
4567,-5.991249999998859,3089.0526315789475,53,25,2,78
4568,4.9625000000003565,4425.05,53,30,0,83
4569,-4.146499999998808,4264.0,69,18,0,87
4570,-15.184249999998787,2595.785714285714,37,28,0,65
4571,-27.840999999999447,2028.25,12,26,3,38
4572,-6.466999999999044,2511.176470588235,46,20,2,66
4573,11.030500000001052,2360.625,49,23,1,72
4574,-2.9324999999992802,2510.714285714286,39,24,0,63
4575,-7.639249999999102,2408.529411764706,49,29,4,78
4576,0.9897500000003834,1904.2941176470588,54,20,2,74
4577,6.517250000002063,4157.7,60,32,0,92
4578,14.00575000000077,3373.0526315789475,60,24,0,84
4579,15.540000000000806,3692.1052631578946,79,23,1,102
4580,5.192500000001248,3155.25,51,17,1,68
4581,-5.024499999999312,2013.5882352941176,32,26,2,58
4582,20.087000000001918,3384.375,84,34,1,118
4583,-10.45799999999922,2723.5,38,28,0,66
4584,-30.641499999999432,1927.5882352941176,23,29,3,52
4585,-17.423249999999438,1904.2941176470588,27,28,1,55
4586,-4.160249999999159,2209.9333333333334,47,26,0,73
4587,-8.726749999999608,2485.8947368421054,26,34,0,60
4588,-4.135999999999903,2521.4117647058824,45,41,0,86
4589,-14.376999999998839,2454.6666666666665,35,29,2,64
4590,26.300500000002245,4752.05,76,24,0,100
4591,-8.258499999999309,2433.5,40,25,3,65
4592,13.105500000000854,3653.1052631578946,54,25,1,79
4593,8.854500000000561,2954.722222222222,69,29,3,98
4594,18.060000000000606,2848.6875,78,25,1,103
4595,15.471500000000841,2833.9166666666665,67,26,0,93
4596,6.574250000001955,4181.35,67,29,0,96
4597,16.5847500000012,3705.3,60,21,0,81
4598,-3.107249999999265,3472.6,44,22,0,66
4599,19.10025000000154,4143.263157894737,78,30,0,108
4600,-19.067999999998914,3785.7894736842104,47,30,1,77
4601,26.865750000002983,2275.0,78,17,3,95
4602,-11.46375000000037,2913.3333333333335,50,40,2,90
4603,12.65750000000066,2259.4375,61,29,1,90
4604,19.965500000001875,4525.15,73,19,2,92
4605,-14.08199999999906,2704.45,37,25,0,62
4606,2.6837500000007326,2507.4117647058824,47,23,1,70
4607,-5.728999999999421,2445.1666666666665,32,27,2,59
4608,4.338750000000848,2866.0588235294117,57,27,1,84
4609,1.6672500000013966,3380.5789473684213,51,21,3,72
4610,-11.27349999999893,3391.0,42,34,2,76
4611,-13.610749999998799,2112.3888888888887,34,27,2,61
4612,13.448500000001896,3687.1,63,24,0,87
4613,1.0380000000011242,3171.6111111111113,43,26,0,69
4614,9.872750000000966,3919.65,47,33,0,80
4615,17.52200000000116,3413.2631578947367,49,27,1,76
4616,-17.390999999998606,3084.0,53,22,7,75
4617,-6.705499999999364,2620.5882352941176,33,26,0,59
4618,-7.037249999999672,1933.4444444444443,42,24,1,66
4619,-16.197999999998423,3829.3684210526317,42,32,1,74
4620,-13.642249999999063,1914.111111111111,20,32,5,52
4621,17.73200000000087,3412.3333333333335,57,35,3,92
4622,36.688250000002014,4153.65,74,19,1,93
4623,-2.721499999999203,3275.9,40,24,0,64
4624,6.5855000000008435,2815.277777777778,37,29,1,66
4625,-9.576249999999087,2935.222222222222,53,26,0,79
4626,16.22375000000057,3492.722222222222,55,27,0,82
4627,23.296750000002184,5143.4,83,17,1,100
4628,19.46625000000065,3236.8947368421054,55,33,1,88
4629,35.19150000000139,4192.8421052631575,83,21,1,104
4630,-14.222499999999082,2474.8888888888887,36,28,1,64
4631,19.4157500000018,2940.4444444444443,52,29,0,81
4632,0.360500000000855,2528.45,32,24,0,56
4633,16.208250000000298,2295.125,49,24,1,73
4634,-2.006499999998559,2473.8823529411766,46,20,0,66
4635,-22.833499999999052,1927.3333333333333,24,31,3,55
4636,-9.721499999998786,2527.3125,47,30,0,77
4637,-35.50274999999914,1993.7894736842106,19,22,4,41
4638,8.482250000001557,4320.45,65,24,0,89
4639,-6.203999999998935,2473.6875,45,25,2,70
4640,-26.269749999999554,1995.1666666666667,25,27,2,52
4641,-17.688999999999574,1913.1875,31,28,6,59
4642,-24.816499999999124,2149.8,23,24,3,47
4643,19.36725000000154,2130.375,71,29,1,100
4644,-6.209249999998731,2922.1111111111113,49,24,0,73
4645,-14.090749999999947,2005.5,27,32,3,59
4646,-20.529999999999433,2034.6842105263158,20,30,2,50
4647,9.91000000000082,3256.15,47,22,0,69
4648,-10.356249999999974,2429.1111111111113,43,34,8,77
4649,8.034250000001233,4041.5789473684213,68,31,0,99
4650,0.4955000000022024,3627.7894736842104,62,29,2,91
4651,-23.462249999999067,2231.5,26,31,0,57
4652,11.121250000001224,4019.55,57,28,2,85
4653,-29.848749999999303,2088.55,17,30,2,47
4654,-17.443999999999406,2794.9473684210525,33,42,3,75
4655,-12.453999999999075,2580.9375,33,25,0,58
4656,-5.9207499999993605,2515.5555555555557,38,30,4,68
4657,20.01300000000094,3405.222222222222,59,27,1,86
4658,21.916000000002335,3248.823529411765,93,35,0,128
4659,-10.608749999999239,2929.4736842105262,36,28,10,64
4660,-1.3534999999988515,2312.722222222222,37,32,2,69
4661,11.327750000001116,2759.5625,59,25,1,84
4662,22.98050000000149,3429.8888888888887,56,31,1,87
4663,1.4510000000017418,3638.75,58,27,1,85
4664,20.370500000001506,4283.85,64,24,0,88
4665,2.8982500000017457,3971.95,61,25,1,86
4666,30.207000000001408,5568.9,87,13,1,100
4667,2.22500000000052,2453.875,54,31,2,85
4668,28.935000000001946,4848.95,67,23,0,90
4669,-10.625499999999358,2491.625,39,30,9,69
4670,1.1565000000004897,2465.277777777778,36,31,5,67
4671,3.863250000000982,4485.5,58,30,1,88
4672,-18.7687499999991,2448.3684210526317,37,22,9,59
4673,9.648000000002371,2653.8888888888887,59,27,1,86
4674,24.365250000001367,2501.0666666666666,56,22,1,78
4675,-7.26774999999935,2533.866666666667,37,33,1,70
4676,18.853500000002036,3788.0,73,31,0,104
4677,42.58425000000203,4386.421052631579,80,20,1,100
4678,-20.634249999999376,2237.05,20,32,2,52
4679,-16.622749999999137,2162.9411764705883,34,21,0,55
4680,-7.264999999998631,2873.5263157894738,45,19,4,64
4681,-21.229999999998753,2446.875,38,31,0,69
4682,4.391500000001278,4108.210526315789,57,28,0,85
4683,14.601250000001581,4328.95,67,30,0,97
4684,4.708250000000226,3127.5,60,31,0,91
4685,24.554750000001555,5133.1,68,32,0,100
4686,-17.336999999999406,3084.277777777778,34,36,3,70
4687,-18.712749999999616,2475.7894736842104,28,37,2,65
4688,1.2582500000005445,2348.75,41,39,1,80
4689,-0.9269999999988924,3262.3888888888887,50,24,0,74
4690,28.256000000001166,5027.263157894737,66,34,1,100
4691,-16.216749999999003,2612.176470588235,33,25,1,58
4692,8.337500000001103,2053.0625,51,33,1,84
4693,6.749250000001068,2920.222222222222,49,22,0,71
4694,-14.911499999999567,2782.5789473684213,40,29,5,69
4695,-7.640999999999027,2441.3333333333335,46,25,5,71
4696,-1.1257500000001108,1809.0625,52,29,3,81
4697,-9.80350000000001,2000.388888888889,20,36,3,56
4698,4.476500000000672,2180.125,59,35,3,94
4699,20.438750000001228,4039.35,50,30,0,80
4700,-19.917499999999244,2262.25,23,28,0,51
4701,-18.08624999999863,3915.5,44,38,1,82
4702,36.92600000000155,4809.25,83,18,1,101
4703,24.237250000001374,2951.866666666667,69,16,0,85
4704,1.6010000000005515,2794.1111111111113,39,32,2,71
4705,8.505750000001665,2399.3125,53,28,0,81
4706,12.426500000001571,3662.0,60,27,0,87
4707,-7.9284999999990315,2593.4,29,31,0,60
4708,1.0615000000011596,3366.470588235294,46,20,0,66
4709,13.579000000001454,2612.5625,80,15,1,95
4710,35.04375000000179,4297.3,74,24,0,98
4711,-16.059999999999253,2536.2,36,20,0,56
4712,-4.448499999998665,2683.133333333333,37,32,1,69
4713,11.741750000001472,3868.0,50,31,0,81
4714,14.043250000002047,2445.0625,61,25,1,86
4715,-11.914249999999884,1882.8823529411766,23,35,2,58
4716,-8.829749999998848,3344.1,44,24,0,68
4717,12.366750000001746,3593.277777777778,61,26,1,87
4718,8.873750000000786,2745.6,42,21,3,63
4719,-10.549249999999276,3201.8947368421054,48,20,0,68
4720,-5.80974999999934,2703.6,30,26,0,56
4721,-10.116749999999431,3274.3,27,38,0,65
4722,-17.487749999999615,2841.75,29,35,0,64
4723,-13.439499999999276,2465.0,25,34,9,59
4724,2.7232500000010185,2412.1875,48,25,0,73
4725,6.143000000000895,2490.6875,41,24,0,65
4726,16.168250000002196,4864.8,75,31,0,106
4727,-26.5462499999992,2104.1052631578946,20,31,4,51
4728,12.115750000000942,3376.222222222222,54,21,0,75
4729,30.69750000000131,3125.4375,71,26,0,97
4730,-6.559499999999714,1966.8823529411766,30,33,3,63
4731,12.950250000001509,3753.75,51,34,0,85
4732,21.291000000001436,3966.35,67,18,0,85
4733,-19.009749999999645,1959.5263157894738,19,27,3,46
4734,8.936500000000944,4088.7,47,30,1,77
4735,-18.656249999999584,1873.5294117647059,20,33,1,53
4736,16.00025000000138,4038.65,62,17,1,79
4737,0.0050000000009035265,3481.5,47,26,0,73
4738,17.67925000000151,3783.3684210526317,64,31,0,95
4739,13.173000000000547,4877.5,64,28,0,92
4740,-2.5754999999994572,2444.9411764705883,42,26,2,68
4741,-3.426499999999828,2063.9411764705883,38,30,4,68
4742,-27.437999999999732,2034.8333333333333,16,30,2,46
4743,-3.301749999998968,2523.4375,54,21,2,75
4744,-12.892750000000195,1786.1875,26,38,0,64
4745,-2.813999999999302,2572.0,44,26,0,70
4746,-24.078749999999552,2048.15,17,25,3,42
4747,-9.405749999999044,3191.0526315789475,44,26,0,70
4748,-9.707749999999551,1723.6875,52,38,2,90
4749,12.077500000000914,4294.2,63,24,0,87
4750,2.627500000001718,3619.7,57,21,1,78
4751,-18.72124999999985,1481.9333333333334,33,35,9,68
4752,2.8260000000019687,3405.5789473684213,52,38,0,90
4753,10.700000000001518,3479.3333333333335,59,25,0,84
4754,-12.961499999999358,2196.5882352941176,29,32,2,61
4755,6.707750000000874,3231.1176470588234,46,20,0,66
4756,-27.216999999999114,2440.7368421052633,32,24,5,56
4757,-1.1129999999991649,2502.277777777778,41,20,1,61
4758,-8.181499999999623,2589.875,30,20,4,50
4759,8.327500000002468,2141.375,60,24,1,84
4760,14.592500000001712,4127.6,74,7,6,81
4761,-25.97699999999968,2140.95,18,27,1,45
4762,34.168250000001024,4809.210526315789,80,29,0,109
4763,25.064750000001553,4437.9,76,21,0,97
4764,-6.615749999998876,3209.2,41,30,0,71
4765,-3.404999999998681,3088.315789473684,45,23,0,68
4766,-1.7857499999992883,2438.0,35,24,0,59
4767,4.032250000000547,3435.0,50,22,0,72
4768,-6.171749999999524,2303.0,43,25,3,68
4769,9.997000000000723,3429.0,71,35,1,106
4770,16.34850000000129,3647.3,61,20,1,81
4771,-15.103249999999411,2553.684210526316,46,29,4,75
4772,16.31800000000158,2744.6875,71,18,0,89
4773,-6.299499999999178,2602.6428571428573,35,25,0,60
4774,-22.53574999999958,2048.05,16,34,0,50
4775,32.83200000000154,2379.4666666666667,66,23,2,89
4776,0.5320000000009497,3010.1111111111113,40,33,0,73
4777,-12.027499999999254,2584.3888888888887,35,20,2,55
4778,-6.079999999999387,2957.3333333333335,44,21,3,65
4779,13.190750000001895,4811.65,79,24,0,103
4780,9.38500000000106,3810.75,52,32,0,84
4781,0.6790000000010282,2811.8823529411766,47,25,1,72
4782,2.300500000001051,3180.1052631578946,42,26,0,68
4783,4.441750000001114,3643.4,50,24,0,74
4784,2.400250000001422,2384.5,53,24,2,77
4785,8.3990000000005,2390.9333333333334,56,35,0,91
4786,1.845500000001676,3979.85,51,25,1,76
4787,-3.2617499999988717,2728.9444444444443,42,30,1,72
4788,23.359750000001704,2776.0,53,25,0,78
4789,16.026750000000913,3095.85,44,27,0,71
4790,-6.143999999998668,3012.8333333333335,44,34,2,78
4791,10.599000000001144,4342.65,51,31,0,82
4792,-17.583499999998512,3601.25,48,32,0,80
4793,-7.545999999998915,3089.0526315789475,45,21,3,66
4794,13.06800000000087,3388.1052631578946,48,25,1,73
4795,18.289500000001777,3926.5,84,20,2,104
4796,9.090250000001086,2865.75,57,17,1,74
4797,16.38150000000071,3239.4210526315787,56,23,9,79
4798,-8.16049999999956,2634.4666666666667,36,26,2,62
4799,-11.283499999999234,2540.1,34,24,1,58
4800,0.4925000000005764,2692.6666666666665,37,25,3,62
4801,20.346750000001077,3269.470588235294,74,23,0,97
4802,37.724500000001804,4631.263157894737,99,26,3,125
4803,-22.659749999999743,2017.235294117647,29,36,0,65
4804,-3.951999999999157,2500.8947368421054,42,19,2,61
4805,-15.25749999999905,2728.1666666666665,33,25,2,58
4806,2.252250000000875,3546.55,41,33,5,74
4807,20.11825000000217,2452.294117647059,62,27,0,89
4808,27.367000000001347,5287.05,80,18,1,98
4809,2.976500000001881,4661.55,62,26,4,88
4810,20.609000000001206,4750.55,72,15,4,87
4811,15.561500000001143,3511.0555555555557,66,35,0,101
4812,12.388500000001004,3335.4,54,23,0,77
4813,-11.271499999999904,1982.2105263157894,24,20,3,44
4814,-24.548749999999846,2101.8333333333335,30,31,5,61
4815,-16.216999999999356,2562.277777777778,33,19,2,52
4816,11.976750000000541,3700.5789473684213,55,25,1,80
4817,7.223500000001553,3760.9,57,27,0,84
4818,-2.32574999999902,3270.3,41,27,3,68
4819,-16.620499999999215,2553.294117647059,33,20,1,53
4820,20.8707500000007,2857.823529411765,63,27,1,90
4821,0.552500000000965,2508.4,30,25,2,55
4822,-6.489249999999174,3132.4736842105262,41,22,4,63
4823,7.01250000000176,2529.823529411765,51,23,1,74
4824,4.624250000001157,2494.5625,53,20,2,73
4825,-17.410749999998643,3775.842105263158,56,19,3,75
4826,-1.9517499999993775,2438.777777777778,44,23,2,67
4827,-1.6039999999986463,2134.866666666667,43,22,0,65
4828,-22.79249999999969,2003.842105263158,16,24,5,40
4829,32.01950000000129,5053.8,76,22,1,98
4830,8.850750000001014,3022.2631578947367,47,21,0,68
4831,7.818500000001062,2891.529411764706,54,31,2,85
4832,-4.68549999999937,2707.7,36,21,5,57
4833,2.6055000000004824,3161.9444444444443,42,32,3,74
4834,-5.66849999999934,2463.4444444444443,42,23,3,65
4835,7.198000000000934,2902.6470588235293,69,16,2,85
4836,-18.0219999999996,2007.157894736842,16,29,5,45
4837,12.319500000001364,4520.35,73,19,0,92
4838,-6.565249999999027,3355.2,40,28,3,68
4839,-9.221999999999282,2616.1111111111113,37,28,3,65
4840,14.911000000001414,2157.1875,62,22,4,84
4841,7.15175000000085,3452.5263157894738,48,32,1,80
4842,-13.412499999999914,1866.0,26,39,0,65
4843,-5.112749999999027,2579.777777777778,37,26,2,63
4844,1.44075000000109,3344.9,49,23,1,72
4845,-2.0777499999992566,1884.375,46,32,0,78
4846,-44.281999999999975,2064.0,15,25,7,40
4847,-2.0897499999995217,2455.7894736842104,31,18,5,49
4848,5.318000000000826,3059.85,45,22,2,67
4849,0.93600000000103,2959.5789473684213,44,28,3,72
4850,-2.750249999998921,3507.5789473684213,49,36,5,85
4851,31.455500000001773,4479.85,77,21,1,98
4852,12.008000000001644,3831.684210526316,60,33,0,93
4853,3.4855000000005867,2445.9411764705883,39,33,0,72
4854,-5.185499999999178,3359.7894736842104,47,25,0,72
4855,0.3817500000009762,2556.0666666666666,44,29,4,73
4856,13.041000000002418,5270.35,64,43,0,107
4857,-1.3182499999984945,3598.1,46,23,0,69
4858,-16.968749999998863,2133.0,27,30,2,57
4859,-0.6624999999986291,3852.95,56,29,0,85
4860,-1.3882499999988869,3058.5,43,23,4,66
4861,3.1192500000011045,2757.6470588235293,53,27,1,80
4862,-6.296749999999628,2090.5,31,26,3,57
4863,-0.6707499999989193,3263.3333333333335,43,18,0,61
4864,-10.408249999999637,1912.7058823529412,45,19,8,64
4865,-0.6372499999993082,2769.923076923077,44,30,0,74
4866,-15.31974999999955,1784.25,27,25,4,52
4867,16.23825000000132,4214.8,70,22,0,92
4868,-0.483499999997923,2309.9375,57,28,3,85
4869,-11.617499999999346,2476.6666666666665,31,24,2,55
4870,-12.794999999999607,2449.3888888888887,31,30,3,61
4871,-33.28424999999992,1429.0,15,29,7,44
4872,32.347750000001284,4245.05,66,20,1,86
4873,-8.394499999999555,2454.235294117647,53,47,1,100
4874,-12.018499999999163,2479.470588235294,39,43,1,82
4875,22.680500000002066,5058.45,63,23,1,86
4876,-3.7122499999991563,2811.285714285714,31,24,1,55
4877,-4.5614999999995085,2378.6470588235293,44,28,1,72
4878,-1.9207499999993636,2400.0588235294117,46,25,3,71
4879,0.37475000000043474,2623.0714285714284,32,35,1,67
4880,7.55625000000159,3735.842105263158,73,26,0,99
4881,8.760250000000774,3080.0,47,18,1,65
4882,25.092750000001587,5129.8,78,29,0,107
4883,1.035000000000786,3036.0,44,27,2,71
4884,24.02025000000075,2622.5,60,27,2,87
4885,9.82050000000157,4454.45,68,21,0,89
4886,-16.59124999999995,1925.5555555555557,21,29,5,50
4887,-10.386249999998789,1952.0555555555557,27,34,5,61
4888,8.258000000002122,2877.8333333333335,59,27,1,86
4889,20.84475000000267,1653.25,61,24,4,85
4890,25.84800000000078,2884.5,64,29,1,93
4891,2.7570000000009145,3028.6666666666665,49,24,0,73
4892,-3.292249999999327,3059.842105263158,49,23,1,72
4893,20.461750000001103,3418.9411764705883,67,21,1,88
4894,-35.43724999999941,2012.35,10,27,5,37
4895,-0.20874999999814267,3333.0,66,23,3,89
4896,-6.694999999999278,2328.294117647059,40,37,0,77
4897,-25.030999999999224,2556.0,18,28,2,46
4898,26.975000000001227,3826.8333333333335,70,19,3,89
4899,-17.28674999999889,3136.7368421052633,39,34,6,73
4900,11.72550000000082,2765.176470588235,65,35,0,100
4901,-26.521499999999726,1978.7894736842106,16,29,1,45
4902,-2.0264999999987565,3106.95,39,30,1,69
4903,23.290250000001123,4167.15,61,20,1,81
4904,-1.6089999999991362,3205.4,49,17,0,66
4905,-10.860499999999824,1933.388888888889,44,18,10,62
4906,13.692000000000728,5985.35,73,26,0,99
4907,-12.212499999999258,2521.7368421052633,34,26,1,60
4908,16.265750000001685,5054.55,69,26,0,95
4909,-31.47299999999938,2011.0,21,27,6,48
4910,-15.073749999999842,2683.05,27,28,1,55
4911,-2.8592499999995526,1925.0625,52,21,7,73
4912,-28.98424999999951,2257.294117647059,31,23,7,54
4913,27.887750000001166,4140.8421052631575,85,13,0,98
4914,3.6420000000009325,2527.3125,45,32,0,77
4915,14.097500000001011,2858.625,57,20,2,77
4916,-23.300249999998734,2596.9473684210525,33,28,2,61
4917,-4.592999999999226,1964.8125,40,41,3,81
4918,24.182000000001647,3415.8888888888887,76,18,2,94
4919,18.861000000001447,3512.6315789473683,60,32,1,92
4920,18.601000000002227,4217.0,76,17,0,93
4921,-27.387999999999586,2040.1,14,27,5,41
4922,-4.546999999999406,3098.2631578947367,34,34,1,68
4923,-21.355499999999402,2627.6111111111113,31,28,3,59
4924,-12.156499999999962,2294.705882352941,30,37,0,67
4925,18.060250000001606,4187.0,76,16,0,92
4926,-15.934249999999171,2552.1,28,29,0,57
4927,-33.22424999999929,2688.55,23,27,6,50
4928,31.719750000002428,2866.625,74,19,0,93
4929,31.100000000000858,4975.25,72,22,0,94
4930,9.516750000000211,2395.470588235294,44,31,2,75
4931,-12.66499999999888,2477.6470588235293,37,30,3,67
4932,5.555250000001199,4286.3,67,25,0,92
4933,24.846750000001684,4214.75,75,15,0,90
4934,-21.522999999998852,2028.611111111111,28,28,1,56
4935,8.594750000000952,2257.375,49,28,0,77
4936,11.807750000001862,3929.9,61,28,1,89
4937,-1.7929999999989537,2946.315789473684,42,25,0,67
4938,11.832000000001127,2675.285714285714,48,24,0,72
4939,-12.03549999999927,2254.3846153846152,22,28,3,50
4940,1.001750000001461,2572.0,49,30,3,79
4941,11.846500000001933,4607.7,70,19,0,89
4942,2.7165000000003756,2094.8125,32,36,5,68
4943,-3.4274999999987728,3190.35,42,23,0,65
4944,-13.19125000000005,2198.8888888888887,35,46,1,81
4945,9.014750000000546,3485.8947368421054,62,30,4,92
4946,-0.13224999999854514,4274.35,56,22,0,78
4947,31.653000000001754,4267.0,86,24,1,110
4948,12.59725000000101,3819.157894736842,62,18,0,80
4949,-5.449249999998514,2383.294117647059,52,33,4,85
4950,-5.463249999999474,1882.4375,36,35,10,71
4951,-2.159749999999019,3781.0,84,31,5,115
4952,9.508750000001351,3826.842105263158,51,31,0,82
4953,-27.167499999999784,1959.5263157894738,17,19,14,36
4954,-24.44924999999923,2857.625,31,34,7,65
4955,11.38250000000169,3571.85,58,24,0,82
4956,20.44150000000106,3784.6,44,32,2,76
4957,-3.0772499999987457,3854.4,52,28,0,80
4958,17.933750000000924,3726.7,48,31,1,79
4959,-0.9204999999988244,2057.0,43,25,0,68
4960,-13.431499999999014,2643.5,36,34,10,70
4961,9.86800000000168,3464.277777777778,59,31,2,90
4962,31.76325000000163,4557.736842105263,81,33,1,114
4963,26.76600000000146,4075.684210526316,59,31,1,90
4964,-0.24399999999908256,2452.9444444444443,35,31,1,66
4965,-8.861499999998905,1933.9375,40,32,1,72
4966,17.545000000001114,4290.25,66,28,1,94
4967,11.996250000001414,3903.7,57,32,0,89
4968,-20.79575000000001,1804.125,30,46,3,76
4969,14.242500000001467,2864.5625,62,17,1,79
4970,-25.18174999999942,2548.0,32,31,1,63
4971,10.419750000001482,3084.133333333333,58,20,0,78
4972,-11.49850000000007,1429.0,22,33,4,55
4973,-12.730749999999357,2571.9,32,26,4,58
4974,21.067500000001257,4997.25,59,41,0,100
4975,2.475000000001722,2046.1875,52,19,3,71
4976,31.765250000001306,3872.6666666666665,81,30,2,111
4977,-28.800499999999694,2034.7894736842106,14,31,6,45
4978,8.538750000001187,4111.578947368421,57,24,2,81
4979,-6.553749999999208,2562.5333333333333,34,26,4,60
4980,-2.20074999999862,2957.764705882353,55,29,3,84
4981,-16.768749999999805,2463.3684210526317,29,32,17,61
4982,33.13125000000106,4175.055555555556,80,22,0,102
4983,-2.047749999998748,3222.75,43,29,0,72
4984,0.009250000001246228,3488.4736842105262,43,35,0,78
4985,3.9632500000002984,2396.3125,52,25,1,77
4986,0.8452500000006694,3303.842105263158,39,38,2,77
4987,9.616500000001965,4429.05,62,31,0,93
4988,10.131500000000807,3493.4210526315787,57,20,4,77
4989,25.485750000000355,3697.2105263157896,56,36,2,92
4990,-8.568749999999353,2608.470588235294,32,22,1,54
4991,-11.232499999999257,2524.45,26,28,1,54
4992,31.09800000000098,4522.7,71,17,0,88
4993,-8.054750000000062,2633.6111111111113,33,35,9,68
4994,31.373000000001753,2784.3125,68,19,2,87
4995,-9.513499999999137,2546.8947368421054,26,30,3,56
4996,23.451750000000775,3329.6315789473683,65,24,2,89
4997,25.226000000002177,2430.0,63,21,3,84
4998,-19.67999999999943,2648.2,35,38,2,73
4999,15.13350000000089,2400.5333333333333,59,24,3,83
5000,-7.037249999998477,3096.6315789473683,41,35,5,76
5001,10.894000000000789,2626.2105263157896,41,27,1,68
5002,19.290500000001757,5250.55,74,21,1,95
5003,-12.146249999999604,2940.2,26,30,3,56
5004,-20.9612499999995,2760.0,20,37,3,57
5005,-2.171999999998919,3927.45,55,26,1,81
5006,-21.220249999999798,2003.842105263158,16,26,6,42
5007,8.856000000000773,2772.4375,58,13,1,71
5008,-1.195249999999275,3210.0,33,33,1,66
5009,-26.217999999999723,2040.1,12,27,5,39
5010,2.7730000000006494,2277.25,53,34,2,87
5011,15.659000000001356,3867.7894736842104,67,24,0,91
5012,0.010500000000612797,3052.15,33,26,0,59
5013,3.657000000001428,2989.0,52,30,2,82
5014,1.0015000000019274,2415.4,54,36,3,90
5015,-11.826000000000304,1429.0,28,42,1,70
5016,-9.139499999998918,1987.5625,46,26,4,72
5017,26.564500000001566,5678.3,76,22,0,98
5018,15.16475000000101,3767.4736842105262,51,28,4,79
5019,16.097000000000765,3667.2,50,25,2,75
5020,-29.672749999999894,1992.0588235294117,25,33,9,58
5021,33.80475000000089,4504.55,63,26,1,89
5022,-24.467749999999647,1956.3157894736842,10,32,4,42
5023,17.26874999999996,3072.529411764706,54,26,3,80
5024,-7.95924999999894,3170.4,46,18,1,64
5025,23.879500000000874,3445.0555555555557,72,34,1,106
5026,-0.26674999999857363,3851.3,52,30,0,82
5027,9.243500000001195,3390.3888888888887,53,23,1,76
5028,19.13850000000152,3323.705882352941,70,16,4,86
5029,18.773500000001384,4066.6315789473683,69,19,2,88
5030,8.92600000000086,3195.0,37,30,3,67
5031,-18.781999999999687,2404.0588235294117,33,41,5,74
5032,12.478250000001005,4456.8,54,29,0,83
5033,-8.32024999999944,2610.75,33,24,0,57
5034,-25.804749999999615,1963.7894736842106,17,24,4,41
5035,16.667500000001773,4630.65,67,29,0,96
5036,-3.2332500000001807,2003.111111111111,48,29,4,77
5037,20.752250000001037,2953.0,64,35,0,99
5038,-10.547999999999735,1957.2777777777778,22,27,4,49
5039,5.732250000000702,2355.625,58,33,3,91
5040,-7.372249999998715,2738.785714285714,45,25,2,70
5041,-1.0859999999991812,2619.6666666666665,39,29,0,68
5042,11.935000000001368,2589.9333333333334,59,24,0,83
5043,-10.89624999999902,3501.684210526316,42,43,2,85
5044,3.9810000000023384,1964.0,47,28,8,75
5045,-14.659749999999534,1999.6315789473683,17,31,2,48
5046,8.991750000001776,3603.65,62,19,0,81
5047,-12.55724999999925,2148.1176470588234,27,28,5,55
5048,-1.5559999999994372,3216.4,43,31,0,74
5049,11.901000000001604,4395.75,68,20,1,88
5050,-28.545999999999545,2024.3,15,27,1,42
5051,-6.713749999999561,1960.875,44,31,1,75
5052,-24.87575000000009,1429.0,15,35,9,50
5053,-8.213249999999542,2459.9444444444443,35,23,2,58
5054,10.756000000001222,3575.85,57,13,1,70
5055,-13.931499999998104,3177.722222222222,52,39,1,91
5056,-12.962250000000079,1812.9375,35,34,4,69
5057,-27.09050000000017,1429.0,2,33,4,35
5058,14.349250000001424,2619.5555555555557,47,29,2,76
5059,-7.458749999999577,2536.722222222222,31,26,6,57
5060,27.577000000001874,3436.1111111111113,63,25,0,88
5061,1.4110000000008907,2884.0,39,32,3,71
5062,22.69950000000196,4135.4,66,25,1,91
5063,13.878750000000403,3034.7368421052633,58,21,1,79
5064,17.11425000000162,2780.3125,68,17,1,85
5065,1.097000000001022,4411.65,57,29,2,86
5066,10.04650000000131,3629.6315789473683,47,27,1,74
5067,5.075250000001437,3095.75,52,19,0,71
5068,0.5372499999998512,2576.4444444444443,47,30,1,77
5069,17.262500000001353,3353.4117647058824,59,23,0,82
5070,-2.1697499999989356,2796.777777777778,40,23,0,63
5071,-14.040249999999451,2433.5,32,29,13,61
5072,-10.836249999999241,2471.0588235294117,44,34,2,78
5073,15.70825000000101,4306.210526315789,79,37,1,116
5074,-24.381999999999607,1967.0,13,28,7,41
5075,6.757750000000231,2790.4117647058824,50,25,1,75
5076,24.670000000001703,2502.9411764705883,57,26,2,83
5077,13.732250000001281,4069.55,59,20,1,79
5078,9.561500000000446,2961.315789473684,42,25,2,67
5079,-28.39074999999955,2040.2,21,24,0,45
5080,41.958750000001814,4655.3,75,19,1,94
5081,-8.473249999999373,2803.375,26,31,1,57
5082,1.5642500000003712,2572.0,30,29,0,59
5083,14.839750000001867,4004.55,61,33,0,94
5084,14.89400000000106,2932.777777777778,63,25,4,88
5085,-9.411999999999864,2528.8333333333335,46,37,1,83
5086,34.58900000000255,5056.9,86,16,0,102
5087,-12.4357499999998,1884.4375,33,34,5,67
5088,17.188750000000862,3249.1111111111113,57,23,6,80
5089,-4.282999999998886,3785.4,42,29,0,71
5090,-20.15949999999859,2580.9375,37,27,1,64
5091,14.300750000001594,3828.35,56,23,2,79
5092,-28.871750000000127,1429.0,19,30,4,49
5093,29.774750000001813,5214.8,75,24,1,99
5094,7.464000000001036,2539.3125,51,29,1,80
5095,-0.4702499999988829,3785.45,55,32,0,87
5096,16.54900000000176,4302.9473684210525,76,35,0,111
5097,-9.749999999999584,2552.15,30,24,2,54
5098,8.610000000001836,5267.95,71,32,3,103
5099,4.439250000001479,2401.25,41,27,0,68
5100,20.033500000001403,2200.4666666666667,69,34,0,103
5101,-10.841749999999411,2526.3529411764707,38,22,5,60
5102,-1.2739999999997376,2005.235294117647,41,27,2,68
5103,28.495500000001137,5064.75,71,27,0,98
5104,5.816750000000617,3140.842105263158,46,23,1,69
5105,-4.925749999999375,2421.0555555555557,33,26,0,59
5106,-18.488499999999853,1967.0526315789473,17,24,14,41
5107,9.167750000000689,2581.6111111111113,43,22,3,65
5108,-20.36149999999984,1997.157894736842,18,23,7,41
5109,21.178500000001918,5364.05,72,34,0,106
5110,2.2735000000006695,2647.777777777778,37,23,0,60
5111,17.79050000000132,3045.1875,68,27,0,95
5112,-11.22249999999905,3576.8947368421054,46,32,0,78
5113,-10.187999999999382,2455.5,38,28,1,66
5114,-21.110249999999738,2028.25,17,31,1,48
5115,22.48375000000171,4357.722222222223,80,19,1,99
5116,10.06925000000034,3039.277777777778,43,27,4,70
5117,38.286500000001986,4718.9473684210525,91,23,2,114
5118,-12.78149999999967,1963.1176470588234,41,26,5,67
5119,2.187000000002052,2726.6875,63,24,0,87
5120,16.708250000001794,4513.95,76,16,0,92
5121,-27.831249999999482,2380.470588235294,34,27,3,61
5122,-8.078249999999363,1975.235294117647,27,40,1,67
5123,16.040250000001194,3765.0,58,29,1,87
5124,4.48775000000081,3390.9333333333334,42,27,0,69
5125,7.957750000000706,4180.9473684210525,60,25,1,85
5126,54.07200000000224,5813.95,107,15,0,122
5127,-12.961249999999676,1971.6875,28,25,1,53
5128,21.00150000000132,4718.75,71,21,0,92
5129,-3.7092499999992947,2615.4736842105262,28,25,4,53
5130,-22.385499999999727,2817.8888888888887,34,32,7,66
5131,4.377250000001414,3699.75,55,22,0,77
5132,-4.076749999998929,3675.0,45,39,1,84
5133,16.961250000001364,4246.5,62,25,1,87
5134,-11.398249999999482,2623.7368421052633,22,36,1,58
5135,-21.360249999999464,2521.5882352941176,35,22,9,57
5136,10.400750000001768,3968.842105263158,68,22,4,90
5137,13.943750000001236,4248.631578947368,57,37,0,94
5138,-3.161499999998829,2976.4210526315787,40,26,4,66
5139,-9.969999999999596,2179.125,32,35,0,67
5140,1.9942500000011445,3071.95,47,24,1,71
5141,-16.86449999999962,2146.55,20,32,1,52
5142,32.62650000000214,4706.05,73,25,0,98
5143,-18.96874999999915,2867.15,35,25,2,60
5144,-31.653499999999422,2008.45,19,29,2,48
5145,-20.977249999999025,2120.3333333333335,27,32,1,59
5146,-11.189499999998786,2657.8,36,22,0,58
5147,-7.701249999999786,1975.235294117647,36,29,5,65
5148,17.193000000002236,3375.277777777778,76,12,0,88
5149,9.086750000000976,3413.9473684210525,51,16,0,67
5150,9.22350000000127,3893.5263157894738,65,19,1,84
5151,-20.719999999999295,2373.4444444444443,39,33,1,72
5152,-15.332499999998124,4325.8,52,40,2,92
5153,-2.5022499999986403,4037.75,55,27,1,82
5154,23.891500000002246,4729.2,79,19,0,98
5155,19.469000000001778,3614.8823529411766,73,20,0,93
5156,24.194500000002506,5052.1,84,16,1,100
5157,-15.93099999999968,2401.777777777778,34,30,4,64
5158,-4.1814999999989535,3284.7,46,29,1,75
5159,-25.891999999999523,2111.65,22,19,6,41
5160,-17.07099999999961,1895.8823529411766,23,29,12,52
5161,4.66750000000112,3556.9444444444443,58,26,1,84
5162,-13.658749999999651,2064.7368421052633,28,30,8,58
5163,-30.33174999999981,1429.0,27,35,5,62
5164,0.858000000000863,3156.9,43,22,2,65
5165,-6.32149999999874,3711.4736842105262,51,20,9,71
5166,-19.032749999999425,2726.176470588235,30,23,1,53
5167,-7.037749999998904,3431.6315789473683,44,29,1,73
5168,-19.292249999999292,2022.9473684210527,26,22,10,48
5169,-10.933249999999035,2536.25,37,21,0,58
5170,-17.25999999999958,2221.823529411765,25,28,2,53
5171,34.6877500000016,4706.85,74,22,0,96
5172,19.379250000000855,4152.9,64,24,0,88
5173,-0.9454999999991239,2493.6666666666665,43,21,1,64
5174,19.461750000001256,4226.75,62,28,0,90
5175,-3.1529999999989236,2563.529411764706,42,24,3,66
5176,25.805500000001746,4282.3,81,13,0,94
5177,-3.695249999999537,2648.266666666667,37,26,1,63
5178,8.502750000001175,3516.0526315789475,53,26,1,79
5179,-29.989999999999363,1996.3684210526317,19,29,3,48
5180,-20.07324999999966,2052.1,19,25,1,44
5181,-8.04149999999835,3121.684210526316,40,28,2,68
5182,-7.8547499999993295,2704.45,27,31,3,58
5183,23.442000000002558,4554.421052631579,88,18,1,106
5184,4.785750000001039,3423.2631578947367,58,19,0,77
5185,-8.901499999999851,2423.777777777778,28,20,5,48
5186,-8.789249999998805,3126.6470588235293,66,27,2,93
5187,-6.376999999999269,2629.0,37,25,0,62
5188,-0.290499999997619,3866.7894736842104,66,20,5,86
5189,22.875500000002198,2863.625,70,16,1,86
5190,-7.3832499999988075,2484.157894736842,26,31,4,57
5191,21.849000000000615,2995.5625,68,21,3,89
5192,-1.9232499999995039,3107.65,45,21,1,66
5193,-13.5612499999994,2708.3529411764707,33,23,1,56
5194,5.273250000000507,2999.7368421052633,50,23,3,73
5195,-21.035999999999813,2138.0,21,21,4,42
5196,7.520250000001198,4126.75,55,25,4,80
5197,16.052000000001353,2755.0,62,23,1,85
5198,-35.676249999999484,2168.529411764706,23,40,5,63
5199,-4.2332499999991535,2608.294117647059,33,24,0,57
5200,5.843250000001027,3101.3,40,24,0,64
5201,5.263750000001138,2530.375,46,27,0,73
5202,-22.919999999999874,1978.6875,27,27,9,54
5203,9.509000000001377,4944.2,64,27,0,91
5204,-4.028999999998984,2738.75,33,30,0,63
5205,7.085250000001212,3024.4444444444443,54,28,1,82
5206,-6.040749999998745,2526.1176470588234,40,28,0,68
5207,40.72775000000132,5568.8,77,20,1,97
5208,21.11400000000101,5402.1,69,24,0,93
5209,30.25475000000277,4223.631578947368,87,20,0,107
5210,15.020250000001212,4183.05,55,26,1,81
5211,3.345500000000398,3891.1052631578946,53,39,4,92
5212,23.939250000001152,2569.866666666667,69,25,1,94
5213,26.280000000002115,3330.176470588235,86,22,1,108
5214,-11.592749999999613,3115.6,31,26,1,57
5215,-7.092499999999484,1795.0588235294117,34,29,6,63
5216,-7.561749999997941,3821.1,60,24,1,84
5217,10.90300000000141,4536.3,55,30,0,85
5218,8.337750000000717,3257.7894736842104,57,27,3,84
5219,31.797250000001288,5958.45,82,27,1,109
5220,-1.972499999999534,2344.75,38,28,5,66
5221,-3.4999999999991958,2619.6666666666665,33,26,1,59
5222,-25.213749999999354,2184.3684210526317,21,23,1,44
5223,29.106500000001272,3993.7368421052633,63,27,0,90
5224,-21.70274999999974,1997.157894736842,16,28,7,44
5225,-6.49474999999929,2851.0714285714284,35,31,1,66
5226,-4.4377499999987275,2992.315789473684,48,23,2,71
5227,28.13450000000136,4923.6,74,24,1,98
5228,16.00600000000035,3206.8888888888887,70,31,1,101
5229,8.905500000001567,3683.0,68,29,0,97
5230,-18.059249999999487,2099.65,20,25,7,45
5231,-3.3464999999992138,2952.8333333333335,47,28,2,75
5232,42.85575000000309,3916.0,90,22,1,112
5233,-30.808999999999816,2052.1,16,23,4,39
5234,9.275750000002361,4300.421052631579,77,17,3,94
5235,-5.073749999999821,2404.0,35,31,0,66
5236,1.6765000000017753,3818.4736842105262,63,22,1,85
5237,-28.74124999999949,2076.5263157894738,20,24,3,44
5238,-33.20649999999967,1429.0,11,40,3,51
5239,2.7510000000009716,2783.1875,49,30,0,79
5240,-14.802499999999265,2472.1666666666665,39,31,9,70
5241,16.6042500000018,4391.8,58,36,2,94
5242,-2.4577499999993906,2528.3,34,21,5,55
5243,5.9955000000013845,4229.05,68,16,2,84
5244,12.731000000001018,3550.157894736842,54,38,0,92
5245,-5.143749999999147,3560.1,43,27,2,70
5246,-23.4924999999997,2028.25,17,27,0,44
5247,6.089000000001905,4080.0,67,23,1,90
5248,-6.285999999999344,3066.4736842105262,44,21,1,65
5249,2.9890000000011048,3164.85,44,21,1,65
5250,-7.375249999999076,3071.85,36,26,2,62
5251,4.961250000000716,3149.8,49,23,3,72
5252,-12.307749999999357,1983.7222222222222,22,29,4,51
5253,0.1322500000002284,2304.0625,58,40,2,98
5254,16.721500000001676,3061.714285714286,62,29,0,91
5255,27.220750000000614,3251.0,73,26,0,99
5256,17.643500000001712,3623.65,54,22,3,76
5257,9.345250000001263,3900.315789473684,64,21,1,85
5258,3.72525000000159,4358.0,76,16,4,92
5259,-19.224999999999408,2526.0526315789475,26,29,7,55
5260,-8.062499999999375,1925.125,35,28,3,63
5261,-8.547999999998753,3671.1,45,35,1,80
5262,-17.46824999999982,2102.4210526315787,24,24,2,48
5263,11.242250000001237,2694.294117647059,55,24,1,79
5264,9.508500000001359,4425.1,51,35,2,86
5265,-21.29400000000026,1429.0,34,26,10,60
5266,-28.986499999999346,2068.2631578947367,19,27,4,46
5267,-13.54599999999952,2833.8888888888887,39,32,0,71
5268,-2.173249999998089,3572.05,50,26,2,76
5269,26.256250000002346,4860.05,88,14,1,102
5270,-1.538499999998912,2336.6470588235293,38,33,0,71
5271,19.092500000001344,2502.8823529411766,72,37,0,109
5272,-38.452500000000065,1429.0,2,26,6,28
5273,15.71350000000128,3823.5,55,27,3,82
5274,24.85225000000154,2634.3125,79,31,5,110
5275,40.01175000000184,4252.894736842105,97,17,1,114
5276,-12.326749999999105,2563.0625,33,27,2,60
5277,-19.98299999999964,2100.7368421052633,29,24,1,53
5278,18.59200000000231,4695.05,69,36,0,105
5279,-17.40974999999937,2657.6,28,24,1,52
5280,-10.705999999999595,1948.235294117647,29,19,3,48
5281,21.098000000001853,3501.9411764705883,65,26,1,91
5282,-3.9804999999982926,3146.6,40,35,1,75
5283,-27.92474999999896,2844.95,33,32,4,65
5284,-20.276499999999658,1429.0,25,19,10,44
5285,9.356249999999987,2500.5,69,31,0,100
5286,13.944250000001364,3202.0,55,23,1,78
5287,9.44175000000079,3461.684210526316,46,30,6,76
5288,21.942750000002384,5326.8,81,16,7,97
5289,1.5572500000012368,2774.9285714285716,48,25,2,73
5290,12.520750000000808,4448.2,63,30,2,93
5291,-0.5809999999988567,3269.6,46,19,2,65
5292,-3.3172499999994853,2391.0666666666666,55,21,3,76
5293,5.623750000000524,2381.470588235294,50,32,2,82
5294,-15.920749999999321,2491.6315789473683,30,32,5,62
5295,-11.90224999999905,2708.6,29,30,1,59
5296,5.483250000001257,2345.9411764705883,58,39,1,97
5297,-22.360749999999264,2117.4210526315787,23,25,4,48
5298,23.618250000001453,4928.45,61,29,0,90
5299,39.63325000000206,5060.85,63,38,0,101
5300,-9.730749999999466,2467.777777777778,50,32,5,82
5301,7.806000000001475,4099.85,57,30,0,87
5302,10.140000000001185,3948.5789473684213,54,28,1,82
5303,16.72575000000193,4296.55,60,29,2,89
5304,-6.597249999999344,2201.0,27,21,5,48
5305,-9.922749999999672,2944.9444444444443,43,45,2,88
5306,-6.688499999999652,2907.0555555555557,40,27,3,67
5307,-3.6224999999992065,3091.8,38,24,2,62
5308,-16.340999999999333,2125.375,33,30,2,63
5309,17.546750000001378,2039.3333333333333,44,28,1,72
5310,2.2822500000022137,2803.470588235294,92,32,4,124
5311,0.30675000000122693,3529.4210526315787,56,17,2,73
5312,-12.502999999999053,2703.6470588235293,32,27,2,59
5313,-9.586249999999556,1845.4705882352941,40,28,2,68
5314,1.1822500000005907,2830.8947368421054,42,36,0,78
5315,16.54000000000139,3753.75,58,22,3,80
5316,-1.5337499999994182,3508.4736842105262,68,31,2,99
5317,4.282750000002733,2369.3529411764707,56,29,6,85
5318,-4.952749999999221,2544.25,31,27,0,58
5319,-3.4997499999988166,3190.15,46,19,1,65
5320,12.843750000001569,1891.5333333333333,58,35,2,93
5321,-4.9929999999996575,2978.0,27,33,0,60
5322,-12.085749999999567,2536.0,30,31,0,61
5323,21.060000000001203,2472.6,62,19,2,81
5324,-3.3997499999999548,2063.0,49,30,3,79
5325,-12.239249999999235,4075.9,41,33,2,74
5326,5.207250000001438,3627.55,56,24,2,80
5327,-2.429499999998959,3092.65,51,19,0,70
5328,29.893750000001422,3124.764705882353,69,21,0,90
5329,24.04725000000275,4710.9,84,23,0,107
5330,-15.808500000000171,1429.0,21,33,4,54
5331,-18.951749999998828,1940.7058823529412,30,32,1,62
5332,-5.9992499999998525,2370.235294117647,44,43,1,87
5333,49.00425000000123,4329.444444444444,82,18,1,100
5334,21.236750000001365,4446.6,64,30,1,94
5335,-11.156999999999114,2539.3333333333335,39,23,2,62
5336,-20.452249999999758,2202.1176470588234,25,33,0,58
5337,-10.342249999999414,2657.8,36,30,1,66
5338,-14.17749999999821,2244.5,38,28,2,66
5339,6.386250000001324,3412.294117647059,66,25,0,91
5340,-7.455249999999568,1977.5555555555557,33,23,4,56
5341,21.398250000001156,4343.105263157895,65,23,3,88
5342,-1.501499999999598,2548.3,33,26,0,59
5343,7.051250000001185,3339.1111111111113,64,21,0,85
5344,3.4712499999997397,2484.722222222222,46,28,13,74
5345,39.16775000000211,5368.75,99,15,1,114
5346,-18.19724999999969,2036.25,16,31,0,47
5347,-12.87024999999954,3678.6111111111113,46,38,3,84
5348,10.38600000000024,4288.55,44,30,0,74
5349,-22.843750000000334,1429.0,10,29,4,39
5350,3.3247500000003476,3825.1,50,22,1,72
5351,-10.523749999998902,2512.294117647059,28,38,0,66
5352,11.306250000000677,2884.5625,54,17,0,71
5353,-11.239749999999082,2621.9,28,31,0,59
5354,-14.55624999999963,2004.7777777777778,34,25,5,59
5355,6.517749999999928,2546.7894736842104,64,25,1,89
5356,6.576250000001048,3484.6111111111113,71,26,1,97
5357,-11.392999999999438,2559.4736842105262,34,21,0,55
5358,1.6245000000009155,3162.5789473684213,45,26,1,71
5359,-12.031999999999414,2653.714285714286,32,24,1,56
5360,-32.512749999999585,2683.05,24,31,1,55
5361,17.88650000000107,2064.0,56,32,2,88
5362,-27.160499999999626,1917.611111111111,25,25,6,50
5363,-1.9457499999988734,2673.230769230769,45,28,1,73
5364,23.054750000000737,2335.9375,71,31,2,102
5365,24.0077500000011,4049.7894736842104,72,28,0,100
5366,23.291250000001185,4694.9,66,21,0,87
5367,7.716000000000537,2471.4444444444443,44,25,2,69
5368,-11.26574999999949,2504.0,31,25,0,56
5369,9.479250000000661,2518.375,49,26,7,75
5370,-10.775249999999323,2622.7,30,27,1,57
5371,8.511499999999957,2589.75,57,27,0,84
5372,8.145250000000862,2646.133333333333,46,21,0,67
5373,13.379250000001203,3068.05,55,20,0,75
5374,-25.295749999999686,2068.0526315789475,16,28,2,44
5375,-18.900249999999904,2517.6315789473683,30,25,4,55
5376,-19.08724999999783,4073.5,53,41,0,94
5377,-15.086249999999177,2509.4375,29,25,0,54
5378,32.09175000000168,2556.230769230769,67,21,1,88
5379,-3.4634999999991765,3243.35,50,16,0,66
5380,24.903250000001883,3724.7368421052633,64,27,3,91
5381,-21.274999999999526,2656.2631578947367,30,31,2,61
5382,-34.9410000000005,1429.0,19,40,11,59
5383,-25.02599999999965,2042.2105263157894,20,26,3,46
5384,-9.452249999999628,2683.85,25,31,1,56
5385,-29.421749999999697,1959.4736842105262,14,28,14,42
5386,6.227000000000517,3087.8333333333335,57,21,0,78
5387,41.706750000001534,5250.55,88,13,0,101
5388,-0.8989999999994817,2134.4375,55,43,1,98
5389,6.430000000001395,4051.4,49,29,0,78
5390,2.873000000001523,3045.842105263158,51,26,0,77
5391,14.159750000001324,4191.055555555556,79,37,1,116
5392,-14.094249999999159,3104.157894736842,46,22,0,68
5393,-18.152499999999137,2636.3333333333335,36,28,0,64
5394,4.705000000000501,2398.3529411764707,41,35,0,76
5395,14.622750000001883,5205.35,68,31,2,99
5396,1.112750000000906,3126.85,43,22,0,65
5397,-7.382999999999507,2612.0526315789475,31,29,0,60
5398,32.30875000000195,3613.3333333333335,72,16,1,88
5399,26.048500000001546,4450.45,75,22,0,97
5400,-21.151249999999926,2074.842105263158,17,30,6,47
5401,22.23350000000131,3759.5882352941176,90,22,0,112
5402,-2.6849999999996017,2510.0526315789475,49,25,2,74
5403,12.002500000001058,3519.315789473684,55,26,0,81
5404,1.7607500000002019,2139.375,56,29,1,85
5405,7.954000000001348,3615.7,52,22,2,74
5406,6.325750000000862,2548.0,51,23,0,74
5407,-15.110499999999444,1839.8125,36,19,4,55
5408,-6.495749999999189,1983.7222222222222,35,30,0,65
5409,-19.228499999999666,2008.5,11,37,1,48
5410,-21.55949999999884,2868.1666666666665,38,34,0,72
5411,4.428000000001079,3191.875,60,23,2,83
5412,1.0182500000008106,2671.5555555555557,40,29,2,69
5413,-2.862749999998843,3107.6,46,18,1,64
5414,-14.513249999999616,2771.9,34,24,0,58
5415,1.6610000000010483,3039.277777777778,52,31,0,83
5416,19.41000000000154,2348.6,58,26,1,84
5417,10.144500000001175,4305.45,60,21,0,81
5418,-25.612999999999964,2026.888888888889,15,34,1,49
5419,-7.0172499999991755,2648.266666666667,27,33,1,60
5420,9.539500000001016,3650.4210526315787,45,31,1,76
5421,9.746500000001438,2946.0,61,22,0,83
5422,10.200500000001362,3572.05,57,18,0,75
5423,6.525500000000614,4481.4,47,34,1,81
5424,33.15925000000205,5790.15,70,28,0,98
5425,23.442750000000494,4150.8421052631575,51,33,0,84
5426,3.40125000000042,2623.625,37,22,0,59
5427,6.506750000001233,3348.9,50,26,1,76
5428,-12.826499999999214,2544.6666666666665,28,25,1,53
5429,10.59025000000155,3792.222222222222,60,15,0,75
5430,13.653250000001751,3564.1,51,26,0,77
5431,8.161500000000807,3119.5,46,22,0,68
5432,5.851500000000563,3009.7894736842104,44,27,1,71
5433,8.466250000001468,2337.705882352941,47,29,1,76
5434,35.29375000000162,2960.9375,82,19,1,101
5435,-5.306499999998417,3190.95,53,20,2,73
5436,-3.4189999999989524,3037.315789473684,51,20,0,71
5437,16.217750000000823,4561.55,61,29,0,90
5438,14.265750000001251,4254.4,64,30,0,94
5439,-32.933999999999855,1429.0,11,36,4,47
5440,-26.532499999999555,2094.1052631578946,19,31,7,50
5441,-15.8482499999993,2548.15,34,23,0,57
5442,-7.2967499999987595,2735.684210526316,34,39,2,73
5443,6.539750000001261,2583.6666666666665,48,23,1,71
5444,0.42675000000096314,2130.4375,56,35,1,91
5445,-0.5602499999988951,2393.375,41,34,0,75
5446,-5.306749999998738,2988.3529411764707,50,13,1,63
5447,-13.359749999999655,2393.4375,55,46,0,101
5448,-7.4197499999992615,2581.5333333333333,27,28,0,55
5449,-1.878249999998734,3748.85,51,27,1,78
5450,-25.61249999999962,2059.842105263158,19,25,2,44
5451,1.8542500000010746,2555.1176470588234,55,24,2,79
5452,-22.932499999999518,1505.2,45,41,7,86
5453,19.50850000000097,3483.8888888888887,58,19,1,77
5454,-0.16024999999890407,2654.6,41,30,0,71
5455,-12.25899999999932,2736.6875,37,28,2,65
5456,-3.942499999999447,2232.75,33,35,0,68
5457,-21.656249999999456,2032.25,17,29,2,46
5458,-18.645249999999333,2022.75,18,30,0,48
5459,-4.749249999998212,2291.25,55,34,0,89
5460,-5.81199999999792,4173.388888888889,60,41,1,101
5461,-13.930499999999242,2524.35,28,24,0,52
5462,-10.20074999999931,2445.842105263158,27,28,2,55
5463,11.192250000000708,3192.722222222222,50,28,0,78
5464,16.53725000000092,3207.0,81,29,3,110
5465,41.844000000002175,5413.95,88,21,0,109
5466,6.698750000000944,3540.222222222222,56,26,5,82
5467,2.250000000001699,2166.1875,60,22,2,82
5468,27.65550000000144,4875.2,79,20,1,99
5469,6.808500000000933,2491.5625,47,26,0,73
5470,-22.85724999999945,1946.8125,31,21,7,52
5471,13.117500000000746,3962.35,48,29,0,77
5472,-2.862999999999012,3403.75,43,27,0,70
5473,-1.6112499999991141,2977.0526315789475,54,18,1,72
5474,0.7175000000011752,3259.8888888888887,43,23,2,66
5475,21.982250000001144,3948.0,59,28,0,87
5476,9.881500000001353,3405.6315789473683,53,35,0,88
5477,-11.009249999999264,2055.6470588235293,29,29,3,58
5478,-5.409499999998718,3243.3,48,27,0,75
5479,16.510500000001564,3914.4736842105262,70,21,2,91
5480,9.979500000001478,3114.4117647058824,71,29,2,100
5481,-17.495749999999692,2008.5,11,32,2,43
5482,3.6097500000003975,2873.5882352941176,48,30,1,78
5483,0.6887500000010482,3147.3,38,35,0,73
5484,-1.471499999999579,2403.823529411765,45,39,0,84
5485,-10.487999999999321,2482.625,54,25,1,79
5486,26.228250000001644,2032.1875,63,33,1,96
5487,0.965750000000799,3009.0,45,18,0,63
5488,-14.344749999999152,2470.842105263158,34,27,5,61
5489,9.255000000001257,2744.6470588235293,66,29,7,95
5490,-2.6147499999982498,3591.9,54,25,0,79
5491,32.9727500000014,5102.95,67,27,0,94
5492,6.519250000001028,3207.722222222222,50,27,2,77
5493,-6.630249999999409,2552.9333333333334,30,24,1,54
5494,33.32450000000241,3274.3125,73,26,0,99
5495,4.208750000000944,5271.1,60,36,1,96
5496,6.469250000000956,2965.222222222222,39,35,0,74
5497,-11.08999999999891,2518.375,31,29,0,60
5498,26.189500000001363,5337.9,78,34,0,112
5499,1.6530000000013512,3544.4736842105262,51,34,1,85
5500,20.89775000000225,4206.888888888889,82,27,0,109
5501,-0.19549999999916254,3323.5,40,34,0,74
5502,11.39650000000163,3701.764705882353,73,29,1,102
5503,-1.078249999999334,2536.1875,45,42,0,87
5504,-16.456749999999438,2855.157894736842,32,32,0,64
5505,12.964250000002341,4196.0526315789475,83,31,6,114
5506,24.537000000001385,5693.4,70,28,0,98
5507,16.32425000000205,4352.9,66,25,0,91
5508,-0.2587499999989949,2462.8125,42,26,0,68
5509,-32.366000000000184,1959.578947368421,16,28,12,44
5510,-12.615999999999236,2485.6111111111113,24,41,1,65
5511,-3.1552499999989703,2731.470588235294,42,33,1,75
5512,62.553500000002714,6239.4,98,24,0,122
5513,14.131000000002235,4571.25,59,47,0,106
5514,25.584500000001142,3663.9473684210525,67,27,1,94
5515,-24.082750000000022,1976.6666666666667,20,37,2,57
5516,-19.74524999999933,1996.888888888889,24,27,3,51
5517,-18.956749999999708,1996.3157894736842,13,34,0,47
5518,-13.602749999999137,2663.777777777778,26,26,1,52
5519,-10.275249999999673,2493.4210526315787,54,27,4,81
5520,-13.819249999999093,3798.1,48,30,1,78
5521,10.711500000001603,4410.684210526316,67,23,0,90
5522,-0.3437499999984526,3445.842105263158,49,32,0,81
5523,-2.3117499999987947,2866.5555555555557,52,33,1,85
5524,-9.084249999999846,2819.2631578947367,35,41,3,76
5525,27.57525000000038,2261.4375,76,30,0,106
5526,6.751250000001565,3516.9473684210525,47,32,0,79
5527,2.7235000000016973,2425.0,60,34,5,94
5528,-18.164999999999246,2602.8947368421054,30,21,0,51
5529,-4.816499999999249,3350.4736842105262,54,26,5,80
5530,4.267750000001092,2148.0,38,26,1,64
5531,21.64300000000182,2387.4375,61,24,0,85
5532,16.17775000000031,2616.0,60,38,0,98
5533,5.064750000001358,3962.25,50,31,1,81
5534,21.01550000000172,4252.1,68,21,1,89
5535,-9.743249999999339,2581.5333333333333,40,24,2,64
5536,-16.627749999999477,3104.2105263157896,37,36,0,73
5537,-19.88249999999909,2544.1,32,19,4,51
5538,-25.160249999999326,2000.4375,32,47,2,79
5539,-10.86449999999899,2429.0555555555557,35,29,0,64
5540,-0.8629999999989604,3128.4,48,22,0,70
5541,11.48800000000051,4026.65,49,27,0,76
5542,17.983750000000672,3663.95,53,23,0,76
5543,-1.1869999999983087,2460.705882352941,53,25,1,78
5544,-16.280249999999324,2490.1052631578946,31,24,1,55
5545,31.494000000001552,5099.0,76,23,0,99
5546,31.657750000001947,4499.65,65,30,0,95
5547,-23.908749999999664,1429.0,14,29,3,43
5548,4.2640000000004745,1481.9333333333334,54,27,3,81
5549,-4.960499999999676,3687.05,36,32,3,68
5550,19.832250000001533,4875.1,65,32,0,97
5551,-11.492499999999422,2475.157894736842,27,28,1,55
5552,35.311250000001905,5191.1,91,22,0,113
5553,-9.434999999999246,2512.0555555555557,42,24,0,66
5554,9.841500000000858,2495.8,44,29,0,73
5555,-17.477749999999634,2572.0714285714284,44,47,0,91
5556,8.450250000000645,3822.7,55,23,0,78
5557,0.3287500000005874,3133.2631578947367,41,32,4,73
5558,11.66025000000226,4148.315789473684,72,17,1,89
5559,11.9227500000011,4266.35,64,20,1,84
5560,-7.418499999998332,3619.55,56,30,0,86
5561,-14.519499999999292,2005.375,28,28,4,56
5562,-18.34974999999951,2794.157894736842,32,34,0,66
5563,11.500250000000689,3013.5882352941176,63,31,1,94
5564,-21.28424999999958,2079.8947368421054,29,31,4,60
5565,-0.07474999999991896,3033.1052631578946,48,20,18,68
5566,11.279000000002078,2129.3529411764707,55,25,0,80
5567,-19.7182499999995,2136.95,21,29,0,50
5568,-26.57199999999984,2075.85,12,29,3,41
5569,6.822250000000906,4516.45,60,30,0,90
5570,10.677500000001713,4611.65,59,27,0,86
5571,4.8367500000006896,2543.4,46,23,1,69
5572,-26.9517500000001,1429.0,22,25,6,47
5573,4.231000000000887,4376.0,51,32,0,83
5574,-14.705749999999417,2690.9444444444443,37,41,0,78
5575,2.161250000000704,3017.1052631578946,43,30,0,73
5576,-22.354249999999208,2560.0,26,34,0,60
5577,16.793500000001398,4764.75,66,21,0,87
5578,-4.558999999999918,1933.4444444444443,45,28,1,73
5579,-21.481749999999032,3000.5555555555557,34,39,0,73
5580,30.089000000002322,5434.65,82,28,0,110
5581,35.00075000000166,5880.7,85,34,0,119
5582,-25.734499999999827,1977.1052631578948,11,39,1,50
5583,18.23900000000129,3627.55,64,19,0,83
5584,-4.564249999998699,3093.315789473684,48,20,1,68
5585,-41.995749999999326,2007.157894736842,20,25,1,45
5586,-9.425499999999767,1997.1052631578948,28,28,12,56
5587,9.95200000000175,3173.133333333333,65,22,0,87
5588,11.934500000002481,3350.722222222222,66,24,0,90
5589,-2.908499999999193,2172.0625,46,20,0,66
5590,35.3937500000017,4131.6,74,24,0,98
5591,7.989000000001525,3585.45,53,29,0,82
5592,6.173000000002338,3037.9411764705883,64,27,0,91
5593,2.635250000000421,2438.6,44,37,0,81
5594,18.878250000000616,2584.4285714285716,54,25,0,79
5595,19.0437500000009,3776.5789473684213,75,30,0,105
5596,-0.7457499999993189,2653.6,38,24,2,62
5597,12.959000000000767,3171.7894736842104,47,25,1,72
5598,22.365000000001366,4737.85,67,22,0,89
5599,10.195750000000794,3117.4736842105262,41,32,1,73
5600,24.793250000002033,4931.5,71,29,0,100
5601,-2.0874999999993795,2571.9375,44,31,0,75
5602,-5.308249999998804,2326.9375,36,30,1,66
5603,10.921500000001084,3890.2,49,28,0,77
5604,22.093250000000758,3778.315789473684,65,28,1,93
5605,-5.413249999999403,2648.266666666667,33,26,0,59
5606,2.0247500000008554,3052.2,46,20,0,66
5607,-9.368999999999328,2923.5,28,29,1,57
5608,-10.438999999999634,2673.8947368421054,38,21,2,59
5609,-10.721999999999705,1954.7058823529412,37,26,0,63
5610,-18.115999999999296,2572.0,30,29,1,59
5611,15.047250000000792,2603.733333333333,57,26,0,83
5612,-5.3499999999984995,3664.85,56,21,0,77
5613,-10.218249999998154,2461.6111111111113,38,27,0,65
5614,2.6605000000008223,2697.0,39,37,5,76
5615,-15.28799999999922,3210.157894736842,35,29,1,64
5616,12.7095000000012,4851.789473684211,64,31,1,95
5617,-25.47649999999961,2206.0,17,37,1,54
5618,-26.013999999999506,2080.65,15,28,0,43
5619,20.312750000001184,5054.35,71,31,0,102
5620,-13.93399999999887,2808.4,36,25,0,61
5621,-18.103249999999324,2447.6111111111113,29,25,0,54
5622,34.43825000000149,4891.105263157895,82,25,0,107
5623,-0.8317499999987261,3835.0526315789475,49,35,0,84
5624,-6.032499999998688,2479.470588235294,36,23,0,59
5625,38.686250000001486,4615.368421052632,90,29,1,119
5626,0.0632500000008834,2476.733333333333,53,24,0,77
5627,21.3480000000009,3162.266666666667,61,24,0,85
5628,-22.069999999999133,2563.125,37,30,0,67
5629,-11.724999999999575,2563.0,42,34,0,76
5630,0.006000000000830052,3273.65,40,24,0,64
5631,-1.483499999999396,3760.7368421052633,64,32,5,96
5632,31.964750000000855,2780.4666666666667,71,30,0,101
5633,0.657000000001551,3152.1,48,26,0,74
5634,9.096750000000759,3037.9473684210525,62,20,1,82
5635,-18.503499999999224,2539.2631578947367,31,28,7,59
5636,-10.590499999999537,2799.75,31,31,0,62
5637,25.506750000001396,4132.526315789473,67,27,1,94
5638,10.536750000001804,4455.3,66,30,0,96
5639,-2.54974999999924,2921.9473684210525,49,22,2,71
5640,-9.051999999999259,2580.9375,35,24,0,59
5641,20.519250000001687,4722.368421052632,88,32,0,120
5642,-5.735999999999973,2164.5555555555557,35,33,0,68
5643,-2.0924999999987515,4143.3,48,35,0,83
5644,27.361750000001837,4008.35,66,18,0,84
5645,-3.0617499999990385,3148.1,40,30,0,70
5646,6.087750000002068,2460.722222222222,47,29,0,76
5647,26.18900000000125,4214.85,59,26,0,85
5648,-16.149499999999293,2421.1666666666665,35,34,2,69
5649,-15.79174999999953,2574.4210526315787,24,39,1,63
5650,-19.886249999998224,3265.8888888888887,46,37,0,83
5651,12.796750000001584,3591.75,48,26,0,74
5652,6.143250000001377,2310.6,51,22,2,73
5653,3.9405000000009074,3072.2631578947367,46,17,0,63
5654,9.41350000000129,3315.176470588235,60,22,0,82
5655,-16.268749999999283,2493.315789473684,36,23,1,59
5656,-16.64599999999968,1429.0,26,35,0,61
5657,-5.546999999999633,2586.2,26,31,0,57
5658,28.863750000001243,4372.75,67,23,0,90
5659,-0.1499999999989859,2518.3125,55,26,0,81
5660,-0.9317499999984392,3824.35,50,30,0,80
5661,-22.38449999999979,2052.1,17,29,0,46
5662,7.22150000000102,3733.05,58,17,0,75
5663,-20.586249999999072,2582.0526315789475,27,32,0,59
5664,15.556250000001281,3729.1,56,24,0,80
5665,-33.18574999999955,2072.7,17,22,1,39
5666,-10.601499999997916,4970.3,54,35,0,89
5667,-22.431999999998787,2586.8823529411766,29,38,2,67
5668,-9.354749999999068,3095.8,47,26,0,73
5669,15.31325000000164,4030.5555555555557,62,28,0,90
5670,-14.597999999999036,2482.6875,33,26,0,59
5671,-9.56449999999894,2962.6111111111113,47,29,1,76
5672,18.71500000000185,4974.25,65,24,0,89
5673,10.61600000000048,3383.1052631578946,60,32,2,92
5674,-3.547999999999867,3230.2105263157896,43,22,2,65
5675,7.96700000000145,4225.95,61,30,0,91
5676,-1.4874999999982457,2176.0,40,33,0,73
5677,-0.87099999999907,2453.9375,53,33,1,86
5678,15.42500000000106,4337.8,50,30,0,80
5679,-9.021999999999473,2628.35,25,32,0,57
5680,-10.576749999999173,2510.714285714286,30,31,0,61
5681,4.5075000000011585,3514.2105263157896,64,19,2,83
5682,43.87500000000178,3334.705882352941,86,25,1,111
5683,27.365250000001982,5047.4,70,35,1,105
5684,10.342250000001222,4621.9,62,29,1,91
5685,11.486500000000834,3201.842105263158,40,29,1,69
5686,-7.443999999999514,2387.0,39,32,0,71
5687,33.071250000001854,4671.8,76,16,0,92
5688,18.14725000000175,4670.35,67,27,0,94
5689,21.62400000000124,2862.4117647058824,69,30,2,99
5690,-2.343749999998532,3044.7368421052633,41,32,0,73
5691,-29.05749999999967,2275.9,20,32,0,52
5692,2.9287500000012328,2938.0625,45,26,0,71
5693,16.128000000000952,3578.684210526316,64,30,0,94
5694,-25.068249999999814,2265.5,18,31,0,49
5695,1.9645000000010726,4002.95,55,29,0,84
5696,14.615750000000826,3848.4210526315787,67,27,0,94
5697,25.429250000001126,3846.277777777778,59,28,0,87
5698,-9.323999999999268,2529.9411764705883,35,23,0,58
5699,-26.291249999999042,1429.0,25,37,1,62
5700,-7.901249999998889,3008.5,40,28,2,68
5701,3.2177500000009083,4776.6,46,37,0,83
5702,-11.55374999999919,3345.6315789473683,41,26,0,67
5703,3.492750000001478,3688.6,44,31,0,75
5704,7.520250000001154,2482.0,53,22,0,75
5705,-12.41299999999867,3598.6315789473683,46,40,0,86
5706,-1.6522499999990248,3033.8,32,34,0,66
5707,-36.49649999999964,2007.157894736842,16,28,1,44
5708,16.91975000000125,3508.5555555555557,63,24,0,87
5709,-11.104499999998938,2663.777777777778,28,32,0,60
5710,25.172500000000774,4095.0526315789475,78,30,0,108
5711,26.500500000001352,5002.2,64,20,0,84
5712,-4.0354999999987005,3052.15,46,24,0,70
5713,-8.767749999999722,1826.9375,29,30,0,59
5714,0.2562500000011923,2375.5625,41,38,0,79
5715,-46.0237499999999,1962.0526315789473,12,32,11,44
5716,-5.309249999998108,3626.6666666666665,60,29,1,89
5717,18.246250000001396,4138.111111111111,59,19,0,78
5718,5.903000000000645,3042.777777777778,46,32,1,78
5719,-1.8664999999986722,2930.722222222222,53,28,2,81
5720,-21.210749999999035,1953.7222222222222,21,30,0,51
5721,-41.95775000000002,1429.0,0,32,0,32
5722,-17.359999999999864,1924.8823529411766,33,37,0,70
5723,7.711500000000585,3118.0,50,24,0,74
5724,17.345000000001164,3691.75,56,26,0,82
5725,33.11575000000138,4809.95,69,26,0,95
5726,3.1317500000007277,2353.4117647058824,40,31,0,71
5727,15.030500000001226,3749.157894736842,61,35,0,96
5728,9.21800000000152,3234.222222222222,61,30,0,91
5729,6.341000000002095,4189.4,55,27,0,82
5730,-10.70624999999918,2852.1,35,27,0,62
5731,6.383000000001088,3442.5263157894738,56,30,0,86
5732,-1.95524999999961,2480.4117647058824,35,29,1,64
5733,-26.081999999999645,1945.7777777777778,18,33,4,51
5734,9.52075000000092,3721.9,47,33,0,80
5735,-15.31424999999886,3180.55,48,30,0,78
5736,-5.6154999999989235,3705.5789473684213,52,27,1,79
5737,-21.402999999999995,1862.2941176470588,27,29,0,56
5738,5.966750000000889,3005.6315789473683,41,28,0,69
5739,8.874250000001018,3071.0555555555557,48,27,0,75
5740,-4.212249999999016,2694.6428571428573,40,25,0,65
5741,12.660000000001752,4306.85,63,28,0,91
5742,7.244250000001237,3111.6,48,22,0,70
5743,-6.137999999999145,2418.125,43,28,0,71
5744,1.3607500000006003,3787.75,46,29,0,75
5745,28.30125000000221,2815.0625,78,17,0,95
5746,13.637250000001007,4111.684210526316,55,26,2,81
5747,-10.95299999999963,2546.0,41,19,4,60
5748,-10.351249999999125,3127.5263157894738,42,25,0,67
5749,-2.5279999999995875,2848.4210526315787,32,33,0,65
5750,-31.452249999999776,2313.2,11,36,1,47
5751,-29.131499999999807,1899.5882352941176,21,30,1,51
5752,-6.7162499999995235,2903.75,31,30,1,61
5753,22.697750000002067,4770.35,72,30,0,102
5754,8.410500000001091,2920.1875,63,16,0,79
5755,8.721000000000775,2949.3888888888887,53,32,3,85
5756,3.195500000000462,3365.6111111111113,53,41,1,94
5757,5.662500000000483,2420.6470588235293,52,36,0,88
5758,10.28500000000165,3931.5,65,20,1,85
5759,-9.258499999999183,2552.1,26,31,1,57
5760,-10.05699999999965,2500.5,48,39,0,87
5761,-7.491499999999498,2286.235294117647,39,30,0,69
5762,-12.89399999999965,2034.7368421052631,29,31,4,60
5763,8.65300000000155,4844.25,49,37,0,86
5764,-17.214249999999183,2605.95,28,23,0,51
5765,24.917500000001137,3647.6470588235293,66,29,0,95
5766,12.487250000001026,3820.9473684210525,49,35,0,84
5767,1.0457500000003286,3187.5789473684213,36,37,0,73
5768,-33.07574999999932,2072.7,19,31,0,50
5769,-2.046999999999345,3087.722222222222,65,27,0,92
5770,-1.035999999999219,2637.7,29,29,0,58
5771,18.2530000000009,3867.95,56,29,0,85
5772,-5.374999999999025,4516.5,47,35,0,82
5773,21.512500000001207,4090.0526315789475,75,20,2,95
5774,28.778250000001304,2936.1176470588234,69,20,0,89
5775,-10.907000000000098,1925.5,34,25,2,59
5776,13.792750000001533,3485.0526315789475,59,23,3,82
5777,25.831000000001684,4667.25,71,25,0,96
5778,-20.404999999999383,2468.6666666666665,35,30,1,65
5779,-35.7999999999997,1983.6842105263158,12,32,2,44
5780,-12.04199999999913,2648.3125,29,24,0,53
5781,-6.7844999999997455,3350.5789473684213,41,29,5,70
5782,-17.276499999999135,2598.277777777778,29,36,1,65
5783,6.24525000000107,3951.3,46,34,0,80
5784,-4.748749999998997,3769.6,46,26,0,72
5785,2.51000000000208,4276.7,63,28,0,91
5786,35.88150000000165,4741.526315789473,93,32,5,125
5787,-21.530749999999863,2012.7777777777778,25,29,0,54
5788,-19.673749999999735,2215.294117647059,26,29,2,55
5789,15.39575000000118,3370.235294117647,57,31,0,88
5790,-18.54474999999933,2567.7368421052633,32,34,2,66
5791,6.432000000000805,3288.1052631578946,51,25,0,76
5792,-11.671249999998725,3074.7368421052633,38,30,0,68
5793,-0.8399999999992692,3338.6,39,29,0,68
5794,-1.416999999998638,3090.684210526316,49,23,1,72
5795,0.5135000000002858,3705.5789473684213,45,34,2,79
5796,3.929000000002348,4953.65,70,26,1,96
5797,-1.7342499999990655,3031.4736842105262,41,29,1,70
5798,-21.153499999999408,2024.2,12,36,0,48
5799,6.130500000002369,5247.4,71,26,0,97
5800,0.46200000000033786,2500.5,48,31,1,79
5801,1.7275000000005147,2866.625,64,32,0,96
5802,-6.884499999999396,2660.1666666666665,34,34,0,68
5803,23.458500000001898,4798.9,68,22,0,90
5804,9.036250000000967,4033.1,41,38,0,79
5805,-4.113499999999123,3917.1,40,37,0,77
5806,-23.53299999999963,3499.6,29,35,0,64
5807,-7.227749999999372,2050.0625,30,34,1,64
5808,-33.15924999999997,1959.5263157894738,17,29,9,46
5809,-26.190999999999484,1933.388888888889,29,25,3,54
5810,31.99850000000103,3294.5882352941176,80,30,0,110
5811,19.209750000001605,3631.6,66,17,0,83
5812,0.7057500000010972,3190.9444444444443,52,25,0,77
5813,2.8007500000007477,2592.277777777778,64,36,6,100
5814,0.6317500000006537,3187.3888888888887,46,32,0,78
5815,16.4622500000011,2391.133333333333,67,38,1,105
5816,4.404250000001161,2335.875,55,22,3,77
5817,7.550000000000662,3247.3,41,22,0,63
5818,6.096250000000939,3507.5,52,25,0,77
5819,9.885250000000166,3603.722222222222,51,37,0,88
5820,-8.974749999998663,2500.5,49,33,0,82
5821,16.683000000001414,5047.45,72,26,0,98
5822,8.406250000000954,3151.823529411765,61,33,0,94
5823,-9.909000000000132,2017.235294117647,39,40,3,79
5824,-0.06424999999872175,2408.8333333333335,36,30,0,66
5825,-8.753749999998629,3944.8888888888887,51,25,1,76
5826,-9.565249999999162,2425.5,25,33,4,58
5827,-14.238750000000095,1989.0,28,29,1,57
5828,-21.476499999999994,1833.8333333333333,24,37,2,61
5829,-27.767999999999894,1429.0,14,41,2,55
5830,21.470250000001037,3892.6,53,29,0,82
5831,40.26925000000259,3127.4666666666667,91,13,0,104
5832,-18.379249999999224,2559.0625,37,26,7,63
5833,-1.6859999999993096,2928.222222222222,40,32,1,72
5834,-14.96974999999956,2866.35,25,36,0,61
5835,-2.96224999999896,2971.529411764706,54,21,0,75
5836,-14.754749999999017,2524.3333333333335,30,27,0,57
5837,23.373000000001483,4115.6,60,26,1,86
5838,16.593000000001403,3003.5,55,28,0,83
5839,3.5127500000017755,1925.8235294117646,45,27,1,72
5840,8.793750000000925,3185.157894736842,41,26,2,67
5841,10.773750000000831,3561.8947368421054,56,29,0,85
5842,-20.709999999999077,2681.3684210526317,35,24,12,59
5843,-29.87774999999972,1830.2777777777778,15,36,4,51
5844,12.06175000000152,5008.4,77,23,0,100
5845,-5.715999999999096,3083.85,38,24,1,62
5846,-3.528999999999499,2730.6666666666665,43,28,0,71
5847,18.62675000000159,4189.35,57,26,0,83
5848,7.592000000000939,3583.9,56,18,0,74
5849,21.541500000000685,3886.1052631578946,82,25,0,107
5850,28.804000000002198,4740.95,88,15,0,103
5851,-23.43124999999974,1837.1176470588234,37,38,8,75
5852,-22.045999999999463,2020.8333333333333,19,35,0,54
5853,-19.959499999999338,2580.235294117647,42,38,0,80
5854,-7.314749999998715,3274.722222222222,40,42,0,82
5855,-3.1377499999982605,3768.0,60,25,0,85
5856,28.44300000000134,2641.5,75,24,0,99
5857,-5.199749999998684,4054.35,57,26,0,83
5858,10.514500000001004,2519.6470588235293,48,32,0,80
5859,5.645500000001099,2436.6,53,24,1,77
5860,26.201500000002618,5256.1,89,23,0,112
5861,17.381500000000905,3020.722222222222,54,25,0,79
5862,-21.57249999999886,3445.65,48,28,0,76
5863,30.361000000001944,4111.666666666667,85,20,0,105
5864,-7.901999999999125,2429.0666666666666,45,32,0,77
5865,7.381500000001415,2679.0625,47,25,0,72
5866,4.6927500000020395,4567.736842105263,69,35,0,104
5867,21.01050000000226,4103.7,78,17,0,95
5868,-14.092499999998143,2462.6666666666665,39,37,4,76
5869,-17.181499999999563,2856.1,32,31,1,63
5870,-11.020749999999875,2055.222222222222,20,34,1,54
5871,-13.497749999999323,2493.4210526315787,28,25,0,53
5872,8.871750000001207,3635.55,50,32,0,82
5873,14.789000000001309,3631.55,64,14,0,78
5874,-18.431750000000036,1975.235294117647,42,36,2,78
5875,-26.67500000000004,2079.8,11,31,2,42
5876,18.94225000000105,4106.8,51,30,0,81
5877,-30.28499999999976,1999.6315789473683,17,25,0,42
5878,-3.2584999999986324,3901.0526315789475,47,30,0,77
5879,-27.739500000000287,1429.0,23,37,6,60
5880,-12.378249999999388,2572.0,29,28,1,57
5881,-22.5784999999996,2012.35,12,31,0,43
5882,7.487000000000506,3655.5789473684213,68,30,0,98
5883,22.901750000001552,4319.578947368421,61,21,0,82
5884,-14.042999999999699,3237.7894736842104,37,34,5,71
5885,11.690250000001168,3551.1052631578946,52,27,0,79
5886,-1.127249999999636,2518.375,40,35,0,75
5887,9.191000000001894,2882.8823529411766,43,41,0,84
5888,-6.310499999999118,3009.5789473684213,44,32,1,76
5889,0.34000000000075536,3829.2,48,32,1,80
5890,24.14050000000161,4206.1,61,29,0,90
5891,-17.99449999999893,2702.1,29,35,0,64
5892,-14.869249999999775,1920.1875,22,36,1,58
5893,17.126750000001262,2842.9375,51,26,0,77
5894,-12.848749999999217,2063.8823529411766,24,33,1,57
5895,-0.7402499999990881,3512.4166666666665,38,40,0,78
5896,16.351500000001803,3671.0,59,26,1,85
5897,6.223500000000676,3233.85,40,27,0,67
5898,-15.898500000000194,1429.0,30,34,5,64
5899,1.92750000000166,3579.9,53,23,0,76
5900,-26.14399999999959,2079.85,20,26,0,46
5901,15.261500000000884,4434.7,59,29,0,88
5902,16.514500000000545,3684.5789473684213,43,30,0,73
5903,20.10725000000121,2650.4117647058824,69,30,0,99
5904,-6.225999999999096,1902.25,41,32,1,73
5905,-8.08199999999998,2454.235294117647,42,41,1,83
5906,10.361750000000283,2523.375,71,22,1,93
5907,-6.294749999998963,2479.470588235294,30,31,0,61
5908,16.244250000000758,3262.5,58,26,1,84
5909,-21.590999999999163,2509.5,27,31,0,58
5910,16.24700000000093,3754.0,51,34,0,85
5911,3.086500000000839,2518.375,43,34,1,77
5912,-18.080749999999405,2063.95,14,37,0,51
5913,9.42600000000174,3404.4444444444443,61,17,0,78
5914,-0.06324999999827038,2110.5625,46,22,0,68
5915,-9.352499999999283,2565.4117647058824,36,32,4,68
5916,-1.001999999998851,3085.6470588235293,59,19,0,78
5917,-7.962999999999353,3260.9411764705883,53,31,1,84
5918,-4.948250000000056,1909.6666666666667,33,30,2,63
5919,-9.68824999999897,2560.15,35,26,2,61
5920,23.36275000000176,3845.277777777778,79,18,0,97
5921,11.573250000001417,3325.8888888888887,51,29,0,80
5922,14.912750000001887,4103.75,70,19,1,89
5923,17.707500000001048,5036.2,69,24,0,93
5924,-11.466499999999096,2348.6875,44,30,1,74
5925,-1.8837499999987704,3060.3529411764707,54,29,0,83
5926,-36.515999999999835,1429.0,3,33,2,36
5927,6.2337500000017645,3483.0,52,24,0,76
5928,-31.645499999999355,1981.111111111111,20,27,4,47
5929,2.3362500000009168,2512.6666666666665,50,17,1,67
5930,29.955250000002117,4795.8,78,22,0,100
5931,31.471750000002622,4508.529411764706,80,25,0,105
5932,-25.237749999999973,1944.4117647058824,25,33,15,58
5933,-10.226249999999272,2842.875,28,28,1,56
5934,24.94000000000126,4842.55,68,28,0,96
5935,-20.22824999999928,4073.45,45,40,0,85
5936,7.970000000001673,4206.75,62,21,0,83
5937,-32.849249999999834,1952.888888888889,13,32,5,45
5938,3.6305000000002736,2738.2105263157896,49,31,2,80
5939,30.929000000003022,5409.3,109,20,0,129
5940,1.7710000000013895,3595.9,60,18,1,78
5941,-21.85549999999916,2742.5,33,22,0,55
5942,14.85050000000308,5344.15,90,17,0,107
5943,-9.326999999999039,2586.0,38,24,0,62
5944,4.755000000001745,3579.8,61,15,0,76
5945,7.844500000000987,2988.0526315789475,50,22,0,72
5946,21.551500000001397,3556.8823529411766,84,19,1,103
5947,-34.11374999999996,1959.5263157894738,17,27,11,44
5948,11.004000000001456,4104.5,62,28,1,90
5949,-20.620499999998692,2595.7,35,26,0,61
5950,9.690500000001448,3968.0,65,21,0,86
5951,2.78124999999989,2602.6428571428573,48,25,0,73
5952,17.995250000000848,4260.95,59,24,0,83
5953,15.926250000000522,3538.294117647059,85,23,0,108
5954,10.083000000001087,2362.3333333333335,57,24,0,81
5955,-5.383749999999291,3275.85,36,34,1,70
5956,23.281750000001686,2831.0,67,31,0,98
5957,-6.231249999999408,2509.4375,28,29,0,57
5958,-7.734249999999669,2599.8,32,23,0,55
5959,-9.747749999999531,2067.6470588235293,35,45,0,80
5960,2.0705000000005147,1929.5882352941176,38,23,1,61
5961,-6.3519999999986645,2892.3125,51,18,0,69
5962,0.3937500000019106,2476.6875,49,42,1,91
5963,-19.40099999999982,1949.4444444444443,48,38,1,86
5964,-11.98100000000015,2684.684210526316,27,28,6,55
5965,24.08100000000119,4491.0,61,23,0,84
5966,21.788750000002572,3613.3888888888887,77,16,1,93
5967,-3.0684999999991343,3036.3125,41,31,0,72
5968,-5.445999999999534,2550.6666666666665,26,36,5,62
5969,28.31725000000148,4472.65,71,23,0,94
5970,20.837750000002252,4696.5,76,21,0,97
5971,1.6052500000016767,4689.3,82,25,2,107
5972,-20.945249999999664,1429.0,14,33,1,47
5973,3.614500000000633,2411.3125,48,29,0,77
5974,-21.458499999999553,2044.2,14,35,0,49
5975,-1.3584999999988778,3623.5,53,18,0,71
5976,3.3825000000003356,4439.45,45,33,0,78
5977,-11.081499999999114,2512.8888888888887,32,27,0,59
5978,28.924500000001085,4103.85,59,17,0,76
5979,14.11400000000109,3765.55,65,19,0,84
5980,-6.403749999999564,2487.3888888888887,42,30,5,72
5981,36.9955000000027,5171.2,88,15,0,103
5982,24.296750000002692,4207.8,78,19,0,97
5983,26.588750000001546,4111.6,67,25,1,92
5984,20.69000000000097,2465.4117647058824,55,26,1,81
5985,-18.360999999999926,1958.111111111111,25,40,3,65
5986,-21.27799999999877,2969.6315789473683,46,23,2,69
5987,39.033750000002506,3353.8125,91,18,2,109
5988,-21.698749999999762,2072.75,14,31,2,45
5989,16.678500000001545,4913.2,68,27,0,95
5990,-14.880249999999654,1882.764705882353,26,34,1,60
5991,-17.686500000000002,2413.1666666666665,22,40,0,62
5992,-0.8977499999990435,2416.1875,39,24,1,63
5993,12.666750000000764,3357.6666666666665,55,32,0,87
5994,-1.3834999999999178,1966.8823529411766,23,39,3,62
5995,-11.146999999999496,2538.5789473684213,32,27,25,59
5996,-18.83849999999976,2158.3888888888887,14,38,0,52
5997,-7.394499999999114,2150.9411764705883,38,30,0,68
5998,-11.374749999999516,1828.764705882353,30,26,1,56
5999,-30.410499999998876,1889.3125,35,27,4,62
6000,1.8135000000010701,3386.4210526315787,50,31,0,81
6001,20.78175000000065,2071.0,70,32,0,102
6002,30.82225000000052,2364.5625,58,21,1,79
6003,-8.058999999998761,3068.05,49,20,0,69
6004,-1.0987499999991335,2433.764705882353,47,24,0,71
6005,8.9160000000013,3502.95,49,24,0,73
6006,52.48975000000056,5734.65,72,35,0,107
6007,16.37700000000178,3571.8823529411766,73,26,1,99
6008,15.56500000000186,4581.9473684210525,63,31,0,94
6009,1.666750000001501,3419.3333333333335,48,37,0,85
6010,-4.196750000000082,1790.3529411764705,33,41,0,74
6011,14.25300000000201,2395.6111111111113,54,22,1,76
6012,17.009250000001707,4629.8,65,29,0,94
6013,22.75825000000207,4884.6,65,32,1,97
6014,-9.559499999999515,2460.8333333333335,22,31,0,53
6015,13.520750000000954,3693.1052631578946,53,34,1,87
6016,-7.324749999999457,3093.2631578947367,51,23,3,74
6017,16.432250000001826,2450.266666666667,69,30,1,99
6018,14.102000000002382,4916.4,73,28,0,101
6019,-12.957999999999188,1670.125,25,35,0,60
6020,32.72825000000194,4407.7,79,15,0,94
6021,-2.8002500000000103,1917.611111111111,32,32,0,64
6022,-24.427999999999624,2303.0,36,43,0,79
6023,-10.982249999999082,2101.294117647059,37,22,0,59
6024,16.405500000001666,4027.5,61,23,0,84
6025,10.984000000000286,3246.5555555555557,49,28,1,77
6026,15.282250000001943,4285.45,74,27,0,101
6027,-18.14299999999965,1929.4705882352941,50,28,5,78
6028,-0.09774999999876854,3027.3125,51,28,0,79
6029,-16.291499999998805,1830.8125,34,34,0,68
6030,-29.395249999999322,2036.2,19,29,0,48
6031,-28.623500000000092,1429.0,37,33,4,70
6032,0.28725000000105405,2973.8125,51,32,0,83
6033,-23.88524999999959,2485.8947368421054,33,22,5,55
6034,16.97050000000125,4882.2,69,24,1,93
6035,25.750250000000754,4191.0,74,34,0,108
6036,15.376750000001385,3603.8,58,21,0,79
6037,11.528500000000687,3553.5263157894738,55,20,4,75
6038,23.76725000000145,5127.5,74,20,0,94
6039,-13.661249999999168,2562.277777777778,31,25,0,56
6040,-1.7267499999992217,1870.7058823529412,39,31,1,70
6041,-2.5794999999994985,2587.8,35,23,0,58
6042,0.6435000000007441,3359.25,39,32,0,71
6043,2.9795000000009315,3337.0,49,27,0,76
6044,-20.715499999999277,1982.5,24,28,1,52
6045,4.248000000000743,3083.95,40,27,1,67
6046,-3.9579999999990934,3651.4,46,28,0,74
6047,-3.6382499999991977,2567.95,33,26,0,59
6048,24.414500000001905,4631.5,76,23,0,99
6049,-6.94349999999928,3004.7368421052633,41,33,4,74
6050,2.497750000000765,3103.6,49,21,1,70
6051,33.15550000000138,5603.6,84,18,0,102
6052,-13.672249999999314,2622.8,36,23,0,59
6053,-2.2422499999999266,2393.5,38,39,7,77
6054,-11.148250000000111,2361.823529411765,34,25,0,59
6055,0.37200000000033456,2543.4,54,27,0,81
6056,8.5230000000019,2807.0625,54,43,0,97
6057,-6.810749999998516,3329.85,49,27,1,76
6058,24.66925000000157,5077.5,81,25,0,106
6059,10.147500000001,2628.4375,54,20,0,74
6060,-4.100999999998881,2686.1875,32,29,2,61
6061,11.240750000001826,3910.05,62,25,0,87
6062,-6.7107499999990825,3185.8,39,31,0,70
6063,20.065250000001345,3847.5789473684213,63,23,0,86
6064,24.578500000001043,4944.95,80,21,0,101
6065,22.55675000000121,5405.3,65,24,0,89
6066,-6.044999999998881,3673.0,56,34,0,90
6067,-19.53174999999969,2050.9411764705883,24,44,0,68
6068,23.720500000001387,5604.55,79,23,0,102
6069,6.591250000000306,2496.294117647059,45,26,0,71
6070,28.72075000000145,2947.0625,74,23,0,97
6071,4.207000000001058,2874.4117647058824,50,29,0,79
6072,-2.9502499999987144,3158.4210526315787,45,27,0,72
6073,-25.64549999999975,1429.0,25,33,2,58
6074,-6.623499999999401,2437.4117647058824,51,31,0,82
6075,24.696750000001504,4808.45,74,19,3,93
6076,-15.595749999999066,1841.8235294117646,27,25,2,52
6077,14.431250000000912,2473.6875,56,24,1,80
6078,-4.879999999999552,2054.0625,37,34,0,71
6079,6.1410000000009095,3940.15,60,21,0,81
6080,0.067750000001039,3273.7894736842104,48,26,1,74
6081,-11.894999999999271,2548.0,23,32,0,55
6082,34.184000000001895,4745.75,78,20,0,98
6083,31.43750000000142,4720.35,71,16,0,87
6084,-4.13649999999946,2711.3888888888887,43,29,0,72
6085,15.372750000000778,4305.95,52,22,0,74
6086,1.9260000000007758,3297.35,43,18,0,61
6087,-5.140249999999242,2640.5789473684213,30,28,0,58
6088,22.99400000000074,2940.764705882353,79,25,0,104
6089,-17.689999999999124,2521.529411764706,36,23,0,59
6090,17.96025000000089,4175.25,65,15,0,80
6091,-8.288499999999186,2303.9411764705883,39,32,0,71
6092,13.768000000000686,3795.0526315789475,54,30,0,84
6093,-10.216999999998887,2840.1111111111113,45,31,0,76
6094,-29.982249999999247,1993.7368421052631,15,30,3,45
6095,-9.371999999999748,2504.705882352941,29,23,2,52
6096,-8.955750000000194,2616.9473684210525,40,32,2,72
6097,23.9195000000014,4342.65,52,36,0,88
6098,-30.41174999999953,2008.4,11,29,0,40
6099,-21.729999999999908,2053.6470588235293,35,38,2,73
6100,-9.52949999999958,2536.7894736842104,41,26,3,67
6101,7.269500000000356,3008.4444444444443,53,30,0,83
6102,21.095250000001826,4187.1,74,17,0,91
6103,-37.205500000000455,1429.0,10,41,2,51
6104,35.34900000000182,5144.9,84,25,0,109
6105,-24.588999999999466,2028.25,16,27,4,43
6106,-19.779499999999654,2530.6111111111113,48,29,1,77
6107,3.9137500000021865,4004.7894736842104,78,15,0,93
6108,-10.190999999999473,2536.45,28,33,0,61
6109,56.09450000000053,5741.15,78,29,0,107
6110,-17.14474999999974,1987.9473684210527,20,26,1,46
6111,-21.668999999999368,1898.3125,41,27,2,68
6112,-10.46374999999927,2552.6111111111113,30,21,0,51
6113,9.47650000000067,3059.3529411764707,68,32,1,100
6114,20.929000000001544,4087.4736842105262,68,10,0,78
6115,-9.417249999999331,2397.277777777778,42,39,0,81
6116,-16.83649999999981,2464.9473684210525,27,28,1,55
6117,-17.6109999999992,1918.2941176470588,43,31,9,74
6118,0.4712500000004417,2323.529411764706,41,27,0,68
6119,0.39700000000037755,3300.45,44,25,0,69
6120,9.928250000002045,3603.6470588235293,79,38,0,117
6121,26.427000000002117,4146.888888888889,85,31,2,116
6122,-7.707249999999439,2938.6111111111113,42,33,1,75
6123,-0.6604999999997283,2495.733333333333,44,31,4,75
6124,8.167750000001504,4480.7,60,26,0,86
6125,20.697250000000707,2362.4666666666667,57,26,0,83
6126,0.8590000000008026,2976.6666666666665,49,29,0,78
6127,16.99175000000188,1862.8666666666666,79,31,1,110
6128,-12.488749999999063,2462.764705882353,36,30,0,66
6129,-18.960249999999114,2193.764705882353,29,36,0,65
6130,0.7512500000029749,5018.8,70,29,0,99
6131,-4.8984999999991,2980.4210526315787,42,28,0,70
6132,-12.773749999999227,1866.0588235294117,33,26,0,59
6133,-0.3959999999985932,4397.35,47,37,0,84
6134,1.2785000000012916,2998.1052631578946,52,20,0,72
6135,2.6960000000012663,3061.222222222222,49,20,0,69
6136,11.765500000001023,3015.470588235294,76,29,0,105
6137,-20.92524999999946,2364.722222222222,27,32,0,59
6138,3.291750000000749,3151.35,38,25,2,63
6139,-4.619999999999321,4029.9,49,32,1,81
6140,-8.057999999998643,2522.3125,37,30,0,67
6141,-1.3989999999995066,2513.1176470588234,33,24,0,57
6142,24.840250000000246,3102.5263157894738,61,27,1,88
6143,15.781250000001219,3478.3684210526317,56,23,1,79
6144,26.456500000001455,5162.45,60,33,0,93
6145,8.099250000000978,4035.5,53,26,0,79
6146,-9.986999999999027,3853.7,54,29,0,83
6147,13.34825000000085,4245.8,55,27,0,82
6148,8.984500000000716,3608.7368421052633,58,23,2,81
6149,-22.132749999999923,2032.1666666666667,17,30,0,47
6150,15.833000000001666,4949.7,78,23,0,101
6151,-29.248249999999803,1917.611111111111,20,30,4,50
6152,7.172750000000446,2509.4375,56,29,0,85
6153,-14.04974999999889,2218.9411764705883,36,33,1,69
6154,4.483000000001073,2598.75,49,24,0,73
6155,1.3432500000006604,2808.3333333333335,42,29,1,71
6156,-0.5837499999991479,3084.842105263158,39,33,0,72
6157,-31.629499999999787,2654.6315789473683,26,25,3,51
6158,-2.6434999999991655,2865.5555555555557,42,31,0,73
6159,-21.2622500000001,1882.9411764705883,29,47,0,76
6160,8.063750000001553,3721.25,55,21,3,76
6161,21.724000000001546,3961.65,69,20,0,89
6162,-26.929249999999882,2048.1,12,29,0,41
6163,-13.686999999998935,2496.1111111111113,35,30,0,65
6164,-11.529999999999433,2721.85,31,30,0,61
6165,-7.116749999999728,1963.1176470588234,28,29,3,57
6166,10.932250000001696,3640.9,66,17,0,83
6167,34.438000000001736,5262.45,81,18,0,99
6168,5.943750000000929,3358.157894736842,51,23,3,74
6169,-0.903249999999262,3103.6,46,23,1,69
6170,-1.2137499999999928,2982.0526315789475,40,35,1,75
6171,23.662000000002305,4113.315789473684,78,23,1,101
6172,-8.781749999999132,2572.0,32,29,0,61
6173,-31.393749999999205,2081.45,16,27,0,43
6174,6.701500000001149,4290.15,54,31,0,85
6175,-14.02574999999862,3147.5263157894738,46,28,0,74
6176,15.489250000001899,3974.6315789473683,66,25,0,91
6177,-13.3354999999991,2623.8,33,33,1,66
6178,-14.82049999999929,2500.842105263158,37,24,1,61
6179,-14.373249999999322,1925.0625,30,38,1,68
6180,-3.7292499999973545,3011.1111111111113,60,21,1,81
6181,19.565000000001326,4156.3,70,12,0,82
6182,3.8662500000026383,2872.5,62,27,0,89
6183,-1.160749999999354,4009.25,42,39,0,81
6184,18.791500000002152,3110.75,73,28,0,101
6185,4.488500000000125,2286.25,59,35,0,94
6186,-12.914749999999321,2134.9411764705883,33,29,0,62
6187,0.8572500000015879,4289.45,54,27,2,81
6188,7.803750000000991,2529.8823529411766,43,26,0,69
6189,-1.824749999998616,4107.368421052632,58,34,1,92
6190,-3.0157499999999957,1853.6875,36,27,4,63
6191,15.46350000000135,3320.6666666666665,54,24,1,78
6192,-0.9829999999998862,3623.55,38,28,1,66
6193,-12.591999999999667,2554.3333333333335,31,24,2,55
6194,-28.11199999999975,2025.5263157894738,17,27,1,44
6195,7.307000000001464,3263.0,54,22,1,76
6196,38.32250000000242,4952.2,86,16,1,102
6197,30.76075000000239,4763.15,80,28,0,108
6198,16.365250000000966,3812.55,63,15,0,78
6199,51.53550000000107,3885.8333333333335,80,21,0,101
6200,-18.356249999999452,2616.764705882353,27,22,0,49
6201,-14.012999999999849,2047.1666666666667,23,29,1,52
6202,6.124750000001301,4327.105263157895,63,31,0,94
6203,-6.198749999998879,2592.4285714285716,40,29,0,69
6204,-7.467999999998907,2081.9333333333334,40,28,5,68
6205,-9.637499999998104,1429.0,33,35,0,68
6206,-0.5389999999989096,3312.45,40,31,0,71
6207,15.424750000000724,3756.6315789473683,63,31,0,94
6208,2.7772500000011187,2616.5625,49,40,0,89
6209,-17.12724999999973,1942.9375,28,34,4,62
6210,30.913250000001465,5229.85,80,15,0,95
6211,28.106250000001637,4571.85,69,23,0,92
6212,-26.431249999999476,2008.45,12,33,0,45
6213,-8.062249999999775,1929.0625,45,42,0,87
6214,57.20050000000201,4028.777777777778,110,18,4,128
6215,-32.836999999999875,1429.0,18,33,0,51
6216,-36.90925000000033,1429.0,1,34,9,35
6217,9.234250000001119,3948.05,45,29,0,74
6218,-19.53449999999907,1917.4705882352941,26,26,0,52
6219,18.02700000000123,3450.529411764706,63,24,0,87
6220,4.950500000001702,3948.2,58,26,0,84
6221,27.49575000000173,4738.7,74,21,0,95
6222,-3.6449999999998526,2605.75,39,31,11,70
6223,-31.204999999999977,1429.0,27,46,1,73
6224,-6.077499999999138,2811.9411764705883,29,30,2,59
6225,9.640750000000676,2419.5333333333333,43,33,0,76
6226,-17.134249999999106,2433.6111111111113,29,29,3,58
6227,39.69600000000091,3734.8947368421054,70,16,0,86
6228,18.496250000001236,4524.3,55,32,0,87
6229,0.8397500000008986,3103.85,46,21,0,67
6230,-7.435499999999474,2381.5,34,31,0,65
6231,23.7855000000017,4805.2,68,21,0,89
6232,-4.607499999999394,3238.65,36,34,1,70
6233,-12.245249999998936,3136.25,34,33,0,67
6234,8.085750000001642,3060.5,55,33,4,88
6235,12.459750000000826,2965.4210526315787,52,19,1,71
6236,-22.652749999999575,1904.2941176470588,34,34,6,68
6237,0.05675000000069987,2807.235294117647,56,30,0,86
6238,-14.476999999999881,1429.0,22,40,1,62
6239,-10.041999999999259,2562.7368421052633,25,35,1,60
6240,4.2707500000013905,5020.4,64,29,0,93
6241,-17.36275000000001,2604.923076923077,43,31,0,74
6242,15.488500000000974,3611.6111111111113,67,38,0,105
6243,17.99875000000181,3555.0588235294117,58,33,0,91
6244,15.217750000001548,2637.375,67,28,0,95
6245,16.27075000000051,2446.8125,64,21,4,85
6246,17.322500000001856,2546.125,56,31,1,87
6247,29.55525000000234,2403.5,59,29,0,88
6248,-10.422499999999108,2369.3529411764707,38,36,0,74
6249,-5.741999999999214,2587.8,30,25,0,55
6250,-4.019749999999,3594.15,39,41,0,80
6251,12.499750000001708,3296.470588235294,64,35,2,99
6252,36.750250000001614,4762.5,69,27,0,96
6253,4.856000000000997,3103.722222222222,38,39,0,77
6254,-42.48699999999978,1429.0,0,33,3,33
6255,8.132500000001516,3872.75,55,31,0,86
6256,8.02675000000151,3492.5555555555557,62,36,0,98
6257,19.75375000000207,5660.95,76,32,0,108
6258,25.74600000000197,4156.05,63,28,0,91
6259,21.634750000002278,3542.1176470588234,63,29,0,92
6260,23.14750000000148,3765.7894736842104,56,31,0,87
6261,-16.31699999999942,2763.15,23,36,0,59
6262,-8.226249999999634,2487.5,54,20,7,74
6263,28.49225000000169,3431.1176470588234,63,24,0,87
6264,-0.21649999999883152,2958.222222222222,42,39,0,81
6265,1.024500000000853,3107.4736842105262,38,25,1,63
6266,25.936000000001286,4000.5263157894738,67,28,0,95
6267,-43.390250000000165,1429.0,5,34,9,39
6268,21.505500000003014,2271.3125,71,26,2,97
6269,23.104000000001648,5177.5,65,33,0,98
6270,12.445000000002054,4522.631578947368,68,30,0,98
6271,-10.058749999999513,2612.8571428571427,32,29,2,61
6272,7.228750000000824,3191.8,43,25,0,68
6273,2.3982500000016023,3419.55,41,41,2,82
6274,8.13275000000213,3157.5882352941176,55,31,0,86
6275,-2.00849999999928,3753.7,43,36,0,79
6276,-18.698749999999553,2017.1764705882354,29,43,0,72
6277,-10.896000000000049,1969.7058823529412,39,34,1,73
6278,39.25450000000131,4726.65,74,20,0,94
6279,-26.977249999999508,2044.15,15,35,0,50
6280,-15.103499999998366,1985.5,33,31,3,64
6281,24.889000000001463,4811.65,65,26,0,91
6282,10.318500000001409,1956.5882352941176,47,22,2,69
6283,3.5195000000012633,3692.55,54,36,0,90
6284,14.276500000001178,4529.9,55,40,0,95
6285,-28.782749999999247,2002.9473684210527,16,37,0,53
6286,4.181250000001536,2299.125,47,30,0,77
6287,-25.855999999999504,2028.3,18,27,0,45
6288,-35.3057499999999,1946.611111111111,21,30,8,51
6289,5.662500000001644,2790.3529411764707,45,29,0,74
6290,15.94875000000081,3720.4,47,26,0,73
6291,17.346500000002035,4379.1,59,35,0,94
6292,-23.323499999999388,2572.75,20,36,0,56
6293,-21.108749999999212,2803.125,25,33,0,58
6294,-14.799999999998786,2541.3571428571427,34,36,6,70
6295,10.86075000000107,2524.3125,71,18,0,89
6296,9.308000000001504,3194.4444444444443,48,37,0,85
6297,14.03400000000076,3305.5263157894738,50,27,2,77
6298,-5.874249999998741,2969.5789473684213,41,29,1,70
6299,-3.1982499999987404,3607.75,52,28,0,80
6300,2.6075000000015534,3544.8823529411766,61,27,0,88
6301,6.470500000000753,3509.315789473684,60,31,7,91
6302,10.489000000001536,4042.076923076923,60,30,0,90
6303,-0.711749999998959,3178.95,48,24,0,72
6304,-21.601249999999087,2168.529411764706,33,34,0,67
6305,-19.82599999999938,2037.05,18,30,1,48
6306,-8.078999999999011,3637.1666666666665,57,37,0,94
6307,-4.789999999999614,1895.8823529411766,46,29,4,75
6308,12.996000000001345,3607.75,63,20,0,83
6309,-9.111249999999186,2614.75,28,30,0,58
6310,-26.234500000000065,1429.0,12,33,1,45
6311,-39.38424999999991,1429.0,0,33,2,33
6312,1.8017500000006006,2933.294117647059,47,32,3,79
6313,15.158000000000765,2498.5,88,22,2,110
6314,20.561250000000708,2891.3529411764707,64,32,0,96
6315,-6.534749999999384,2458.75,38,27,0,65
6316,20.22525000000145,4493.578947368421,73,33,2,106
6317,-19.457749999999912,2297.8947368421054,25,30,1,55
6318,30.545000000000943,5487.8,69,30,0,99
6319,-6.06124999999807,1986.2631578947369,33,23,13,56
6320,17.499499999999934,2298.125,51,29,0,80
6321,0.9335000000017504,3329.7368421052633,46,28,0,74
6322,17.932500000001113,2438.6,75,27,0,102
6323,26.99900000000149,4301.45,62,26,2,88
6324,8.339000000001537,3144.25,53,20,0,73
6325,12.909500000000786,2978.5,59,22,3,81
6326,-1.4412499999993043,3055.222222222222,42,36,0,78
6327,-8.598749999999558,2592.8125,38,33,1,71
6328,14.772750000001656,4356.05,66,26,0,92
6329,13.973750000000859,4213.2,45,33,0,78
6330,0.24300000000135422,3142.5789473684213,43,26,0,69
6331,-3.296249999998717,3808.4,51,25,2,76
6332,-2.981499999999113,2907.0,38,36,6,74
6333,-24.935499999999713,2036.15,13,32,0,45
6334,-2.5424999999985896,2298.125,51,37,1,88
6335,14.703000000001941,4612.0526315789475,76,28,1,104
6336,1.440750000001668,3982.35,59,24,0,83
6337,-22.454999999998957,2003.235294117647,24,34,0,58
6338,-28.881249999999135,2045.235294117647,22,29,2,51
6339,53.538000000004004,5571.9,98,23,0,121
6340,-14.633249999999268,2569.6,33,24,1,57
6341,21.094000000001298,3705.4,58,29,1,87
6342,14.445499999999607,2114.4117647058824,59,22,2,81
6343,41.5932500000017,3336.875,71,17,2,88
6344,-21.344499999999563,2127.55,16,36,0,52
6345,15.157250000000948,3846.9473684210525,63,26,5,89
6346,13.109500000000917,2765.176470588235,51,27,0,78
6347,-7.977999999998694,3056.5789473684213,41,37,3,78
6348,-16.105999999998893,2528.4666666666667,36,32,1,68
6349,-9.001000000000058,1946.875,33,33,1,66
6350,3.1395000000008526,2438.6,55,33,0,88
6351,34.75900000000223,4804.210526315789,84,26,0,110
6352,-22.40024999999883,2072.2631578947367,15,38,2,53
6353,6.149750000001582,3548.15,48,31,1,79
6354,25.437250000003022,2813.875,74,21,0,95
6355,-1.6787499999984081,3087.8,52,24,0,76
6356,5.552500000000862,3238.5,44,28,0,72
6357,34.071000000001916,5027.6,78,29,0,107
6358,2.8725000000013816,2500.4375,56,30,1,86
6359,0.20400000000015864,2928.6666666666665,57,38,4,95
6360,-27.886499999999636,2008.45,12,30,0,42
6361,-9.862999999999424,2541.3571428571427,32,29,0,61
6362,10.936750000000808,3771.6315789473683,54,27,0,81
6363,10.859250000000891,2467.133333333333,65,35,0,100
6364,13.717250000001352,3214.235294117647,50,37,0,87
6365,32.59450000000232,4651.4,89,13,0,102
6366,1.310750000001757,2551.3529411764707,59,25,5,84
6367,24.284250000001997,4319.5,65,22,0,87
6368,37.05750000000158,5202.8,74,23,0,97
6369,-17.821999999999964,1906.9473684210527,9,36,4,45
6370,-8.700000000000227,1959.5263157894738,22,28,6,50
6371,-4.802499999999602,2857.777777777778,48,41,0,89
6372,0.6317500000007625,1862.5625,56,28,2,84
6373,5.336250000000887,3648.5,64,39,0,103
6374,25.151500000000592,3768.75,48,27,0,75
6375,-23.154499999999672,1952.0526315789473,18,30,6,48
6376,5.885500000001487,2419.823529411765,54,29,2,83
6377,-20.974749999999492,2038.388888888889,20,31,2,51
6378,-4.326499999999345,2568.0,27,34,0,61
6379,41.83025000000182,5190.95,81,18,0,99
6380,-18.234249999999456,2583.9,29,27,1,56
6381,-10.756249999998486,1977.1333333333334,63,27,11,90
6382,26.466250000002145,3705.5333333333333,68,22,2,90
6383,7.804250000000977,3318.1111111111113,50,33,0,83
6384,2.2950000000006328,2496.294117647059,51,33,1,84
6385,-11.71174999999958,2697.25,27,24,0,51
6386,11.776000000002163,3844.4444444444443,84,25,1,109
6387,0.47925000000015106,2840.9411764705883,66,30,0,96
6388,9.710000000000772,3214.1,47,19,0,66
6389,-2.8859999999988504,3526.9444444444443,54,30,3,84
6390,-28.67724999999981,2007.1052631578948,10,37,0,47
6391,10.698000000001343,3613.684210526316,74,31,1,105
6392,-34.75475000000026,1429.0,15,34,2,49
6393,-11.84774999999834,2690.529411764706,47,28,1,75
6394,8.888000000000204,2495.733333333333,43,25,1,68
6395,-5.732999999999127,3581.9473684210525,47,32,1,79
6396,2.387750000001238,4036.2,54,36,0,90
6397,-3.692249999998514,2716.5882352941176,47,27,0,74
6398,25.368000000002073,5733.1,78,26,0,104
6399,-17.79624999999917,2176.0,26,27,2,53
6400,21.201250000002023,4315.55,69,23,0,92
6401,-15.604999999998896,2508.3888888888887,38,33,1,71
6402,18.424250000001155,3776.65,51,30,0,81
6403,-8.106999999998735,2951.45,42,21,4,63
6404,-12.467499999999834,2387.0,40,33,0,73
6405,-11.076499999999147,2464.75,34,28,0,62
6406,-26.836749999999547,2080.6315789473683,20,27,0,47
6407,3.6202500000006195,2941.5882352941176,46,25,0,71
6408,-13.822500000000073,2468.722222222222,34,32,3,66
6409,19.035500000001235,3607.7,54,23,0,77
6410,-4.784249999999571,1933.2941176470588,32,40,1,72
6411,-6.97999999999837,3285.4736842105262,53,22,0,75
6412,-8.703999999999118,2540.05,24,30,0,54
6413,9.480000000000663,2567.6666666666665,35,28,0,63
6414,-1.8222499999993473,2545.1875,39,29,1,68
6415,12.729500000001138,2892.235294117647,55,22,0,77
6416,-14.46199999999963,1912.7058823529412,35,32,3,67
6417,-11.177749999999113,2550.2631578947367,31,21,2,52
6418,34.992750000001216,4202.95,72,15,0,87
6419,32.20150000000156,4466.684210526316,77,33,0,110
6420,0.17200000000034493,2552.9333333333334,52,31,3,83
6421,36.800000000001354,4508.444444444444,84,26,0,110
6422,-0.38099999999854645,2998.6666666666665,55,23,2,78
6423,24.725750000000698,4223.733333333334,53,25,0,78
6424,23.428750000002587,4825.2,85,23,1,108
6425,-5.499999999999458,3449.8,39,30,0,69
6426,-5.690249999998989,2582.214285714286,40,27,1,67
6427,20.640250000002034,3968.722222222222,80,22,0,102
6428,-4.979249999998741,2417.8823529411766,38,29,0,67
6429,-5.4022499999991025,2431.823529411765,35,29,2,64
6430,0.7262500000007359,2550.125,35,27,1,62
6431,-5.732500000000348,1933.5,47,27,3,74
6432,8.213250000001448,4010.85,59,22,0,81
6433,24.59750000000151,4646.6,73,17,0,90
6434,-34.69699999999899,2481.6315789473683,25,38,0,63
6435,10.065750000001245,4038.157894736842,65,24,0,89
6436,24.59800000000201,5234.55,89,26,2,115
6437,7.686250000000837,2348.6875,44,28,0,72
6438,0.2997500000008477,3119.6,49,22,0,71
6439,-12.19024999999928,2409.6111111111113,38,23,4,61
6440,23.06000000000129,4319.736842105263,67,28,0,95
6441,-9.464499999999399,2028.6666666666667,30,30,1,60
6442,36.109500000000835,5221.95,72,30,1,102
6443,13.263750000001147,2536.3125,61,40,0,101
6444,-3.6094999999990476,3465.5,47,22,3,69
6445,-25.84374999999933,2008.35,18,24,1,42
6446,-8.306999999999338,2613.9,31,26,0,57
6447,27.152500000001385,4976.8,90,20,1,110
6448,16.560000000001402,3639.5,59,21,2,80
6449,9.066750000000827,2448.75,56,28,1,84
6450,11.91375000000159,4568.0,62,24,0,86
6451,-4.774249999999488,2503.4736842105262,30,25,0,55
6452,5.19025000000204,3658.7894736842104,62,29,0,91
6453,10.405250000001448,3445.8888888888887,58,25,0,83
6454,39.116500000000435,2967.0,86,33,0,119
6455,2.679250000000674,2595.8571428571427,45,20,1,65
6456,-10.064749999999203,2527.684210526316,33,27,0,60
6457,17.578500000000922,4277.5,59,28,0,87
6458,1.0145000000009485,3508.4444444444443,61,31,0,92
6459,1.2545000000009519,2457.6666666666665,44,25,0,69
6460,-1.3169999999991864,3145.9444444444443,49,31,4,80
6461,-27.692999999999756,2028.25,14,26,3,40
6462,6.360250000000095,2591.0666666666666,60,29,0,89
6463,-4.468999999999216,2524.375,49,22,4,71
6464,1.677500000001697,2857.8125,62,20,0,82
6465,-18.56224999999996,2112.4736842105262,19,33,15,52
6466,-13.406999999999357,2437.0555555555557,32,34,0,66
6467,-27.401749999999435,1893.1875,29,48,2,77
6468,25.808000000001414,4312.4,65,22,0,87
6469,-17.83899999999975,1879.1176470588234,22,27,3,49
6470,-5.274999999999151,2437.9375,36,31,2,67
6471,7.123750000001242,3794.157894736842,47,26,0,73
6472,-2.1427499999989683,3564.0,49,32,0,81
6473,-14.701750000000345,1429.0,43,34,6,77
6474,-10.82774999999858,3143.35,40,30,0,70
6475,-2.215749999999756,2779.222222222222,47,37,3,84
6476,11.989000000001854,4734.6,68,29,0,97
6477,-4.912749999999499,2967.1052631578946,41,20,1,61
6478,2.72225000000095,2900.0555555555557,41,31,2,72
6479,22.688000000001,3730.8,54,24,0,78
6480,11.400250000000765,2989.1111111111113,64,23,0,87
6481,4.483500000000838,2438.0,65,36,2,101
6482,15.216500000002437,4667.2,77,22,0,99
6483,-19.685999999999133,2561.8947368421054,27,34,0,61
6484,17.176750000001732,4159.25,74,19,0,93
6485,5.508500000000401,4256.9,46,29,1,75
6486,-7.868249999998848,2588.6470588235293,42,34,1,76
6487,-12.682749999999544,2297.5555555555557,33,36,5,69
6488,2.3000000000004874,1912.7058823529412,45,31,0,76
6489,0.33800000000141717,3136.9,49,24,0,73
6490,-34.470749999999754,1429.0,30,43,0,73
6491,-25.623999999999597,2024.35,14,28,1,42
6492,-14.008749999998983,2072.4117647058824,31,33,2,64
6493,2.6420000000010773,2276.0,51,27,3,78
6494,20.280250000000613,3873.7368421052633,55,19,3,74
6495,-15.544499999998814,2503.277777777778,30,31,0,61
6496,12.008500000001675,5059.8,70,20,0,90
6497,8.651500000001294,4206.85,58,34,0,92
6498,0.696000000001195,3722.7,50,31,0,81
6499,36.486000000001994,5186.0,77,26,0,103
6500,25.129750000000904,3780.0526315789475,63,28,1,91
6501,10.66100000000153,3230.2631578947367,51,24,1,75
6502,-11.705499999999077,2584.8823529411766,33,24,0,57
6503,9.82000000000155,3651.25,57,22,0,79
6504,-2.122749999999172,2511.294117647059,50,23,0,73
6505,19.243500000001163,3561.1052631578946,61,29,0,90
6506,-16.169249999999398,2631.133333333333,34,25,4,59
6507,11.885250000001577,3643.35,63,22,0,85
6508,2.527000000000837,3666.4,44,36,0,80
6509,7.872000000000935,3725.1,57,22,0,79
6510,18.215500000001214,4050.8333333333335,77,29,4,106
6511,0.6620000000010862,2488.823529411765,38,26,0,64
6512,-4.912000000000354,2185.4117647058824,54,48,1,102
6513,7.444000000001087,2517.375,47,17,0,64
6514,1.7725000000006865,2652.294117647059,42,30,5,72
6515,-16.287249999999023,2420.0625,34,45,0,79
6516,-14.332749999999152,2876.7894736842104,36,34,4,70
6517,1.1687500000010485,3139.157894736842,42,28,1,70
6518,-9.287249999999643,2587.85,32,25,0,57
6519,-1.9984999999993007,2607.157894736842,25,36,0,61
6520,13.052500000001425,3603.6111111111113,63,34,0,97
6521,-15.126749999998973,2488.3333333333335,31,33,1,64
6522,6.029000000001412,4760.9,64,24,0,88
6523,-11.10299999999932,2589.875,27,29,0,56
6524,45.396500000000586,5336.25,61,28,0,89
6525,-24.836999999999946,1983.7894736842106,21,26,8,47
6526,-1.7494999999980685,4307.0526315789475,63,27,0,90
6527,-17.188499999999568,1896.8235294117646,23,30,1,53
6528,11.58025000000045,2852.3333333333335,56,30,3,86
6529,27.965750000001197,4649.684210526316,88,13,0,101
6530,-1.813749999999936,2489.1052631578946,36,22,1,58
6531,-19.359999999999435,2840.1052631578946,29,33,1,62
6532,-1.3824999999991092,3276.65,34,30,0,64
6533,12.669250000000915,4011.7,58,25,0,83
6534,18.013750000000503,2541.125,61,23,0,84
6535,11.060000000000977,5134.6,56,31,0,87
6536,-5.088500000000176,1891.1764705882354,35,41,0,76
6537,-1.9912499999993774,2929.1666666666665,49,32,1,81
6538,-12.188749999998887,3206.15,46,25,1,71
6539,1.9495000000016425,3154.2631578947367,45,27,0,72
6540,-14.347499999999513,2574.4210526315787,27,37,1,64
6541,4.871500000001424,5025.9,48,30,0,78
6542,20.925750000001006,3805.4,62,19,0,81
6543,-20.32249999999963,2032.25,16,31,1,47
6544,8.184250000001063,1889.3125,60,31,2,91
6545,30.24175000000212,4722.8,79,18,0,97
6546,12.334000000000557,4825.15,52,34,0,86
6547,7.921250000000903,4051.5263157894738,43,33,0,76
6548,9.60625000000008,3079.842105263158,46,33,2,79
6549,1.393500000001312,3091.684210526316,39,32,0,71
6550,18.803500000001357,5250.5,68,34,0,102
6551,9.944750000001502,4495.75,52,35,0,87
6552,11.040500000000884,2966.9411764705883,49,28,0,77
6553,21.720000000001246,4668.85,57,33,0,90
6554,31.24975000000232,4762.45,73,33,0,106
6555,12.091000000000827,2273.375,70,21,0,91
6556,43.263000000001725,4679.1,81,21,0,102
6557,27.022750000004102,5008.45,91,21,0,112
6558,3.147000000000373,2095.6666666666665,46,29,1,75
6559,-7.409749999999178,3134.1052631578946,36,28,0,64
6560,36.481750000002236,3110.6875,81,17,0,98
6561,32.679750000000105,3854.4210526315787,78,47,0,125
6562,20.100500000000906,2664.1875,62,25,0,87
6563,27.2872500000014,4377.944444444444,68,31,2,99
6564,13.319500000002009,4155.25,67,24,0,91
6565,23.4810000000019,3629.95,59,25,0,84
6566,2.128250000001261,2693.3529411764707,48,35,1,83
6567,-17.37849999999984,1959.5263157894738,19,32,6,51
6568,2.9457500000011305,2545.25,49,28,0,77
6569,7.3602500000008915,3397.3888888888887,60,22,0,82
6570,12.112000000000778,3595.722222222222,60,39,0,99
6571,26.280000000001888,4580.7,68,24,0,92
6572,-23.00374999999971,1924.8235294117646,20,41,0,61
6573,7.26725000000139,3844.15,48,39,0,87
6574,-14.909249999999522,2028.3,18,31,0,49
6575,-16.334249999999848,1612.5625,30,28,3,58
6576,-5.909999999999375,3075.6315789473683,40,30,1,70
6577,13.519750000000922,2429.133333333333,55,24,0,79
6578,14.690000000000747,3151.6470588235293,61,42,0,103
6579,8.241500000001164,4413.2,54,30,0,84
6580,-1.0632499999983949,3120.7368421052633,47,28,1,75
6581,0.45975000000195243,2586.1111111111113,46,28,0,74
6582,15.312000000000316,2732.625,79,29,0,108
6583,10.154000000001272,2227.3529411764707,55,33,0,88
6584,45.898000000002796,4503.941176470588,96,14,0,110
6585,-12.888999999999417,2563.470588235294,27,43,2,70
6586,-2.3272499999986533,3048.1,41,28,1,69
6587,14.702750000001467,4879.95,61,28,0,89
6588,6.305500000000215,4240.210526315789,41,36,0,77
6589,11.132750000001177,3693.35,62,21,0,83
6590,-11.23749999999951,1910.9411764705883,26,33,1,59
6591,-20.167999999999402,2129.3529411764707,25,30,1,55
6592,36.72800000000167,3396.4117647058824,71,21,0,92
6593,-1.0634999999977368,3845.75,59,22,0,81
6594,-3.22049999999861,3076.0,51,23,0,74
6595,5.395250000000781,2415.1176470588234,59,22,1,81
6596,18.587000000001503,3564.15,62,17,0,79
6597,-11.448499999999143,2866.0588235294117,53,28,0,81
6598,-5.466499999999696,2988.6153846153848,37,37,1,74
6599,18.74150000000055,3987.75,54,27,0,81
6600,10.335750000000118,2692.285714285714,57,28,0,85
6601,-12.896249999998352,3091.65,40,33,0,73
6602,3.8555000000007715,2375.5,66,31,1,97
6603,6.304750000000729,2259.375,49,29,0,78
6604,18.991250000001124,2925.5555555555557,67,22,0,89
6605,-29.32700000000032,1429.0,21,37,3,58
6606,-6.8445000000004415,2071.875,47,47,1,94
6607,-14.324749999999227,2589.5263157894738,33,28,4,61
6608,-6.14899999999909,3167.1,47,30,0,77
6609,-8.419999999998456,3515.1052631578946,51,29,5,80
6610,20.670500000001983,4237.777777777777,72,33,1,105
6611,8.685000000000977,2344.75,57,24,1,81
6612,-34.66075000000002,1429.0,13,40,0,53
6613,-17.316999999999275,2741.0588235294117,30,20,1,50
6614,4.368250000000682,3730.65,57,20,1,77
6615,-18.665749999999687,2500.5555555555557,25,35,0,60
6616,-19.845249999998973,2567.9,31,30,0,61
6617,20.13825000000171,4930.75,66,23,0,89
6618,-5.622749999999911,2685.6153846153848,47,32,12,79
6619,-20.336249999999843,2500.842105263158,25,34,2,59
6620,9.96175000000203,2067.9375,68,25,0,93
6621,6.069250000000248,2652.25,42,38,0,80
6622,0.17050000000189716,2026.9444444444443,53,21,3,74
6623,-8.55149999999865,2739.9411764705883,44,27,0,71
6624,3.1392500000011734,3065.0,52,34,2,86
6625,4.1585000000010925,3250.0555555555557,45,27,0,72
6626,-4.542749999999242,2607.1052631578946,30,27,1,57
6627,16.2800000000009,4603.75,70,28,0,98
6628,2.915750000000637,2387.176470588235,41,47,1,88
6629,-29.11674999999973,2149.75,17,27,0,44
6630,-6.812499999999728,3286.25,36,28,0,64
6631,40.39075000000277,5750.45,88,20,0,108
6632,2.1192500000012893,2917.6111111111113,69,27,4,96
6633,-0.640999999999171,2468.6666666666665,32,31,0,63
6634,8.761000000000442,3392.0,67,26,0,93
6635,-5.827999999997746,3528.4,53,26,1,79
6636,-19.57274999999897,2821.866666666667,29,31,2,60
6637,6.538750000001114,3692.55,47,19,0,66
6638,-14.765249999999138,2712.2631578947367,31,28,0,59
6639,12.46975000000127,4746.6,51,32,0,83
6640,10.689500000001312,4119.6,48,34,0,82
6641,12.874250000000368,2536.1875,67,35,0,102
6642,17.681000000000576,3740.15,48,30,0,78
6643,-13.039499999998998,3342.2105263157896,54,29,2,83
6644,28.965750000001236,3274.235294117647,76,24,2,100
6645,15.269500000001518,4318.75,60,21,1,81
6646,18.7330000000012,5496.45,64,29,0,93
6647,-1.0394999999987997,3325.9,37,33,1,70
6648,9.983500000000829,3132.35,42,31,0,73
6649,23.643500000001122,4645.526315789473,84,23,1,107
6650,24.252000000001697,4764.0,63,24,0,87
6651,35.39450000000125,3455.6111111111113,92,26,0,118
6652,16.401500000000464,2409.1875,53,37,1,90
6653,13.392500000000691,2400.6,59,26,0,85
6654,-3.113999999999172,2407.8888888888887,42,33,0,75
6655,19.49500000000071,2996.764705882353,72,26,2,98
6656,2.8462499999997113,1429.0,53,45,0,98
6657,13.840250000000452,2652.1875,74,42,0,116
6658,-8.671999999999105,2991.4210526315787,49,28,7,77
6659,7.420250000001424,3984.65,58,24,0,82
6660,6.327500000002105,4467.2,61,26,0,87
6661,31.331750000001353,2851.75,81,21,1,102
6662,-12.652999999999725,2564.0,26,31,0,57
6663,26.742000000001276,4894.85,69,24,1,93
6664,13.325000000001305,4123.315789473684,62,22,0,84
6665,-30.14524999999952,1959.5263157894738,16,25,4,41
6666,-25.584749999999886,2405.3888888888887,29,21,1,50
6667,4.526000000000968,2463.75,49,32,1,81
6668,22.542000000001547,4099.8,56,26,0,82
6669,23.24875000000072,3027.375,60,37,0,97
6670,-32.02799999999957,2040.2,16,31,0,47
6671,8.671750000001511,3599.85,51,29,0,80
6672,12.066250000001695,3393.8333333333335,60,30,0,90
6673,-3.6517499999994003,3121.6315789473683,42,28,0,70
6674,0.0705000000008881,3736.4736842105262,50,32,0,82
6675,-23.66099999999941,2550.315789473684,31,36,5,67
6676,-6.158499999999423,2462.705882352941,40,32,1,72
6677,0.30200000000122207,3370.35,41,30,0,71
6678,26.249500000001518,4333.95,72,20,0,92
6679,8.082500000000454,3027.9473684210525,50,27,4,77
6680,-18.240499999999464,2657.8,28,29,1,57
6681,-26.032249999999454,2129.95,17,33,1,50
6682,-19.478999999998866,2664.8,26,31,1,57
6683,44.57650000000329,3197.0625,94,17,1,111
6684,-13.678249999999101,2775.9,26,32,2,58
6685,-5.592749999999427,2463.5,30,31,0,61
6686,5.010750000000746,2767.0,57,26,1,83
6687,-13.923249999999603,2887.85,30,29,0,59
6688,4.286750000001597,3674.842105263158,57,31,0,88
6689,-8.991499999999188,2482.9444444444443,45,27,1,72
6690,13.810500000001005,3729.05,56,17,3,73
6691,12.016750000002625,3957.3888888888887,76,22,0,98
6692,13.380750000000939,2438.6666666666665,50,22,0,72
6693,26.016500000001237,4287.05,57,29,0,86
6694,2.680250000000618,2268.3125,46,31,1,77
6695,-15.870999999999924,1966.764705882353,37,37,2,74
6696,42.14650000000209,4661.944444444444,87,28,0,115
6697,36.2540000000025,5849.75,104,13,0,117
6698,-7.472749999999175,3063.8888888888887,43,31,0,74
6699,1.8605000000009853,2998.0526315789475,47,21,1,68
6700,20.04500000000167,4095.8333333333335,73,35,0,108
6701,-5.413499999999459,3014.7894736842104,42,25,1,67
6702,13.602250000001439,4508.35,65,29,0,94
6703,-13.52499999999932,2571.95,30,32,0,62
6704,-5.963999999999361,3039.842105263158,41,30,0,71
6705,-16.91324999999923,2928.6,28,32,0,60
6706,5.026250000002721,2410.0666666666666,71,34,0,105
6707,-14.580999999999344,2559.95,31,24,1,55
6708,11.088000000000537,2536.1875,48,36,0,84
6709,-32.008499999999486,2008.55,13,32,0,45
6710,8.880500000000819,3076.0,42,22,0,64
6711,8.063750000000624,3048.0555555555557,61,34,0,95
6712,1.0547500000000007,1879.1764705882354,53,26,1,79
6713,-12.975749999998722,2333.8125,50,22,0,72
6714,12.537750000003149,2418.4666666666667,81,14,0,95
6715,16.00000000000151,4060.7368421052633,70,22,0,92
6716,16.44975000000099,3382.3684210526317,59,25,0,84
6717,25.67325000000107,3963.7894736842104,70,19,0,89
6718,17.50900000000096,3508.4736842105262,70,19,7,89
6719,10.259750000001123,3887.6315789473683,58,28,0,86
6720,-6.609749999998947,3466.35,39,35,0,74
6721,-27.06449999999959,1959.578947368421,16,25,9,41
6722,13.6615000000013,4218.8,59,29,0,88
6723,-21.49374999999931,2595.75,25,25,1,50
6724,11.663750000001784,2444.0588235294117,56,26,1,82
6725,-10.94574999999843,3024.35,41,27,1,68
6726,-2.6327499999993984,2572.0,42,23,1,65
6727,43.922250000001775,5328.35,82,24,0,106
6728,34.87400000000213,5143.35,83,18,2,101
6729,6.984000000001712,5128.3,75,25,0,100
6730,-19.24575000000015,2124.0,43,37,12,80
6731,4.344750000001238,2682.0625,55,25,1,80
6732,-16.655249999999036,2492.6111111111113,30,27,0,57
6733,13.348750000001164,4333.9,68,28,0,96
6734,-16.307749999999338,1895.8823529411766,44,40,3,84
6735,-15.670749999999495,2625.05,29,28,0,57
6736,0.7570000000005452,2304.0625,47,35,0,82
6737,-21.606750000000375,1756.764705882353,26,46,3,72
6738,23.20025000000185,4621.3,66,23,0,89
6739,26.768000000001486,4786.15,74,27,0,101
6740,12.77350000000063,4046.55,47,35,0,82
6741,-18.621499999999486,2008.45,16,30,2,46
6742,-26.83849999999983,2008.5,12,29,0,41
6743,-0.9489999999991408,3071.95,44,18,0,62
6744,-27.89249999999958,2028.25,14,27,3,41
6745,9.135750000001213,2371.5,65,28,0,93
6746,0.8542500000003717,2726.0,45,33,1,78
6747,-20.033499999999318,2529.9411764705883,24,28,0,52
6748,-13.290749999997866,3188.65,43,21,2,64
6749,11.350250000000823,2869.9444444444443,54,28,1,82
6750,16.44350000000185,3759.375,73,23,0,96
6751,8.260250000000903,2849.6666666666665,59,36,0,95
6752,-23.851249999999332,2044.15,18,31,1,49
6753,-5.093999999999246,2540.2,37,18,1,55
6754,-13.394749999999297,2671.15,29,27,0,56
6755,-19.63899999999978,2127.5,20,28,0,48
6756,30.325750000002,4398.263157894737,85,26,8,111
6757,-19.413249999999596,2040.15,12,32,1,44
6758,-5.3002499999990444,3131.45,47,22,0,69
6759,-0.47674999999847467,3448.2105263157896,68,29,2,97
6760,1.863750000001468,4070.35,56,29,0,85
6761,6.558000000001378,4540.15,57,33,0,90
6762,-2.571749999999072,3421.95,48,19,0,67
6763,1.1657500000006356,2652.294117647059,42,23,2,65
6764,-4.620749999999012,3166.4,44,27,2,71
6765,-8.321749999999469,2320.0,44,17,3,61
6766,10.249500000000328,3343.5555555555557,50,35,0,85
6767,8.650250000000295,2940.823529411765,53,17,4,70
6768,18.757500000001198,4271.25,71,18,0,89
6769,0.9855000000008551,2938.6666666666665,47,31,0,78
6770,23.326500000000784,3003.4117647058824,71,10,0,81
6771,-10.842499999999188,2544.25,33,20,4,53
6772,-3.75949999999891,3224.4210526315787,51,24,2,75
6773,19.630250000001887,4171.1,68,18,0,86
6774,21.586500000000413,3841.8888888888887,71,33,1,104
6775,-11.948999999999186,3277.842105263158,38,32,0,70
6776,-5.5152499999995355,2272.176470588235,40,27,0,67
6777,24.956000000001197,5377.55,83,17,0,100
6778,3.1877500000013748,3843.45,61,29,0,90
6779,20.145500000000954,2518.3125,61,34,0,95
6780,1.9377500000010375,2694.9375,54,29,4,83
6781,-26.100999999999107,2681.4210526315787,33,29,1,62
6782,-20.61024999999976,1908.9411764705883,29,27,3,56
6783,21.538250000001508,4070.6315789473683,70,16,0,86
6784,-3.1892499999988737,2598.176470588235,42,28,0,70
6785,30.999500000001706,4855.2,86,16,1,102
6786,-27.844999999999704,1972.0,15,29,4,44
6787,-12.99774999999931,3063.9444444444443,42,29,0,71
6788,-16.23849999999951,2160.75,22,27,0,49
6789,2.5322500000019934,3201.6111111111113,52,42,0,94
6790,3.621000000001113,4159.3,62,20,0,82
6791,-1.75149999999948,3838.55,40,32,0,72
6792,-11.574249999999429,2491.7368421052633,32,23,1,55
6793,-6.622999999999148,2557.0,36,22,0,58
6794,-7.598749999998951,3009.7894736842104,37,37,2,74
6795,4.222750000000071,2415.0588235294117,50,26,1,76
6796,-12.900749999999013,2531.277777777778,32,27,2,59
6797,-22.655749999999383,2044.1,17,31,1,48
6798,-7.423499999999247,2558.777777777778,28,29,0,57
6799,-12.067999999999635,1429.0,25,32,0,57
6800,16.699250000001136,4288.736842105263,59,25,1,84
6801,-3.4204999999995302,3032.2631578947367,46,27,2,73
6802,8.957750000001331,3655.25,59,18,0,77
6803,-5.63949999999951,1996.625,37,32,0,69
6804,24.86125000000148,4837.15,78,19,1,97
6805,-22.53399999999945,2465.7894736842104,26,31,0,57
6806,-38.14599999999987,1429.0,4,30,4,34
6807,17.592500000001728,2898.222222222222,65,35,0,100
6808,9.876500000000894,4107.65,53,28,0,81
6809,-8.196749999998431,3599.75,57,22,1,79
6810,-17.6952499999991,2257.235294117647,33,26,4,59
6811,7.071250000001541,2878.5625,58,20,0,78
6812,10.336000000001409,3607.6,56,23,0,79
6813,4.8655000000008215,3278.7368421052633,49,29,6,78
6814,-12.019749999999702,1981.111111111111,27,31,1,58
6815,9.298250000000674,4340.25,59,31,0,90
6816,0.9020000000012924,4554.5,70,20,2,90
6817,18.826500000001975,4898.95,75,16,0,91
6818,-9.445499999998951,2452.8888888888887,35,25,1,60
6819,9.0677500000015,3847.35,55,31,0,86
6820,0.9590000000007185,2925.823529411765,52,11,0,63
6821,30.13750000000213,4294.111111111111,95,29,0,124
6822,-29.409749999999626,2012.35,12,26,1,38
6823,-16.766749999999714,2429.1111111111113,29,39,0,68
6824,-5.171249999999449,2524.3333333333335,56,35,0,91
6825,3.6082500000017186,3730.6,63,19,0,82
6826,13.207000000001486,3734.6,59,26,0,85
6827,-25.121249999999314,2210.9,12,40,0,52
6828,20.763000000001092,3635.5,56,26,0,82
6829,-21.7714999999996,2071.1,13,33,1,46
6830,-3.2714999999990404,2433.5555555555557,50,32,3,82
6831,15.292750000002332,4151.35,74,27,1,101
6832,3.402000000001009,3798.0,60,16,0,76
6833,6.30450000000108,4230.7,64,34,0,98
6834,7.602000000001591,3221.9444444444443,61,25,0,86
6835,-10.114249999999368,2784.8,30,31,0,61
6836,-9.959249999999475,2395.4117647058824,53,26,1,79
6837,-5.2497499999983885,3268.75,47,29,0,76
6838,30.6752500000017,3408.705882352941,72,22,1,94
6839,13.012000000001967,4208.5,67,22,0,89
6840,9.106250000001635,3637.157894736842,57,24,0,81
6841,-18.22049999999909,2542.684210526316,31,29,2,60
6842,2.902500000000642,2419.6,47,27,0,74
6843,-10.889249999999251,2479.529411764706,33,25,1,58
6844,9.311000000001034,3585.277777777778,58,27,0,85
6845,-4.001999999999552,2483.2631578947367,31,26,2,57
6846,7.563000000001229,3619.5263157894738,60,27,2,87
6847,10.22750000000135,3825.95,64,19,0,83
6848,22.87950000000307,5240.9,84,22,0,106
6849,-0.10449999999832098,4074.35,51,31,0,82
6850,26.261250000001382,4413.15,59,25,0,84
6851,-7.718999999999281,2286.1176470588234,37,30,0,67
6852,2.1005000000006797,2999.684210526316,38,30,0,68
6853,5.524750000000684,2622.5625,40,24,0,64
6854,-7.174249999998463,2982.157894736842,50,25,1,75
6855,8.415750000001097,3615.6,50,25,1,75
6856,23.448750000001027,4455.0,65,34,0,99
6857,33.041500000000944,2833.9375,87,28,1,115
6858,-8.561749999999439,2328.235294117647,39,37,2,76
6859,13.529750000002025,5246.5,78,27,0,105
6860,-26.502999999999325,2549.4210526315787,27,34,0,61
6861,11.857750000001396,4574.3,60,26,0,86
6862,17.808750000001986,3930.9444444444443,81,23,0,104
6863,-12.771249999999153,2189.176470588235,24,37,1,61
6864,16.765750000000207,1965.2222222222222,50,37,1,87
6865,-29.055249999999567,2024.3,11,28,2,39
6866,31.795250000001595,4611.7,75,18,1,93
6867,-34.97949999999976,1960.7777777777778,13,37,4,50
6868,-26.264499999999476,2114.05,18,29,1,47
6869,8.157250000001273,3670.4,47,33,0,80
6870,-27.287999999999577,2109.8333333333335,21,32,2,53
6871,-11.277750000000092,1944.888888888889,28,29,0,57
6872,9.051000000001162,3333.777777777778,48,31,0,79
6873,-2.231749999999951,2496.294117647059,55,53,1,108
6874,32.906250000002004,4259.526315789473,89,17,0,106
6875,10.720250000001183,2557.0625,63,22,0,85
6876,24.999750000001363,3865.5555555555557,74,42,0,116
6877,-10.508749999999981,2038.764705882353,51,26,4,77
6878,3.668250000000147,2386.866666666667,52,23,6,75
6879,1.6092500000021261,4993.3,60,26,0,86
6880,-35.81549999999975,2098.75,28,45,1,73
6881,-19.110999999999823,2465.0526315789475,26,30,5,56
6882,-14.978999999998976,3194.15,29,39,3,68
6883,-1.4539999999985131,3809.9473684210525,53,31,1,84
6884,41.59650000000292,5991.0,95,22,0,117
6885,6.89175000000112,4522.8,59,28,4,87
6886,-9.926749999999101,2493.2631578947367,32,29,3,61
6887,12.759250000001675,2353.6875,56,19,1,75
6888,1.3400000000008832,3487.85,46,31,0,77
6889,-3.1517499999996565,2641.1,26,33,0,59
6890,11.056500000001924,5341.75,78,23,1,101
6891,14.127250000002055,3877.7894736842104,62,28,0,90
6892,10.285750000000776,2726.75,52,23,0,75
6893,-2.1872499999985475,3177.0,59,35,1,94
6894,-18.721499999999647,2156.1,14,34,0,48
6895,-13.822249999999215,2754.45,28,27,2,55
6896,16.145500000001125,4130.894736842105,60,26,1,86
6897,-17.019249999999616,1916.4117647058824,30,51,0,81
6898,11.128250000000978,4094.1,46,39,0,85
6899,-3.4209999999991765,2572.0,44,25,6,69
6900,12.810750000001317,4336.2,53,26,0,79
6901,6.583250000000423,4414.0,62,29,0,91
6902,-7.82424999999939,1952.8823529411766,34,32,0,66
6903,-0.3449999999988376,3112.714285714286,40,28,0,68
6904,20.13725000000148,3101.9444444444443,56,22,1,78
6905,-21.824749999999558,2028.25,11,31,0,42
6906,-5.942499999999259,2550.777777777778,30,28,0,58
6907,2.067000000001129,3092.222222222222,47,26,2,73
6908,32.74475000000116,4702.8,71,17,0,88
6909,10.76250000000106,3151.9473684210525,49,18,0,67
6910,-12.478249999999477,3693.3,33,34,0,67
6911,15.0380000000004,3016.3888888888887,48,31,0,79
6912,-8.41824999999915,2638.0,36,32,0,68
6913,37.71175000000137,3232.625,78,31,0,109
6914,2.2195000000003353,2633.6470588235293,56,32,5,88
6915,-10.099500000000187,2571.8823529411766,44,29,0,73
6916,27.375250000000154,3298.5555555555557,64,26,0,90
6917,20.635750000000275,3568.5789473684213,55,24,1,79
6918,0.685500000000728,3812.4,46,26,0,72
6919,13.602750000000995,3928.7368421052633,66,20,0,86
6920,6.670750000000751,3246.157894736842,38,30,1,68
6921,-13.25974999999932,2480.8947368421054,31,27,1,58
6922,-30.029250000000296,2179.5,32,35,1,67
6923,-0.16074999999792255,1915.8,55,21,0,76
6924,-24.9619999999996,2048.05,18,28,0,46
6925,14.272000000001213,3292.9473684210525,51,31,0,82
6926,21.444750000001374,3976.315789473684,67,16,2,83
6927,-19.392749999998813,2552.15,32,23,1,55
6928,13.89975000000187,2367.625,57,28,0,85
6929,-1.0507499999997874,1889.375,50,33,1,83
6930,11.365250000000447,1777.25,46,41,0,87
6931,40.928000000001774,5771.15,76,25,0,101
6932,21.714000000001402,5563.2,67,30,5,97
6933,-4.837249999999441,2471.3888888888887,36,27,0,63
6934,-2.7922499999985666,3060.4444444444443,39,27,0,66
6935,-9.284749999998953,2572.0,30,34,0,64
6936,25.060250000001705,4378.35,75,21,0,96
6937,-4.84174999999909,3262.7894736842104,48,30,0,78
6938,25.798499999999912,2309.0625,63,24,0,87
6939,7.196500000000396,1912.6470588235295,54,31,0,85
6940,24.223500000001113,3492.6666666666665,62,26,0,88
6941,-10.969749999998493,2052.764705882353,27,35,1,62
6942,0.11000000000091355,3151.25,45,29,1,74
6943,-12.441999999999023,2550.8333333333335,33,25,0,58
6944,37.814750000001695,5080.7,80,27,0,107
6945,25.3910000000009,3794.2631578947367,57,29,2,86
6946,-0.3842500000001877,1920.0625,52,33,1,85
6947,19.537000000001914,3290.0,73,29,1,102
6948,-7.351749999999856,2613.3333333333335,29,31,2,60
6949,17.546750000001545,3241.625,63,21,0,84
6950,-5.766749999999347,2563.95,30,27,0,57
6951,4.70150000000096,3151.35,38,28,0,66
6952,-10.007499999999899,1957.2222222222222,36,26,2,62
6953,-4.898249999999409,2411.25,44,42,0,86
6954,22.63725000000134,4307.0526315789475,67,19,1,86
6955,7.480000000002268,2595.75,56,24,0,80
6956,-5.100999999999983,2421.0555555555557,49,35,1,84
6957,20.656500000001074,4297.35,72,20,0,92
6958,7.752500000000611,2491.625,55,41,0,96
6959,8.780000000001824,3694.25,57,27,1,84
6960,7.4622500000002985,3020.4736842105262,55,22,1,77
6961,53.71525000000243,5825.85,114,18,0,132
6962,17.534250000002125,4119.6,66,24,0,90
6963,33.78150000000137,3336.6470588235293,73,30,0,103
6964,-12.847499999998774,2592.4285714285716,41,29,1,70
6965,-13.092499999999456,2468.722222222222,34,31,0,65
6966,16.650000000001025,2911.25,67,34,0,101
6967,-9.489249999999256,2598.7368421052633,31,24,0,55
6968,2.560250000000169,4114.0526315789475,64,35,1,99
6969,2.2417500000011805,3653.0526315789475,50,28,1,78
6970,-6.7667499999989005,3217.7368421052633,40,31,0,71
6971,-10.933249999998955,2391.823529411765,41,31,2,72
6972,17.79300000000113,3714.85,54,26,0,80
6973,21.530500000001005,3445.8333333333335,62,29,0,91
6974,-9.821999999999269,3135.5,42,23,2,65
6975,20.308250000001124,2937.9375,65,19,0,84
6976,-12.039749999999794,1857.5625,34,39,1,73
6977,-1.3157499999990327,1963.1176470588234,46,27,5,73
6978,-9.75349999999995,1769.8235294117646,23,23,1,46
6979,4.370000000000994,3178.3,40,26,0,66
6980,-7.4667500000000135,2499.2631578947367,36,27,7,63
6981,-13.963249999999345,2168.8888888888887,26,24,1,50
6982,2.3647500000008916,3085.7368421052633,42,28,1,70
6983,2.037250000001436,3743.45,58,25,0,83
6984,7.93950000000131,2326.875,53,29,1,82
6985,-1.9984999999998885,2504.6470588235293,43,40,0,83
6986,14.695750000001235,3701.3,58,28,0,86
6987,-14.86199999999852,3044.1,42,34,0,76
6988,26.45400000000174,3945.1666666666665,76,17,0,93
6989,-3.9837499999994854,2571.95,27,31,0,58
6990,35.90175000000154,4773.6,80,15,1,95
6991,5.663500000001237,3954.45,54,23,0,77
6992,-29.86849999999963,2003.7368421052631,14,23,7,37
6993,9.86850000000094,3476.722222222222,67,37,0,104
6994,-11.723249999999537,2642.9333333333334,24,40,1,64
6995,28.51850000000144,3137.5625,75,18,1,93
6996,5.060750000001507,3846.5,48,31,0,79
6997,-15.090000000000268,1874.4117647058824,28,29,0,57
6998,-23.94724999999999,1992.1052631578948,12,30,4,42
6999,-10.478999999999646,2014.611111111111,38,35,0,73
7000,3.402750000000772,3084.55,38,22,0,60
7001,-4.2397499999993915,2479.470588235294,46,34,0,80
7002,20.423250000001335,4774.3,65,23,0,88
7003,-21.86849999999982,1963.388888888889,29,28,5,57
7004,13.532750000001567,4325.9,67,26,0,93
7005,-25.209249999999564,1976.2631578947369,18,28,2,46
7006,15.529750000001474,3961.315789473684,60,28,0,88
7007,-6.097249999999818,2436.8888888888887,41,27,1,68
7008,-0.16249999999801412,2306.0,66,29,0,95
7009,-12.072000000000026,1949.2777777777778,34,23,13,57
7010,18.728750000001767,4791.8,61,28,0,89
7011,22.772250000000632,3410.684210526316,53,26,3,79
7012,16.12650000000144,3615.65,58,20,0,78
7013,0.30200000000129423,4156.05,55,32,0,87
7014,-4.704499999998768,3362.35,49,27,0,76
7015,-3.7994999999986128,2814.5555555555557,51,28,0,79
7016,31.451000000001493,4278.4,56,28,0,84
7017,23.3627500000018,4047.176470588235,74,25,1,99
7018,-2.7174999999981972,3614.85,53,26,1,79
7019,32.47525000000101,4318.0,79,22,0,101
7020,-5.405249999999031,2998.0,41,20,0,61
7021,-17.123249999999786,3325.4736842105262,26,36,5,62
7022,22.253250000000833,3797.6315789473683,64,32,0,96
7023,8.998500000000341,2420.0625,46,30,0,76
7024,-15.9782499999998,2472.6315789473683,25,31,4,56
7025,18.243500000000786,4932.25,66,17,0,83
7026,23.011000000000834,2854.0,64,23,3,87
7027,-1.6752499999990291,3856.05,52,26,0,78
7028,23.362500000001525,4414.0,64,24,0,88
7029,33.47350000000155,3496.7894736842104,66,23,0,89
7030,13.2270000000013,3654.684210526316,51,23,0,74
7031,-34.74500000000015,1964.9411764705883,14,27,10,41
7032,19.154500000001857,4295.421052631579,77,15,1,92
7033,8.960000000001388,3091.85,49,26,0,75
7034,9.054750000001077,4582.3,56,38,1,94
7035,7.983250000000929,3710.7,46,26,0,72
7036,-14.605750000000176,1973.2777777777778,31,34,2,65
7037,-22.938999999999485,2024.0,20,28,2,48
7038,-18.259499999999072,1961.7222222222222,25,27,1,52
7039,13.913500000000823,3660.15,53,22,1,75
7040,1.4112500000012596,2877.9444444444443,43,28,1,71
7041,-23.78249999999932,2821.15,22,39,0,61
7042,24.1097500000011,4693.894736842105,86,21,0,107
7043,-32.47674999999956,1933.4444444444443,17,28,2,45
7044,-2.7534999999993426,2276.8823529411766,32,43,7,75
7045,20.289750000000346,2393.8333333333335,53,39,0,92
7046,-30.400499999999255,2059.7894736842104,12,34,6,46
7047,13.338750000000852,3377.9444444444443,55,25,2,80
7048,-6.261999999999135,2338.222222222222,42,28,1,70
7049,27.197250000002605,4679.1,81,24,0,105
7050,-26.826499999999527,2032.25,16,35,0,51
7051,-9.626499999999599,2841.8,32,24,0,56
7052,-6.313749999999009,2612.4,31,26,0,57
7053,-15.587499999998917,2650.3333333333335,30,30,3,60
7054,21.60925000000186,2718.0,74,16,1,90
7055,10.620500000000819,2610.8125,56,27,0,83
7056,26.95550000000216,4778.3,71,25,0,96
7057,1.0530000000001754,2429.0555555555557,40,30,0,70
7058,-3.9397499999990506,3194.1428571428573,48,18,0,66
7059,-8.050749999995993,1831.875,64,37,1,101
7060,15.79625000000144,3782.4210526315787,67,30,0,97
7061,-12.161749999999214,3393.0526315789475,41,34,0,75
7062,-5.0007499999997895,2462.764705882353,61,30,1,91
7063,-6.835499999998275,3244.176470588235,49,27,0,76
7064,5.549500000001162,3982.25,48,27,0,75
7065,8.29650000000125,3668.65,56,16,1,72
7066,0.96975000000023,2170.0625,49,35,0,84
7067,-12.954999999999606,2718.0,28,28,0,56
7068,-30.25124999999964,2076.5263157894738,15,27,1,42
7069,35.359750000001476,3625.625,76,24,0,100
7070,-8.495249999998482,2447.6111111111113,46,21,0,67
7071,-1.6179999999989563,3832.3,50,25,1,75
7072,-17.086999999999502,2587.9,24,28,1,52
7073,-9.876749999999422,2505.3333333333335,37,28,2,65
7074,2.57375000000019,3051.0,46,33,0,79
7075,1.6235000000005684,2514.4375,36,32,1,68
7076,27.236750000001155,3787.0555555555557,79,22,0,101
7077,36.22575000000228,5218.8,89,19,0,108
7078,-4.926249999999373,1998.5294117647059,33,34,2,67
7079,-4.083249999999181,3105.25,46,15,0,61
7080,6.432000000002287,2922.133333333333,56,32,0,88
7081,17.238000000001097,4147.25,53,24,0,77
7082,18.684250000001292,4769.6,75,34,1,109
7083,-23.36874999999897,3250.55,35,26,1,61
7084,19.312000000000523,4119.722222222223,84,11,0,95
7085,10.27025000000113,4034.7894736842104,64,20,3,84
7086,-5.224999999999749,2361.823529411765,68,37,0,105
7087,-4.808999999998986,4141.0,47,39,1,86
7088,22.50400000000121,3456.875,57,32,0,89
7089,4.949500000001055,3869.65,61,16,0,77
7090,-21.849999999999515,2051.4,16,31,1,47
7091,11.82975000000069,3579.9444444444443,73,31,0,104
7092,7.373750000000433,2934.3888888888887,41,31,0,72
7093,12.329250000001656,3607.6,56,22,1,78
7094,-5.68099999999927,2473.6875,32,24,0,56
7095,-16.809499999999314,2495.733333333333,34,30,1,64
7096,-17.447499999999835,2054.125,31,33,3,64
7097,-15.63299999999948,1895.8823529411766,31,24,0,55
7098,-11.175999999999089,2974.35,44,25,0,69
7099,21.50225000000114,5129.85,76,19,0,95
7100,17.36525000000068,2348.625,59,52,0,111
7101,-9.039749999999618,2171.5555555555557,30,28,1,58
7102,-0.8017499999986543,4143.35,55,20,0,75
7103,-7.9222499999989155,3294.95,48,29,0,77
7104,14.408500000000572,2304.0625,62,27,0,89
7105,1.4182500000011093,2005.4375,56,20,2,76
7106,1.3175000000005421,3856.75,55,23,0,78
7107,21.52825000000184,4123.55,69,21,0,90
7108,18.701750000001397,4235.210526315789,63,30,0,93
7109,-1.353749999999061,3436.25,42,26,0,68
7110,5.2590000000006665,2455.6875,55,29,0,84
7111,-0.4062499999988331,3252.7894736842104,48,28,1,76
7112,-26.999250000000053,1977.1052631578948,10,38,6,48
7113,10.126500000000792,2921.1666666666665,50,25,0,75
7114,-3.990999999999192,3275.1,45,28,2,73
7115,-18.709749999999143,2923.7,34,34,0,68
7116,1.2527500000011382,4477.473684210527,59,29,1,88
7117,25.596500000001306,3887.7894736842104,64,26,0,90
7118,13.626250000001724,4185.9473684210525,71,35,0,106
7119,-11.635749999999213,2481.0,36,31,2,67
7120,37.12600000000337,2409.25,82,22,0,104
7121,-23.008999999999638,2034.7368421052631,19,32,3,51
7122,-5.131749999999355,2568.05,34,24,1,58
7123,4.891000000001638,3837.95,58,25,0,83
7124,1.1992500000005812,3011.1111111111113,58,24,2,82
7125,16.80875000000031,3419.5,45,32,0,77
7126,8.140500000001506,2394.470588235294,53,22,0,75
7127,29.164250000000248,3587.8333333333335,77,20,0,97
7128,-27.518249999999654,1979.5263157894738,30,33,10,63
7129,17.24950000000205,2605.529411764706,67,23,0,90
7130,-32.368749999999515,2024.3,16,26,2,42
7131,5.235500000001809,3765.65,63,20,0,83
7132,-43.03149999999995,1429.0,0,28,1,28
7133,28.80225000000206,4275.15,71,23,0,94
7134,-25.858999999999906,2004.6842105263158,17,25,4,42
7135,-37.4544999999997,2032.3,11,33,0,44
7136,-7.236249999999505,2721.8333333333335,41,36,0,77
7137,26.802500000001196,4195.0,71,26,0,97
7138,2.0547500000016745,3181.6470588235293,60,29,0,89
7139,33.05600000000186,4953.65,88,16,0,104
7140,-18.398499999998787,2676.6,31,29,0,60
7141,8.830999999999685,2054.0625,56,33,0,89
7142,18.967750000001274,3890.2,62,24,0,86
7143,1.986500000000298,2963.1176470588234,55,22,0,77
7144,7.033500000001192,3790.2,54,21,0,75
7145,-9.474999999998897,3411.55,42,34,0,76
7146,8.656750000000903,2857.5555555555557,50,24,0,74
7147,21.804000000000688,3487.9411764705883,67,21,0,88
7148,-19.19299999999946,2384.1666666666665,42,32,7,74
7149,-37.57174999999903,2655.3,26,31,2,57
7150,-4.249249999998757,3859.25,53,24,0,77
7151,4.405750000000843,2722.75,64,20,5,84
7152,-14.460499999999735,1946.875,31,40,0,71
7153,13.358750000001347,3675.1111111111113,70,41,0,111
7154,-14.772749999998473,4329.15,51,42,1,93
7155,-1.466499999999493,2536.6111111111113,58,24,0,82
7156,1.4860000000009113,3846.8947368421054,46,29,0,75
7157,-2.952249999998864,2870.0555555555557,48,20,0,68
7158,8.647000000000848,4329.1,53,27,0,80
7159,0.2040000000011064,2411.1875,76,27,0,103
7160,24.22500000000131,4163.2,72,14,0,86
7161,-18.711499999999337,1848.625,33,31,0,64
7162,19.436500000001804,3380.529411764706,70,19,0,89
7163,13.597750000001389,3758.4,59,27,0,86
7164,1.4082500000010825,3437.3684210526317,62,32,0,94
7165,-11.241999999999255,4334.6,44,36,0,80
7166,-22.585249999999814,2216.45,16,32,3,48
7167,3.273000000000524,2744.6470588235293,37,24,0,61
7168,-2.2944999999986493,2989.0,52,15,0,67
7169,8.542000000000993,3627.55,63,18,0,81
7170,20.440250000001704,4690.15,71,22,0,93
7171,12.121750000003036,2374.5555555555557,63,29,1,92
7172,-4.355749999999485,2425.5555555555557,39,34,2,73
7173,-16.04924999999935,2129.85,22,26,0,48
7174,7.302250000001346,3672.75,58,20,1,78
7175,1.8725000000013736,4306.05,59,26,0,85
7176,1.524500000000621,3927.55,47,29,0,76
7177,-30.609249999999253,2644.9,23,31,0,54
7178,8.575000000000577,2995.277777777778,50,27,0,77
7179,-5.334749999998868,3183.05,48,23,0,71
7180,0.5785000000005628,2659.866666666667,44,28,0,72
7181,24.25700000000241,4663.2,85,9,0,94
7182,26.642250000001418,3431.9411764705883,75,19,0,94
7183,7.908000000001815,2885.6470588235293,59,30,0,89
7184,-6.106999999998203,2385.235294117647,46,26,1,72
7185,-5.334749999999013,2548.15,38,21,0,59
7186,1.3647500000013213,3814.75,60,22,0,82
7187,34.11775000000121,2448.0666666666666,69,27,0,96
7188,2.7852500000005618,1866.4375,43,41,0,84
7189,-9.00249999999836,2171.4117647058824,40,32,1,72
7190,8.704500000001252,3493.3333333333335,62,24,1,86
7191,-10.86349999999939,2504.9444444444443,27,28,0,55
7192,15.532750000001766,3744.1,55,27,0,82
7193,-7.024749999998778,3234.9411764705883,49,21,1,70
7194,-17.286249999999306,2569.4210526315787,30,20,0,50
7195,-12.636999999998896,2560.05,37,26,0,63
7196,-14.29649999999921,2514.9411764705883,41,26,2,67
7197,-3.743249999998953,4691.8,59,20,0,79
7198,-5.5352499999993,3071.8888888888887,53,35,1,88
7199,28.254000000002367,4701.25,90,13,2,103
7200,28.34875000000211,5143.35,92,14,0,106
7201,16.927250000000626,3230.6111111111113,61,24,1,85
7202,4.832249999999926,1946.3529411764705,44,24,3,68
7203,-6.797249999999177,2672.4444444444443,41,16,1,57
7204,13.242000000001019,2444.9375,59,25,4,84
7205,-41.71149999999997,1952.1052631578948,13,27,13,40
7206,-5.648999999998896,1942.9375,58,22,0,80
7207,-22.61374999999959,1830.8125,26,28,0,54
7208,-1.7957499999990691,2580.4117647058824,58,20,0,78
7209,21.22375000000181,5187.0,86,21,1,107
7210,17.637000000002672,1953.7777777777778,57,24,1,81
7211,-2.9399999999993502,2462.5,48,26,0,74
7212,-19.727249999999774,1919.1764705882354,36,31,1,67
7213,-11.813249999998636,1961.6666666666667,29,32,0,61
7214,11.755250000001514,2785.25,62,20,0,82
7215,-6.1232499999989844,2301.176470588235,52,25,2,77
7216,2.519500000001182,2982.5625,69,41,0,110
7217,26.24650000000175,4080.75,69,26,0,95
7218,1.2760000000001308,2812.6666666666665,52,25,4,77
7219,0.3442500000008376,2268.25,51,25,0,76
7220,10.59500000000165,2895.9411764705883,66,31,0,97
7221,-12.775249999999016,3611.2105263157896,42,26,1,68
7222,-12.224749999999759,2162.8823529411766,50,25,4,75
7223,20.907000000000494,3722.8333333333335,76,16,1,92
7224,-7.678749999999293,2639.3076923076924,43,25,1,68
7225,3.5782500000000446,2992.722222222222,56,32,0,88
7226,2.926000000000786,2695.3888888888887,52,32,2,84
7227,-34.70474999999963,2886.3333333333335,28,25,0,53
7228,4.681000000001847,2531.25,63,21,0,84
7229,-34.259249999999824,1966.888888888889,20,27,5,47
7230,7.445750000000902,1867.0,41,24,0,65
7231,-3.2192499999999074,2455.7894736842104,30,26,1,56
7232,2.7737500000009634,3773.55,57,20,0,77
7233,-1.9747499999981606,3328.8947368421054,54,26,0,80
7234,-42.79725000000022,2111.5555555555557,19,39,4,58
7235,-11.024249999999526,2562.277777777778,34,24,5,58
7236,-17.29999999999964,2475.7368421052633,27,23,0,50
7237,24.31000000000127,2329.875,62,22,1,84
7238,-34.047249999999835,1987.9473684210527,17,23,3,40
7239,12.337750000001584,3805.3,66,15,0,81
7240,8.743000000001066,3022.2105263157896,40,32,0,72
7241,-7.044499999999613,2476.6315789473683,30,27,1,57
7242,-14.960749999999075,3253.65,47,23,1,70
7243,-8.143749999999207,2496.0,51,26,0,77
7244,41.584500000002436,5148.25,87,13,0,100
7245,-1.7852499999984068,2539.3888888888887,40,34,5,74
7246,-8.104999999999585,2657.9473684210525,28,25,0,53
7247,-0.8697499999993958,2355.8888888888887,33,26,1,59
7248,-0.10099999999818073,3430.0,63,20,0,83
7249,15.780000000001664,4234.65,67,31,0,98
7250,1.8232500000003928,1876.4375,55,27,1,82
7251,17.238000000001655,3795.0,67,16,0,83
7252,-0.25099999999896017,3098.2631578947367,42,28,0,70
7253,8.780000000000856,3440.7894736842104,50,28,0,78
7254,0.8257500000016413,3738.75,65,16,1,81
7255,18.920000000000897,3864.85,55,21,0,76
7256,-15.989749999999077,2739.6666666666665,31,29,0,60
7257,29.589250000001847,3362.764705882353,82,12,0,94
7258,-2.645999999999078,3058.1052631578946,46,25,0,71
7259,3.668500000000379,2597.0588235294117,47,31,0,78
7260,18.07175000000115,4268.75,58,17,0,75
7261,4.248500000000556,2696.3333333333335,36,24,0,60
7262,31.293500000002002,4785.35,79,15,0,94
7263,26.574750000000932,4464.8,65,27,0,92
7264,-10.747249999999667,2583.8,31,27,0,58
7265,-23.277749999999774,2075.2,15,31,2,46
7266,-12.515999999999089,2690.1111111111113,38,24,0,62
7267,10.48500000000182,4647.25,73,19,0,92
7268,25.28675000000074,3074.875,72,12,0,84
7269,-14.295249999999612,2531.3333333333335,35,27,7,62
7270,-4.276499999998991,3109.2105263157896,50,22,0,72
7271,13.083500000000717,3603.75,56,16,0,72
7272,55.73475000000148,4521.588235294118,91,23,0,114
7273,-22.491499999999508,2016.3,15,28,1,43
7274,40.09950000000208,4667.2,92,14,0,106
7275,13.635000000001313,3864.85,57,22,0,79
7276,-18.45674999999976,2126.6315789473683,25,30,2,55
7277,-23.09174999999958,1429.0,12,35,1,47
7278,-17.1039999999995,1986.2631578947369,14,33,5,47
7279,18.02475000000124,3898.9,51,28,0,79
7280,-12.352999999999525,1901.4117647058824,38,32,0,70
7281,23.34875000000165,5463.95,79,27,0,106
7282,-18.26124999999964,1976.2105263157894,16,35,0,51
7283,-15.44774999999996,2100.222222222222,19,27,2,46
7284,25.07600000000169,3658.8947368421054,64,20,0,84
7285,24.603750000001476,4350.4,70,21,0,91
7286,-5.375499999999335,2488.3684210526317,32,24,0,56
7287,20.733000000001702,4439.210526315789,78,28,1,106
7288,8.54925000000165,3796.65,61,26,0,87
7289,-10.370749999999124,3656.3684210526317,49,23,0,72
7290,-3.548499999999554,2107.625,54,32,0,86
7291,-8.489499999998635,3448.15,56,23,0,79
7292,-2.299999999999752,2616.0,50,36,0,86
7293,-29.104999999999666,2040.25,16,27,0,43
7294,11.421500000000936,2510.714285714286,75,27,0,102
7295,-12.866999999998702,3386.2,38,31,1,69
7296,-2.8484999999995213,2471.0588235294117,27,34,0,61
7297,-1.506249999999238,2429.0588235294117,45,23,0,68
7298,-7.365749999999376,2571.9375,34,42,1,76
7299,0.5352500000004066,2870.8333333333335,34,37,1,71
7300,-30.329999999999522,2044.15,17,20,9,37
7301,-5.169499999999603,2871.15,34,27,0,61
7302,-3.533249999998805,2755.3888888888887,48,15,0,63
7303,18.242250000001057,3641.75,58,22,0,80
7304,13.437750000001895,3328.4117647058824,77,18,0,95
7305,-4.410249999999332,3141.15,49,15,0,64
7306,0.8000000000005786,2391.133333333333,41,30,0,71
7307,-15.652999999999341,2068.6470588235293,25,24,2,49
7308,-24.221499999999946,1814.388888888889,25,33,18,58
7309,31.403500000001475,6175.05,95,22,1,117
7310,14.841250000001708,4155.35,58,27,1,85
7311,-6.219499999999135,2548.25,34,24,0,58
7312,21.64200000000141,4465.894736842105,76,19,0,95
7313,-5.468499999999823,3808.2631578947367,55,29,0,84
7314,-43.19350000000009,1429.0,0,33,1,33
7315,-1.6817499999986374,2250.4375,50,29,0,79
7316,20.1997500000011,3662.777777777778,70,21,0,91
7317,10.516250000000964,4849.65,72,23,0,95
7318,-10.993999999999605,2770.0666666666666,27,30,2,57
7319,-0.10949999999896746,3511.55,44,33,0,77
7320,0.7812500000003066,2457.3888888888887,48,29,5,77
7321,1.0987500000002413,1996.764705882353,43,30,1,73
7322,-21.373000000000353,1429.0,21,29,2,50
7323,8.567750000000448,2495.733333333333,52,22,0,74
7324,15.169750000000672,3314.5,63,22,5,85
7325,-1.2754999999990708,3186.8947368421054,49,31,0,80
7326,18.430749999999822,2482.625,57,40,0,97
7327,-2.986749999998835,2923.684210526316,44,26,0,70
7328,20.88675000000149,2909.0588235294117,69,34,3,103
7329,-1.095749999999014,1954.764705882353,42,21,1,63
7330,-26.842999999999495,2007.2105263157894,15,28,1,43
7331,-3.8777499999999883,2572.0,44,49,0,93
7332,-32.73974999999975,1429.0,5,35,8,40
7333,12.538250000000989,3566.1052631578946,50,29,0,79
7334,18.291250000000794,5008.4,64,30,0,94
7335,21.990750000001235,2558.266666666667,81,21,0,102
7336,2.821250000000906,2614.5625,50,30,1,80
7337,5.284750000000723,1771.8666666666666,44,32,1,76
7338,-30.186749999999854,2008.5,10,28,0,38
7339,11.376750000001076,3929.15,61,16,0,77
7340,12.16124999999971,2656.0,55,27,1,82
7341,19.03775000000173,4877.5,77,19,0,96
7342,2.3540000000011783,3023.3333333333335,40,31,0,71
7343,1.2350000000015318,3724.15,54,24,0,78
7344,28.99650000000106,2835.176470588235,75,22,0,97
7345,37.567750000001475,5150.55,82,19,0,101
7346,-7.769749999998614,2520.9285714285716,43,37,0,80
7347,5.729750000001155,3572.0555555555557,68,29,0,97
7348,10.254250000001154,2494.5,60,21,0,81
7349,1.158250000000487,2603.6111111111113,54,23,0,77
7350,23.347500000000956,4040.222222222222,77,26,0,103
7351,-11.9552499999991,2425.5,35,32,3,67
7352,13.328000000001541,3233.277777777778,62,23,1,85
7353,8.738500000000823,1975.1764705882354,75,25,1,100
7354,21.025500000002193,4950.5,87,13,0,100
7355,3.6470000000017206,3566.8947368421054,56,26,0,82
7356,-10.090749999999575,1977.5555555555557,28,29,1,57
7357,53.94375000000234,5817.2,98,14,0,112
7358,-0.5759999999995766,3158.4210526315787,45,29,2,74
7359,-11.627249999998991,2523.4375,38,27,4,65
7360,-0.23149999999888865,3441.4444444444443,62,16,2,78
7361,-31.387999999999323,2040.1,15,32,0,47
7362,15.216750000001133,3163.9411764705883,77,31,3,108
7363,2.908500000002036,3595.65,64,26,0,90
7364,-15.17749999999867,3295.0,49,26,0,75
7365,15.020750000001538,2505.5882352941176,50,23,0,73
7366,-3.8049999999987305,4181.736842105263,54,37,0,91
7367,34.250750000001425,4403.7,70,19,0,89
7368,-6.621499999998863,3037.2631578947367,46,25,0,71
7369,-0.5452499999987472,3350.5,54,23,0,77
7370,-22.026249999998942,2637.75,27,30,0,57
7371,3.653750000000682,2933.1666666666665,37,25,0,62
7372,-18.524749999999436,2476.7368421052633,28,24,3,52
7373,31.599750000002928,4093.0,90,39,0,129
7374,6.388500000000918,3183.85,39,28,1,67
7375,-32.63249999999973,1976.2631578947369,11,28,0,39
7376,11.275500000000331,3474.2105263157896,65,23,5,88
7377,10.14475000000174,4783.05,63,21,1,84
7378,-14.395999999999542,2637.0,29,42,0,71
7379,-12.951249999999026,2579.8,28,29,0,57
7380,3.772750000000695,3064.15,47,21,0,68
7381,-9.719249999999361,2485.8947368421054,24,31,0,55
7382,-12.212999999999223,2676.8333333333335,32,23,0,55
7383,16.659500000000772,3721.2,43,29,0,72
7384,9.312250000000535,4400.5,59,28,0,87
7385,20.142500000001526,3406.3333333333335,56,28,0,84
7386,13.341250000001214,2873.625,56,25,1,81
7387,-0.07774999999940775,3706.8,46,22,1,68
7388,-14.306999999998869,2352.470588235294,33,29,0,62
7389,15.206500000000052,2092.0,43,24,0,67
7390,0.6187500000004361,2587.875,44,28,1,72
7391,-38.45724999999989,2241.1666666666665,14,29,0,43
7392,-11.138249999998475,3967.95,54,29,0,83
7393,-0.9829999999969171,2072.777777777778,48,29,2,77
7394,11.286500000000341,2370.5,53,31,0,84
7395,-8.366499999999046,3631.45,43,28,0,71
7396,6.620750000000595,3734.65,52,18,0,70
7397,-12.049749999998603,3217.85,51,20,0,71
7398,-27.24824999999969,1974.5263157894738,13,37,12,50
7399,5.3765000000008865,2438.0625,56,26,0,82
7400,25.292750000001224,5241.9,77,25,0,102
7401,-4.686249999999288,2584.5263157894738,28,30,1,58
7402,4.2285000000011035,3399.8888888888887,48,27,0,75
7403,-26.324000000000144,1429.0,21,32,0,53
7404,-26.055749999999385,1993.7368421052631,19,25,0,44
7405,-26.601499999999515,2028.25,11,34,0,45
7406,-28.560499999999728,2040.1,14,26,4,40
7407,6.432500000001527,2969.875,58,24,0,82
7408,7.7157500000016155,3587.85,65,18,0,83
7409,-4.4072499999999435,2421.1666666666665,38,35,0,73
7410,14.951750000001656,5132.35,74,37,0,111
7411,35.14425000000252,6145.75,93,20,0,113
7412,19.19200000000047,3588.764705882353,64,24,0,88
7413,-35.67299999999967,1429.0,8,41,1,49
7414,-7.274499999999305,2460.777777777778,35,22,0,57
7415,3.315000000000738,4339.35,52,31,0,83
7416,5.793250000000482,2505.3333333333335,59,24,0,83
7417,-8.333249999999111,3261.6,33,29,0,62
7418,36.52725000000155,2961.3529411764707,73,23,0,96
7419,-12.730999999999131,2520.6666666666665,37,30,0,67
7420,-33.154749999999666,2044.1,20,26,0,46
7421,-10.604999999998821,2202.1176470588234,34,31,0,65
7422,-3.226749999998906,3083.9,42,25,0,67
7423,0.34550000000080827,2660.6470588235293,77,21,0,98
7424,33.672250000001426,4667.35,75,21,0,96
7425,-14.679499999999337,2148.3125,48,33,1,81
7426,-28.029249999999585,2048.1,19,26,0,45
7427,-1.786499999998534,4348.9,66,26,0,92
7428,13.852750000000919,2524.4666666666667,51,32,0,83
7429,-2.84724999999948,2538.4444444444443,29,24,0,53
7430,9.734250000001584,4328.3,63,16,0,79
7431,20.305750000001936,4240.2,73,21,0,94
7432,14.649750000001154,2967.75,63,33,5,96
7433,-11.231499999999647,1958.111111111111,35,33,2,68
7434,4.88200000000077,2409.1875,63,28,0,91
7435,-5.42699999999948,3131.45,34,39,0,73
7436,1.5775000000006494,4494.15,44,35,0,79
7437,-14.580499999999052,1648.25,38,32,2,70
7438,14.45125000000103,3382.2631578947367,44,26,0,70
7439,-14.403499999999548,1795.125,43,41,0,84
7440,10.652250000000814,3609.4736842105262,57,19,0,76
7441,-3.2249999999986634,3025.5789473684213,48,24,0,72
7442,24.712000000001723,4236.25,65,25,0,90
7443,-9.205749999998968,2476.6666666666665,32,28,0,60
7444,-18.892499999999217,2728.157894736842,30,33,1,63
7445,0.7012500000004345,3504.157894736842,49,37,0,86
7446,4.967500000001017,3423.777777777778,51,36,0,87
7447,-3.718749999999087,3139.3,38,33,0,71
7448,-16.046250000000068,1946.4117647058824,31,29,2,60
7449,-28.516249999999637,2048.1,17,28,0,45
7450,44.83450000000248,6173.55,85,30,0,115
7451,-7.877499999999207,3155.8947368421054,48,32,0,80
7452,-13.7589999999994,2087.75,29,27,3,56
7453,-14.5429999999991,2516.3888888888887,33,32,1,65
7454,20.856000000001718,4252.05,64,24,0,88
7455,37.06750000000118,3875.294117647059,72,27,0,99
7456,-20.918999999999436,2937.0,33,33,16,66
7457,-41.155499999999805,1429.0,0,32,0,32
7458,-5.780749999999859,1933.4444444444443,40,28,1,68
7459,33.65550000000191,3638.25,88,20,0,108
7460,23.38550000000176,4876.8421052631575,86,32,0,118
7461,-6.018750000000034,2185.1052631578946,22,29,1,51
7462,-8.517749999999248,2700.9375,29,34,0,63
7463,-7.11324999999866,4360.75,45,29,2,74
7464,-1.8952499999990906,3441.5789473684213,55,26,0,81
7465,-30.604499999999625,2032.25,15,29,0,44
7466,-28.435999999999588,2044.15,14,30,0,44
7467,4.854750000000959,3473.4736842105262,47,22,0,69
7468,-12.675999999999128,2583.85,28,29,0,57
7469,1.8827500000012356,3837.1,54,29,0,83
7470,-0.18324999999986896,2384.4375,54,30,0,84
7471,-2.4414999999987805,3095.8947368421054,52,25,0,77
7472,-5.938499999999193,3302.85,42,23,0,65
7473,-7.0292499999994105,2643.375,50,22,0,72
7474,-10.362249999999268,2709.25,30,32,0,62
7475,11.734750000001746,3643.4,64,20,0,84
7476,-1.1892499999992225,2353.6875,38,26,0,64
7477,-1.8834999999994693,2037.0,42,31,0,73
7478,-1.214249999999049,2607.7368421052633,35,32,0,67
7479,-6.927749999999001,2559.95,32,27,0,59
7480,-3.8927499999990887,2639.3125,39,23,0,62
7481,-0.560749999999301,3622.0,39,29,0,68
7482,14.39500000000083,2766.777777777778,45,27,0,72
7483,28.736750000002054,4457.0,74,24,0,98
7484,-8.632499999999414,2330.8125,43,26,0,69
7485,-8.768749999998802,2540.2,33,30,0,63
7486,-14.827750000000472,1429.0,35,36,0,71
7487,-11.463499999998819,2526.9444444444443,37,30,0,67
7488,10.789750000000263,3163.722222222222,45,31,8,76
7489,45.37325000000203,4951.210526315789,82,21,0,103
7490,-16.85224999999949,2504.2631578947367,27,25,0,52
7491,42.010250000001776,5198.95,83,25,0,108
7492,29.49775000000222,2116.5,70,33,0,103
7493,11.8835000000012,2884.625,62,24,0,86
7494,-18.885499999999627,1971.2631578947369,16,30,2,46
7495,11.586250000000874,3124.35,51,20,0,71
7496,-9.976499999999458,2513.1176470588234,30,25,1,55
7497,-20.967499999998857,2670.3,31,29,0,60
7498,-17.747750000000202,1924.8823529411766,27,37,0,64
7499,-6.508499999999107,2958.529411764706,40,33,0,73
7500,-0.8079999999993145,2487.8823529411766,34,25,0,59
7501,-24.979249999999546,2063.157894736842,16,28,0,44
7502,41.62300000000194,4943.578947368421,86,22,0,108
7503,-19.79599999999952,2385.8888888888887,44,24,2,68
7504,-42.24825000000032,2048.1111111111113,16,39,19,55
7505,13.857250000001832,3100.470588235294,62,26,0,88
7506,1.3177500000004956,3026.4736842105262,54,32,5,86
7507,-12.063999999999146,2562.4666666666667,32,29,0,61
7508,-12.971249999998392,1901.0,42,24,1,66
7509,-17.00899999999935,2622.75,30,23,0,53
7510,20.380000000001036,4123.55,65,15,0,80
7511,-5.529999999998376,2146.9444444444443,32,37,1,69
7512,-19.933249999999752,1936.111111111111,25,39,1,64
7513,26.694500000000808,2786.8823529411766,64,33,0,97
7514,-15.836999999999577,2623.684210526316,31,25,2,56
7515,14.9645000000011,3015.5,54,16,0,70
7516,-4.453999999999404,2499.1176470588234,41,28,0,69
7517,-12.239249999999597,2822.5263157894738,32,42,0,74
7518,-1.3592499999993295,2991.3684210526317,47,20,0,67
7519,-12.175999999999224,2528.25,29,24,0,53
7520,6.293250000000457,2825.8333333333335,50,33,0,83
7521,-15.9604999999999,1952.888888888889,20,31,0,51
7522,-2.5774999999983423,3083.85,53,20,0,73
7523,9.241750000001115,4472.0,66,25,0,91
7524,-16.78774999999917,2518.4210526315787,28,33,1,61
7525,17.733000000001677,4710.95,82,12,0,94
7526,-2.050999999998843,3294.9,36,25,0,61
7527,35.14475000000285,3161.1176470588234,81,20,2,101
7528,18.60600000000158,4319.736842105263,65,28,0,93
7529,-21.444249999999585,2027.2105263157894,18,34,2,52
7530,7.951250000001934,3579.85,55,23,0,78
7531,16.12775000000162,4103.8,66,24,2,90
7532,6.721499999999944,2935.277777777778,48,26,0,74
7533,-5.3519999999990215,2474.1111111111113,40,22,0,62
7534,11.1697500000015,3643.5625,72,23,0,95
7535,0.4577500000013156,2986.3684210526317,48,23,0,71
7536,-22.506999999998776,2162.5263157894738,27,29,0,56
7537,-21.93149999999909,1981.0555555555557,33,34,1,67
7538,-13.58024999999914,2676.1875,35,27,0,62
7539,-24.775499999999894,1950.0588235294117,24,38,0,62
7540,-23.052749999999904,1976.2631578947369,26,23,7,49
7541,-1.0102499999992671,3710.7,49,32,0,81
7542,5.406500000001022,3576.2105263157896,56,37,0,93
7543,-5.222999999999335,2741.1176470588234,28,31,0,59
7544,-29.169249999999703,2487.8823529411766,29,65,1,94
7545,-12.218999999998662,3539.315789473684,55,38,0,93
7546,-9.127749999999567,2353.4117647058824,42,29,0,71
7547,4.599250000000625,3246.4444444444443,61,29,0,90
7548,37.248750000001365,4036.777777777778,82,24,1,106
7549,8.08950000000114,2594.0,57,29,0,86
7550,-15.35624999999897,2488.4210526315787,37,22,0,59
7551,13.14975000000033,2541.3571428571427,58,27,0,85
7552,12.265750000000743,2744.5882352941176,59,27,1,86
7553,0.026500000001452317,2913.277777777778,46,29,0,75
7554,-4.990499999999616,2638.733333333333,32,25,0,57
7555,-35.337499999999835,1933.4444444444443,23,28,6,51
7556,7.183500000001042,3683.05,52,30,0,82
7557,7.924000000001425,3538.6315789473683,59,22,0,81
7558,-9.905999999999148,2548.2,27,29,0,56
7559,2.75400000000061,3586.8947368421054,50,35,0,85
7560,-12.775749999999302,2548.0,29,23,0,52
7561,-1.9572499999991806,2950.4210526315787,42,29,0,71
7562,-31.18824999999951,1987.8947368421052,18,31,1,49
7563,14.866750000001066,3290.4736842105262,80,26,0,106
7564,26.228000000001316,4274.35,66,22,0,88
7565,-27.07799999999948,2028.25,18,31,0,49
7566,-9.674749999998884,2772.7,32,28,6,60
7567,-10.949749999998849,2936.9444444444443,46,34,0,80
7568,-5.674499999998623,3052.05,49,18,1,67
7569,16.329000000001646,3016.3888888888887,65,19,0,84
7570,-22.524749999999646,2489.2631578947367,25,26,0,51
7571,-36.31849999999933,2024.25,15,25,3,40
7572,-10.086249999999396,2462.6470588235293,34,31,0,65
7573,-15.447749999998482,3012.3684210526317,42,28,2,70
7574,-14.32849999999888,3663.15,44,34,2,78
7575,-3.0454999999998673,2000.5,55,27,2,82
7576,14.154000000001464,3652.2105263157896,71,20,0,91
7577,16.651000000001662,3935.3684210526317,63,26,0,89
7578,1.1760000000013207,4336.2,60,25,0,85
7579,-18.38224999999948,2810.0,49,34,1,83
7580,-16.87474999999957,2311.3529411764707,30,36,1,66
7581,1.5915000000009514,3206.1052631578946,45,28,0,73
7582,11.6437500000023,2561.4,62,21,0,83
7583,-26.28850000000022,1874.4117647058824,38,41,1,79
7584,-21.800749999999454,1978.7894736842106,22,22,3,44
7585,-10.074499999999661,1866.0,40,29,0,69
7586,-14.363249999999075,2471.0588235294117,37,34,5,71
7587,6.172250000001049,2486.2,59,21,0,80
7588,-4.199999999999931,1976.7222222222222,33,42,1,75
7589,21.750250000000594,2582.214285714286,67,30,0,97
7590,-16.436749999999506,2313.0,39,28,0,67
7591,-36.6202500000003,1429.0,14,34,4,48
7592,-7.532999999999072,2492.5882352941176,30,28,1,58
7593,-21.12074999999943,1965.1666666666667,38,27,2,65
7594,14.57325000000192,3011.764705882353,71,15,1,86
7595,22.254000000001085,4816.45,75,20,0,95
7596,11.957250000001494,2982.9444444444443,63,22,0,85
7597,-10.176249999999397,3241.9473684210525,42,32,0,74
7598,-30.649999999999324,2047.35,19,21,5,40
7599,28.73225000000258,3093.875,91,10,0,101
7600,-31.815249999999356,1958.9444444444443,23,29,1,52
7601,-25.949749999999227,2833.85,32,31,0,63
7602,24.98475000000032,2393.3125,85,19,0,104
7603,-20.12949999999948,2032.3,20,31,0,51
7604,-29.470749999999093,1670.0625,29,36,1,65
7605,19.613250000002257,5207.6,81,34,0,115
7606,-11.203249999999205,2508.4,31,24,0,55
7607,-1.58874999999797,3830.1052631578946,60,35,0,95
7608,1.5135000000005205,2420.0625,75,30,0,105
7609,-18.27074999999973,2109.1052631578946,19,29,4,48
7610,0.5472500000008205,3615.7,44,24,0,68
7611,-24.189249999999536,2083.8,19,28,1,47
7612,11.650750000001137,3667.1,57,15,0,72
7613,-22.895999999999837,1921.0555555555557,19,44,1,63
7614,2.1807500000001374,2519.0,40,26,3,66
7615,-15.187249999999054,2491.5625,34,22,0,56
7616,-7.798249999999548,2504.764705882353,35,26,0,61
7617,-4.589999999999702,2721.0,39,20,0,59
7618,-20.57999999999985,2048.1,13,29,0,42
7619,-3.6357499999988483,2508.4375,39,23,0,62
7620,-30.239499999999424,2008.35,13,30,1,43
7621,20.92875000000181,2980.6875,84,13,0,97
7622,22.31075000000076,2382.375,73,16,2,89
7623,-7.401249999999337,2638.733333333333,34,21,0,55
7624,-4.236249999999176,3081.5789473684213,48,27,0,75
7625,-1.1312499999994678,2391.705882352941,52,20,1,72
7626,22.988000000000874,3220.8333333333335,62,28,2,90
7627,-22.411999999999477,2487.5263157894738,28,22,0,50
7628,-28.772999999999193,2650.4,27,32,0,59
7629,23.25675000000082,4864.0,78,19,1,97
7630,27.44750000000166,4636.368421052632,72,23,0,95
7631,9.972000000001259,3304.25,79,25,0,104
7632,6.70475000000104,2780.235294117647,52,18,0,70
7633,16.625000000001865,4186.35,65,24,0,89
7634,26.19550000000074,3227.4117647058824,88,21,1,109
7635,14.577750000002203,3294.222222222222,70,15,0,85
7636,-16.13524999999951,1931.7777777777778,20,29,0,49
7637,21.349750000001134,3617.25,55,18,0,73
7638,-24.005499999999472,2034.7894736842106,17,32,7,49
7639,18.784500000001483,4691.05,81,13,0,94
7640,3.8122500000004655,4017.2,43,24,0,67
7641,-42.64450000000007,1952.0526315789473,14,23,5,37
7642,-12.783499999998856,2544.2,33,27,0,60
7643,12.875250000000714,3802.1,46,27,0,73
7644,-7.521250000000011,1951.0555555555557,41,32,0,73
7645,-8.430749999999342,2500.5,35,27,0,62
7646,9.027500000000062,2636.2631578947367,50,26,5,76
7647,-13.534249999999421,2051.8823529411766,34,33,2,67
7648,-10.216249999999405,2575.95,29,29,0,58
7649,15.355250000001416,4489.35,77,20,0,97
7650,11.025750000000475,3327.9473684210525,49,30,4,79
7651,2.613500000000541,3325.1,49,22,0,71
7652,-3.2119999999994375,2076.875,41,29,1,70
7653,10.628250000000588,1879.0588235294117,66,33,2,99
7654,-2.3447499999988772,2993.1052631578946,48,22,0,70
7655,-23.596999999999575,2103.722222222222,17,42,0,59
7656,-11.469749999999115,2580.9375,34,22,0,56
7657,17.386750000001758,2825.0,70,23,0,93
7658,-4.393999999998526,3271.95,43,25,1,68
7659,-41.72499999999995,1429.0,2,30,5,32
7660,17.24350000000001,2625.0,51,24,0,75
7661,-5.297499999999464,3178.25,41,23,0,64
7662,20.300000000001443,3303.0588235294117,74,24,0,98
7663,29.304250000000884,4806.736842105263,83,18,0,101
7664,5.087500000001667,3675.2,56,20,0,76
7665,14.313250000001634,3426.5789473684213,61,20,1,81
7666,-12.905249999998848,2514.9411764705883,35,29,0,64
7667,10.80425000000115,4938.6,65,27,1,92
7668,-31.265499999999303,2168.05,17,29,6,46
7669,2.484000000000677,3799.6,53,25,0,78
7670,20.128000000001755,5774.4,89,24,0,113
7671,10.806500000001321,4750.45,65,22,0,87
7672,50.8932500000016,5469.6,92,20,0,112
7673,-27.923249999999655,2042.2105263157894,14,35,1,49
7674,-1.4372499999992239,2505.266666666667,34,38,0,72
7675,-33.03474999999958,2087.722222222222,21,42,4,63
7676,17.633250000002047,4228.45,72,15,0,87
7677,24.840750000001027,4150.8421052631575,58,29,0,87
7678,13.501249999999876,1933.8,50,34,0,84
7679,12.758750000001836,4666.315789473684,67,23,1,90
7680,24.31150000000195,4184.8,76,14,0,90
7681,-4.405499999999171,2445.823529411765,48,32,0,80
7682,-2.4464999999998938,2473.625,46,29,0,75
7683,-14.20624999999998,4624.25,41,20,10,61
7684,10.798750000000485,2544.6111111111113,62,20,0,82
7685,-3.233499999999313,2548.15,30,24,0,54
7686,16.114000000002072,4269.526315789473,76,17,0,93
7687,32.656750000001225,4675.2,79,13,0,92
7688,28.631500000001886,4702.95,82,20,0,102
7689,-24.868249999999456,2024.25,22,27,0,49
7690,2.8640000000014196,1974.8125,44,30,0,74
7691,-9.539249999999964,1929.5294117647059,37,34,1,71
7692,31.61875000000105,3951.8888888888887,60,25,0,85
7693,18.428000000000743,3766.5263157894738,57,27,2,84
7694,-1.9357499999988346,3201.9473684210525,47,35,1,82
7695,-19.983000000000168,2050.8823529411766,45,44,1,89
7696,26.538000000001272,4183.1,62,24,0,86
7697,20.925750000001194,2533.3125,61,24,0,85
7698,-6.398749999998824,3051.5789473684213,49,23,0,72
7699,-7.049749999999355,3081.5789473684213,38,35,0,73
7700,20.102500000001744,3610.176470588235,72,23,0,95
7701,14.755000000000752,4644.95,66,22,2,88
7702,-24.4432499999987,3240.2,39,29,1,68
7703,-8.33499999999928,2462.6470588235293,36,28,0,64
7704,-43.27849999999965,2087.85,10,38,0,48
7705,-22.881749999999805,2479.157894736842,26,31,3,57
7706,6.842500000001041,3668.157894736842,51,25,1,76
7707,29.639250000001717,4758.45,78,19,0,97
7708,12.30250000000067,3964.0,45,36,1,81
7709,8.150250000000806,3432.5263157894738,49,32,1,81
7710,10.801750000001025,3937.0,46,30,0,76
7711,10.221000000000938,3784.75,45,31,0,76
7712,-10.108249999999568,1853.9411764705883,25,33,1,58
7713,-14.310999999999623,2019.0,29,34,7,63
7714,18.950750000001676,4706.0,64,25,1,89
7715,-12.41100000000005,2520.777777777778,56,29,0,85
7716,-8.453249999999102,4011.65,47,25,0,72
7717,25.62000000000259,4912.789473684211,83,26,0,109
7718,3.2735000000013024,3037.315789473684,46,21,0,67
7719,4.84900000000071,2616.5,81,28,0,109
7720,24.76725000000092,3562.842105263158,57,17,0,74
7721,4.089500000000832,3732.4444444444443,54,29,2,83
7722,-10.983499999999493,2353.294117647059,39,28,0,67
7723,5.685500000001907,3508.4,55,26,1,81
7724,-27.650499999999447,1971.157894736842,13,34,3,47
7725,4.822000000000692,4127.578947368421,61,26,0,87
7726,29.8165000000018,4163.2,77,21,1,98
7727,-18.07149999999931,2560.0,29,24,1,53
7728,-31.57499999999962,2087.05,14,26,2,40
7729,20.05650000000164,2935.176470588235,62,34,1,96
7730,29.81300000000208,5238.65,80,19,0,99
7731,23.653500000002587,5173.45,90,21,0,111
7732,13.908000000000962,2780.1176470588234,48,33,2,81
7733,4.440500000000877,2572.0,36,30,0,66
7734,13.152500000001472,5251.35,55,18,2,73
7735,20.678500000001314,4145.894736842105,72,25,0,97
7736,-15.243749999998801,2960.0,40,39,0,79
7737,-28.82474999999933,2028.25,14,30,1,44
7738,0.9517500000006656,2612.4,25,35,0,60
7739,11.73125000000191,4137.1,59,35,0,94
7740,10.039500000000885,3947.0526315789475,64,26,0,90
7741,-11.13999999999915,2686.5555555555557,33,34,0,67
7742,18.23325000000135,4394.1,68,19,0,87
7743,-29.086499999999415,1904.2941176470588,18,31,12,49
7744,-15.040499999998724,2587.875,34,23,3,57
7745,1.3837500000008884,3688.8947368421054,61,36,4,97
7746,-22.7594999999999,2013.0,14,31,0,45
7747,18.99075000000181,4531.789473684211,67,30,0,97
7748,2.5055000000010357,2574.764705882353,42,34,0,76
7749,16.82875000000065,3252.5882352941176,61,37,0,98
7750,16.566250000000974,3357.75,57,27,0,84
7751,5.871750000001507,1882.375,42,29,3,71
7752,13.833750000001237,4245.0,58,28,0,86
7753,14.263000000001233,3540.277777777778,65,30,0,95
7754,-3.1047499999994352,2564.529411764706,37,26,1,63
7755,14.605250000001693,2939.8823529411766,64,31,0,95
7756,27.224750000001524,4040.5263157894738,66,32,0,98
7757,-3.235000000000062,2643.7368421052633,44,25,15,69
7758,2.8320000000006633,2543.5333333333333,43,34,0,77
7759,-4.995999999998994,2471.8125,28,39,0,67
7760,13.961750000000668,3667.2,45,26,0,71
7761,16.745750000001458,4163.3,57,27,0,84
7762,0.37775000000040987,2425.3529411764707,35,30,15,65
7763,19.42725000000159,4690.25,62,28,0,90
7764,-5.112499999998673,2425.0625,42,31,4,73
7765,-4.163249999999487,2619.6666666666665,34,28,4,62
7766,2.168250000001137,3111.7,47,24,0,71
7767,-8.123999999998532,3137.4375,43,26,0,69
7768,8.585500000001558,3501.0,55,24,1,79
7769,5.503750000001318,1961.2941176470588,41,26,2,67
7770,12.150250000000653,2152.6470588235293,44,18,2,62
7771,5.233750000000539,2703.846153846154,44,33,1,77
7772,10.397000000002013,2556.0666666666666,57,27,0,84
7773,18.141750000001007,3449.277777777778,60,33,0,93
7774,-12.164749999999803,2512.8888888888887,34,28,12,62
7775,11.816500000000493,2529.3125,46,30,1,76
7776,-20.363499999999224,2504.705882352941,29,27,0,56
7777,-14.29899999999905,2564.0,33,24,0,57
7778,4.811250000001639,3569.4210526315787,62,30,0,92
7779,39.628000000001876,5884.6,82,22,0,104
7780,-17.39074999999942,2533.4736842105262,28,30,3,58
7781,20.189250000000506,3115.9473684210525,58,31,1,89
7782,-6.584499999999322,2516.3888888888887,32,26,0,58
7783,0.5637500000008498,2741.625,43,44,0,87
7784,-27.46574999999931,1958.9444444444443,35,31,5,66
7785,55.772750000002716,5714.8,112,20,0,132
7786,-0.7499999999996255,2640.6666666666665,29,29,0,58
7787,-1.1309999999990505,3136.764705882353,38,30,6,68
7788,-19.643500000000117,2464.3333333333335,29,45,13,74
7789,4.783750000001146,2467.2,51,25,1,76
7790,11.941250000000656,4091.5789473684213,67,34,0,101
7791,6.581750000000649,2975.0,73,29,1,102
7792,40.660750000001734,4551.8421052631575,77,25,1,102
7793,-6.266999999998913,2387.0,41,28,1,69
7794,18.520000000001392,4629.2,74,13,0,87
7795,-6.286499999999457,3208.5263157894738,40,27,0,67
7796,1.3247499999998211,1970.5882352941176,36,34,0,70
7797,3.201250000000465,3013.0,49,27,0,76
7798,-12.583749999999002,2602.9473684210525,28,32,0,60
7799,-3.184499999999294,4142.55,48,36,0,84
7800,8.035250000000756,2719.529411764706,47,24,2,71
7801,27.351000000002408,4781.5,84,21,1,105
7802,-25.77424999999905,1925.0625,32,27,4,59
7803,8.872750000001474,5310.0,62,31,1,93
7804,24.442750000002384,4056.3684210526317,70,23,0,93
7805,-10.220249999999751,2619.5555555555557,40,32,0,72
7806,-27.18449999999957,2179.2631578947367,19,36,2,55
7807,35.479000000000966,4028.0526315789475,86,27,1,113
7808,26.546500000000485,2815.705882352941,67,23,2,90
7809,33.917500000001965,4708.5,81,25,0,106
7810,-13.886249999999738,2020.3,17,25,2,42
7811,-0.7267499999991778,2095.6666666666665,50,27,0,77
7812,-14.053249999999164,3200.4,29,33,1,62
7813,-18.37399999999956,2757.6923076923076,33,37,13,70
7814,-4.172999999999565,2744.0555555555557,28,26,0,54
7815,1.7275000000008855,3158.35,37,30,0,67
7816,1.7557500000004194,2080.8823529411766,36,31,7,67
7817,-14.571999999999985,1429.0,36,32,4,68
7818,-13.990249999999625,1429.0,26,41,1,67
7819,24.645250000002257,2422.866666666667,66,28,3,94
7820,2.070750000001113,3183.75,50,19,0,69
7821,-9.320249999998982,2191.0,42,34,1,76
7822,22.96300000000155,4206.0,69,24,0,93
7823,17.18750000000166,4551.35,58,34,0,92
7824,16.520000000000838,2448.133333333333,63,19,0,82
7825,31.169500000001584,5005.2,70,21,0,91
7826,6.306500000002027,3615.6,55,25,0,80
7827,-20.813999999999105,2392.0,23,38,1,61
7828,-20.129999999999455,2857.529411764706,29,41,0,70
7829,9.032250000000994,2685.823529411765,59,22,1,81
7830,19.957000000002843,5378.15,77,26,0,103
7831,-12.505249999998943,2562.3333333333335,34,25,0,59
7832,-4.510249999999674,1876.6,41,41,0,82
7833,-17.853999999999285,2440.842105263158,31,23,6,54
7834,-1.2507499999990983,2395.3529411764707,49,23,0,72
7835,2.514000000001527,1835.8125,48,29,1,77
7836,24.92700000000224,3987.157894736842,69,27,1,96
7837,23.611000000002015,4119.7,67,23,0,90
7838,-13.151499999999455,3672.9473684210525,47,46,3,93
7839,-4.640749999999096,3371.05,40,28,0,68
7840,-6.958999999998734,3099.65,44,30,0,74
7841,0.6652500000006658,2514.8,32,28,1,60
7842,3.1732500000018034,3200.6111111111113,55,39,2,94
7843,-8.650749999998684,3839.4,49,40,0,89
7844,23.99500000000242,4987.7,62,28,0,90
7845,18.38800000000179,4269.578947368421,63,29,0,92
7846,10.123250000001224,3774.25,52,21,1,73
7847,-8.226749999999301,2554.3333333333335,25,31,0,56
7848,-12.206499999999787,1879.1176470588234,36,36,6,72
7849,20.064750000000142,2795.0588235294117,56,20,1,76
7850,2.818250000002506,2801.6470588235293,61,29,0,90
7851,12.826250000000877,2556.1176470588234,48,33,0,81
7852,13.373500000001224,3087.722222222222,49,26,0,75
7853,-24.067499999999434,2629.6315789473683,23,40,0,63
7854,28.678000000002488,4967.25,87,15,0,102
7855,15.708000000001187,3660.4210526315787,55,28,0,83
7856,-34.39374999999955,1980.421052631579,18,26,3,44
7857,22.211250000001666,3861.8947368421054,75,30,1,105
7858,32.64350000000136,4722.7,64,24,1,88
7859,-3.8309999999995306,2515.9411764705883,41,24,1,65
7860,-24.15849999999962,1992.157894736842,15,28,1,43
7861,31.04275000000117,3917.15,54,33,0,87
7862,22.12975000000111,4392.55,50,35,0,85
7863,9.510750000001424,3718.2631578947367,64,26,3,90
7864,6.766000000000609,2610.8333333333335,51,29,0,80
7865,16.165250000001432,3583.95,57,17,1,74
7866,-5.745749999999094,2478.470588235294,60,26,2,86
7867,-7.135749999998882,3461.6,39,36,0,75
7868,10.27775000000084,2429.2,44,29,0,73
7869,19.056000000001053,4009.7368421052633,52,25,0,77
7870,3.87425000000133,5114.8,55,34,0,89
7871,27.674500000001597,3758.722222222222,69,25,0,94
7872,-1.3852499999992276,3468.2,37,28,0,65
7873,12.412000000001887,3599.65,57,33,0,90
7874,3.8317500000008833,3635.4,43,32,0,75
7875,5.770500000001213,3084.9473684210525,52,30,0,82
7876,12.426500000001875,4336.1,67,24,0,91
7877,43.8462500000017,5160.9,88,20,0,108
7878,13.118250000001538,3638.55,56,18,0,74
7879,3.8952500000005785,3127.3684210526317,39,28,0,67
7880,5.017500000002059,4247.8421052631575,83,40,0,123
7881,6.531750000002182,2010.375,56,22,1,78
7882,12.670250000001657,3024.375,60,24,0,84
7883,13.072250000001997,4610.8,58,38,0,96
7884,7.530750000000452,3534.65,43,30,0,73
7885,-16.06124999999991,1866.0,29,38,0,67
7886,-15.04249999999968,2118.6111111111113,25,30,0,55
7887,-10.872999999999573,2968.8888888888887,36,34,1,70
7888,4.978250000001289,1539.235294117647,30,29,1,59
7889,-24.584749999999666,2048.1,18,24,3,42
7890,-31.19074999999924,2044.1,12,34,0,46
7891,14.563250000000561,3756.5789473684213,46,33,0,79
7892,21.613500000002542,2845.529411764706,80,12,0,92
7893,-7.904999999998948,2937.0555555555557,42,38,0,80
7894,-26.077999999999452,2008.35,12,32,0,44
7895,27.84300000000145,3974.35,61,24,0,85
7896,24.428500000002067,3889.3333333333335,94,27,0,121
7897,11.393500000001982,4206.8,56,34,0,90
7898,-13.377749999999324,2589.875,33,27,13,60
7899,-36.322749999999715,1996.3684210526317,16,30,0,46
7900,-0.05949999999906526,2999.684210526316,41,32,0,73
7901,-52.446999999999946,1429.0,0,34,1,34
7902,-4.500749999998652,3028.1052631578946,42,27,1,69
7903,-8.180749999998794,3119.55,42,32,0,74
7904,21.53650000000095,4320.3,67,24,0,91
7905,-14.250749999999112,2630.65,28,25,0,53
7906,-27.646249999999686,2008.4,5,38,0,43
7907,0.469250000000625,2304.8823529411766,42,27,0,69
7908,22.881250000001415,3521.6470588235293,76,50,0,126
7909,12.647500000001061,2446.9375,62,23,0,85
7910,-26.478499999999325,2024.3,12,37,1,49
7911,-2.171249999998918,3213.15,46,25,0,71
7912,-14.692249999999305,3016.6315789473683,41,32,9,73
7913,-15.828749999999914,1998.5294117647059,40,26,8,66
7914,23.50400000000115,4374.25,59,31,0,90
7915,-3.3452499999990253,3183.0,40,30,0,70
7916,17.694500000001106,4381.45,54,29,1,83
7917,-6.307499999999678,1837.1176470588234,39,30,3,69
7918,-14.361999999999147,2648.85,31,30,0,61
7919,20.001000000002055,3349.6470588235293,75,23,0,98
7920,-4.293249999999343,2790.6666666666665,37,40,0,77
7921,2.519500000000747,2815.5882352941176,36,43,0,79
7922,2.0042500000017482,3818.05,60,27,0,87
7923,8.135750000001053,3495.8947368421054,58,17,0,75
7924,9.611750000000976,4738.55,65,33,1,98
7925,6.300250000001104,3696.45,43,32,0,75
7926,-1.9747499999991949,2455.8125,44,33,0,77
7927,-3.7992499999985134,2977.8947368421054,38,28,1,66
7928,-29.315749999999564,2044.2,19,28,0,47
7929,0.29250000000100734,3929.5263157894738,53,34,0,87
7930,-1.0317499999993052,2536.529411764706,52,29,0,81
7931,29.43400000000142,2574.875,77,21,0,98
7932,-11.058250000000397,2160.1176470588234,45,36,0,81
7933,29.52725000000239,5006.1,81,18,0,99
7934,11.456000000000998,2287.176470588235,45,23,0,68
7935,9.602000000001201,2849.294117647059,53,26,0,79
7936,24.722000000001483,4156.05,74,12,0,86
7937,14.985250000001276,3774.2105263157896,60,21,0,81
7938,5.604500000000939,2732.6875,55,28,0,83
7939,0.22400000000155407,1862.625,74,39,0,113
7940,2.359500000000058,2487.9411764705883,50,30,1,80
7941,39.461750000001146,4904.5,79,15,0,94
7942,-32.62849999999961,1971.2631578947369,15,30,2,45
7943,-8.209999999999223,2413.0555555555557,27,31,0,58
7944,5.127500000001397,4202.9,57,29,0,86
7945,-17.043499999999284,2696.4210526315787,32,30,5,62
7946,13.940000000001465,2619.470588235294,65,26,2,91
7947,-6.927749999998764,3115.65,37,33,0,70
7948,12.831000000000518,3511.7,47,21,0,68
7949,24.01675000000137,4425.1,67,30,1,97
7950,-16.64950000000008,1874.4117647058824,39,45,0,84
7951,12.211000000000656,2588.9333333333334,60,35,2,95
7952,13.410250000001,2647.470588235294,54,29,1,83
7953,16.188750000002347,2698.9375,66,29,0,95
7954,-22.911749999999508,2028.3,13,33,0,46
7955,21.682000000002127,4233.85,80,20,0,100
7956,-24.963749999999465,2028.3,16,29,0,45
7957,-15.715249999999376,2749.1052631578946,31,28,3,59
7958,-22.054499999999305,2454.294117647059,43,35,2,78
7959,-7.3969999999996805,2717.9375,31,27,3,58
7960,-12.086499999999504,2655.4375,36,26,4,62
7961,14.160000000001208,3923.684210526316,63,22,1,85
7962,10.898250000001166,2500.5,50,36,0,86
7963,-23.98099999999974,1987.8947368421052,15,31,2,46
7964,4.163500000000846,2580.875,44,31,0,75
7965,30.289500000001198,4484.6,66,21,0,87
7966,35.66325000000174,3935.277777777778,86,18,0,104
7967,-6.231249999999006,3016.5263157894738,46,25,2,71
7968,13.273750000001627,3385.3125,66,25,1,91
7969,6.448000000000282,3780.7,48,19,0,67
7970,12.130750000002456,4360.0,73,16,0,89
7971,44.517750000001676,5045.125,76,18,1,94
7972,11.890250000001558,4142.684210526316,59,24,0,83
7973,-27.152249999999377,2119.55,15,36,0,51
7974,-10.629999999998935,2712.45,34,29,1,63
7975,-6.6739999999988955,3099.1,39,27,0,66
7976,41.840500000001796,6222.75,87,31,0,118
7977,21.431000000001557,3107.625,77,27,0,104
7978,-30.07149999999954,2024.3,13,30,1,43
7979,26.617750000001855,4490.2,70,21,1,91
7980,-23.761999999999468,2008.45,12,33,0,45
7981,-2.9542499999992784,2467.0555555555557,41,38,1,79
7982,24.513499999999855,2790.722222222222,74,22,1,96
7983,-9.808749999999126,2330.8125,41,32,0,73
7984,13.042250000001712,3508.5,49,25,2,74
7985,18.341500000002597,4158.4,74,20,0,94
7986,-27.134749999999762,1973.1666666666667,20,40,10,60
7987,-0.4449999999992844,3770.4,43,31,1,74
7988,-5.219249999999621,2854.4210526315787,29,28,3,57
7989,27.11050000000251,5048.1,82,35,0,117
7990,19.46200000000194,2696.875,64,24,0,88
7991,-5.489499999999029,2484.625,40,20,0,60
7992,-7.490499999999225,2671.315789473684,34,24,0,58
7993,-11.604999999999077,2579.8,27,30,0,57
7994,-27.05324999999936,2028.3,12,35,0,47
7995,-6.618749999998475,1967.764705882353,34,31,4,65
7996,-8.964749999999341,2637.3333333333335,25,31,0,56
7997,3.2090000000009105,3017.3529411764707,49,33,0,82
7998,-4.160249999999168,2728.0,44,30,4,74
7999,40.99775000000115,3881.9411764705883,88,27,0,115
8000,20.062750000001778,4107.75,68,15,0,83
8001,-15.114749999999148,2554.125,37,36,0,73
8002,14.993000000000938,4246.5,53,28,0,81
8003,-17.27774999999971,1983.6470588235295,26,35,0,61
8004,-11.751249999998743,2926.277777777778,46,29,3,75
8005,-21.229499999999348,2050.777777777778,20,34,1,54
8006,15.182000000001816,3704.6428571428573,62,28,0,90
8007,8.405750000000948,2960.0555555555557,76,23,1,99
8008,17.25700000000161,4404.45,69,20,1,89
8009,17.153500000002232,4615.55,77,17,0,94
8010,39.790500000001586,4564.05,70,14,0,84
8011,-10.212749999998707,3209.4210526315787,48,30,0,78
8012,-37.703999999999986,1429.0,1,28,2,29
8013,15.69325000000031,2045.125,50,35,0,85
8014,-10.798999999999237,2613.7368421052633,29,34,0,63
8015,-17.119999999998434,3258.35,43,28,0,71
8016,9.315250000000765,2528.1176470588234,45,24,1,69
8017,20.982250000001546,2829.0,65,18,0,83
8018,-14.485999999999393,3278.3,44,27,0,71
8019,-15.542749999999952,2469.6111111111113,34,38,3,72
8020,-22.79299999999953,2440.7894736842104,22,29,6,51
8021,3.506000000001022,4699.65,46,41,0,87
8022,-15.825249999999263,3455.842105263158,27,37,4,64
8023,-8.435499999999847,2633.285714285714,29,31,4,60
8024,30.505500000001796,4707.125,64,23,0,87
8025,-1.175999999999183,3482.25,36,38,0,74
8026,-3.2292499999993516,2491.5625,35,37,0,72
8027,-5.213249999999659,2710.0,29,25,0,54
8028,8.131750000000796,2786.6315789473683,46,32,2,78
8029,3.8060000000012586,4206.9,51,30,0,81
8030,-4.007999999998959,2754.5,28,36,1,64
8031,0.8072500000002606,2425.6111111111113,27,37,10,64
8032,-4.2314999999994605,2601.8888888888887,56,28,4,84
8033,-11.388749999998598,3254.5,58,30,0,88
8034,-29.204499999999676,2109.8888888888887,12,33,0,45
8035,8.253750000001581,2575.133333333333,55,33,0,88
8036,6.807000000001432,4398.9,59,31,0,90
8037,31.84950000000176,5409.25,71,26,1,97
8038,-9.222999999999752,2548.222222222222,38,41,1,79
8039,-11.671499999998934,2548.25,25,31,0,56
8040,8.532000000001748,2467.75,56,37,0,93
8041,14.722000000001637,4603.64705882353,53,27,0,80
8042,24.804500000001045,2634.4375,58,30,0,88
8043,20.12525000000125,3976.777777777778,72,33,0,105
8044,30.175750000002715,5532.3,80,17,0,97
8045,1.280500000001402,4575.95,55,38,0,93
8046,-15.671000000000054,2102.3684210526317,31,31,3,62
8047,32.339000000002095,4611.65,66,26,1,92
8048,-5.648249999998926,2479.529411764706,37,37,0,74
8049,-7.353499999999732,1933.4444444444443,37,32,5,69
8050,-8.515749999998807,3313.7894736842104,45,30,1,75
8051,7.552500000001089,3470.45,33,38,0,71
8052,-20.5604999999995,2112.4444444444443,21,34,1,55
8053,22.278000000001196,2886.2,63,32,0,95
8054,7.852750000001104,3918.8,43,33,0,76
8055,-32.388249999999324,3144.95,27,38,0,65
8056,-6.056999999998821,3220.3684210526317,44,36,0,80
8057,42.80975000000241,3936.125,85,25,0,110
8058,-25.35699999999958,2461.7368421052633,26,28,0,54
8059,2.3675000000009927,3121.25,43,25,0,68
8060,-2.764499999998658,3183.7,39,27,0,66
8061,4.321250000000188,2441.5,45,31,6,76
8062,-7.970249999999341,2545.1875,26,31,2,57
8063,19.769750000001547,4488.55,62,27,0,89
8064,-20.723499999999298,1630.4375,24,34,0,58
8065,-20.397999999999893,1933.4444444444443,14,32,2,46
8066,52.04525000000247,5786.3,81,33,0,114
8067,8.23275000000191,4363.2,52,38,0,90
8068,5.662250000000666,3990.2,41,29,0,70
8069,23.36375000000086,3484.4210526315787,74,18,0,92
8070,-25.40700000000009,2236.0526315789475,24,43,1,67
8071,-9.768999999998753,3199.3684210526317,43,38,1,81
8072,18.915500000001238,4006.85,58,31,0,89
8073,-29.987749999999426,2018.3125,39,42,0,81
8074,5.705250000000608,2184.0,51,29,1,80
8075,1.085499999999964,2025.6470588235295,36,49,0,85
8076,1.1960000000007234,3517.15,38,30,0,68
8077,-20.16424999999953,2506.7368421052633,25,30,6,55
8078,-2.8144999999990263,3095.65,38,30,0,68
8079,44.59575000000258,6329.9,88,40,0,128
8080,40.688000000001885,4611.65,76,20,0,96
8081,9.685250000001187,5051.4,59,34,0,93
8082,-0.8352499999988044,3882.25,47,30,0,77
8083,34.880000000002774,6110.789473684211,74,29,0,103
8084,36.12650000000091,4448.421052631579,62,24,1,86
8085,-2.611499999999307,3060.1,36,22,1,58
8086,5.073500000000405,2489.0,50,29,0,79
8087,-26.591499999999847,1916.4117647058824,15,39,0,54
8088,-15.835499999999456,2856.0,24,37,1,61
8089,-0.6839999999988058,3688.6,49,34,0,83
8090,25.173750000001284,4920.45,60,35,0,95
8091,-3.446749999998918,3151.3,48,28,0,76
8092,13.024750000001399,3064.0,49,22,0,71
8093,8.255250000000881,3944.9444444444443,60,37,0,97
8094,13.066500000001648,3672.0,65,20,0,85
8095,-9.926999999998527,3595.0,42,45,0,87
8096,-10.475499999999656,2521.5882352941176,28,37,7,65
8097,15.45475000000182,4537.0,67,41,1,108
8098,13.049750000000557,2417.1875,48,29,1,77
8099,-13.622999999999289,2957.8947368421054,36,35,1,71
8100,4.867500000001229,3343.0,46,30,0,76
8101,5.89450000000113,3744.8947368421054,49,39,0,88
8102,32.743500000001845,3475.75,74,25,0,99
8103,29.282000000001904,4723.55,78,20,0,98
8104,-3.8932499999989068,3290.4210526315787,52,34,13,86
8105,-18.2889999999985,3913.1,41,31,2,72
8106,3.9710000000011916,3989.3846153846152,47,37,0,84
8107,-26.688999999999886,1987.9473684210527,11,35,2,46
8108,-0.731499999998723,5149.65,48,40,0,88
8109,-20.74649999999928,2463.315789473684,19,35,0,54
8110,22.473250000002007,4576.7,56,43,0,99
8111,-1.7172499999987902,3895.75,41,48,0,89
8112,-3.5244999999987234,4859.95,54,41,0,95
8113,0.6230000000002318,2402.4375,53,35,0,88
8114,-9.256249999999214,3278.684210526316,30,38,0,68
8115,21.909000000001658,3579.9,57,24,0,81
8116,-12.318499999999249,2448.315789473684,27,31,3,58
8117,17.6760000000017,4631.4,71,22,0,93
8118,11.218000000000782,3341.8333333333335,53,31,0,84
8119,12.043250000001098,2443.9333333333334,60,31,1,91
8120,17.302500000000475,2386.8,41,25,0,66
8121,3.5002500000010484,2915.8333333333335,44,42,0,86
8122,-5.661749999998657,2644.3888888888887,30,36,0,66
8123,15.872500000001125,2837.176470588235,52,26,1,78
8124,-3.343999999998059,3795.0,57,26,0,83
8125,-33.08574999999989,1429.0,11,41,0,52
8126,-11.429499999998972,2417.5555555555557,34,28,2,62
8127,35.96500000000246,5844.25,81,26,0,107
8128,-22.094749999999962,1429.0,16,34,0,50
8129,-23.973499999999454,1902.25,24,46,0,70
8130,-31.082999999999494,1967.0526315789473,12,32,5,44
8131,-17.954749999999727,2544.8823529411766,38,29,11,67
8132,-0.08924999999966872,2545.157894736842,36,32,0,68
8133,19.899250000003086,5045.05,67,36,0,103
8134,36.66725000000132,4786.25,70,27,0,97
8135,24.11975000000145,3387.176470588235,67,25,0,92
8136,4.741500000001118,3192.6315789473683,38,35,1,73
8137,0.08650000000113618,3178.3,42,31,0,73
8138,-5.452999999998861,2377.4375,40,28,0,68
8139,20.862750000001693,4706.055555555556,78,27,0,105
8140,5.495750000000905,2386.375,60,22,1,82
8141,18.91050000000103,3866.235294117647,72,23,0,95
8142,-4.203999999999556,2683.0,28,29,0,57
8143,14.445000000001212,2782.4375,61,23,0,84
8144,-35.29299999999932,2050.5789473684213,19,27,0,46
8145,12.672250000000252,2435.9375,46,27,2,73
8146,-0.2729999999990106,4117.2,44,29,0,73
8147,-8.73349999999915,3157.45,36,36,0,72
8148,-34.52025000000035,1429.0,0,33,13,33
8149,6.439000000001445,3711.5789473684213,52,25,0,77
8150,7.607750000000751,2899.705882352941,38,35,0,73
8151,12.263500000001141,3398.222222222222,60,25,0,85
8152,32.26150000000177,4975.05,66,32,0,98
8153,-6.8082499999989805,2070.9375,39,33,1,72
8154,-27.408249999999992,1966.9473684210527,10,34,10,44
8155,33.87175000000168,4131.3,63,31,0,94
8156,10.214250000001512,4123.6,62,22,0,84
8157,0.7130000000006815,2209.3333333333335,43,31,1,74
8158,24.03275000000179,3512.5,77,14,0,91
8159,-29.2624999999992,2493.3684210526317,29,27,3,56
8160,19.430500000001746,4671.15,65,23,0,88
8161,-3.321999999998778,3265.6428571428573,45,31,0,76
8162,14.44500000000113,3821.684210526316,56,29,0,85
8163,2.2255000000012086,3094.8333333333335,47,27,1,74
8164,0.7872500000017434,1871.5625,72,34,1,106
8165,-10.07399999999978,2789.35,28,27,0,55
8166,27.580750000001927,4263.95,80,11,0,91
8167,-26.0497499999998,2008.45,14,28,0,42
8168,25.795500000001134,4568.0,72,28,0,100
8169,-18.684499999998156,2280.25,52,22,2,74
8170,-3.9662499999988237,4632.0526315789475,51,41,0,92
8171,14.209000000000936,3595.8888888888887,79,35,0,114
8172,-4.419499999999088,2554.0,31,28,0,59
8173,-21.75349999999963,2024.3,14,29,1,43
8174,19.19650000000114,3856.0,63,23,1,86
8175,-8.146499999998928,3677.4,43,39,0,82
8176,3.4392500000012403,3252.1,41,29,1,70
8177,-26.74325000000013,1429.0,17,31,3,48
8178,-15.183749999999469,2564.3684210526317,27,34,1,61
8179,11.392250000000727,3168.529411764706,51,45,0,96
8180,11.152000000001333,4660.9,68,28,0,96
8181,19.493250000001098,4233.85,56,25,0,81
8182,-7.858999999999514,2441.4444444444443,23,37,1,60
8183,-1.9404999999995944,2857.6111111111113,57,33,0,90
8184,34.832500000001815,4612.5,71,19,0,90
8185,20.447750000001673,4798.1,73,21,0,94
8186,0.270750000000514,2605.875,58,33,0,91
8187,12.674500000000865,4968.85,55,35,0,90
8188,-26.93849999999926,2008.4,15,26,2,41
8189,-32.964749999999526,2170.4,11,35,1,46
8190,-32.86324999999939,2048.1,10,32,0,42
8191,5.281250000000599,3229.3333333333335,37,33,0,70
8192,5.125750000000957,5267.95,57,30,0,87
8193,0.8622500000007751,3359.3,39,36,0,75
8194,-19.341999999999565,1966.764705882353,21,31,1,52
8195,13.221500000000825,3608.0555555555557,50,34,0,84
8196,22.265750000002026,3762.3684210526317,67,28,0,95
8197,17.999750000001008,3593.45,48,24,0,72
8198,-6.603999999999348,3162.4,36,30,1,66
8199,-4.849749999998772,3346.315789473684,49,35,1,84
8200,-10.995999999999096,2509.4375,36,31,0,67
8201,14.044250000003013,4059.5555555555557,79,30,3,109
8202,-3.0617500000001163,2666.222222222222,40,37,0,77
8203,17.398750000000653,2714.75,58,23,0,81
8204,21.67600000000156,3345.0,75,20,0,95
8205,30.996250000000714,3746.5555555555557,72,22,0,94
8206,6.16275000000042,5133.85,57,27,0,84
8207,20.555250000001966,2392.529411764706,60,25,0,85
8208,-48.75024999999981,2227.684210526316,11,40,1,51
8209,-7.906749999999955,1983.5882352941176,30,44,0,74
8210,-25.84149999999979,1913.111111111111,34,32,0,66
8211,2.3147500000002714,2541.25,42,22,1,64
8212,-17.036249999998834,3514.3684210526317,40,36,0,76
8213,26.96300000000112,4143.45,63,19,0,82
8214,30.361750000001695,4986.25,68,23,0,91
8215,18.948000000001304,4036.3,53,31,0,84
8216,6.551250000001447,4110.05,59,26,0,85
8217,2.979500000000803,2987.9473684210525,44,24,2,68
8218,22.989250000002265,5175.9,76,26,0,102
8219,-11.842749999999093,2563.9444444444443,42,28,2,70
8220,25.15300000000044,4038.157894736842,59,27,0,86
8221,0.994750000001401,2501.4444444444443,43,31,0,74
8222,-1.61749999999939,2457.6666666666665,42,30,1,72
8223,13.438750000001383,3742.6,54,33,0,87
8224,17.669000000001056,3361.1666666666665,47,33,1,80
8225,4.198250000000536,2277.25,50,33,0,83
8226,-21.65824999999979,1429.0,21,31,3,52
8227,-17.744249999999294,2548.2,25,32,0,57
8228,-0.9019999999993544,3151.3,41,23,0,64
8229,30.71225000000127,4764.05,73,24,0,97
8230,-5.171999999998923,2977.157894736842,46,22,1,68
8231,-6.839749999998565,2308.875,54,28,2,82
8232,-9.954749999997944,2390.277777777778,42,26,7,68
8233,20.012000000002157,3144.5,65,22,0,87
8234,-19.036749999999397,2540.9473684210525,22,33,1,55
8235,-16.462249999999255,2711.7,23,34,1,57
8236,21.29600000000163,3893.777777777778,68,18,0,86
8237,4.8762500000012565,3571.1111111111113,60,30,0,90
8238,10.837750000001854,2980.3888888888887,58,29,0,87
8239,20.180500000001206,4262.5,65,23,1,88
8240,-32.284499999999575,2028.25,12,25,2,37
8241,-13.468249999998278,2431.722222222222,39,29,1,68
8242,16.96200000000159,3820.8947368421054,49,28,1,77
8243,40.956250000001475,3512.294117647059,76,35,0,111
8244,-12.156499999999172,2624.8333333333335,34,25,0,59
8245,9.379000000001021,3452.4736842105262,66,21,2,87
8246,13.872000000000677,2437.9375,74,23,0,97
8247,-29.122749999999805,1913.2222222222222,22,38,0,60
8248,27.777750000001397,3618.6666666666665,69,35,1,104
8249,36.649750000002726,5449.05,94,22,0,116
8250,7.8457500000017415,3680.5,68,24,0,92
8251,-7.440250000000189,2495.8947368421054,27,33,2,60
8252,4.37000000000106,2041.1875,48,30,1,78
8253,31.417750000001764,5274.35,70,24,0,94
8254,-5.741499999998587,3406.75,48,26,0,74
8255,-29.63924999999956,2338.277777777778,29,31,13,60
8256,6.545000000001844,3040.222222222222,52,33,0,85
8257,18.56825000000088,3675.2,58,26,0,84
8258,-11.108249999999154,2554.4210526315787,31,28,0,59
8259,41.866250000001756,5401.4,89,26,0,115
8260,0.07949999999982538,1978.1176470588234,36,31,3,67
8261,10.677000000000486,2543.0588235294117,48,34,0,82
8262,30.653000000000713,3209.705882352941,74,31,3,105
8263,25.74950000000154,4080.0,75,27,1,102
8264,-8.86699999999901,3233.5789473684213,40,37,0,77
8265,16.893250000001967,4738.55,68,30,0,98
8266,14.711750000002658,4107.7,58,33,1,91
8267,-4.241249999998999,1985.4444444444443,30,30,1,60
8268,24.230250000001316,3053.705882352941,67,38,0,105
8269,0.6140000000013994,3189.55,49,29,0,78
8270,-13.4174999999999,1904.235294117647,46,31,7,77
8271,-16.46524999999813,4030.0,54,28,0,82
8272,-6.334999999999502,2558.8333333333335,28,27,0,55
8273,-17.414749999999454,2173.3333333333335,21,36,0,57
8274,-5.141499999998942,3079.7894736842104,40,30,1,70
8275,10.547000000001082,4137.5625,49,22,0,71
8276,-50.09200000000019,1429.0,21,35,9,56
8277,0.6272500000006708,2998.0,39,38,7,77
8278,-1.2137499999991763,3906.1052631578946,57,36,0,93
8279,-3.8072499999989864,3140.0,44,24,2,68
8280,31.08775000000051,3241.6875,68,25,0,93
8281,17.496750000001615,4131.55,53,28,0,81
8282,6.169000000001114,3121.7894736842104,48,22,0,70
8283,-5.402749999999815,1925.0625,52,30,0,82
8284,-14.222999999999121,2438.733333333333,47,48,0,95
8285,4.068500000000844,2257.294117647059,42,33,5,75
8286,12.450250000001128,2362.4666666666667,60,33,1,93
8287,4.5522500000023935,2366.529411764706,65,37,3,102
8288,-10.6322499999993,2505.157894736842,25,34,0,59
8289,19.70800000000138,5060.85,62,33,1,95
8290,-20.314999999999618,1941.7058823529412,29,41,0,70
8291,-28.123999999999974,1429.0,14,46,0,60
8292,23.9162500000015,4514.315789473684,70,33,1,103
8293,-18.73724999999935,3108.5,24,32,1,56
8294,-10.82974999999957,2825.8888888888887,39,24,0,63
8295,-21.545249999999037,2576.8947368421054,27,30,1,57
8296,2.263500000001064,3066.5263157894738,39,32,1,71
8297,18.96050000000225,2841.8823529411766,58,28,0,86
8298,14.212500000001649,4248.0,55,28,0,83
8299,11.971250000000976,3535.2105263157896,45,35,0,80
8300,5.852250000001222,3691.8,46,21,0,67
8301,-13.96649999999993,2024.2222222222222,19,29,0,48
8302,-22.167749999999277,2407.25,37,33,1,70
8303,-7.8962499999991325,2070.529411764706,36,22,1,58
8304,-28.46475000000017,1887.5294117647059,18,26,17,44
8305,46.39175000000181,4706.95,73,26,0,99
8306,15.639750000001602,4350.5,55,35,0,90
8307,22.78850000000113,4501.0526315789475,62,37,1,99
8308,32.76150000000118,4701.4,58,27,0,85
8309,-29.061249999999312,2589.4736842105262,27,32,0,59
8310,-31.385749999999895,1960.7777777777778,15,40,7,55
8311,23.610750000000785,4755.684210526316,81,29,0,110
8312,-17.92049999999943,2205.2631578947367,23,32,2,55
8313,-15.722249999999267,2664.0,28,22,0,50
8314,24.296500000001366,4371.25,66,19,1,85
8315,0.33800000000057506,2719.0526315789475,35,32,4,67
8316,4.486750000000485,3405.3333333333335,48,27,0,75
8317,1.4652500000010498,3102.3684210526317,46,24,0,70
8318,9.657250000001174,3636.25,56,30,0,86
8319,22.656500000001774,4770.3,68,27,0,95
8320,9.415750000000568,2849.294117647059,52,30,0,82
8321,-13.180499999999393,2572.0,32,26,4,58
8322,35.816000000002056,4882.684210526316,74,27,0,101
8323,-0.07499999999955129,2849.294117647059,44,40,0,84
8324,30.62850000000203,4705.631578947368,73,40,0,113
8325,2.6200000000023715,4016.4,59,25,0,84
8326,-32.27899999999936,2179.2631578947367,11,39,0,50
8327,-16.92549999999932,2767.2,28,29,1,57
8328,-33.0027499999999,1941.5882352941176,17,39,11,56
8329,-28.889249999999645,2028.25,16,22,5,38
8330,40.519750000001835,5254.55,92,19,0,111
8331,-4.820250000000154,1937.9411764705883,30,30,0,60
8332,-40.7645,1774.7222222222222,8,34,7,42
8333,-16.150999999999232,2376.1666666666665,26,27,0,53
8334,5.875500000001266,3802.15,47,28,0,75
8335,-21.953499999999714,1946.875,34,44,0,78
8336,4.131999999999918,2460.8333333333335,46,28,0,74
8337,-10.017749999999477,2464.75,31,33,0,64
8338,35.65425000000301,4399.692307692308,77,26,0,103
8339,16.143500000001218,3579.4210526315787,56,23,1,79
8340,32.745250000001846,4718.7,77,17,0,94
8341,6.295750000000558,2999.6111111111113,42,38,1,80
8342,-6.095499999999401,1853.9411764705883,30,36,2,66
8343,18.601750000001726,4087.1,66,18,0,84
8344,-21.137749999999507,1965.2222222222222,24,31,6,55
8345,4.496000000000835,3118.75,39,31,0,70
8346,19.84700000000111,4322.210526315789,64,33,2,97
8347,-3.4187499999987443,3847.5789473684213,60,29,0,89
8348,21.941500000000815,3122.8823529411766,53,29,0,82
8349,-14.199249999999612,2361.823529411765,26,40,1,66
8350,46.024250000001196,5295.7,70,26,0,96
8351,-32.80824999999967,2147.5263157894738,13,27,2,40
8352,23.59550000000143,4012.8888888888887,58,33,0,91
8353,0.6350000000009521,3356.9444444444443,35,26,0,61
8354,7.383500000000673,3145.8947368421054,43,31,1,74
8355,12.966250000001072,4425.8,58,26,0,84
8356,-2.337249999999277,2698.0588235294117,36,43,0,79
8357,7.967750000000382,3091.9,35,34,0,69
8358,-7.789249999999359,3331.45,38,34,2,72
8359,-0.9144999999981923,3708.55,55,26,0,81
8360,8.242000000001648,3927.0,52,42,0,94
8361,6.694750000000343,3094.8888888888887,50,30,1,80
8362,11.898750000000724,3810.1,51,25,0,76
8363,1.9055000000010813,4061.65,54,24,0,78
8364,9.700000000001506,1534.8666666666666,46,27,0,73
8365,14.444500000001756,4007.2105263157896,69,33,0,102
8366,29.024750000001394,5183.05,64,23,1,87
8367,9.313250000001366,3848.1,47,31,1,78
8368,1.9915000000011602,3874.4210526315787,48,34,2,82
8369,-4.610499999999607,1984.5882352941176,41,39,2,80
8370,-25.245999999999476,2028.25,14,31,0,45
8371,34.232250000000306,4383.0526315789475,47,33,1,80
8372,16.308750000001975,4225.3,68,25,1,93
8373,18.163000000000956,4264.0,49,33,0,82
8374,-0.7667499999991223,2384.1111111111113,50,35,0,85
8375,-13.840000000000336,1946.875,45,43,0,88
8376,-14.274749999999091,3072.2631578947367,22,43,1,65
8377,11.021000000001296,3179.5,59,35,3,94
8378,12.073750000001091,4309.2,55,25,6,80
8379,-3.27574999999836,1925.125,47,33,0,80
8380,10.322750000001129,3696.4736842105262,58,28,0,86
8381,-24.390749999998818,2577.1052631578946,25,31,0,56
8382,1.8085000000014735,3940.95,61,28,0,89
8383,6.126750000000199,2643.5,54,27,0,81
8384,10.541250000000751,2808.9166666666665,38,30,0,68
8385,-17.876999999999786,2540.222222222222,36,38,0,74
8386,6.438250000001494,3827.5789473684213,54,36,0,90
8387,13.30150000000061,3754.55,43,30,0,73
8388,-36.731749999999806,1429.0,0,36,2,36
8389,-7.0127499999990714,2546.842105263158,25,37,0,62
8390,25.703000000002373,4603.75,76,24,0,100
8391,-19.256999999998925,1957.2222222222222,31,41,1,72
8392,-24.28499999999942,2010.5263157894738,14,34,1,48
8393,4.572750000001147,2047.0625,47,30,0,77
8394,24.11375000000102,3036.375,70,28,0,98
8395,-12.168499999998591,3995.65,43,39,1,82
8396,-4.084749999998753,3366.5882352941176,36,31,0,67
8397,-2.201249999999558,2471.1176470588234,51,31,0,82
8398,-4.0524999999992675,4119.6,50,29,0,79
8399,2.0740000000011447,3161.0,43,24,2,67
8400,40.13350000000175,4635.45,74,21,0,95
8401,-1.6799999999978799,1894.3125,80,29,0,109
8402,15.277000000001545,4368.7,66,26,0,92
8403,11.112750000001345,3643.3,46,36,0,82
8404,4.609500000000628,2429.1875,47,29,0,76
8405,-16.04674999999944,1930.0,13,34,4,47
8406,0.15075000000101904,2941.6470588235293,55,28,0,83
8407,-2.760749999999539,2471.5,33,34,0,67
8408,-5.134999999999657,2176.8823529411766,38,27,0,65
8409,-15.675249999998815,1895.6,42,35,0,77
8410,16.184750000000946,3956.05,53,23,0,76
8411,-20.518249999999618,2028.25,12,34,1,46
8412,0.050500000000935776,3357.7,38,32,1,70
8413,-36.147499999999646,2056.1,10,37,2,47
8414,-3.1087499999988477,2463.6470588235293,46,21,0,67
8415,-11.34349999999823,4250.5,60,25,0,85
8416,-0.18774999999950434,2130.1666666666665,25,28,3,53
8417,21.417000000002666,4971.2,76,32,0,108
8418,11.508000000000651,2048.0666666666666,58,27,0,85
8419,18.515750000002136,2635.470588235294,60,29,0,89
8420,-12.422249999999522,2571.9,28,21,0,49
8421,-10.040250000000501,1899.5882352941176,41,33,1,74
8422,17.12850000000137,2359.9411764705883,62,25,1,87
8423,20.518250000001558,4205.95,75,16,0,91
8424,-13.739749999999237,2513.1176470588234,29,27,0,56
8425,-5.259249999999411,2668.222222222222,27,29,0,56
8426,-7.181499999999521,2653.65,31,25,0,56
8427,-5.0529999999990185,3336.2,39,33,1,72
8428,-10.277499999998943,2602.8947368421054,32,27,0,59
8429,-9.266249999998537,2525.222222222222,39,32,0,71
8430,47.13400000000232,5141.529411764706,79,24,0,103
8431,-1.6104999999984457,2019.1176470588234,42,33,1,75
8432,5.243500000001269,3316.714285714286,46,24,0,70
8433,-15.984999999998772,3337.0,44,18,0,62
8434,20.12000000000205,4749.0,79,18,0,97
8435,30.81375000000199,5214.8,87,15,1,102
8436,15.75975000000148,4163.15,72,20,0,92
8437,-11.844499999999089,3734.7,41,33,0,74
8438,13.702000000001291,3688.157894736842,69,23,0,92
8439,-28.070249999999675,1959.5263157894738,12,28,7,40
8440,16.52325000000096,3611.7,47,27,0,74
8441,1.7915000000007506,2975.0,45,25,1,70
8442,11.202250000001632,3325.4117647058824,67,19,0,86
8443,-17.671749999999456,2389.3333333333335,29,35,0,64
8444,13.489750000001937,4127.4,69,19,1,88
8445,-10.188999999999128,2540.1,27,30,0,57
8446,19.89775000000212,4897.35,75,26,0,101
8447,0.4620000000007093,2286.1875,41,32,0,73
8448,8.856000000001462,3132.5,46,26,0,72
8449,24.4227500000012,4186.95,59,21,0,80
8450,14.035250000001344,3205.0,60,18,0,78
8451,11.26075000000053,2445.8823529411766,50,37,0,87
8452,10.997500000001065,4082.2,57,30,1,87
8453,-30.310999999999456,2028.25,13,32,0,45
8454,17.105000000001773,4349.65,64,21,0,85
8455,19.93300000000192,4774.3,67,33,0,100
8456,-13.597499999998863,3328.8947368421054,39,43,1,82
8457,-7.668499999999648,2518.375,37,36,5,73
8458,2.828000000001888,3079.85,48,25,2,73
8459,-8.007749999999145,3127.5,41,32,0,73
8460,39.736250000001895,4687.1,71,22,0,93
8461,-12.17199999999911,2108.0,27,28,1,55
8462,5.403250000001542,2372.0666666666666,61,37,0,98
8463,-19.028999999999794,2048.05,15,30,0,45
8464,-11.618999999999323,1862.3529411764705,38,33,0,71
8465,25.841750000000967,2405.25,64,28,0,92
8466,25.142250000000942,3867.9,58,22,1,80
8467,8.58375000000252,5125.1,69,32,0,101
8468,-14.251749999999547,2527.5789473684213,27,30,0,57
8469,-12.251999999999116,2556.05,29,31,0,60
8470,22.82850000000147,3215.235294117647,90,20,0,110
8471,-22.569750000000283,1984.5555555555557,25,45,0,70
8472,-13.563999999998918,2683.05,30,26,0,56
8473,-6.23849999999935,2961.2631578947367,34,28,0,62
8474,7.859500000000978,2509.3529411764707,49,26,0,75
8475,46.67375000000136,4683.8421052631575,95,23,1,118
8476,32.62625000000175,4781.45,71,28,0,99
8477,-6.267499999999112,3167.6315789473683,45,35,0,80
8478,-5.762999999999422,3856.0,48,31,0,79
8479,5.6527500000001005,4323.55,60,19,0,79
8480,-19.71199999999955,2118.75,21,26,1,47
8481,-13.782249999999621,2523.5789473684213,25,34,1,59
8482,23.263750000001764,4714.8,69,32,0,101
8483,-9.999499999999431,2657.6,26,27,0,53
8484,8.398500000001025,3856.9473684210525,55,34,0,89
8485,-18.083999999999286,2698.9,26,31,1,57
8486,-26.73599999999978,1982.625,26,37,0,63
8487,9.954750000001113,3607.7,63,19,0,82
8488,-25.77549999999951,2614.5263157894738,38,28,8,66
8489,-17.516499999999645,2681.315789473684,29,27,0,56
8490,-34.69799999999927,1978.7368421052631,15,29,2,44
8491,-14.226999999998668,3327.5,44,29,0,73
8492,22.206750000000856,3730.722222222222,77,36,0,113
8493,-2.005999999998668,3967.15,52,29,1,81
8494,22.59575000000114,4230.611111111111,80,27,0,107
8495,-0.07774999999858459,3757.65,51,24,0,75
8496,-8.067749999999085,2495.1052631578946,32,23,0,55
8497,-3.618499999999601,3840.1052631578946,58,32,1,90
8498,23.38075000000137,4166.4,65,20,1,85
8499,7.487000000001491,4654.45,69,17,3,86
8500,-2.206999999999053,4677.4,49,35,0,84
8501,13.723250000002675,4622.75,67,20,1,87
8502,1.2145000000015194,3214.4210526315787,46,35,0,81
8503,16.525750000000208,2491.5,55,42,0,97
8504,-0.08624999999945988,3262.45,38,27,0,65
8505,4.6522500000012545,3333.1111111111113,56,22,1,78
8506,-0.0219999999994549,2087.294117647059,32,29,0,61
8507,-18.639749999999363,2703.65,27,32,2,59
8508,-20.203499999999906,1857.5882352941176,21,38,0,59
8509,10.44900000000228,4862.65,71,23,0,94
8510,-1.583499999999026,3040.3,41,23,0,64
8511,-14.16799999999913,2497.6315789473683,31,26,0,57
8512,-19.632749999999593,2028.3,10,33,1,43
8513,15.385750000001341,3694.15,53,24,0,77
8514,-20.317999999999966,2050.9411764705883,15,37,1,52
8515,-31.92549999999959,2012.157894736842,16,33,5,49
8516,12.309750000001612,4211.55,58,29,1,87
8517,0.30825000000114067,2282.470588235294,50,25,3,75
8518,28.162750000001306,5035.117647058823,69,22,0,91
8519,-14.629999999999143,2677.5,26,33,0,59
8520,7.489250000000323,3358.842105263158,62,32,0,94
8521,35.96625000000189,3513.733333333333,84,17,0,101
8522,20.21650000000109,3929.0555555555557,67,26,0,93
8523,2.8992500000007846,3135.5,44,27,0,71
8524,-28.738249999999596,2048.1,16,32,0,48
8525,27.514750000001833,3776.470588235294,66,25,2,91
8526,-11.138250000000077,1429.0,33,33,1,66
8527,3.5640000000010774,2936.1111111111113,54,28,0,82
8528,2.9132500000001205,1916.3529411764705,39,37,1,76
8529,-9.811999999999472,2521.529411764706,30,25,1,55
8530,17.189250000002342,4710.8,80,28,0,108
8531,1.4107500000010962,3048.25,48,18,0,66
8532,35.046000000001705,4730.75,85,12,0,97
8533,12.225500000000778,3320.4210526315787,44,29,6,73
8534,-9.460499999999447,2521.529411764706,32,29,0,61
8535,-0.49824999999886826,3289.45,43,24,0,67
8536,3.9252500000011232,2373.0588235294117,48,28,3,76
8537,11.109250000000799,3689.7894736842104,61,23,0,84
8538,29.44100000000006,2973.6875,87,20,0,107
8539,-3.131250000000173,2319.823529411765,35,33,1,68
8540,41.57450000000142,5901.4,88,30,0,118
8541,-16.56474999999981,1567.9375,21,25,1,46
8542,12.057750000000738,3048.3,42,22,0,64
8543,15.993250000000469,3950.3684210526317,64,36,4,100
8544,52.838750000002435,6393.45,101,22,0,123
8545,1.9592500000016735,2358.1176470588234,61,32,1,93
8546,-6.069999999999191,2746.785714285714,35,28,0,63
8547,41.891250000001996,4490.777777777777,75,19,0,94
8548,31.77700000000123,2319.9375,75,26,0,101
8549,35.21050000000159,4643.4,73,23,0,96
8550,6.247000000002002,2473.6875,70,33,0,103
8551,9.471000000001576,4447.35,64,29,0,93
8552,37.774000000002644,2322.133333333333,71,27,0,98
8553,28.071250000002067,4570.4,65,27,1,92
8554,-9.825749999999168,3503.4210526315787,44,41,0,85
8555,-6.644749999999438,2531.4444444444443,31,34,9,65
8556,-30.423250000000024,1429.0,0,34,1,34
8557,28.25650000000177,4952.95,71,39,0,110
8558,-12.192499999999217,2100.222222222222,27,33,0,60
8559,-2.882499999999534,2493.4210526315787,44,32,2,76
8560,9.285250000000374,3584.222222222222,61,38,0,99
8561,-21.56649999999944,2114.75,14,34,0,48
8562,5.0950000000016376,5196.5,62,32,0,94
8563,11.100500000000604,3063.2631578947367,45,29,0,74
8564,21.352250000002464,4508.473684210527,77,22,0,99
8565,5.301000000001598,4002.05,46,32,1,78
8566,-21.024000000000427,1429.0,34,38,5,72
8567,33.02400000000186,3361.823529411765,85,33,0,118
8568,7.55225000000115,3770.35,49,29,1,78
8569,12.430000000000721,3143.4117647058824,49,30,0,79
8570,12.956250000001324,4467.95,58,31,0,89
8571,-17.243249999998742,3267.85,42,29,0,71
8572,-26.145499999999345,2012.2105263157894,12,33,3,45
8573,-0.2744999999991893,3108.2105263157896,50,29,3,79
8574,31.26875000000166,4091.7,58,27,0,85
8575,6.462750000000838,2527.5333333333333,41,31,1,72
8576,-9.292999999999415,2397.277777777778,28,28,0,56
8577,19.553250000001373,3703.2631578947367,52,31,3,83
8578,20.61375000000184,3078.0,69,23,1,92
8579,-8.452499999999354,2089.75,37,33,0,70
8580,-10.596499999998812,2683.0,33,33,1,66
8581,11.036250000001628,2822.0625,63,21,0,84
8582,10.966000000001111,3762.4210526315787,60,26,0,86
8583,-20.246999999999026,2706.7,30,29,0,59
8584,4.056250000001088,2543.25,56,25,1,81
8585,-5.206499999999307,2500.5,44,29,0,73
8586,-14.707249999999721,1528.25,24,24,0,48
8587,-9.798249999998877,2552.1,31,28,0,59
8588,-6.504499999998805,3385.4,41,29,0,70
8589,-0.7712499999997261,1921.0588235294117,41,27,1,68
8590,-7.070749999999935,1887.4705882352941,35,28,0,63
8591,2.853250000000666,2572.0,58,27,3,85
8592,6.08125000000144,3782.25,60,27,0,87
8593,16.572750000001882,3751.0,68,27,0,95
8594,-24.834999999998576,3393.4,42,32,0,74
8595,5.436500000001308,4595.0,72,30,0,102
8596,30.70100000000151,4730.65,82,20,0,102
8597,-6.548000000000366,1921.1176470588234,45,35,5,80
8598,18.001250000001555,4290.1,63,30,0,93
8599,-2.4054999999988107,2448.0666666666666,50,23,1,73
8600,11.52300000000173,3599.75,61,20,0,81
8601,3.8207500000007086,3052.15,37,24,1,61
8602,12.288000000001736,4094.8947368421054,62,35,1,97
8603,-17.37599999999975,1933.5,40,32,6,72
8604,-2.1874999999991003,3334.75,45,25,0,70
8605,35.8132500000021,2487.5625,78,36,0,114
8606,12.150000000002741,2660.705882352941,66,31,0,97
8607,0.9027500000010449,1944.9375,51,32,0,83
8608,2.3620000000016437,3814.0,58,28,0,86
8609,-6.831999999998322,4450.45,66,23,1,89
8610,-8.163999999999124,3702.15,38,35,0,73
8611,-10.942999999999477,2595.7,28,29,0,57
8612,-26.015499999999587,2028.3,14,29,5,43
8613,10.26175000000184,3572.1,55,24,0,79
8614,13.099500000001816,3830.0,55,26,1,81
8615,5.197750000000627,3048.25,46,20,1,66
8616,-32.703750000000035,2019.6842105263158,16,30,8,46
8617,30.196000000001685,5087.85,63,29,0,92
8618,-5.252249999999118,2234.625,43,34,0,77
8619,-0.4989999999992746,1821.875,45,31,1,76
8620,8.12350000000067,3065.6315789473683,59,29,1,88
8621,3.0057499999998085,2118.6666666666665,44,34,0,78
8622,-14.517499999999075,2544.1,35,20,1,55
8623,-10.391499999998512,3253.75,45,27,0,72
8624,-17.64250000000016,1981.111111111111,27,35,2,62
8625,6.79200000000031,2476.6111111111113,37,36,0,73
8626,-36.65650000000004,1899.5882352941176,19,54,0,73
8627,36.51050000000244,2762.375,107,27,2,134
8628,27.341000000000918,4238.611111111111,76,32,2,108
8629,-18.593249999999536,2583.8,28,30,1,58
8630,6.617250000001898,3672.75,51,26,0,77
8631,19.2862500000022,4621.263157894737,73,32,0,105
8632,-17.645750000000056,2552.9333333333334,27,47,2,74
8633,-22.43374999999967,2122.1111111111113,25,30,2,55
8634,13.499500000001428,4003.75,49,30,0,79
8635,-4.281249999999838,1904.3529411764705,32,27,1,59
8636,-7.4314999999993345,3300.55,43,31,0,74
8637,-18.249999999999414,2149.157894736842,19,25,3,44
8638,12.562750000000927,3761.4736842105262,48,37,1,85
8639,13.339500000001669,3591.8,52,28,0,80
8640,-6.745249999999297,2500.5,29,33,0,62
8641,-20.3650000000001,1705.8125,33,40,0,73
8642,16.278500000001074,3857.6,58,27,0,85
8643,14.736000000000761,2973.222222222222,51,23,0,74
8644,5.904000000000066,2212.4117647058824,46,31,0,77
8645,36.448750000001915,5028.35,84,29,1,113
8646,-5.969999999999361,2582.214285714286,45,39,0,84
8647,-26.816249999999542,2028.25,15,30,0,45
8648,12.422750000001411,4378.2,53,24,0,77
8649,-5.291749999999299,2500.5,23,35,0,58
8650,20.819500000000563,4444.2,59,27,0,86
8651,-24.12049999999994,1959.5263157894738,13,35,14,48
8652,-22.39825000000033,1976.6666666666667,23,38,3,61
8653,-19.879499999999293,2587.9,26,37,0,63
8654,-23.3039999999994,2032.3,14,30,1,44
8655,-7.186749999999412,2536.25,26,30,0,56
8656,10.838000000000761,4269.45,54,29,0,83
8657,44.17450000000291,4756.941176470588,84,33,0,117
8658,12.926750000000629,2514.4375,39,26,0,65
8659,17.703500000000865,4442.6,63,33,0,96
8660,-7.931249999999079,4204.4,42,43,0,85
8661,3.4592500000005573,2059.3529411764707,34,27,0,61
8662,11.98875000000114,3761.7,57,22,0,79
8663,-4.96749999999861,3079.8,41,28,0,69
8664,20.28800000000166,4589.45,63,28,0,91
8665,-19.68549999999899,2513.1176470588234,29,31,0,60
8666,-9.936249999999646,2179.0625,28,37,0,65
8667,-2.975999999999497,3463.315789473684,52,35,0,87
8668,-26.484499999999496,2032.25,15,34,1,49
8669,16.314000000002178,4208.5,66,23,1,89
8670,-2.143749999998792,2702.0,48,27,1,75
8671,4.705500000000638,2705.8125,51,28,0,79
8672,-32.82349999999923,2023.5,13,32,0,45
8673,-27.148999999999337,1914.9444444444443,13,37,2,50
8674,-10.836749999999274,3472.5789473684213,44,31,0,75
8675,-26.151249999999642,3446.6315789473683,38,32,0,70
8676,22.964250000001883,4516.35,67,20,0,87
8677,-1.200499999998804,2071.875,47,32,0,79
8678,2.928750000001389,4717.2,54,43,0,97
8679,4.999000000000606,2054.125,54,41,0,95
8680,9.333250000000332,2554.1875,51,31,3,82
8681,25.04050000000127,4903.75,68,33,0,101
8682,18.358750000000835,3810.0555555555557,65,32,0,97
8683,-0.09124999999893842,3294.25,40,26,1,66
8684,-4.429749999998949,2627.0666666666666,35,26,0,61
8685,-5.682999999999713,2370.0,40,34,2,74
8686,-2.0869999999991946,2455.8125,34,40,1,74
8687,25.06575000000148,4530.555555555556,67,19,0,86
8688,38.65950000000283,2875.6666666666665,78,28,0,106
8689,22.035000000001805,4866.45,71,32,0,103
8690,3.391000000001197,2194.875,41,35,0,76
8691,2.5167500000006333,3609.15,44,29,0,73
8692,-16.379000000000037,1966.9411764705883,36,48,1,84
8693,29.22775000000059,2746.5625,79,29,0,108
8694,-13.248999999999404,2657.9473684210525,37,30,6,67
8695,-2.1549999999981955,3628.842105263158,54,29,1,83
8696,10.478250000002033,2895.5,60,24,0,84
8697,-17.0127499999991,2473.315789473684,29,26,0,55
8698,16.290250000001777,2496.5625,60,22,0,82
8699,28.433250000002356,4131.45,68,30,0,98
8700,22.025000000001505,3933.684210526316,59,32,1,91
8701,11.460500000001472,4815.5,60,34,0,94
8702,-0.22574999999905626,3351.4444444444443,48,35,1,83
8703,-8.308499999998652,2717.5,39,26,1,65
8704,8.327500000001061,2963.5555555555557,53,21,1,74
8705,-6.542999999998746,3055.6470588235293,59,26,2,85
8706,19.845500000000783,3952.157894736842,65,35,0,100
8707,19.553500000001954,4774.210526315789,88,26,0,114
8708,7.155750000000734,2984.5555555555557,58,34,1,92
8709,-43.9589999999996,1971.5882352941176,16,36,16,52
8710,-15.311249999999779,2057.3684210526317,31,28,5,59
8711,-9.725499999999633,1857.5625,31,43,1,74
8712,16.145750000000596,1967.6,78,25,4,103
8713,18.394500000001493,2489.5625,77,24,2,101
8714,-12.481249999999125,2504.705882352941,31,27,1,58
8715,-14.091999999999604,2495.1052631578946,24,27,2,51
8716,-5.16349999999942,2579.3529411764707,49,32,4,81
8717,18.860000000001087,4343.4,63,29,0,92
8718,-2.1259999999997987,2282.722222222222,37,34,0,71
8719,28.640750000001425,5421.1,82,30,1,112
8720,5.325750000000974,3506.842105263158,50,29,1,79
8721,-22.727249999999813,2022.8,15,25,1,40
8722,1.7377500000008292,3572.0,52,15,0,67
8723,14.583500000000807,3176.0,49,36,0,85
8724,5.852500000000173,2479.470588235294,51,28,0,79
8725,-6.052249999998758,3197.25,38,29,0,67
8726,24.99300000000086,4371.35,68,21,0,89
8727,6.243250000000875,3179.1,35,34,0,69
8728,4.298250000000956,3949.05,45,25,0,70
8729,-21.792749999999284,2610.75,26,27,0,53
8730,-4.168249999999217,3067.315789473684,38,25,1,63
8731,-12.60774999999931,1967.8333333333333,32,29,3,61
8732,5.1185000000006315,2938.125,57,34,1,91
8733,3.719750000001364,3119.315789473684,43,26,0,69
8734,12.686250000000973,4018.7,52,32,0,84
8735,1.1597500000013523,3013.2105263157896,42,29,0,71
8736,-8.889249999999354,2486.7368421052633,33,30,2,63
8737,-2.412999999999116,3106.7368421052633,51,35,5,86
8738,6.967250000000128,2529.8823529411766,45,29,0,74
8739,16.49350000000063,3072.0,58,41,0,99
8740,24.71575000000125,4302.1,71,20,0,91
8741,-31.69974999999883,2440.4444444444443,30,25,0,55
8742,36.591500000002384,4810.1,75,22,0,97
8743,4.411750000000642,2568.235294117647,51,28,1,79
8744,19.147750000001047,3759.0555555555557,68,30,0,98
8745,-7.552499999999304,3466.6315789473683,49,40,0,89
8746,15.099500000001132,4475.95,58,28,0,86
8747,25.055750000002384,4658.789473684211,86,20,0,106
8748,9.730750000000924,2896.5,58,24,0,82
8749,-13.899499999999108,2116.1111111111113,27,36,0,63
8750,27.384500000001516,4816.2,80,10,3,90
8751,33.18550000000291,2519.3125,82,18,1,100
8752,7.669000000000409,3147.5263157894738,61,24,0,85
8753,-12.868499999998756,2252.529411764706,56,29,4,85
8754,2.8072500000020155,2251.6470588235293,53,21,4,74
8755,-5.331749999998609,2964.277777777778,56,25,1,81
8756,-10.409249999999515,2521.529411764706,27,28,1,55
8757,-4.767999999999183,1953.8125,49,27,0,76
8758,51.40100000000116,4715.65,76,14,0,90
8759,7.044250000000086,2152.1875,49,34,0,83
8760,-12.76274999999919,2682.0625,33,24,0,57
8761,-11.28699999999951,3706.0,31,42,0,73
8762,-15.7514999999996,2713.25,29,30,0,59
8763,-3.939999999999654,2532.3125,37,28,2,65
8764,5.409750000001326,2431.2,44,22,0,66
8765,-22.702749999999575,2024.3,16,30,0,46
8766,1.057250000000644,2472.6875,55,29,1,84
8767,14.748500000002071,4600.45,64,27,0,91
8768,-26.760999999999388,2147.4736842105262,19,26,0,45
8769,-19.470749999999768,2091.75,15,33,0,48
8770,22.97825000000141,3780.9473684210525,61,27,0,88
8771,-12.915999999999068,2490.8333333333335,33,26,2,59
8772,21.348500000001383,2672.764705882353,55,31,0,86
8773,11.154750000001465,3683.153846153846,48,26,0,74
8774,7.061250000001818,4302.15,68,27,1,95
8775,-0.5252499999991039,2846.1666666666665,41,27,0,68
8776,-23.43324999999966,2036.25,14,32,1,46
8777,13.1772500000023,3121.823529411765,69,39,6,108
8778,5.1097500000003055,2715.0,46,25,0,71
8779,-18.04599999999893,2517.5263157894738,34,22,1,56
8780,3.062250000000886,1983.6470588235295,76,39,0,115
8781,11.333500000001411,3683.157894736842,59,23,0,82
8782,-5.303749999998631,3339.35,41,38,0,79
8783,13.925500000001296,4159.25,47,30,1,77
8784,21.447250000001475,3431.25,67,20,1,87
8785,26.272500000001024,5714.75,82,20,1,102
8786,23.55300000000085,2533.5882352941176,67,24,2,91
8787,-2.1259999999992503,2115.625,39,32,0,71
8788,-20.324999999999438,2058.4,11,35,0,46
8789,-18.442749999999062,2420.25,35,35,0,70
8790,18.218000000001943,3909.777777777778,93,26,1,119
8791,-28.107250000000015,1429.0,23,26,7,49
8792,-15.516749999999584,2693.25,28,34,0,62
8793,3.9047500000007247,2072.8333333333335,34,34,0,68
8794,8.91500000000151,4121.95,57,29,0,86
8795,5.348000000001489,3738.6,55,23,0,78
8796,13.419250000000995,3615.6,49,23,0,72
8797,8.94475000000151,3490.705882352941,63,24,0,87
8798,41.098000000001676,4748.315789473684,89,21,0,110
8799,-4.6152499999987,4206.85,68,14,0,82
8800,44.39125000000277,5174.4,99,13,1,112
8801,-6.080499999998873,4399.75,47,31,0,78
8802,-16.304749999998755,2550.2631578947367,26,34,0,60
8803,5.880250000001218,3583.7894736842104,58,27,1,85
8804,11.812250000000919,3081.5789473684213,44,30,4,74
8805,-1.9439999999992985,2682.9411764705883,38,27,1,65
8806,35.16375000000138,5337.9,76,34,1,110
8807,-24.64249999999941,2414.1111111111113,30,30,2,60
8808,-4.201499999998601,3740.95,39,40,0,79
8809,-11.74699999999881,3363.1,43,30,2,73
8810,-7.704499999998714,3982.95,40,38,0,78
8811,16.253750000001773,4048.8947368421054,64,33,0,97
8812,-1.6697499999985272,3120.35,49,25,0,74
8813,28.71225000000149,5056.95,70,29,0,99
8814,20.44275000000173,5593.35,75,35,0,110
8815,3.838250000000393,1820.3529411764705,50,36,2,86
8816,36.66450000000087,5677.5,72,28,0,100
8817,-29.576499999999708,1984.6315789473683,17,32,9,49
8818,-2.5452499999987586,4609.2,54,27,1,81
8819,-14.540999999999425,2423.8333333333335,29,34,0,63
8820,-0.7807499999995218,3702.85,50,24,0,74
8821,7.4350000000010485,2467.2,51,26,0,77
8822,1.6217500000016698,3019.1176470588234,57,34,0,91
8823,-0.5409999999989059,3919.55,56,27,1,83
8824,-5.882249999999384,2488.3684210526317,32,25,1,57
8825,6.5137500000009325,3042.6666666666665,45,24,2,69
8826,19.930000000000767,3150.3125,67,31,3,98
8827,25.033750000001596,4360.85,62,26,1,88
8828,-14.075999999999016,3285.4,34,33,0,67
8829,15.08150000000098,4029.0,62,30,3,92
8830,-11.327749999999188,2623.0714285714284,37,32,4,69
8831,2.7230000000010754,3724.25,54,24,0,78
8832,11.23875000000141,2197.875,50,33,0,83
8833,6.760750000001039,3504.3684210526317,54,25,3,79
8834,6.58425000000161,3526.7368421052633,49,30,0,79
8835,22.576250000001174,2615.5625,57,35,0,92
8836,4.2802500000008745,2963.6111111111113,38,33,0,71
8837,-24.288499999999537,2074.7894736842104,18,27,2,45
8838,37.56575000000242,5214.75,84,24,0,108
8839,-1.1474999999993638,2562.5333333333333,40,28,1,68
8840,-6.7417499999991914,2194.875,33,35,1,68
8841,24.80500000000101,4087.4210526315787,64,25,1,89
8842,43.573000000002715,5163.25,85,21,1,106
8843,-16.530000000000133,3255.2631578947367,33,44,0,77
8844,26.3137500000014,3585.222222222222,58,26,0,84
8845,-12.238499999998396,3202.15,46,26,0,72
8846,-3.416499999999042,2128.5,37,32,3,69
8847,12.70925000000138,4427.45,58,24,1,82
8848,-0.9379999999990059,3124.2105263157896,39,26,3,65
8849,14.119750000001925,4291.0,56,28,0,84
8850,10.035250000000616,3532.277777777778,48,32,1,80
8851,-18.00049999999941,2489.0,37,22,1,59
8852,21.750750000001126,3281.8333333333335,82,24,1,106
8853,13.988500000001256,3891.8947368421054,82,33,1,115
8854,18.115500000001745,2922.1176470588234,60,36,0,96
8855,-4.910749999998694,2425.294117647059,38,22,5,60
8856,12.397000000000554,3108.8888888888887,58,30,1,88
8857,-0.3552499999993194,2509.5,55,27,0,82
8858,-11.235000000000012,2131.9444444444443,30,34,9,64
8859,-24.36749999999976,2748.95,27,23,3,50
8860,-3.066999999999339,2783.0,35,27,1,62
8861,-24.765999999999547,2044.1,11,37,0,48
8862,6.939500000000462,3111.5555555555557,52,40,0,92
8863,36.18475000000044,4309.631578947368,65,33,0,98
8864,15.734250000002026,5117.95,71,40,0,111
8865,7.613250000001014,3581.6666666666665,58,37,0,95
8866,20.61150000000076,2566.0,63,25,1,88
8867,-4.3369999999987385,2467.2,51,23,0,74
8868,-15.761749999999395,2607.65,27,33,0,60
8869,17.025250000001357,5405.25,60,40,1,100
8870,-1.8427499999989116,2865.5555555555557,48,23,1,71
8871,25.01275000000025,2797.0,59,28,0,87
8872,12.005250000000645,3299.9333333333334,53,32,1,85
8873,23.190500000001524,4937.1,80,32,0,112
8874,21.980750000000548,2759.5,56,33,0,89
8875,24.80625000000162,5308.5,72,30,0,102
8876,35.01100000000184,4712.45,69,21,1,90
8877,27.967000000002294,5679.15,83,24,0,107
8878,10.600500000000766,2501.0,68,29,2,97
8879,-13.604999999999418,2857.705882352941,45,27,0,72
8880,22.55100000000163,4764.85,64,31,0,95
8881,-44.64999999999988,2057.4210526315787,13,36,13,49
8882,-11.229749999999285,2881.4444444444443,38,35,0,73
8883,23.53575000000101,4628.25,63,31,0,94
8884,13.766750000001906,4398.2,70,27,0,97
8885,27.61225000000177,4144.15,66,28,0,94
8886,-14.942499999999615,2521.529411764706,27,25,3,52
8887,21.9802500000002,3555.3333333333335,69,35,1,104
8888,17.06025000000016,3899.75,48,28,1,76
8889,18.17975000000193,4441.05,65,29,0,94
8890,7.236250000001346,4788.6,64,33,1,97
8891,-18.490999999998856,2580.9375,31,28,2,59
8892,8.195000000000896,3635.25,51,27,0,78
8893,25.42925000000165,4032.35,63,27,0,90
8894,-22.97124999999941,2437.0,40,34,3,74
8895,20.487750000000958,4201.8421052631575,58,26,0,84
8896,4.003250000000364,2546.705882352941,45,37,0,82
8897,23.624000000000848,3776.0,55,27,0,82
8898,26.611750000001297,4192.631578947368,71,24,1,95
8899,14.763250000001587,3561.7,56,22,0,78
8900,-0.5314999999991947,2741.4210526315787,40,30,5,70
8901,0.252500000002459,2715.75,56,30,0,86
8902,20.68825000000189,4932.2,74,23,0,97
8903,-16.498249999999878,2674.4,30,28,0,58
8904,-2.659499999999133,3474.9473684210525,48,25,0,73
8905,21.14800000000177,3847.3529411764707,80,26,1,106
8906,11.813750000001379,4963.2,75,31,0,106
8907,5.760750000001026,3603.7,45,25,1,70
8908,21.60050000000187,3601.8888888888887,70,29,3,99
8909,38.79225000000268,5310.05,85,21,0,106
8910,22.030750000001657,4099.7,59,22,0,81
8911,-12.665250000000013,1989.6315789473683,25,33,6,58
8912,13.893500000001254,4529.95,62,31,1,93
8913,-9.417749999999295,2544.2,28,22,2,50
8914,-11.964249999999284,2514.866666666667,29,25,2,54
8915,2.6547500000008255,4848.05,53,21,4,74
8916,16.760500000000974,2807.0,57,21,1,78
8917,17.624500000002275,2853.8823529411766,61,27,2,88
8918,12.920750000001515,3742.6,60,19,1,79
8919,-15.267999999999082,2902.8,34,31,0,65
8920,-17.227249999999593,2024.3,19,26,0,45
8921,11.555250000000658,2976.777777777778,52,25,0,77
8922,15.411750000000561,2685.6153846153848,62,34,0,96
8923,7.187750000001015,3396.5,33,34,0,67
8924,-6.043249999998288,3440.7368421052633,54,29,4,83
8925,-7.663999999999116,3045.3529411764707,50,32,1,82
8926,2.7722500000011117,2948.6111111111113,42,24,0,66
8927,-21.336499999999575,1929.0,22,33,0,55
8928,-17.629749999998857,2503.222222222222,30,32,0,62
8929,-15.389999999999418,2673.7894736842104,23,36,2,59
8930,-46.576999999999856,1429.0,0,29,6,29
8931,8.890000000000928,2673.125,51,24,1,75
8932,24.486250000001625,4123.4,67,27,0,94
8933,24.605000000001898,2158.2,68,24,0,92
8934,-16.93924999999917,2570.1052631578946,29,29,2,58
8935,-4.468999999998923,2573.9375,38,29,2,67
8936,-7.324499999999529,1988.235294117647,34,24,7,58
8937,-13.577499999999352,2512.6315789473683,22,33,0,55
8938,-19.77174999999928,2698.8125,25,31,2,56
8939,-32.557749999999054,1986.2631578947369,15,26,8,41
8940,-21.852499999999594,2086.95,17,28,1,45
8941,33.05725000000143,2571.9333333333334,88,24,0,112
8942,-5.264749999998648,3535.2631578947367,51,20,0,71
8943,12.119750000000035,2644.0,63,29,0,92
8944,0.6320000000012752,3412.45,50,23,2,73
8945,-1.6842499999988683,2941.5555555555557,43,29,0,72
8946,15.5872500000014,3449.9473684210525,75,26,1,101
8947,39.72425000000119,4469.55,67,24,0,91
8948,-19.034499999999007,2704.4,37,24,0,61
8949,-6.127500000000258,1429.0,45,37,1,82
8950,3.961250000001308,4494.95,58,31,0,89
8951,-9.380999999999135,2617.625,38,22,0,60
8952,4.113500000001464,3826.7894736842104,54,28,0,82
8953,-8.30774999999851,3343.176470588235,41,28,0,69
8954,0.8172500000018023,2855.75,64,28,1,92
8955,6.883000000001123,2415.0,61,26,1,87
8956,-11.064999999999412,2715.0,29,28,0,57
8957,0.8012500000008377,2570.866666666667,47,20,0,67
8958,33.2622500000016,5210.05,80,19,0,99
8959,21.14750000000266,4613.9,81,18,0,99
8960,23.084750000001186,4272.65,62,22,0,84
8961,-3.7974999999990673,2973.0,43,28,2,71
8962,-2.845999999999764,2092.1666666666665,38,32,0,70
8963,9.38800000000117,3120.0,48,34,0,82
8964,17.06450000000148,4187.05,65,23,0,88
8965,-8.074999999999163,2625.9,28,30,0,58
8966,6.53475000000135,2566.0,58,24,1,82
8967,6.500750000000896,3010.5263157894738,44,28,0,72
8968,-0.15249999999899036,2586.875,44,24,0,68
8969,-13.486999999999489,2476.6666666666665,30,33,0,63
8970,-7.2029999999993874,3571.0,46,32,7,78
8971,-12.674249999999317,2635.4736842105262,33,33,1,66
8972,-17.61349999999881,3089.6111111111113,39,37,0,76
8973,-13.081499999998854,3345.0,44,29,0,73
8974,3.299250000000595,3168.8,36,27,0,63
8975,40.83725000000196,5331.65,80,23,0,103
8976,25.880750000000923,4405.277777777777,62,42,0,104
8977,43.24925000000152,5532.25,88,20,0,108
8978,-2.7899999999988965,3073.2631578947367,40,32,0,72
8979,6.011750000001592,3415.176470588235,77,28,3,105
8980,6.425750000000887,2649.0,50,30,0,80
8981,16.928000000001656,1903.25,54,25,1,79
8982,9.17700000000061,3852.05,40,29,2,69
8983,-4.055499999998444,3052.25,51,19,0,70
8984,10.513500000001113,3554.3333333333335,82,24,1,106
8985,3.108500000000848,2409.9333333333334,46,28,0,74
8986,10.602500000000905,2299.3529411764707,43,31,1,74
8987,28.188250000001112,3557.7894736842104,62,18,0,80
8988,-1.9304999999988233,3123.65,42,29,0,71
8989,15.878000000000927,2874.625,60,32,1,92
8990,-1.015249999998874,2880.0,55,24,1,79
8991,4.0335000000005135,1429.0,47,31,3,78
8992,18.65375000000142,4271.1,71,16,2,87
8993,-15.152249999999208,2521.5882352941176,31,20,2,51
8994,46.40500000000195,3490.8333333333335,92,23,1,115
8995,17.72550000000181,4706.75,69,24,0,93
8996,21.955750000001732,4902.9,73,22,0,95
8997,-8.549499999999167,3186.95,38,25,0,63
8998,20.288000000001336,2439.866666666667,59,21,1,80
8999,4.123500000001743,5030.7,68,25,2,93
9000,-31.457249999999494,2028.3,15,27,4,42
9001,-6.552999999999598,1429.0,41,36,1,77
9002,4.077500000000753,2410.0666666666666,42,34,1,76
9003,-7.1377499999993415,2598.2,30,29,0,59
9004,-5.108999999999691,2425.7894736842104,30,25,3,55
9005,14.981500000000858,3822.0,61,25,0,86
9006,-27.125249999999784,1429.0,14,32,3,46
9007,32.66000000000186,4856.9,76,26,0,102
9008,36.81525000000108,5362.35,70,29,0,99
9009,10.002000000001106,3703.65,60,28,0,88
9010,16.616000000000977,2419.5333333333333,74,31,0,105
9011,-0.859749999998255,3052.05,42,26,0,68
9012,-11.477999999998504,1983.6666666666667,33,27,1,60
9013,1.1547500000009545,2438.5333333333333,48,35,0,83
9014,38.54025000000201,4823.65,86,22,0,108
9015,-20.791249999999174,2560.1,29,26,1,55
9016,-6.8912499999990215,3662.5,45,33,2,78
9017,31.46725000000219,2971.529411764706,76,27,0,103
9018,-40.07575000000027,1429.0,8,28,12,36
9019,32.63500000000191,5437.05,71,16,1,87
9020,11.919000000001803,4214.0,70,21,0,91
9021,-0.4067499999988919,2060.0,42,25,1,67
9022,27.336500000000957,3277.25,74,23,0,97
9023,12.325000000000099,2586.9411764705883,45,32,1,77
9024,25.574250000000525,2398.3125,69,32,1,101
9025,-7.897999999999098,2181.5882352941176,27,36,3,63
9026,-18.249500000000214,2013.842105263158,14,29,16,43
9027,-9.847999999999399,1661.1875,41,32,0,73
9028,-4.526499999999176,3241.5,36,26,0,62
9029,-12.808000000000328,2026.3157894736842,29,32,3,61
9030,14.729750000001223,2605.6875,65,34,0,99
9031,-4.079249999999058,2586.866666666667,41,24,1,65
9032,-13.276249999999084,2555.9,35,21,1,56
9033,12.465000000000504,3851.842105263158,49,36,0,85
9034,-21.999749999999363,1429.0,21,30,1,51
9035,38.5960000000016,3660.764705882353,75,26,0,101
9036,13.974750000001677,4913.25,69,30,0,99
9037,1.4420000000012803,3078.157894736842,43,32,1,75
9038,-12.316499999999658,2678.25,28,26,2,54
9039,21.695500000001154,4252.9473684210525,74,27,0,101
9040,19.33650000000198,2727.625,70,25,1,95
9041,16.462500000001096,3783.0,60,18,1,78
9042,8.442500000000805,2839.875,63,25,0,88
9043,22.821500000001716,2453.875,59,34,1,93
9044,21.038250000003444,2682.0588235294117,78,21,0,99
9045,-0.4309999999992115,3059.9473684210525,34,33,0,67
9046,23.842500000002843,3265.375,83,23,0,106
9047,-2.8679999999987222,3192.65,46,28,0,74
9048,30.819250000003883,3810.9444444444443,98,17,2,115
9049,-6.615749999998947,3599.65,44,24,1,68
9050,10.734250000002152,4223.6,69,31,0,100
9051,-14.884749999999062,2788.8333333333335,43,35,3,78
9052,3.8742500000019207,4193.4,72,23,0,95
9053,18.2430000000018,4252.95,60,31,0,91
9054,-5.210249999999588,2607.1052631578946,29,26,1,55
9055,4.5245000000011775,3698.85,54,28,0,82
9056,28.0607500000022,5022.7,77,31,0,108
9057,40.932500000002506,6111.6,92,31,0,123
9058,-5.145749999999422,2705.470588235294,47,32,1,79
9059,41.80000000000075,3849.722222222222,97,35,0,132
9060,13.020500000002134,4780.85,71,29,0,100
9061,24.826750000001717,4746.6,74,23,0,97
9062,41.46600000000204,5750.5,78,30,0,108
9063,0.9312500000010161,3099.75,35,34,0,69
9064,-10.352499999998296,2517.764705882353,48,25,1,73
9065,-3.6819999999993493,3425.7894736842104,38,25,3,63
9066,4.378250000000888,2588.823529411765,49,45,1,94
9067,-17.137499999999374,2007.157894736842,16,29,0,45
9068,20.170500000001745,4689.3,64,34,0,98
9069,-20.26049999999976,2032.3,12,28,2,40
9070,25.030000000001515,4199.8,67,22,0,89
9071,-32.84599999999956,1429.0,13,31,3,44
9072,-20.016999999999065,2536.842105263158,29,34,2,63
9073,-14.75299999999948,2016.45,17,30,1,47
9074,-5.280749999999129,2589.875,33,24,2,57
9075,9.39875000000091,3866.5,62,20,0,82
9076,8.288750000001508,4272.7,53,32,0,85
9077,-5.792749999999158,2473.6875,35,33,0,68
9078,-12.164249999999022,2490.0526315789475,33,32,0,65
9079,2.6005000000015484,2516.3125,51,24,0,75
9080,20.4387500000012,2705.9375,70,28,0,98
9081,-25.484749999999018,2514.3684210526317,27,41,9,68
9082,-2.974749999999034,3432.15,41,31,0,72
9083,-16.317749999999762,1904.235294117647,31,38,0,69
9084,24.836750000001548,3917.842105263158,68,33,0,101
9085,-8.428999999999185,1481.9333333333334,60,29,4,89
9086,-23.289749999999735,2028.2,11,34,2,45
9087,-3.388249999998782,3058.2631578947367,41,37,0,78
9088,25.37050000000183,5037.85,70,35,0,105
9089,-1.0559999999990413,2401.1176470588234,39,25,1,64
9090,13.710500000000948,4338.6,52,28,0,80
9091,13.68575000000125,3996.5,60,32,0,92
9092,17.970500000001028,3628.4444444444443,60,21,0,81
9093,15.40025000000025,2410.0,47,34,0,81
9094,18.445500000000454,4974.35,57,40,0,97
9095,2.791000000001204,3052.15,41,25,1,66
9096,13.043000000000877,3643.3,55,21,0,76
9097,37.06550000000093,5515.55,66,33,0,99
9098,15.984250000001447,3777.55,54,36,0,90
9099,10.068000000001641,3700.722222222222,57,23,0,80
9100,-27.996999999999623,2028.25,16,25,1,41
9101,-19.3417499999997,2072.7,18,28,3,46
9102,16.902250000001807,3407.705882352941,63,29,0,92
9103,13.396250000000919,4266.45,54,30,0,84
9104,14.846750000000387,2908.176470588235,50,29,0,79
9105,-6.808249999998516,4640.25,53,31,0,84
9106,-21.69774999999934,2825.8333333333335,34,34,1,68
9107,-16.707249999999785,2663.95,20,35,1,55
9108,42.69525000000287,3542.1875,73,27,0,100
9109,-19.38599999999919,2553.5263157894738,23,34,2,57
9110,-12.834249999998836,2556.0,29,29,0,58
9111,18.5065000000005,2585.0588235294117,51,33,1,84
9112,-3.427999999999513,1893.25,29,35,2,64
9113,1.0970000000011946,4209.25,47,29,1,76
9114,-9.824249999998944,2944.8888888888887,50,32,0,82
9115,-42.5964999999998,2220.35,9,38,0,47
9116,-21.090249999999696,2469.2631578947367,19,39,2,58
9117,1.0745000000015124,3137.133333333333,44,29,0,73
9118,17.7955000000018,2869.5625,63,36,1,99
9119,-1.664749999999843,2171.6111111111113,36,28,11,64
9120,7.68625000000128,2357.6875,48,36,0,84
9121,-21.015499999999772,2008.45,9,31,1,40
9122,14.20125000000127,5256.0,53,43,0,96
9123,33.43875000000167,4115.6,55,31,0,86
9124,1.226250000000722,3145.75,41,25,0,66
9125,26.706250000001443,4269.526315789473,64,20,0,84
9126,41.009250000001956,5544.25,72,19,0,91
9127,34.52575000000211,4087.9,63,26,0,89
9128,6.182250000000922,2983.8947368421054,45,26,2,71
9129,24.905000000002772,5345.75,92,29,0,121
9130,-5.797499999999333,1481.9333333333334,27,32,1,59
9131,7.493500000001559,3639.5789473684213,52,28,0,80
9132,24.58750000000162,3253.076923076923,68,28,0,96
9133,-19.329499999999037,2683.0,25,34,0,59
9134,5.407750000000658,3825.95,49,30,0,79
9135,-24.629499999999855,2036.25,9,32,1,41
9136,-9.362749999999185,3539.315789473684,44,35,1,79
9137,-32.63924999999944,2857.5789473684213,24,38,0,62
9138,-4.003249999999586,3072.0,43,33,0,76
9139,-16.259749999999134,3083.0,29,35,1,64
9140,-7.738499999999284,2429.1875,38,40,2,78
9141,6.601000000000925,2989.1111111111113,49,30,5,79
9142,-14.706000000000362,1429.0,37,34,2,71
9143,47.81325000000229,5421.3,91,19,0,110
9144,-19.266249999998774,2530.0,30,47,0,77
9145,34.16350000000145,5334.6,62,31,0,93
9146,27.99275000000148,4820.4,67,32,1,99
9147,-0.20074999999884682,2921.0,42,34,0,76
9148,-24.561749999999456,2008.5,13,32,0,45
9149,-13.62374999999955,1887.4705882352941,20,35,1,55
9150,25.01725000000225,5298.25,81,26,0,107
9151,9.657000000000819,3072.2,39,32,0,71
9152,-2.6782499999989082,2541.3571428571427,37,30,2,67
9153,33.85600000000154,5713.3,77,32,0,109
9154,-10.11274999999964,2445.0,22,33,1,55
9155,-2.2052499999991837,3299.6315789473683,41,31,0,72
9156,-21.969749999999582,2052.05,13,33,0,46
9157,5.078000000001768,3615.6,49,34,0,83
9158,-7.0889999999999365,2478.315789473684,23,37,1,60
9159,-34.158249999999846,1429.0,10,35,0,45
9160,8.406250000002045,1961.6666666666667,45,26,0,71
9161,-13.288499999999413,2495.9473684210525,23,34,0,57
9162,3.7027500000012608,3490.8947368421054,54,30,0,84
9163,-1.6284999999991006,3165.65,37,26,0,63
9164,14.940750000001009,4600.45,47,34,1,81
9165,20.992500000001122,4200.210526315789,70,26,0,96
9166,2.6112500000009833,2447.0,53,31,0,84
9167,-12.661749999999094,2921.9473684210525,36,33,13,69
9168,-5.873749999998397,3759.2,41,37,1,78
9169,-18.825999999999375,1963.1176470588234,27,35,5,62
9170,33.94075000000128,4651.35,57,26,0,83
9171,24.318250000001118,2938.0625,58,31,0,89
9172,-22.449749999999568,2008.4,13,25,4,38
9173,17.967500000000605,2871.8333333333335,57,25,0,82
9174,7.889250000000703,3139.35,35,37,0,72
9175,-10.493249999999517,3431.1176470588234,32,30,0,62
9176,20.613000000001296,4179.05,57,31,0,88
9177,18.93325000000143,4560.85,61,34,0,95
9178,5.684250000001308,3636.95,56,22,0,78
9179,-1.5132499999989175,3861.6,43,37,0,80
9180,5.180000000000281,3849.8,42,25,0,67
9181,-28.753749999999503,2044.15,15,29,0,44
9182,-11.747249999998928,2440.3529411764707,31,38,0,69
9183,-7.0332499999989055,3605.4,44,37,0,81
9184,-35.18074999999918,2003.0,15,32,0,47
9185,-15.52549999999925,2557.0,25,35,2,60
9186,6.856750000001698,3667.15,52,35,0,87
9187,29.33725000000115,4345.85,65,24,0,89
9188,13.756500000000901,2457.6,42,34,0,76
9189,-25.153749999999523,2048.15,17,27,4,44
9190,30.912000000002042,4935.5,75,37,0,112
9191,-17.567999999999195,2214.75,30,48,0,78
9192,-2.5894999999992776,3163.1,42,26,1,68
9193,20.78575000000161,1773.0,52,28,0,80
9194,-17.020499999999576,2444.8333333333335,32,30,6,62
9195,-13.708749999998943,2495.0526315789475,25,37,1,62
9196,-14.761999999999237,3061.4210526315787,37,32,1,69
9197,34.83550000000101,4113.388888888889,78,33,2,111
9198,9.143500000000747,3197.684210526316,52,31,1,83
9199,3.492000000001247,3739.0,50,27,0,77
9200,0.6650000000012716,3762.45,39,40,1,79
9201,2.71400000000157,3760.15,51,32,0,83
9202,23.098500000001305,3643.3,51,30,0,81
9203,35.93025000000299,4989.4,85,23,0,108
9204,27.140750000001475,4867.15,74,22,0,96
9205,6.275250000001148,3643.25,50,23,0,73
9206,26.20450000000135,4123.55,62,23,0,85
9207,-7.346999999999089,2491.5625,31,27,0,58
9208,-9.496249999999336,2514.4375,29,26,0,55
9209,5.195000000000834,4408.5,57,27,0,84
9210,10.006250000001497,3266.9473684210525,51,30,0,81
9211,-14.291749999999976,2218.8823529411766,45,46,0,91
9212,14.712000000001742,3033.235294117647,64,28,0,92
9213,-10.798999999998866,2997.0555555555557,37,37,3,74
9214,1.0852500000014758,3749.0,53,26,0,79
9215,13.410500000001278,3548.2,50,24,0,74
9216,-33.351249999999695,2049.842105263158,12,35,3,47
9217,10.431750000001713,4003.1052631578946,63,38,0,101
9218,-6.083499999998798,3068.8,42,28,1,70
9219,38.43675000000152,4918.684210526316,76,26,0,102
9220,-17.47124999999935,2480.8947368421054,24,35,0,59
9221,-0.06399999999918907,3014.157894736842,40,24,3,64
9222,16.290750000000465,2448.133333333333,60,20,0,80
9223,-2.8029999999988453,4593.35,65,29,0,94
9224,-25.26725000000055,1429.0,29,41,0,70
9225,18.154250000001433,3600.315789473684,65,23,2,88
9226,3.050250000000993,3639.5,50,24,0,74
9227,43.54025000000323,3122.8823529411766,77,28,1,105
9228,-0.9189999999992537,2731.6470588235293,47,19,1,66
9229,-17.422999999998893,2633.285714285714,30,35,1,65
9230,0.51425000000086,3099.7,41,26,0,67
9231,-9.900499999999202,3519.0555555555557,58,22,0,80
9232,8.415500000000431,3162.5789473684213,46,25,4,71
9233,9.673250000001296,3340.2,45,31,1,76
9234,-12.47749999999889,3144.95,33,30,2,63
9235,-27.959249999999805,2052.9,15,23,1,38
9236,-15.737249999999142,3018.0526315789475,36,26,3,62
9237,5.358500000001247,3306.4210526315787,49,32,0,81
9238,2.482250000000672,3183.15,44,18,0,62
9239,2.645250000001337,3560.9,51,24,0,75
9240,-25.354499999999515,2008.5,13,32,1,45
9241,17.249500000001614,3681.4,62,18,0,80
9242,4.794250000000525,2168.470588235294,64,39,0,103
9243,19.25525000000105,4862.4,61,25,0,86
9244,-34.0694999999996,3019.55,25,28,6,53
9245,2.857750000001187,4198.526315789473,54,30,0,84
9246,-7.702999999998509,3557.842105263158,44,33,0,77
9247,-12.595249999999677,1965.9411764705883,22,36,0,58
9248,-10.498749999999173,3002.9473684210525,36,37,0,73
9249,13.16625000000117,4848.15,62,30,0,92
9250,9.419250000000979,3004.6315789473683,50,24,5,74
9251,32.30250000000176,5295.85,75,29,0,104
9252,-9.145249999999042,3175.2105263157896,38,26,0,64
9253,-22.996249999999634,1925.5555555555557,16,31,1,47
9254,-9.871999999999842,3162.4736842105262,58,27,2,85
9255,-13.66074999999872,3389.35,43,31,0,74
9256,-27.983249999999668,2001.3157894736842,16,28,0,44
9257,-16.807499999998974,2639.0,29,26,1,55
9258,18.236250000000993,2739.9411764705883,56,19,0,75
9259,-21.113749999999307,2390.705882352941,34,42,0,76
9260,-10.273249999999145,3567.95,44,26,1,70
9261,7.196250000000811,2467.133333333333,56,30,0,86
9262,27.337000000002,4276.263157894737,66,27,0,93
9263,-3.171999999999005,2751.5,54,32,2,86
9264,-21.823999999999238,3871.9,43,40,3,83
9265,14.532250000000479,2443.222222222222,52,39,0,91
9266,-27.96274999999995,1429.0,12,35,3,47
9267,18.172500000001637,4800.55,78,21,0,99
9268,27.11500000000322,5139.4,82,22,0,104
9269,-26.14949999999978,2658.277777777778,29,42,0,71
9270,24.275250000001382,3616.4210526315787,58,28,0,86
9271,0.3340000000006157,2358.1176470588234,47,28,2,75
9272,0.5797500000018956,2490.3571428571427,52,34,1,86
9273,23.193000000000982,4138.421052631579,69,18,2,87
9274,13.665500000001401,4482.35294117647,54,30,0,84
9275,-9.47199999999901,2608.1666666666665,28,28,0,56
9276,37.28475000000291,5738.55,88,19,0,107
9277,-1.738749999998652,2505.266666666667,47,31,0,78
9278,-8.425499999998532,3164.157894736842,47,30,0,77
9279,-9.541499999999063,3298.2,44,32,0,76
9280,1.436250000001582,2456.176470588235,43,29,1,72
9281,-18.353499999999034,2050.0625,41,26,3,67
9282,27.314500000001146,2677.470588235294,54,22,0,76
9283,3.10700000000057,2794.157894736842,37,31,1,68
9284,-4.126999999998532,3601.2631578947367,53,32,0,85
9285,11.920000000000993,3760.0,51,26,0,77
9286,-12.795999999998969,3107.6,43,23,1,66
9287,19.451000000000473,4163.421052631579,56,22,0,78
9288,17.844500000000867,2864.625,57,27,4,84
9289,9.634250000000817,2803.1875,56,19,0,75
9290,9.73000000000136,4115.55,63,23,0,86
9291,8.321500000001386,3583.7894736842104,52,24,0,76
9292,13.228750000001586,3036.9411764705883,69,24,1,93
9293,-5.124749999999625,2445.823529411765,43,32,3,75
9294,-14.353999999999221,2604.5789473684213,32,29,1,61
9295,-25.057249999999208,2076.5263157894738,15,33,0,48
9296,-8.995999999999013,2321.875,39,30,0,69
9297,-31.246249999999424,2040.1,14,35,0,49
9298,4.723250000000806,4256.05,47,36,1,83
9299,-23.07974999999951,1950.1666666666667,18,32,0,50
9300,35.379250000001306,4726.7,63,24,0,87
9301,13.53775000000186,5105.35,73,37,0,110
9302,-1.885499999999076,2571.9375,43,26,0,69
9303,14.227250000001206,2410.0,73,39,0,112
9304,-30.555249999999813,2144.222222222222,20,28,0,48
9305,4.5175000000015615,3660.1,56,25,0,81
9306,-40.01200000000025,1970.421052631579,13,36,9,49
9307,-7.676499999999135,3302.1666666666665,51,43,0,94
9308,15.758750000001609,4432.25,59,35,0,94
9309,5.665750000001395,4152.95,44,40,4,84
9310,-28.563499999999898,2333.777777777778,21,33,2,54
9311,-14.915749999999644,2117.2,18,28,3,46
9312,-4.726749999999054,3418.8571428571427,36,28,0,64
9313,7.141999999999719,2500.5,62,29,1,91
9314,-3.9277499999996066,3095.684210526316,32,34,0,66
9315,0.6295000000012525,3604.5263157894738,55,36,4,91
9316,-30.036249999999548,2007.1052631578948,18,25,4,43
9317,-8.562999999999528,2567.95,27,31,0,58
9318,-22.14900000000035,2585.3684210526317,43,22,11,65
9319,-10.289999999999562,2513.1176470588234,36,26,1,62
9320,-11.916999999999078,1844.75,28,34,0,62
9321,-0.5647499999989029,3317.25,42,26,0,68
9322,30.510250000001538,4703.105263157895,85,28,0,113
9323,-2.7477499999995905,2935.3684210526317,38,18,4,56
9324,-26.2567500000002,1429.0,17,32,4,49
9325,17.738000000000927,3849.8333333333335,66,36,0,102
9326,2.3367500000011416,3806.1,38,33,0,71
9327,35.497500000002546,2542.125,70,26,1,96
9328,-17.18574999999926,2544.5555555555557,38,35,2,73
9329,-9.622999999999177,3467.2,45,29,2,74
9330,-10.96624999999889,2927.3888888888887,33,41,0,74
9331,44.94775000000261,4378.833333333333,87,20,1,107
9332,18.309000000001145,3101.8888888888887,60,19,0,79
9333,41.161750000000836,4986.315789473684,86,26,1,112
9334,7.540000000001726,4627.45,77,13,0,90
9335,9.372250000000871,2442.1176470588234,56,18,2,74
9336,-10.226999999998567,2893.777777777778,50,22,2,72
9337,5.974750000000418,2400.4,48,23,1,71
9338,-2.556249999999055,2448.133333333333,59,33,1,92
9339,-5.828499999999154,2518.375,71,48,0,119
9340,29.54150000000152,5322.65,73,16,0,89
9341,2.3272500000012917,3060.0,37,31,0,68
9342,1.4632500000007223,2709.5,44,29,0,73
9343,-8.087249999998885,2520.375,44,20,2,64
9344,-42.056749999999695,1429.0,0,32,3,32
9345,21.929750000001572,4533.1,60,28,0,88
9346,1.4715000000011345,3072.05,38,30,0,68
9347,26.5882500000016,3471.1176470588234,80,22,0,102
9348,-3.745749999999584,2695.0,28,24,2,52
9349,-4.101249999998507,2653.6428571428573,42,26,0,68
9350,-5.498499999999486,2499.0588235294117,29,26,1,55
9351,-3.8694999999985575,2860.9473684210525,42,30,0,72
9352,3.7700000000008416,2725.176470588235,54,31,3,85
9353,25.61925000000145,4031.5263157894738,60,23,2,83
9354,18.573250000000872,2650.3125,56,30,0,86
9355,-16.330249999998646,3012.2105263157896,36,31,1,67
9356,3.895750000000335,3096.6315789473683,57,30,5,87
9357,-8.9689999999997,2152.5882352941176,21,28,4,49
9358,-0.49349999999967925,3085.6315789473683,41,29,7,70
9359,22.539750000001447,3951.315789473684,67,31,0,98
9360,24.52975000000181,4526.8421052631575,64,35,2,99
9361,7.8962500000014115,4036.5789473684213,59,32,0,91
9362,-35.89674999999993,1429.0,0,33,0,33
9363,-10.472749999999245,2544.1,28,24,1,52
9364,28.75625000000162,5057.315789473684,67,27,0,94
9365,-4.92474999999953,3458.45,38,24,1,62
9366,36.82775000000271,5329.9,94,28,0,122
9367,-15.636499999998922,2495.1666666666665,31,38,1,69
9368,19.282000000001904,3401.8888888888887,72,26,3,98
9369,-19.923499999999567,2104.8947368421054,21,28,1,49
9370,-19.38024999999857,2417.5555555555557,34,32,5,66
9371,24.329250000001828,4179.2,62,26,0,88
9372,-16.63624999999977,1874.3529411764705,21,33,2,54
9373,26.19075000000271,3685.125,86,26,3,112
9374,-26.394249999999708,2063.95,16,24,0,40
9375,-7.352499999999422,3686.2,47,25,0,72
9376,5.202500000001175,2962.6111111111113,45,27,0,72
9377,13.1650000000013,3896.5555555555557,54,32,0,86
9378,5.664249999999476,1975.2941176470588,42,32,0,74
9379,-9.494749999999222,2480.0,36,23,2,59
9380,8.962250000000925,2408.5882352941176,70,23,3,93
9381,11.080250000001419,3981.4210526315787,59,34,0,93
9382,2.6855000000014586,4003.65,57,27,0,84
9383,-10.885249999999974,1844.75,42,28,2,70
9384,25.282250000001692,3177.9411764705883,84,27,0,111
9385,6.734500000000564,3004.8333333333335,55,22,0,77
9386,19.626000000001945,4857.55,79,20,0,99
9387,-29.661000000000104,1997.1052631578948,12,34,14,46
9388,4.059250000001182,2342.294117647059,41,28,0,69
9389,20.036000000000985,3220.230769230769,67,27,0,94
9390,34.323500000002134,4829.0,68,32,0,100
9391,14.487250000001183,3825.05,56,35,2,91
9392,22.422750000001972,4898.2,71,28,1,99
9393,-2.227749999999486,2563.5882352941176,31,40,0,71
9394,41.141750000001984,4373.263157894737,84,31,1,115
9395,36.26075000000094,4439.5,68,21,0,89
9396,38.02775000000254,6482.25,98,28,0,126
9397,-14.589249999998973,2544.8823529411766,31,28,1,59
9398,16.823750000001343,4331.5,68,24,1,92
9399,8.87000000000078,4081.5789473684213,53,33,0,86
9400,-11.802749999999362,3274.95,40,28,0,68
9401,-11.530749999998344,3151.25,47,23,0,70
9402,29.13550000000223,5196.45,81,22,0,103
9403,4.536250000000551,2663.9285714285716,43,34,3,77
9404,-1.8172499999992993,2103.75,44,35,1,79
9405,-3.9322499999990557,2502.4375,42,25,3,67
9406,3.9160000000017496,3569.4736842105262,57,20,0,77
9407,17.343250000001554,2718.4615384615386,67,25,1,92
9408,-23.95949999999952,2532.3888888888887,33,41,1,74
9409,13.402000000000768,3705.5789473684213,61,27,0,88
9410,32.598750000002006,4841.9,76,35,0,111
9411,11.440000000001024,3639.45,50,27,2,77
9412,-15.870499999999666,1943.1666666666667,41,33,3,74
9413,15.584250000001422,5110.0,63,31,0,94
9414,4.205000000001842,4054.842105263158,69,41,3,110
9415,1.0785000000011085,3828.9,46,32,0,78
9416,-16.762499999999704,1991.4375,25,28,3,53
9417,-26.835749999999564,1992.157894736842,16,33,0,49
9418,14.304750000000652,2579.4,48,23,0,71
9419,-3.1442499999983804,3134.0,44,28,0,72
9420,-28.378250000000104,2073.157894736842,18,26,15,44
9421,2.8462500000014863,3861.55,47,35,0,82
9422,11.590000000001133,4107.315789473684,52,42,0,94
9423,-1.6034999999993573,2420.125,39,34,0,73
9424,27.200750000001527,3415.9444444444443,60,29,0,89
9425,25.638250000002266,4818.75,72,26,1,98
9426,-0.13774999999901158,3045.6315789473683,39,26,0,65
9427,44.82150000000182,4954.45,83,21,0,104
9428,28.713750000001863,4495.894736842105,81,20,0,101
9429,-7.66174999999851,2321.9375,70,41,1,111
9430,-15.097499999998954,2562.684210526316,32,27,1,59
9431,-3.9314999999982314,4618.8,53,43,0,96
9432,-9.068749999999467,2583.0,28,29,1,57
9433,11.907500000001162,2398.235294117647,65,37,0,102
9434,13.28075000000164,2735.0555555555557,53,29,2,82
9435,31.63475000000193,4527.55,67,22,0,89
9436,-4.966749999999165,2980.1666666666665,46,31,2,77
9437,-10.021249999999561,2540.2,22,26,0,48
9438,-10.662749999999294,2591.8947368421054,28,36,1,64
9439,-15.688749999998965,2041.1875,36,34,2,70
9440,52.251750000001266,5640.85,79,32,0,111
9441,8.575000000001264,4262.45,56,30,0,86
9442,-12.27199999999857,3399.1052631578946,44,36,0,80
9443,39.233250000002144,5818.2,93,16,0,109
9444,17.235000000001225,3707.2631578947367,61,41,5,102
9445,9.878000000001549,4510.8,62,26,0,88
9446,-19.89049999999903,2063.8823529411766,22,34,1,56
9447,-8.250249999999477,2674.222222222222,26,35,0,61
9448,-8.448499999999303,2638.733333333333,29,27,1,56
9449,-9.954749999999176,2496.3529411764707,32,23,0,55
9450,14.677750000001515,3582.8947368421054,56,20,0,76
9451,-9.504249999999029,1970.5,26,27,0,53
9452,46.6552500000026,4135.941176470588,92,26,0,118
9453,-25.687999999999526,2048.1,13,32,0,45
9454,9.777500000000984,3651.4210526315787,55,29,1,84
9455,3.590750000000945,3087.85,35,26,0,61
9456,4.275250000002119,3356.3684210526317,62,20,0,82
9457,16.535000000002235,2149.3125,57,34,0,91
9458,11.624750000001626,4887.684210526316,57,38,0,95
9459,-0.5985000000000144,1988.4117647058824,32,32,3,64
9460,-14.461499999999486,2484.2631578947367,32,24,3,56
9461,4.7147500000009,3502.6315789473683,58,35,0,93
9462,23.410750000001627,4240.15,57,29,0,86
9463,47.6827500000024,5393.4,88,30,0,118
9464,22.377250000001332,5405.25,66,32,0,98
9465,19.778500000001223,4365.65,56,34,0,90
9466,-20.427249999999287,2536.2,25,30,0,55
9467,-26.244999999999568,2024.3,14,28,0,42
9468,-6.95174999999811,3565.55,50,25,0,75
9469,-6.387249999998808,3047.315789473684,37,32,0,69
9470,9.350750000001783,2365.6470588235293,45,31,2,76
9471,29.906750000000454,4062.315789473684,62,32,0,94
9472,46.18650000000166,6427.35,69,21,0,90
9473,25.57750000000156,4286.25,73,21,0,94
9474,29.06425000000167,4726.8,78,27,0,105
9475,-12.691249999998274,3791.0,49,27,0,76
9476,2.354250000000788,1880.5,46,30,1,76
9477,-8.962999999999022,3510.75,39,31,0,70
9478,-36.46974999999974,1980.4736842105262,15,36,5,51
9479,7.0622500000009065,2440.294117647059,37,34,0,71
9480,7.300500000001307,4824.3,54,29,0,83
9481,-4.580749999998972,2554.3888888888887,30,30,0,60
9482,-7.115999999999374,3525.1,34,34,0,68
9483,-14.928499999999369,2508.5,24,29,1,53
9484,4.815250000002112,4070.7368421052633,67,27,0,94
9485,28.30275000000129,4469.1578947368425,81,17,0,98
9486,11.373500000001789,1930.0,50,21,0,71
9487,7.099750000000915,3516.3333333333335,55,44,0,99
9488,-13.512499999998377,1824.8,49,30,0,79
9489,-5.196999999999369,3064.05,41,23,0,64
9490,43.85550000000269,5888.6,93,30,0,123
9491,-16.166499999999285,2501.7894736842104,26,36,1,62
9492,-30.408499999999453,1895.8823529411766,42,31,4,73
9493,51.12875000000238,6625.95,89,30,0,119
9494,2.1357500000003795,1429.0,46,27,6,73
9495,24.384250000001515,5082.25,64,33,0,97
9496,17.61175000000147,4691.1,65,27,0,92
9497,25.680000000001048,4645.0,59,26,0,85
9498,-0.563499999998864,2934.3888888888887,43,25,0,68
9499,-9.68699999999966,4218.0,45,42,0,87
9500,23.59475000000204,4502.95,68,28,0,96
9501,-7.411999999999429,2536.1052631578946,24,30,0,54
9502,13.001000000000946,3834.65,51,28,0,79
9503,16.3057500000019,4119.45,70,17,0,87
9504,11.241250000001134,2148.0588235294117,57,27,0,84
9505,-31.764499999999412,1986.3157894736842,13,27,4,40
9506,-24.325500000000208,1917.6666666666667,25,33,7,58
9507,-11.121249999999431,2324.470588235294,32,29,0,61
9508,13.36450000000099,4636.95,59,29,0,88
9509,-1.2844999999994335,2955.6111111111113,42,25,1,67
9510,9.463750000000937,2429.0666666666666,64,33,1,97
9511,27.821750000001508,3387.1176470588234,76,26,0,102
9512,-41.829499999998696,1429.0,12,35,6,47
9513,-30.899249999999842,2475.95,15,35,0,50
9514,25.478000000003075,5145.75,79,24,1,103
9515,-6.5162499999996655,2638.6,33,28,0,61
9516,18.44425000000166,2438.5333333333333,66,28,0,94
9517,-2.516999999999265,2998.842105263158,41,29,0,70
9518,-24.34099999999997,1941.6470588235295,30,36,0,66
9519,13.53625000000093,4247.45,64,9,0,73
9520,10.785000000000512,3040.3888888888887,54,23,0,77
9521,-12.716249999998983,2494.3333333333335,29,32,0,61
9522,26.372750000000877,3897.3333333333335,76,21,0,97
9523,1.0730000000012,4797.375,50,28,0,78
9524,28.21650000000127,3528.0588235294117,93,21,1,114
9525,14.549500000000407,2739.4615384615386,57,27,3,84
9526,-31.355499999999502,2053.9473684210525,16,25,2,41
9527,34.05800000000026,3403.8823529411766,86,26,0,112
9528,-21.534499999999603,2452.8888888888887,30,38,8,68
9529,8.033750000001028,4313.95,64,21,0,85
9530,-2.495499999998896,2676.470588235294,48,30,0,78
9531,9.179750000000793,3206.8333333333335,54,33,0,87
9532,23.09175000000118,4714.75,78,9,0,87
9533,12.28400000000158,3375.6470588235293,66,15,0,81
9534,30.167000000000833,3158.5,75,16,0,91
9535,-8.760249999999568,2756.5789473684213,47,30,3,77
9536,-4.39874999999841,3508.5,52,17,0,69
9537,-16.466749999999553,1931.4117647058824,30,20,1,50
9538,-16.291999999999497,1963.388888888889,36,27,3,63
9539,-14.969499999999428,2572.0666666666666,28,33,1,61
9540,-3.4874999999983602,4040.1,53,18,2,71
9541,-3.4979999999999634,1941.388888888889,45,30,1,75
9542,-8.535749999999496,3223.55,35,21,0,56
9543,-1.9707499999991065,2639.375,36,25,1,61
9544,1.8277500000011861,3055.7368421052633,46,25,0,71
9545,-15.555249999999043,1951.8125,28,29,1,57
9546,-10.336999999999305,2015.5,26,34,0,60
9547,-16.322249999998807,2565.5,28,29,1,57
9548,-19.868249999999666,2040.5263157894738,19,30,1,49
9549,-35.933749999999876,1955.4444444444443,16,29,1,45
9550,-2.997999999999118,2849.8333333333335,36,26,0,62
9551,-14.674749999999317,2571.8,38,18,0,56
9552,12.205500000001376,3714.15,49,28,0,77
9553,-5.313499999999819,1887.5294117647059,36,27,2,63
9554,-2.3232499999989984,3174.4,40,31,4,71
9555,16.453250000002047,4618.05,76,22,0,98
9556,1.056000000000844,2782.9411764705883,54,29,1,83
9557,2.8845000000006578,3063.8888888888887,55,27,2,82
9558,-4.562499999998813,2625.0,40,26,0,66
9559,5.365500000002077,3948.05,67,27,1,94
9560,-3.5572499999997853,2572.0,34,28,0,62
9561,-6.955499999999281,2612.1176470588234,30,27,0,57
9562,5.397750000001122,3696.6,61,16,0,77
9563,8.660750000000707,2605.470588235294,55,34,1,89
9564,-23.79574999999962,1429.0,28,32,4,60
9565,-1.6389999999994351,2515.9473684210525,31,31,4,62
9566,12.54325000000088,4429.8,60,25,0,85
9567,-8.090999999999699,2448.315789473684,23,33,6,56
9568,5.512500000000496,2495.8,55,26,0,81
9569,-15.534999999998979,2146.176470588235,33,30,2,63
9570,5.447500000001439,3561.1052631578946,53,35,0,88
9571,7.467000000000878,3091.8,50,20,0,70
9572,-22.971500000000496,1429.0,27,34,3,61
9573,-28.004749999997586,1942.5294117647059,31,29,17,60
9574,13.268250000001057,3591.8,59,18,0,77
9575,-16.482249999999148,2575.85,26,22,0,48
9576,-0.14549999999918475,3349.75,43,29,0,72
9577,-16.760249999999406,2039.0,17,30,4,47
9578,-3.9134999999993894,3025.5789473684213,41,27,3,68
9579,-3.3727499999993165,2631.0555555555557,31,26,1,57
9580,-9.98274999999946,2638.6,27,27,0,54
9581,-10.705999999999444,2715.0,32,29,2,61
9582,-9.702999999999063,2486.2,31,26,1,57
9583,-5.860249999999364,2508.4736842105262,28,24,2,52
9584,15.53350000000134,2778.3529411764707,61,26,1,87
9585,1.7922499999997843,2034.0,48,30,4,78
9586,5.240500000000533,3087.315789473684,46,20,0,66
9587,27.7055000000009,3286.1176470588234,77,32,0,109
9588,-3.803749999999268,2336.5882352941176,47,34,0,81
9589,-9.056249999998979,2484.5555555555557,45,32,0,77
9590,-8.477499999999363,2735.0555555555557,39,25,2,64
9591,-3.68699999999962,2241.5625,33,38,1,71
9592,14.778250000001208,2464.6875,60,27,0,87
9593,25.72375000000215,4921.05,69,26,0,95
9594,-3.351749999999415,1921.1176470588234,39,32,8,71
9595,0.36800000000112326,3456.8,36,35,0,71
9596,27.906000000001438,2781.3125,78,23,0,101
9597,-26.185999999999517,2018.0,17,26,2,43
9598,-11.462999999998967,2725.85,34,28,2,62
9599,-20.334999999999702,2072.75,15,27,0,42
9600,-13.379999999999024,2521.529411764706,34,24,0,58
9601,18.198500000000347,3000.5625,69,31,0,100
9602,11.025000000000697,2707.235294117647,49,27,1,76
9603,-4.7399999999989495,3080.0,44,26,0,70
9604,17.71225000000107,6107.65,71,29,0,100
9605,3.5575000000010784,3091.75,42,28,0,70
9606,10.935250000001721,2706.9375,50,25,0,75
9607,16.882750000000122,2527.375,63,29,0,92
9608,4.376250000000861,1887.5294117647059,77,23,5,100
9609,-15.995749999999063,2634.6666666666665,32,22,0,54
9610,-9.28824999999931,2668.7,30,27,0,57
9611,-5.844249999999386,2603.705882352941,29,26,4,55
9612,-24.13674999999973,2028.2,13,28,2,41
9613,-3.7212499999990527,2542.7368421052633,30,34,0,64
9614,-8.992749999999212,2725.4666666666667,33,27,2,60
9615,7.860000000001233,3221.15,45,26,0,71
9616,29.315000000002822,4246.555555555556,89,26,0,115
9617,-7.144749999999073,2644.0,24,30,2,54
9618,-1.9619999999989344,3777.45,48,23,6,71
9619,-15.249249999999606,2538.6315789473683,27,28,4,55
9620,-5.442749999998695,3091.75,34,32,0,66
9621,39.17850000000148,5721.95,83,26,1,109
9622,-26.325749999999452,1903.25,24,27,0,51
9623,-8.925500000000058,2028.7222222222222,35,28,2,63
9624,-5.477749999999537,2591.2631578947367,32,24,3,56
9625,11.611250000000695,4516.45,61,24,0,85
9626,-2.9212499999987904,2125.4375,49,32,2,81
9627,-1.8084999999993747,2540.2,29,27,0,56
9628,20.46700000000166,2391.0,77,26,0,103
9629,22.40950000000142,2479.8,61,22,0,83
9630,-8.181499999999323,2460.777777777778,31,28,0,59
9631,40.73625000000195,5163.15,73,29,0,102
9632,6.251250000000999,3302.15,48,24,0,72
9633,-21.384249999999394,2571.8823529411766,31,39,2,70
9634,29.786250000000525,4478.473684210527,75,22,0,97
9635,13.631500000001756,5044.95,71,27,1,98
9636,3.8217500000016793,3591.8,54,26,0,80
9637,6.0690000000006,3452.8888888888887,66,27,0,93
9638,-9.310249999998387,3117.777777777778,45,37,0,82
9639,14.00825000000123,4105.3,54,24,0,78
9640,16.26500000000103,4246.55,56,23,0,79
9641,43.14975000000221,5597.45,86,21,0,107
9642,21.138750000002776,4389.789473684211,76,24,1,100
9643,1.7837500000019808,2779.1111111111113,49,25,2,74
9644,1.9750000000018761,3336.5882352941176,71,32,0,103
9645,7.5637500000010665,3599.4210526315787,53,27,1,80
9646,1.376750000000845,2586.866666666667,47,25,0,72
9647,33.407750000001585,4723.65,68,23,0,91
9648,51.167000000001806,4775.25,87,15,0,102
9649,1.5792500000012681,3001.3888888888887,52,36,1,88
9650,-15.470749999999379,2916.3,28,37,1,65
9651,23.316750000001843,4702.9,78,20,1,98
9652,-5.0352499999990545,2987.1052631578946,45,29,0,74
9653,33.93275000000114,5523.55,72,26,0,98
9654,-33.86875000000016,1429.0,6,34,1,40
9655,-8.801249999999333,2579.8,28,28,0,56
9656,20.697750000001896,2866.6875,76,22,0,98
9657,10.78550000000138,2457.6666666666665,59,25,0,84
9658,26.600250000001115,3439.6666666666665,67,26,0,93
9659,-10.002999999999567,2610.3684210526317,26,27,0,53
9660,11.089000000001471,4045.6315789473683,64,20,0,84
9661,37.78900000000181,5536.2,86,30,0,116
9662,5.215500000001503,3489.2631578947367,49,28,1,77
9663,-3.2499999999995963,2635.4444444444443,35,37,0,72
9664,-5.47674999999972,1954.764705882353,40,36,0,76
9665,-6.736750000000188,1908.0588235294117,28,35,0,63
9666,31.74925000000144,4695.05,72,25,0,97
9667,17.644500000000622,5659.2,70,39,1,109
9668,-10.896749999998784,2934.277777777778,36,41,2,77
9669,14.181750000001324,4498.0,68,21,1,89
9670,-29.775999999999918,2307.6,14,32,0,46
9671,-41.00325000000006,1429.0,0,34,3,34
9672,24.25050000000139,2903.4117647058824,52,30,0,82
9673,26.330750000002176,4691.0,79,28,0,107
9674,-14.3069999999994,2009.764705882353,28,32,3,60
9675,-19.02349999999997,2027.2105263157894,16,31,16,47
9676,19.470000000001317,3408.5882352941176,67,17,0,84
9677,3.578250000001332,2934.3333333333335,52,24,0,76
9678,9.258500000000971,3919.3888888888887,55,33,0,88
9679,33.32575000000102,4405.444444444444,75,25,0,100
9680,19.467250000001417,4398.9,63,36,0,99
9681,26.957750000002335,3322.875,82,20,0,102
9682,-8.495999999999585,2552.6111111111113,34,33,3,67
9683,-15.285249999999413,2804.5,32,33,5,65
9684,-31.41274999999942,2142.55,17,27,0,44
9685,-23.720499999999582,2748.9333333333334,24,34,2,58
9686,-1.3067499999996754,2617.722222222222,46,27,1,73
9687,20.697250000001333,5214.85,67,27,0,94
9688,7.476500000001752,4723.9473684210525,69,42,1,111
9689,18.26100000000167,5674.35,64,29,0,93
9690,33.51375000000196,3814.277777777778,79,16,0,95
9691,-7.888749999999169,3035.5263157894738,39,32,1,71
9692,3.250000000001117,3116.1666666666665,45,39,3,84
9693,-1.0422499999990877,3470.1052631578946,45,32,0,77
9694,-0.19275000000015882,1990.7777777777778,36,34,0,70
9695,30.69575000000151,4465.8421052631575,72,33,1,105
9696,28.443750000000914,3559.8823529411766,56,31,0,87
9697,-16.75824999999805,3683.05,55,30,1,85
9698,-19.434749999998992,2333.8333333333335,33,34,0,67
9699,2.8480000000016683,4033.9,46,35,0,81
9700,-6.045749999999139,2646.3125,39,31,0,70
9701,-9.05499999999926,2583.85,30,30,1,60
9702,14.943000000000776,3476.7894736842104,47,27,1,74
9703,-11.668749999999699,2109.9473684210525,17,35,6,52
9704,13.712250000001657,4240.25,64,26,0,90
9705,25.257500000000526,4746.631578947368,69,27,0,96
9706,13.097500000001151,3044.3529411764707,60,18,3,78
9707,8.203250000001812,4364.95,65,30,0,95
9708,-7.592249999999064,3195.0,44,24,1,68
9709,-18.222999999999608,2008.4444444444443,28,40,1,68
9710,-7.3277499999991305,2438.6,42,24,0,66
9711,-27.41649999999994,2028.25,13,23,1,36
9712,18.32900000000139,4151.3,60,24,0,84
9713,0.9502500000008836,2410.2,44,34,0,78
9714,3.1270000000010425,3519.65,48,29,0,77
9715,8.524750000000658,4142.45,60,33,0,93
9716,-1.9917500000000927,1728.6875,49,29,5,78
9717,-5.960999999998725,3387.8,44,28,0,72
9718,36.29000000000205,2395.25,80,30,0,110
9719,0.06899999999980935,2633.0,38,30,5,68
9720,-0.9107499999983611,3717.95,50,30,1,80
9721,-4.0512499999987615,2597.4444444444443,41,33,0,74
9722,-3.042749999999656,2554.125,28,33,4,61
9723,-17.62724999999964,2725.3333333333335,24,24,1,48
9724,31.784500000002623,5097.4,80,21,0,101
9725,-16.112499999999194,1866.5,26,39,0,65
9726,23.425750000003315,4801.25,82,30,0,112
9727,-21.721999999999603,2008.4,12,30,0,42
9728,-23.36124999999983,1976.7222222222222,23,24,1,47
9729,29.745250000001242,5069.45,61,37,0,98
9730,-13.261749999999424,2459.8947368421054,30,30,11,60
9731,4.660000000001075,4061.5,52,23,2,75
9732,-1.1014999999991621,3027.8333333333335,35,38,0,73
9733,-5.140499999999319,2957.277777777778,39,35,0,74
9734,17.04875000000135,3251.705882352941,71,25,1,96
9735,-11.79224999999921,1888.4117647058824,26,30,4,56
9736,-6.956000000000058,2187.9375,52,31,0,83
9737,5.5097500000009685,2564.5333333333333,58,33,2,91
9738,-8.406499999999427,1874.4705882352941,37,32,3,69
9739,-19.764749999999637,1904.2941176470588,46,28,3,74
9740,11.478250000001264,4365.65,56,31,0,87
9741,0.43600000000074274,3052.2631578947367,45,32,7,77
9742,5.505000000000871,2438.6666666666665,65,39,1,104
9743,23.451250000001625,4310.75,74,15,1,89
9744,-10.854999999999121,2509.4375,37,38,2,75
9745,-13.812749999999095,1954.7058823529412,36,31,3,67
9746,10.857500000000787,3023.8947368421054,48,25,5,73
9747,-14.559749999999402,3446.5,34,36,0,70
9748,-6.127249999998546,3177.5789473684213,58,28,7,86
9749,-18.016249999999765,2647.9473684210525,29,30,3,59
9750,28.80025000000122,4064.1111111111113,79,26,0,105
9751,27.884500000001754,4746.5,69,31,0,100
9752,-4.6167499999988095,1871.5,41,43,0,84
9753,-29.572999999999826,1977.0526315789473,12,29,6,41
9754,-19.84749999999911,1993.5,27,31,0,58
9755,17.664500000001556,3802.5263157894738,52,32,0,84
9756,24.619250000001806,4095.75,74,19,0,93
9757,13.935500000001923,5213.15,65,28,0,93
9758,-11.276749999999387,2441.3888888888887,29,29,0,58
9759,5.201000000000915,3347.25,39,31,0,70
9760,-12.321499999999096,2118.4375,48,31,6,79
9761,20.129500000000796,2510.6666666666665,64,26,0,90
9762,4.13700000000173,4126.65,58,23,1,81
9763,-28.2014999999993,1986.2631578947369,15,31,4,46
9764,21.599500000002088,5306.85,75,27,1,102
9765,-16.129999999999374,2252.5882352941176,34,32,1,66
9766,27.70975000000242,4698.9,81,27,0,108
9767,-26.38249999999987,2534.8333333333335,29,30,10,59
9768,-2.8139999999997016,2341.4117647058824,45,27,2,72
9769,-16.033999999999317,2491.6315789473683,30,24,2,54
9770,24.384500000000912,4257.0526315789475,73,30,0,103
9771,-19.020749999999445,2556.15,24,31,0,55
9772,17.607500000000876,4133.05,57,40,1,97
9773,-7.330499999999631,2517.8823529411766,39,26,3,65
9774,12.841500000000945,4308.5,58,23,0,81
9775,-12.218999999999928,1960.7222222222222,20,41,0,61
9776,-24.468249999999497,2076.5263157894738,12,32,1,44
9777,-2.225749999999102,2476.6666666666665,40,35,0,75
9778,-25.462249999999557,2028.2,13,33,0,46
9779,1.423750000001014,3313.15,41,28,0,69
9780,14.410750000002437,5202.9,75,30,0,105
9781,26.160000000001407,4135.4,67,20,0,87
9782,25.306000000001596,5468.8,78,35,0,113
9783,19.26725000000102,4784.7,71,23,0,94
9784,6.18050000000016,1895.8823529411766,44,30,3,74
9785,-20.077249999999843,1429.0,26,34,5,60
9786,21.50950000000234,2467.133333333333,79,19,0,98
9787,28.281250000001478,5083.05,75,26,0,101
9788,-5.882499999999771,2252.529411764706,45,33,1,78
9789,-3.834499999999605,2603.722222222222,35,36,0,71
9790,-6.397749999999322,2524.3529411764707,29,29,1,58
9791,1.1157500000008413,2764.0,45,35,4,80
9792,-6.445499999999052,3141.684210526316,35,31,0,66
9793,-4.026749999999226,3238.6666666666665,50,39,1,89
9794,27.2280000000014,3634.5789473684213,55,30,1,85
9795,26.914500000003464,2246.0588235294117,68,30,1,98
9796,7.220000000000958,2572.0,56,25,0,81
9797,-21.62824999999969,2040.15,9,32,0,41
9798,-4.690499999999596,3017.3888888888887,35,28,1,63
9799,-5.390749999998255,1961.235294117647,64,35,0,99
9800,48.63275000000204,5271.25,83,24,0,107
9801,16.387250000001313,3753.176470588235,57,27,0,84
9802,-7.449499999999356,2575.85,31,24,0,55
9803,-12.52474999999934,2579.8,27,32,0,59
9804,10.64325000000096,2789.529411764706,67,29,1,96
9805,-9.418249999999315,2468.722222222222,25,32,0,57
9806,6.488500000001045,3652.157894736842,54,30,0,84
9807,-9.384249999998868,2590.470588235294,35,30,0,65
9808,13.109500000002601,2099.277777777778,57,34,1,91
9809,11.677000000001165,3743.45,57,20,0,77
9810,19.12300000000164,4777.55,65,26,2,91
9811,-20.15249999999892,2710.85,25,34,0,59
9812,5.470750000000682,3105.7368421052633,46,23,1,69
9813,7.420750000000529,3103.7,44,22,1,66
9814,26.732000000001136,2391.0,73,27,0,100
9815,-24.079249999999753,1957.2222222222222,22,21,11,43
9816,-26.067499999999846,1977.1052631578948,16,30,4,46
9817,-20.648999999998935,2719.55,30,24,3,54
9818,-9.327499999999034,2509.4375,34,23,2,57
9819,-5.366249999998369,1746.5625,44,29,1,73
9820,-1.1139999999988432,3167.2,47,23,0,70
9821,1.2242500000007304,3358.35,35,30,2,65
9822,0.3852500000003749,2543.4666666666667,51,39,1,90
9823,1.528500000000924,3020.0555555555557,41,28,0,69
9824,15.15725000000146,2679.25,48,22,0,70
9825,7.721500000001013,4119.6,56,18,0,74
9826,-4.301249999998898,2459.0,42,24,0,66
9827,-11.096749999998769,3926.0,49,37,3,86
9828,14.60400000000151,3684.0,55,26,0,81
9829,5.484500000000143,2047.1764705882354,48,29,2,77
9830,12.264250000001615,2849.75,61,21,0,82
9831,21.85525000000123,4776.631578947368,87,23,0,110
9832,3.0410000000004684,2548.9444444444443,50,36,1,86
9833,16.029750000000043,3016.3888888888887,66,30,0,96
9834,-10.254749999999195,2561.3888888888887,25,34,1,59
9835,14.324000000002162,4197.45,70,25,0,95
9836,-17.452999999999513,2028.25,19,27,2,46
9837,14.532750000001363,3732.15,70,16,0,86
9838,1.886500000000255,2541.3571428571427,48,31,1,79
9839,14.344500000002776,4889.5,88,25,0,113
9840,-12.642999999998768,2661.6470588235293,32,27,1,59
9841,7.661500000001522,2985.6111111111113,56,27,3,83
9842,-3.543249999999486,2836.6666666666665,31,26,0,57
9843,25.75925000000178,4830.7,80,21,0,101
9844,-0.5239999999986229,3874.35,56,24,0,80
9845,-18.893499999999197,1943.1666666666667,44,34,2,78
9846,13.311500000000924,5107.65,61,25,0,86
9847,39.374250000001055,4159.388888888889,76,35,0,111
9848,-22.95499999999971,2040.15,17,26,4,43
9849,-8.789249999999116,2053.823529411765,27,28,0,55
9850,19.598250000001606,2959.529411764706,60,23,0,83
9851,13.432000000000425,2527.3125,59,34,3,93
9852,-20.091999999999977,1984.578947368421,19,30,5,49
9853,-4.4462499999989955,3052.15,42,21,1,63
9854,16.024250000000443,2873.5,56,31,0,87
9855,-4.897749999999587,2554.3333333333335,33,22,0,55
9856,-22.88499999999948,2008.4,18,24,2,42
9857,33.254500000000924,3840.8888888888887,86,28,0,114
9858,-3.249499999998984,3113.3,42,26,0,68
9859,11.059000000001129,3526.1052631578946,67,23,1,90
9860,-12.746999999999344,2530.8823529411766,53,36,4,89
9861,18.70925000000284,4655.2,81,29,2,110
9862,5.4907500000014595,3889.4,59,18,1,77
9863,28.092000000002514,2720.6875,81,18,0,99
9864,-8.19974999999966,1912.764705882353,25,30,1,55
9865,27.305250000000704,4141.611111111111,75,22,0,97
9866,-0.5869999999989522,3123.5,47,20,0,67
9867,-6.50424999999979,3272.0,49,37,1,86
9868,6.805000000001073,4012.8333333333335,74,44,1,118
9869,-8.178999999999638,2493.315789473684,32,25,3,57
9870,18.102000000001638,4471.9,70,22,0,92
9871,27.74125000000085,4179.263157894737,79,21,1,100
9872,28.288000000001574,4822.05,90,11,0,101
9873,-19.754249999999693,1980.4736842105262,11,35,2,46
9874,17.04975000000127,4213.1,71,19,0,90
9875,-6.419499999998979,2511.375,34,29,0,63
9876,-38.3667499999997,1429.0,14,39,2,53
9877,27.758500000001483,3402.0,72,24,0,96
9878,-33.744749999999854,2847.25,23,36,2,59
9879,11.22675000000075,2364.705882352941,43,22,1,65
9880,2.1005000000012473,3060.0,50,18,0,68
9881,8.554750000000883,2944.1666666666665,58,26,0,84
9882,-16.02999999999953,2581.5333333333333,36,30,27,66
9883,-25.923999999999587,1986.3157894736842,16,27,2,43
9884,4.263999999999678,1429.0,53,29,4,82
9885,-7.880249999999506,2256.375,67,19,2,86
9886,37.74725000000129,6079.85,95,20,0,115
9887,32.60750000000096,2877.1176470588234,70,21,1,91
9888,-9.337999999999207,2356.8333333333335,34,34,1,68
9889,-14.232499999999249,3294.1,42,27,0,69
9890,-15.327749999999815,1937.9375,45,23,2,68
9891,31.25550000000115,4614.1,65,27,0,92
9892,27.025500000002324,3861.277777777778,82,12,1,94
9893,19.007250000001438,4160.0,72,21,1,93
9894,23.217750000001715,4191.0,73,15,0,88
9895,12.94600000000131,3912.0,59,26,0,85
9896,-23.77174999999949,2461.6315789473683,26,27,0,53
9897,-0.8222499999993034,3038.0,47,18,1,65
9898,-5.130249999998809,2552.5,41,24,0,65
9899,-4.9389999999993766,3798.315789473684,63,26,4,89
9900,-14.431499999999243,2425.5,41,31,4,72
9901,-12.132999999999665,2107.625,27,26,1,53
9902,20.789250000000916,3794.222222222222,74,15,0,89
9903,-8.532499999999528,1820.235294117647,51,22,6,73
9904,1.697000000000974,2960.8333333333335,49,35,1,84
9905,11.353000000001682,4330.65,72,13,0,85
9906,3.9080000000006807,1928.9375,69,31,1,100
9907,-9.839249999999387,1429.0,51,26,3,77
9908,7.054250000001105,3009.3888888888887,47,27,2,74
9909,28.675750000002285,5328.4,93,16,1,109
9910,21.068500000001574,3491.8333333333335,73,17,1,90
9911,4.928000000000965,2381.470588235294,50,21,3,71
9912,-19.1652499999998,2460.777777777778,32,46,2,78
9913,15.434750000001248,3815.8947368421054,65,22,0,87
9914,7.257000000000289,2664.294117647059,67,25,0,92
9915,-21.058499999999768,1429.0,19,34,1,53
9916,0.4460000000009856,3007.315789473684,50,17,1,67
9917,-11.936249999999017,2702.2,37,24,0,61
9918,-23.280749999999585,1998.7222222222222,26,28,10,54
9919,-12.879749999999223,2606.8,28,25,1,53
9920,5.554250000000774,3364.8,50,22,2,72
9921,2.029250000001598,2215.75,47,22,0,69
9922,6.9095000000004845,3125.7368421052633,49,15,1,64
9923,30.177250000001465,4293.222222222223,83,24,2,107
9924,26.875750000002473,2768.3125,66,34,0,100
9925,-14.763249999998564,4164.85,48,31,3,79
9926,26.89900000000166,4237.85,74,16,0,90
9927,18.56725000000108,2337.75,55,24,1,79
9928,-9.649499999999223,1987.5625,33,24,2,57
9929,35.03025000000133,3328.176470588235,66,26,0,92
9930,28.618750000000727,5373.45,82,22,0,104
9931,-5.630499999998878,4417.3,69,23,1,92
9932,-10.74224999999944,1918.125,42,26,4,68
9933,-14.224999999999152,2038.388888888889,33,33,3,66
9934,23.852250000000403,2357.625,72,19,1,91
9935,-5.2437499999992045,3896.45,51,23,1,74
9936,24.961500000002054,4867.95,84,18,5,102
9937,28.93550000000193,3702.315789473684,71,21,2,92
9938,1.320750000000834,2415.0,43,26,1,69
9939,15.931250000001224,3611.7,62,16,0,78
9940,3.418500000001292,2486.2,50,26,3,76
9941,-2.7672500000000055,1946.8125,45,29,3,74
9942,13.460250000001432,2786.6470588235293,53,23,2,76
9943,-23.623999999999263,3320.45,42,31,2,73
9944,-14.651499999998723,3187.05,41,23,1,64
9945,-2.7834999999992496,2449.3333333333335,66,20,5,86
9946,4.704000000000823,2798.5555555555557,53,23,2,76
9947,7.480750000001208,3627.6,63,14,1,77
9948,-19.650749999999128,1971.5294117647059,36,22,3,58
9949,-11.768249999999496,2643.3333333333335,30,35,0,65
9950,-5.999999999998825,3107.55,48,23,1,71
9951,-8.503749999999396,2040.5294117647059,31,17,8,48
9952,-17.422999999999327,3248.15,41,25,1,66
9953,22.200000000000877,5040.2,72,23,1,95
9954,16.975500000001468,2449.875,65,21,4,86
9955,-14.653250000000133,2588.764705882353,47,36,1,83
9956,-24.350749999999813,2028.25,13,27,2,40
9957,29.50950000000035,3227.4117647058824,78,10,0,88
9958,-10.84924999999961,2765.55,21,36,1,57
9959,-23.065749999999465,2064.0,27,36,11,63
9960,-0.5792499999988802,3771.85,45,20,2,65
9961,-20.11674999999927,2879.95,27,25,2,52
9962,11.181750000001466,2518.1875,57,24,2,81
9963,-24.852999999999817,1959.5263157894738,16,25,5,41
9964,21.31600000000103,2144.375,51,21,5,72
9965,-1.3014999999991004,3286.153846153846,60,14,0,74
9966,-8.863249999999184,1857.625,41,30,2,71
9967,-8.14024999999954,2787.05,30,33,0,63
9968,2.9515000000009826,2973.5625,51,23,1,74
9969,-19.438999999998806,2112.625,45,39,4,84
9970,7.667750000001538,3740.95,57,18,0,75
9971,-2.256000000000157,1429.0,57,34,5,91
9972,48.910250000002236,3115.6875,108,10,1,118
9973,-12.270249999999248,2609.0,30,29,1,59
9974,15.51950000000086,2763.529411764706,64,28,3,92
9975,16.360250000000416,2605.9285714285716,62,24,0,86
9976,-4.242249999999095,2460.8333333333335,36,23,1,59
9977,9.803000000001951,2677.722222222222,56,26,2,82
9978,7.144750000000856,1943.2666666666667,63,18,7,81
9979,12.46800000000171,4640.15,73,26,0,99
9980,30.25875000000196,4763.15,74,14,1,88
9981,-4.167749999998745,3836.95,56,21,5,77
9982,-4.134999999999414,3306.15,47,24,1,71
9983,-21.3817499999998,2032.3,14,34,1,48
9984,-12.890249999999464,2485.842105263158,29,27,4,56
9985,7.768000000000901,3125.7894736842104,46,28,1,74
9986,13.308750000001172,3588.0,56,21,0,77
9987,0.5107500000016072,3826.75,60,23,0,83
9988,37.86050000000176,3453.875,87,17,0,104
9989,22.696750000001696,4931.4,84,32,0,116
9990,17.973000000001683,2420.5882352941176,72,20,1,92
9991,-8.898499999998918,2562.4666666666667,36,27,0,63
9992,-8.01324999999924,2554.125,32,21,3,53
9993,-18.647999999999875,1998.8333333333333,17,30,3,47
9994,-16.04550000000009,1429.0,15,32,2,47
9995,-0.5672499999971354,2043.5294117647059,61,19,5,80
9996,18.019000000001693,4597.3,72,18,0,90
9997,-30.516999999999495,2008.4,11,30,0,41
9998,-11.16949999999926,2536.25,34,26,2,60
9999,-16.835249999999554,1871.5,28,31,9,59
10000,-10.774499999998621,2922.0,45,22,3,67
10001,5.196500000001324,3395.470588235294,66,28,0,94
10002,12.966000000002193,2473.823529411765,71,19,5,90
10003,3.1932500000008748,2961.777777777778,42,27,1,69
10004,-11.653249999999233,2563.95,34,22,2,56
10005,-7.388749999999076,3126.8,49,17,0,66
10006,12.066250000001638,2389.4375,66,18,2,84
10007,10.380250000001599,4521.736842105263,59,24,0,83
10008,-13.808749999999325,2314.3888888888887,28,26,0,54
10009,11.54775000000118,3328.3529411764707,73,27,0,100
10010,-3.0099999999993505,2471.684210526316,36,23,0,59
10011,34.33375000000178,5556.0,87,18,0,105
10012,-21.778749999999757,2044.1,15,28,4,43
10013,10.021000000000996,3137.1,50,17,0,67
10014,13.629750000001357,3607.75,65,17,0,82
10015,-12.4087499999993,2513.176470588235,32,29,2,61
10016,7.339250000001179,3377.9444444444443,59,30,1,89
10017,8.663250000001423,3651.35,59,16,1,75
10018,4.850750000002299,2550.4117647058824,61,21,2,82
10019,-19.98624999999958,1963.0,29,22,12,51
10020,10.735500000001245,3033.3333333333335,55,16,1,71
10021,5.944500000001256,2529.0,43,22,0,65
10022,-22.897999999999424,2059.7894736842104,16,26,5,42
10023,8.456750000001904,4347.3,72,24,0,96
10024,-3.0562499999992037,2548.0,33,24,2,57
10025,11.999000000000605,1943.3333333333333,55,22,0,77
10026,-5.935249999999063,3267.3,40,25,1,65
10027,9.19825000000098,4058.5,57,17,6,74
10028,13.145000000002444,3341.0,73,30,1,103
10029,21.74125000000076,4774.3,65,23,0,88
10030,-9.600749999999213,2564.2631578947367,31,29,0,60
10031,-21.24849999999968,2008.5,12,31,3,43
10032,19.63225000000177,4159.3,73,18,0,91
10033,12.234250000002296,1951.0588235294117,53,24,3,77
10034,-11.911749999999326,1983.6470588235295,30,30,1,60
10035,-0.5934999999992772,3083.9,39,23,1,62
10036,-13.461249999999362,2541.3571428571427,37,37,1,74
10037,0.7630000000011853,3667.2,50,21,1,71
10038,17.731750000000652,2342.785714285714,51,26,1,77
10039,29.158000000002442,5972.8,93,18,1,111
10040,0.21300000000084163,2718.3529411764707,46,16,1,62
10041,-8.031499999998985,2610.3529411764707,34,28,0,62
10042,13.546250000001768,3744.25,68,11,0,79
10043,22.159250000002476,4262.5,89,15,0,104
10044,-4.8329999999991635,3066.6666666666665,49,27,1,76
10045,-1.3994999999987678,3397.315789473684,51,29,0,80
10046,2.7455000000006713,3165.55,44,18,0,62
10047,25.865250000001463,2598.625,107,23,0,130
10048,41.777250000003804,4057.8888888888887,98,14,4,112
10049,25.704000000001734,4488.55,67,24,0,91
10050,0.518250000001227,3485.9473684210525,54,25,3,79
10051,1.0012500000006486,3729.7894736842104,51,27,0,78
10052,3.781000000000448,2048.9411764705883,46,26,0,72
10053,17.578250000001532,3649.0,56,23,0,79
10054,3.3317500000009885,4525.15,57,29,0,86
10055,-12.7747499999994,2579.8,29,33,0,62
10056,5.442750000000414,2978.7894736842104,45,29,1,74
10057,17.97225000000163,4864.8,70,26,0,96
10058,4.531000000000475,2518.0,70,32,1,102
10059,-1.0377499999988926,3151.3,49,22,0,71
10060,-39.43449999999952,2055.95,14,20,12,34
10061,-1.4944999999987423,3269.5263157894738,40,29,0,69
10062,16.38525000000113,3804.2105263157896,56,25,0,81
10063,33.30625000000157,4706.75,76,17,0,93
10064,1.99750000000074,3845.05,47,22,0,69
10065,15.633750000001157,4115.6,65,15,0,80
10066,-10.700499999999689,2100.1666666666665,27,27,1,54
10067,-19.305499999999213,3028.3,34,20,2,54
10068,1.4090000000015297,2497.5,47,22,0,69
10069,-23.8042499999996,2011.0,27,30,5,57
10070,10.445750000001834,1867.0666666666666,70,32,3,102
10071,-27.22674999999967,1978.7894736842106,13,31,2,44
10072,20.083750000001388,3631.9444444444443,79,32,0,111
10073,13.754500000001105,2339.875,67,26,0,93
10074,13.158500000001515,4151.4,63,20,0,83
10075,21.18775000000168,2741.5625,79,33,0,112
10076,0.8262500000004731,3328.5555555555557,32,27,0,59
10077,20.50499999999988,1866.5,68,27,0,95
10078,-16.95549999999889,3048.0526315789475,41,25,4,66
10079,-16.81149999999932,2529.2631578947367,28,27,1,55
10080,-7.446499999999777,2613.266666666667,36,31,3,67
10081,-25.75399999999943,2079.85,13,30,1,43
10082,-7.81524999999885,2366.470588235294,49,21,1,70
10083,-1.1467499999991255,3200.5,44,25,1,69
10084,-11.310999999999321,2642.9473684210525,34,37,1,71
10085,11.014750000001575,3744.25,66,18,0,84
10086,13.157250000001355,4348.1,63,25,0,88
10087,3.368750000000835,3095.9,47,25,0,72
10088,16.372250000001678,3484.2631578947367,57,27,0,84
10089,-13.388249999999497,1809.0625,28,30,0,58
10090,12.188750000001647,4931.45,71,26,0,97
10091,-14.940999999999471,1973.0555555555557,18,34,5,52
10092,-5.924499999999258,2446.9375,33,30,0,63
10093,41.59675000000164,5905.3,92,19,0,111
10094,19.24950000000205,4218.75,69,21,3,90
10095,-3.117249999999554,2561.3333333333335,35,30,1,65
10096,30.027750000002197,4664.411764705882,76,21,0,97
10097,-7.891999999999311,2533.866666666667,25,28,1,53
10098,-15.724749999999736,3015.55,26,35,2,61
10099,1.3482500000007758,3042.315789473684,51,20,0,71
10100,-17.95949999999877,2453.875,44,27,2,71
10101,-4.3649999999992195,3495.15,47,25,0,72
10102,8.694250000001233,3972.7,51,26,0,77
10103,-16.42224999999911,3348.95,47,18,1,65
10104,9.462250000001456,3708.55,56,22,0,78
10105,28.05125000000117,4246.6,65,19,0,84
10106,1.9712500000012618,3075.8,45,19,0,64
10107,-2.902999999999596,2461.823529411765,42,30,13,72
10108,-11.207999999999545,1911.1875,32,29,0,61
10109,36.12050000000092,2821.875,72,39,0,111
10110,28.979000000001342,5791.05,83,23,1,106
10111,-4.678749999999768,3734.65,44,27,2,71
10112,21.259500000000916,3988.222222222222,60,28,0,88
10113,21.789500000003457,2778.375,78,26,0,104
10114,0.7124999999999699,1989.111111111111,39,26,1,65
10115,6.149500000001084,2472.8125,48,33,1,81
10116,12.609000000000993,3794.1,50,28,0,78
10117,11.626000000000403,2786.25,68,36,0,104
10118,-14.48074999999904,2579.8,34,26,1,60
10119,2.6035000000009174,3418.2631578947367,50,30,3,80
10120,31.571250000001378,4789.55,76,26,0,102
10121,25.298250000001065,4627.45,55,33,0,88
10122,20.068500000001674,2415.125,62,34,0,96
10123,-33.15224999999942,1979.5263157894738,13,31,3,44
10124,9.24450000000185,2649.0,63,30,0,93
10125,17.915750000001406,2795.0,65,27,0,92
10126,-23.38649999999934,2024.25,15,25,3,40
10127,-6.618999999999143,2464.8947368421054,27,30,2,57
10128,-4.925749999998778,3130.65,42,31,0,73
10129,1.1047500000007404,2460.722222222222,49,31,1,80
10130,21.351500000001042,3126.470588235294,62,27,1,89
10131,35.811000000001535,3966.9444444444443,83,24,1,107
10132,27.881000000000444,3897.3888888888887,76,31,0,107
10133,20.66225000000116,4191.05,65,29,0,94
10134,3.240500000001282,3882.7368421052633,58,22,3,80
10135,-3.580249999998606,4032.25,59,24,0,83
10136,17.53975000000144,4959.35,72,26,1,98
10137,-5.6937499999991,2552.866666666667,35,35,0,70
10138,26.203250000000928,2821.8125,66,20,2,86
10139,11.598250000001057,4393.3,71,15,1,86
10140,-10.732749999998731,2556.0,34,23,1,57
10141,-8.328999999999594,2484.5555555555557,34,32,0,66
10142,4.239500000000741,2977.842105263158,35,33,0,68
10143,14.977750000000905,2552.9333333333334,61,30,0,91
10144,-9.52649999999936,2882.15,32,30,0,62
10145,-0.9459999999989414,3418.1052631578946,43,23,3,66
10146,8.8677500000022,3567.95,70,13,0,83
10147,22.93475000000189,4746.55,86,18,0,104
10148,21.64025000000192,4341.1,74,14,0,88
10149,-2.3519999999988843,2419.6,45,29,0,74
10150,1.4732500000001107,3117.5263157894738,59,25,4,84
10151,-13.621999999999153,2607.0,35,24,0,59
10152,8.136250000001626,2015.4705882352941,64,35,2,99
10153,1.7500000000010374,3067.9,46,24,1,70
10154,20.27200000000201,4782.25,67,21,1,88
10155,11.394500000001496,4551.95,66,29,0,95
10156,4.750250000001459,3851.25,62,20,0,82
10157,19.31925000000008,2311.4117647058824,61,30,0,91
10158,-10.572249999999531,2591.85,31,25,1,56
10159,38.60200000000147,4706.8,82,19,1,101
10160,1.2677500000005006,2259.375,57,15,0,72
10161,7.373250000000465,3543.3,41,25,0,66
10162,6.050750000001439,3593.0,62,31,0,93
10163,8.756250000001643,3010.133333333333,52,36,0,88
10164,10.831750000001003,3151.5789473684213,49,27,0,76
10165,41.56700000000196,5254.4,95,11,1,106
10166,-22.2367499999998,1997.0,29,29,10,58
10167,8.700500000000547,4345.75,48,29,0,77
10168,-18.369999999999152,2196.5882352941176,27,33,0,60
10169,14.161250000000631,3210.95,45,23,0,68
10170,1.585250000000878,2888.529411764706,50,18,0,68
10171,6.906500000001161,2857.6111111111113,45,24,1,69
10172,22.34100000000142,4530.263157894737,71,21,0,92
10173,-16.184249999999917,2018.9444444444443,31,28,2,59
10174,-16.646750000000004,2489.157894736842,24,25,3,49
10175,-12.603749999999094,1898.25,38,28,1,66
10176,16.501000000001476,3833.85,65,23,0,88
10177,-1.945249999999024,3183.1111111111113,44,32,0,76
10178,-26.502749999999526,2008.55,15,32,1,47
10179,16.54050000000096,2959.1666666666665,63,26,1,89
10180,-8.34999999999931,2548.25,33,24,2,57
10181,-9.625999999999065,3503.315789473684,49,23,3,72
10182,35.509750000000786,3719.0,75,22,2,97
10183,-6.3337499999994975,2518.375,37,32,3,69
10184,-8.915749999999788,2429.0,40,43,0,83
10185,0.3575000000011358,3517.7894736842104,58,20,0,78
10186,-15.080499999999095,3244.9,38,28,0,66
10187,-9.533249999998997,1978.625,32,27,0,59
10188,13.352000000002416,4024.4,69,22,0,91
10189,5.965000000001795,2469.75,56,31,0,87
10190,-6.6089999999990825,3487.5789473684213,51,29,1,80
10191,10.034750000001369,3674.35,56,22,0,78
10192,18.831750000001072,4355.25,67,29,0,96
10193,21.456500000002055,4210.85,73,20,0,93
10194,27.51300000000125,4167.1,62,22,0,84
10195,1.540750000000799,2487.8823529411766,50,32,0,82
10196,-9.537749999999269,2529.9411764705883,31,27,1,58
10197,-35.038750000000086,1429.0,3,33,4,36
10198,20.7772500000009,3807.7,52,23,0,75
10199,0.1092500000011567,3055.7368421052633,43,27,0,70
10200,1.148000000000344,2958.277777777778,41,29,1,70
10201,28.24700000000084,2686.0,94,20,2,114
10202,-16.48449999999915,2725.15,27,33,0,60
10203,6.383000000000889,2937.0526315789475,52,18,3,70
10204,39.4520000000013,5325.85,74,30,0,104
10205,4.682250000001248,2490.5625,46,31,1,77
10206,16.131750000001272,3611.65,59,21,0,80
10207,-6.316249999999294,2490.777777777778,30,28,1,58
10208,26.65850000000135,3154.705882352941,65,23,0,88
10209,19.579500000001698,4652.15,67,27,0,94
10210,19.43875000000175,4815.65,79,16,0,95
10211,-19.642999999998835,2534.315789473684,34,21,2,55
10212,23.48300000000163,3916.8947368421054,69,25,1,94
10213,3.2580000000008544,3773.55,51,29,0,80
10214,-1.0522499999993176,2411.125,42,31,1,73
10215,-5.997249999999087,2438.0,46,33,0,79
10216,32.106250000002824,4466.684210526316,81,20,0,101
10217,2.3210000000011197,1429.0,64,44,2,108
10218,-27.236250000000013,1848.6875,20,29,1,49
10219,-8.746499999997674,1934.235294117647,51,23,0,74
10220,13.148000000000696,3044.722222222222,48,19,1,67
10221,29.120000000001323,3219.0588235294117,74,33,0,107
10222,48.916750000001926,4154.055555555556,106,15,1,121
10223,-24.190499999999368,2460.8333333333335,24,37,1,61
10224,11.738250000000926,2799.3888888888887,54,32,1,86
10225,2.944000000000225,3006.315789473684,42,31,0,73
10226,35.73275000000121,4040.222222222222,80,31,0,111
10227,1.4770000000011911,3075.95,47,26,0,73
10228,10.906250000001588,3595.75,56,21,2,77
10229,6.237000000001136,4010.05,57,32,0,89
10230,-11.857249999999585,3547.25,30,36,1,66
10231,-19.404999999999283,1994.8823529411766,32,34,0,66
10232,-8.53199999999897,2559.9,26,36,0,62
10233,23.102250000000918,4633.95,71,20,0,91
10234,-14.760249999999152,2638.1666666666665,25,30,0,55
10235,-19.714249999999353,2498.4736842105262,28,36,4,64
10236,19.966250000001324,4104.1578947368425,67,27,3,94
10237,-30.841499999999893,2176.65,13,31,0,44
10238,-2.1577499999986403,2996.2631578947367,40,33,0,73
10239,-20.832999999999604,1999.7368421052631,16,32,0,48
10240,25.247500000001704,3470.6666666666665,62,31,0,93
10241,-14.135749999999627,1786.1875,32,43,1,75
10242,17.353250000001836,4327.105263157895,64,27,0,91
10243,25.56500000000111,4195.0,58,37,0,95
10244,-4.17024999999891,3300.45,49,26,0,75
10245,10.87600000000224,3489.2105263157896,64,15,0,79
10246,1.9600000000008422,3141.684210526316,50,22,2,72
10247,20.375500000001573,4282.35,60,29,0,89
10248,0.7292500000002545,2045.1875,47,25,0,72
10249,-21.037999999999364,1501.0,28,27,0,55
10250,10.60775000000175,3667.1666666666665,54,43,0,97
10251,-8.722749999999536,2653.6428571428573,33,32,0,65
10252,-10.037249999999544,2493.4210526315787,27,26,3,53
10253,18.89600000000178,5257.55,66,30,0,96
10254,-9.495749999999052,2551.95,27,27,0,54
10255,12.837500000001054,2664.3529411764707,49,31,2,80
10256,-16.719999999999352,3213.95,40,25,4,65
10257,21.409250000002434,4494.263157894737,67,30,0,97
10258,20.691500000001742,4183.166666666667,75,12,0,87
10259,5.722250000000554,3252.8,43,22,0,65
10260,-27.66624999999964,2028.25,16,23,1,39
10261,23.831500000002407,6077.6,101,28,0,129
10262,7.891500000000624,1875.4117647058824,37,25,1,62
10263,-9.547999999999428,2445.0,33,28,0,61
10264,16.945750000001443,3728.1111111111113,52,26,0,78
10265,40.87575000000227,4532.789473684211,80,26,0,106
10266,53.74425000000205,5195.0,86,22,0,108
10267,13.043000000002445,4679.2,77,25,0,102
10268,7.98100000000183,4424.45,67,24,0,91
10269,21.079750000000544,4079.9444444444443,65,29,0,94
10270,10.055500000000695,2465.529411764706,48,28,1,76
10271,17.613000000001144,4683.944444444444,81,30,0,111
10272,6.682000000001051,3947.45,58,24,0,82
10273,-7.132749999999374,2418.764705882353,38,20,1,58
10274,5.207750000001119,3256.1,50,23,0,73
10275,-4.752249999998944,3623.55,48,29,0,77
10276,15.308000000001883,4599.75,67,21,0,88
10277,-11.74624999999924,2500.0,28,28,1,56
10278,-2.2427499999994156,2585.315789473684,28,27,0,55
10279,-19.666499999999438,2534.529411764706,37,27,4,64
10280,-1.7574999999999268,2000.5,47,37,0,84
10281,-33.95574999999975,1905.2222222222222,16,35,2,51
10282,-26.972749999999387,2024.35,18,27,1,45
10283,3.7210000000006502,2682.0,39,28,0,67
10284,-7.947999999999306,1924.2,46,39,0,85
10285,10.465500000000839,3021.0588235294117,53,22,0,75
10286,11.17825000000057,2517.823529411765,51,33,1,84
10287,3.6832500000007196,2625.5625,42,34,0,76
10288,15.85125000000249,2769.8823529411766,60,27,0,87
10289,-3.3672499999991743,2485.8947368421054,33,26,0,59
10290,15.305000000002355,3837.5263157894738,58,26,0,84
10291,-35.12024999999941,1913.111111111111,20,31,3,51
10292,17.125500000001374,3744.95,59,17,0,76
10293,1.4205000000009187,2374.8823529411766,62,27,1,89
10294,1.069750000000378,2005.1176470588234,52,26,1,78
10295,20.00925000000022,2975.3529411764707,66,20,0,86
10296,8.961250000001176,2371.866666666667,66,26,0,92
10297,24.90675000000148,2514.375,57,26,0,83
10298,-1.433999999999322,2330.8125,42,26,0,68
10299,16.474750000000835,3852.95,54,21,0,75
10300,-20.655499999999442,2675.1111111111113,29,44,0,73
10301,0.7855000000018575,4631.5,78,18,0,96
10302,-39.28925000000008,1429.0,0,30,0,30
10303,15.660750000001713,3507.6111111111113,67,20,0,87
10304,6.476250000000306,3660.222222222222,59,34,0,93
10305,21.380500000002684,5336.3,86,22,0,108
10306,-6.4277499999995715,2496.294117647059,26,32,4,58
10307,1.70525000000099,3248.0666666666666,43,22,0,65
10308,18.209500000002006,4151.25,75,16,0,91
10309,5.068750000000973,2007.0,45,32,0,77
10310,-11.643499999999644,2713.8125,39,26,3,65
10311,46.38950000000191,5282.2,88,27,0,115
10312,-2.9624999999990402,3883.1,50,30,0,80
10313,29.808250000001795,2747.5625,65,29,0,94
10314,22.77650000000164,4667.05,67,26,0,93
10315,0.7972500000014164,4633.0,68,35,0,103
10316,-11.442750000000448,1429.0,28,31,1,59
10317,22.81000000000099,4155.3,59,25,0,84
10318,5.6622500000005,2608.294117647059,41,31,4,72
10319,41.69975000000208,5111.65,92,20,0,112
10320,26.423750000001416,4941.210526315789,78,32,0,110
10321,36.33200000000214,4623.5,81,16,0,97
10322,16.533750000000676,3667.1,53,22,0,75
10323,13.429250000001261,3658.1052631578946,52,30,0,82
10324,28.034000000002273,5424.3,73,25,1,98
10325,15.495750000001994,4611.65,66,25,0,91
10326,28.86275000000116,3538.6315789473683,63,22,1,85
10327,30.93500000000235,4807.75,82,23,0,105
10328,10.393250000002059,3228.75,69,23,0,92
10329,7.718000000000875,2756.8823529411766,58,26,0,84
10330,10.394500000000676,2448.133333333333,49,20,0,69
10331,-15.22849999999921,2595.2631578947367,30,30,0,60
10332,16.398250000001344,3849.777777777778,79,33,0,112
10333,-14.109749999999142,2415.1176470588234,39,30,1,69
10334,5.237000000001393,3164.315789473684,49,32,1,81
10335,34.76450000000136,3650.5789473684213,74,24,1,98
10336,2.4142500000008456,2400.4666666666667,59,37,0,96
10337,27.799250000001543,3951.2105263157896,70,14,0,84
10338,3.636500000000536,2345.0,49,33,0,82
10339,-13.665999999999778,2082.764705882353,26,30,1,56
10340,-6.750499999999495,2554.0,33,29,0,62
10341,22.644500000001237,3881.5,74,17,0,91
10342,30.490500000000953,2723.6875,73,33,0,106
10343,14.920000000000806,2943.222222222222,49,18,1,67
10344,-2.2477499999985797,3132.25,50,20,1,70
10345,-12.730749999999492,2725.85,26,31,0,57
10346,21.395250000001642,3351.6470588235293,94,15,0,109
10347,-4.733499999999452,2595.4210526315787,31,27,4,58
10348,-13.264499999999526,2561.8571428571427,46,24,1,70
10349,2.9570000000009533,3048.25,45,17,0,62
10350,2.9600000000012185,3699.85,50,25,0,75
10351,-0.27649999999875485,2318.9375,49,27,0,76
10352,19.310500000001397,3076.1176470588234,71,23,0,94
10353,31.281250000001393,4095.8333333333335,83,17,0,100
10354,2.060500000001092,3106.0,45,24,1,69
10355,3.329000000000742,3045.5789473684213,40,26,0,66
10356,-34.69624999999971,1988.842105263158,15,40,0,55
10357,2.2957500000016102,3697.3,51,23,0,74
10358,-24.974499999999715,2008.4,14,27,2,41
10359,15.643250000000322,2021.3125,67,18,0,85
10360,28.517500000001764,3203.176470588235,78,7,0,85
10361,5.633500000000599,3102.4736842105262,43,24,0,67
10362,11.084000000001234,3678.8947368421054,57,30,1,87
10363,2.234250000000017,2737.777777777778,44,29,0,73
10364,-20.059499999999602,2486.7368421052633,24,36,2,60
10365,8.735500000001265,3717.15,56,32,0,88
10366,-35.70374999999906,2612.842105263158,24,32,3,56
10367,50.94675000000107,5266.4,80,17,0,97
10368,23.825750000001758,4598.684210526316,69,31,0,100
10369,26.28400000000222,4379.8,78,19,0,97
10370,-5.032249999999161,2508.4736842105262,31,29,0,60
10371,12.231000000001485,4248.15,61,24,0,85
10372,-12.587749999999001,2506.722222222222,35,31,0,66
10373,-24.56649999999953,2085.35,16,24,4,40
10374,-12.23299999999905,2153.1111111111113,26,36,0,62
10375,4.050500000000774,3745.842105263158,56,30,0,86
10376,-29.230749999999368,2106.85,15,29,1,44
10377,-5.432499999999063,2610.625,43,23,2,66
10378,-0.7222499999986788,3210.05,48,22,0,70
10379,-13.34674999999918,2608.235294117647,29,25,0,54
10380,25.44625000000199,4726.6,72,22,0,94
10381,10.001250000002033,4191.1,64,24,0,88
10382,-3.023999999997897,1978.625,60,32,1,92
10383,6.556000000000933,2849.176470588235,52,19,0,71
10384,-11.470999999999245,2001.4444444444443,30,28,2,58
10385,23.90325000000097,2081.9333333333334,72,26,0,98
10386,-18.072999999998892,2506.722222222222,26,37,0,63
10387,-1.889999999999315,2971.3684210526317,41,21,2,62
10388,15.215000000000012,3362.2105263157896,69,27,0,96
10389,10.517000000000703,3937.9,42,37,0,79
10390,24.700750000001534,4336.368421052632,73,19,0,92
10391,-1.6654999999990263,3461.7368421052633,59,25,1,84
10392,20.021000000001514,4600.55,66,25,0,91
10393,21.24525000000162,4656.1,72,24,0,96
10394,10.750250000001202,5344.25,75,28,0,103
10395,5.014250000000511,3087.9444444444443,49,29,0,78
10396,-29.260749999999632,1926.5882352941176,24,25,2,49
10397,15.590500000001267,4439.35,67,21,0,88
10398,23.27925000000112,4278.35,59,22,0,81
10399,-8.325249999998118,3055.684210526316,48,20,7,68
10400,13.657999999999731,2311.4117647058824,57,28,0,85
10401,0.3030000000005744,3225.95,41,21,0,62
10402,43.11075000000211,5329.95,90,19,0,109
10403,-22.52024999999984,2008.45,12,24,4,36
10404,36.37800000000231,5230.6,80,21,0,101
10405,14.613000000000994,4675.2,71,24,0,95
10406,-10.499249999999652,2561.0526315789475,56,24,1,80
10407,28.205000000001906,5876.65,89,22,0,111
10408,36.5255000000012,5327.55,90,22,0,112
10409,-4.735749999998591,4129.05,58,35,0,93
10410,-4.343749999999278,3071.95,41,19,1,60
10411,-1.894249999998879,2005.375,56,31,0,87
10412,-0.3307499999985766,2678.6666666666665,37,36,3,73
10413,2.2887500000009426,3008.5,51,36,0,87
10414,10.646750000000951,3302.1176470588234,43,27,0,70
10415,-21.96099999999906,1993.6842105263158,24,22,7,46
10416,9.624500000000875,3760.8,51,21,0,72
10417,3.708250000000329,2790.4117647058824,67,34,0,101
10418,0.7085000000003288,2749.842105263158,36,27,2,63
10419,-20.193499999999162,2522.470588235294,26,28,0,54
10420,18.478000000000705,2175.125,53,24,0,77
10421,18.060000000001104,4641.0,60,27,1,87
10422,22.577250000000365,3603.6666666666665,66,32,1,98
10423,22.863000000000763,2509.375,63,30,1,93
10424,-9.389499999999098,2506.6666666666665,34,28,0,62
10425,43.20950000000184,5409.35,82,17,0,99
10426,7.476500000000738,4245.7,51,25,0,76
10427,-7.738999999999071,2628.35,37,27,1,64
10428,8.876750000001657,2264.4375,65,24,2,89
10429,8.52475000000082,1979.9411764705883,55,27,0,82
10430,-17.503749999998785,2625.235294117647,34,29,0,63
10431,58.556250000000986,4851.736842105263,101,14,0,115
10432,0.7427500000008039,3136.2,48,20,0,68
10433,16.859500000000875,4447.35,68,17,0,85
10434,-22.27249999999998,1984.5555555555557,21,39,3,60
10435,27.739500000001545,3124.5625,73,25,0,98
10436,-28.341999999999747,1987.8947368421052,18,26,3,44
10437,-29.983999999999376,1987.8947368421052,24,27,5,51
10438,0.7622500000007624,2685.6111111111113,39,26,0,65
10439,-30.46449999999975,2003.0,16,21,2,37
10440,21.709250000000257,2313.0625,74,40,1,114
10441,2.71600000000073,2972.842105263158,48,18,2,66
10442,8.811750000000737,2507.5882352941176,56,24,1,80
10443,-3.7197499999993937,2362.1111111111113,47,31,4,78
10444,3.996500000001513,4138.6,60,28,0,88
10445,20.147750000001952,2868.0,66,30,0,96
10446,-13.989999999999043,2429.133333333333,43,37,0,80
10447,-9.409999999999355,1429.0,47,33,2,80
10448,1.6135000000009476,2476.6666666666665,49,35,0,84
10449,7.08125000000135,2854.0,66,27,0,93
10450,-7.238999999998865,2554.3333333333335,37,26,0,63
10451,-12.111249999999231,2580.2105263157896,38,23,3,61
10452,-27.149499999999573,1987.8947368421052,15,34,2,49
10453,-7.12424999999925,2581.5333333333333,32,26,0,58
10454,53.98650000000329,5129.9,106,8,0,114
10455,8.730500000001012,3714.85,58,26,0,84
10456,2.1810000000011707,3963.2,55,32,0,87
10457,15.753750000001896,4139.210526315789,75,20,1,95
10458,-15.418999999998979,2572.0,32,27,0,59
10459,37.522000000000794,4069.842105263158,95,17,0,112
10460,7.783500000000077,2197.0625,68,27,0,95
10461,0.6060000000001479,2250.5,64,30,1,94
10462,8.074000000001616,2548.0625,59,21,1,80
10463,-3.4014999999982107,3487.4210526315787,57,28,4,85
10464,-20.534499999999785,2488.4210526315787,28,33,0,61
10465,-10.736499999999603,2554.3333333333335,35,23,3,58
10466,0.2472500000008857,3164.1,45,27,0,72
10467,-6.712749999998844,3131.55,44,23,0,67
10468,31.16850000000199,5386.15,84,23,0,107
10469,17.38775000000083,3413.1666666666665,67,35,0,102
10470,1.5032500000010045,2874.4117647058824,51,29,2,80
10471,-1.266999999998351,3460.842105263158,58,20,2,78
10472,24.3745000000025,5465.6,87,24,0,111
10473,30.504500000001606,4218.05,77,17,0,94
10474,0.3577500000008196,2425.0625,50,23,0,73
10475,11.622500000001306,3590.5,67,19,0,86
10476,7.386500000000763,2550.8,57,26,1,83
10477,16.88450000000106,3936.9444444444443,74,28,0,102
10478,4.85650000000072,3138.4210526315787,48,23,1,71
10479,11.749500000000427,2375.5,50,25,0,75
10480,2.888750000001801,2248.5625,68,18,1,86
10481,30.569500000001636,4591.8,81,13,0,94
10482,-8.23524999999883,4310.05,62,32,0,94
10483,-26.64374999999985,1959.5263157894738,17,23,7,40
10484,45.80625000000195,4210.529411764706,110,27,0,137
10485,34.949250000002195,3148.0588235294117,97,17,0,114
10486,43.91550000000115,5298.15,83,22,0,105
10487,25.431500000001126,4782.2,64,17,0,81
10488,14.622750000000703,2446.9375,63,29,0,92
10489,9.267000000001016,3060.5,50,30,0,80
10490,28.101000000002404,4217.0,82,14,0,96
10491,-29.208749999999515,1997.1052631578948,13,30,0,43
10492,3.575250000000936,3245.722222222222,42,21,0,63
10493,18.79375000000201,4839.4,71,25,1,96
10494,20.82700000000105,2813.0,52,31,0,83
10495,17.008000000001523,4232.35,57,33,0,90
10496,48.81175000000137,3204.8125,105,21,0,126
10497,-2.1619999999992743,2452.8333333333335,29,30,0,59
10498,-21.137249999999675,2008.388888888889,23,35,1,58
10499,28.5152500000011,4859.25,68,25,0,93
10500,-18.61924999999963,2044.2,14,30,1,44
10501,36.07450000000019,3548.222222222222,84,24,0,108
10502,16.45925000000138,3532.5789473684213,58,21,0,79
10503,35.964000000002336,4852.1,85,24,1,109
10504,17.658750000000712,4667.2,61,20,0,81
10505,-2.962499999999033,2570.0,38,35,0,73
10506,-10.953749999999664,2807.5263157894738,35,20,0,55
10507,21.035000000002547,2982.823529411765,72,19,0,91
10508,-0.4932499999984823,3036.777777777778,51,30,9,81
10509,-31.29049999999919,1429.0,25,25,2,50
10510,-10.942749999999366,2581.5333333333333,37,27,0,64
10511,4.265500000000985,2992.176470588235,59,20,0,79
10512,33.16300000000178,3234.6875,74,25,0,99
10513,-21.075499999999824,1966.8823529411766,34,39,7,73
10514,6.692250000001394,2171.125,42,26,1,68
10515,6.188500000001737,3450.0526315789475,59,23,1,82
10516,23.006250000000776,3378.6470588235293,74,23,0,97
10517,23.120000000000278,2324.3333333333335,75,28,0,103
10518,-7.948749999998914,2531.733333333333,50,20,0,70
10519,11.30975000000135,3687.85,64,23,0,87
10520,44.88175000000215,4791.05,78,23,0,101
10521,-12.317749999999268,2563.0625,34,23,0,57
10522,12.114250000001272,4406.1,61,21,0,82
10523,-34.94774999999928,2044.1,14,32,1,46
10524,30.45975000000171,4593.4,77,23,0,100
10525,-14.593749999999076,2467.0555555555557,44,20,0,64
10526,11.046500000001547,4128.35,68,8,0,76
10527,14.169750000000395,2629.8823529411766,55,33,2,88
10528,-18.752749999999264,2524.3,26,23,0,49
10529,2.871750000000316,2514.5,42,25,11,67
10530,20.709250000002168,4323.75,83,9,0,92
10531,-5.7684999999990305,2588.6470588235293,44,25,0,69
10532,-1.9189999999989102,2495.733333333333,49,30,0,79
10533,13.230750000000643,2798.8823529411766,48,25,0,73
10534,-2.723249999998447,2361.5625,56,30,1,86
10535,-4.2617499999986554,2594.2,58,21,2,79
10536,14.56275000000257,3818.4117647058824,88,16,0,104
10537,0.3440000000038875,1894.3125,73,23,1,96
10538,28.532250000001802,5282.25,83,18,0,101
10539,-6.53024999999918,2417.0,54,21,2,75
10540,19.141250000001158,3260.722222222222,61,21,0,82
10541,10.169250000000435,3091.222222222222,63,28,0,91
10542,-0.9107499999989532,2719.529411764706,53,17,0,70
10543,6.010750000001351,2800.5882352941176,61,22,1,83
10544,-10.012749999999247,2703.842105263158,37,33,2,70
10545,12.458500000001909,4076.0,68,13,0,81
10546,-0.0284999999997952,3382.2,37,30,0,67
10547,-2.893249999999001,3135.4,48,20,0,68
10548,16.275750000001057,3945.0,85,22,0,107
10549,2.7060000000019877,3606.2631578947367,66,14,0,80
10550,-0.7574999999991284,3319.777777777778,44,26,0,70
10551,21.657500000001527,2952.875,66,16,0,82
10552,-1.4929999999982801,3109.35,48,25,0,73
10553,-18.030249999999832,2982.9473684210525,38,20,1,58
10554,-14.891999999999786,2526.1111111111113,33,28,0,61
10555,16.69300000000173,4163.2,59,25,0,84
10556,0.6580000000004477,2564.05,28,27,1,55
10557,13.173750000001537,2570.8823529411766,56,33,1,89
10558,-23.448500000000454,1822.3333333333333,14,32,17,46
10559,-8.39399999999856,4331.45,49,39,0,88
10560,37.224000000001745,4849.05,85,23,0,108
10561,21.9417500000018,3134.4375,78,19,0,97
10562,0.6677500000019012,3622.222222222222,63,30,0,93
10563,42.16200000000239,4552.0,82,18,0,100
10564,36.383250000000906,4143.45,70,11,0,81
10565,-21.607499999999128,2508.4210526315787,34,21,1,55
10566,-15.38899999999901,2712.45,29,29,0,58
10567,17.834000000001055,3576.0526315789475,70,21,0,91
10568,3.8927500000006012,2536.4,28,32,1,60
10569,26.718000000001048,4882.3,69,20,0,89
10570,-27.354499999999554,2008.35,11,28,0,39
10571,30.59400000000261,4067.6111111111113,93,14,0,107
10572,21.428500000000938,5096.6,73,12,0,85
10573,5.039500000001211,3088.3529411764707,52,27,0,79
10574,29.309750000001166,2937.176470588235,63,32,0,95
10575,4.863500000000833,3588.684210526316,49,27,0,76
10576,7.00825000000121,2457.6666666666665,48,22,0,70
10577,-14.16749999999906,2551.842105263158,30,33,1,63
10578,7.1545000000019225,3659.6470588235293,59,30,0,89
10579,-25.452749999999597,1983.7368421052631,14,35,0,49
10580,0.173750000001398,3898.2,51,31,0,82
10581,14.353500000001375,2543.25,56,28,0,84
10582,3.00725000000081,2646.4375,39,35,0,74
10583,-10.450749999999045,3378.95,37,38,0,75
10584,-19.867249999999583,2040.2,17,29,3,46
10585,17.76575000000073,3178.1875,52,29,0,81
10586,30.773500000001444,4757.421052631579,76,30,0,106
10587,23.83400000000028,3086.8888888888887,70,24,0,94
10588,2.2230000000011736,2589.875,55,28,1,83
10589,-6.099499999999076,2847.8888888888887,44,41,0,85
10590,7.631750000001577,2456.875,56,22,0,78
10591,20.66425000000124,3794.222222222222,65,34,0,99
10592,19.63450000000111,4836.25,62,28,0,90
10593,-15.959500000000148,2455.842105263158,44,20,14,64
10594,24.31175000000256,4826.7,81,25,0,106
10595,-16.799999999999386,2413.277777777778,35,21,0,56
10596,-9.898749999998664,2559.6111111111113,33,35,0,68
10597,-26.078499999999433,2028.25,16,27,4,43
10598,7.430750000000954,2495.733333333333,54,25,0,79
10599,9.001750000001467,3711.55,54,25,0,79
10600,-10.558249999999047,3125.2105263157896,39,27,3,66
10601,-8.799499999999302,2620.5882352941176,28,29,1,57
10602,-23.897249999998948,2505.1052631578946,26,26,0,52
10603,-8.856499999999212,4203.65,43,34,0,77
10604,1.0115000000016725,3513.4210526315787,56,29,0,85
10605,-1.9919999999989848,2563.9,37,21,3,58
10606,26.521500000001414,4510.210526315789,82,39,0,121
10607,15.8645000000021,4267.15,72,22,0,94
10608,8.160000000001274,3641.75,47,28,0,75
10609,16.52625000000221,3578.222222222222,64,29,0,93
10610,-19.05049999999914,2055.5789473684213,23,26,3,49
10611,-4.560499999998838,3671.15,47,37,0,84
10612,24.45225000000204,5028.1578947368425,80,25,0,105
10613,-22.82449999999947,2474.8888888888887,32,41,6,73
10614,0.1124999999999842,1791.1875,40,34,4,74
10615,12.296500000000492,3039.277777777778,42,27,0,69
10616,-3.9067499999993816,2563.125,25,33,0,58
10617,21.727500000000052,4460.777777777777,92,34,0,126
10618,4.097250000001027,3254.4444444444443,64,32,0,96
10619,19.21625000000117,4858.45,58,20,0,78
10620,-1.6779999999990036,3010.5789473684213,48,26,0,74
10621,19.367000000002214,2967.9375,66,25,0,91
10622,21.65175000000162,5182.25,59,37,1,96
10623,-5.255999999998894,3357.6428571428573,38,28,0,66
10624,21.91150000000179,5410.0,63,24,0,87
10625,7.800750000000926,3111.65,49,23,1,72
10626,24.20950000000166,3449.3333333333335,76,15,1,91
10627,46.20350000000183,4861.789473684211,75,31,0,106
10628,29.81850000000236,4752.15,72,29,0,101
10629,-13.241249999999159,2821.176470588235,23,32,0,55
10630,0.48850000000008736,1429.0,39,31,1,70
10631,-1.2772499999991456,2987.2105263157896,35,35,0,70
10632,30.032750000002657,5294.25,100,24,2,124
10633,-27.525499999999813,2024.3,10,30,0,40
10634,22.085500000001332,5315.7,63,37,0,100
10635,22.484750000002432,4819.6,70,36,1,106
10636,-0.9919999999989588,3714.7894736842104,56,36,0,92
10637,-11.64349999999989,1839.75,45,30,0,75
10638,-12.209499999999515,1953.7777777777778,21,26,1,47
10639,-14.791749999999547,2668.125,26,26,5,52
10640,13.70275000000149,3771.2,52,29,0,81
10641,16.25900000000053,3515.1052631578946,47,24,0,71
10642,-8.798999999999134,2556.0,30,27,0,57
10643,-4.229499999999115,4510.0526315789475,49,32,1,81
10644,24.346750000000686,4110.0,67,32,0,99
10645,-9.747999999999381,3937.7894736842104,41,41,3,82
10646,11.629750000001081,5235.45,54,28,0,82
10647,27.092500000002946,4622.75,82,23,0,105
10648,-2.2939999999989515,2359.5,34,29,1,63
10649,18.001000000000978,3668.8,52,24,0,76
10650,15.805750000001368,3866.9473684210525,64,25,0,89
10651,-7.670249999998771,3152.1,36,31,0,67
10652,2.5585000000018523,2893.3125,59,30,0,89
10653,-9.336499999999429,2561.785714285714,24,33,0,57
10654,11.989250000001814,2541.1875,63,15,1,78
10655,-3.226749999997872,3843.3,56,33,0,89
10656,2.0065000000014264,3252.1,43,30,0,73
10657,-10.212499999999423,2629.2,28,28,0,56
10658,12.432750000001793,3619.6,53,32,0,85
10659,9.16900000000094,4312.894736842105,64,31,1,95
10660,-2.9044999999988503,2540.05,27,35,0,62
10661,28.794500000002976,4603.65,71,32,0,103
10662,-19.827999999999967,1952.0526315789473,17,26,1,43
10663,22.627750000001903,4114.411764705882,80,26,0,106
10664,-2.2914999999998087,3310.6,40,30,16,70
10665,6.17100000000012,3878.2,37,33,0,70
10666,6.440500000001376,3876.75,53,24,0,77
10667,14.06675000000096,3834.315789473684,57,24,0,81
10668,20.041250000001533,3989.5789473684213,56,28,0,84
10669,-22.7862499999994,2028.25,16,29,0,45
10670,31.647750000000876,4207.888888888889,61,17,0,78
10671,28.586000000001025,4151.3,64,24,0,88
10672,-7.598249999999419,2092.0,37,31,2,68
10673,-20.213499999999524,2028.3,15,33,1,48
10674,-6.209499999999087,3107.7,45,25,0,70
10675,24.780000000001433,5050.6,65,26,0,91
10676,-3.1142499999988007,2512.235294117647,44,25,0,69
10677,-6.710249999999073,3081.5263157894738,33,40,1,73
10678,-16.8462499999992,2529.823529411765,39,30,9,69
10679,-31.40974999999949,2108.55,14,32,2,46
10680,29.196750000002424,5096.55,88,21,0,109
10681,27.771000000001116,4277.0526315789475,86,26,0,112
10682,-13.849249999998657,2690.95,30,35,1,65
10683,-2.5282499999991552,2370.235294117647,45,23,0,68
10684,31.438500000001188,4551.0,83,34,0,117
10685,5.929500000000422,2441.0625,52,25,9,77
10686,-12.299999999999198,2030.6,14,39,0,53
10687,9.659750000001647,4171.9,60,21,0,81
10688,-14.03999999999902,3203.6,30,36,0,66
10689,9.53775000000103,3675.1,52,26,0,78
10690,-34.193249999999416,2028.2,18,24,2,42
10691,-14.13849999999887,2531.1428571428573,36,28,1,64
10692,26.14350000000211,4844.2,79,17,0,96
10693,6.4867500000013205,3464.8,50,24,0,74
10694,1.4637500000009882,3339.35,44,25,0,69
10695,-8.444499999999298,2972.3333333333335,45,26,1,71
10696,7.09100000000146,4572.7,62,42,0,104
10697,20.49100000000122,4187.1,63,20,0,83
10698,-17.52849999999915,3032.222222222222,39,43,0,82
10699,-10.12024999999951,2454.3529411764707,32,29,0,61
10700,21.21875000000201,5259.25,69,29,0,98
10701,9.102000000001492,3841.7368421052633,60,33,0,93
10702,14.174750000001003,2892.8888888888887,45,31,1,76
10703,-0.15149999999868466,2530.4444444444443,39,25,0,64
10704,-10.662250000000153,2019.7368421052631,41,34,8,75
10705,0.8565000000006151,2495.222222222222,57,30,1,87
10706,-21.259999999999458,2156.9,13,33,1,46
10707,-7.442749999999154,1958.1333333333334,58,24,10,82
10708,4.268750000000916,3152.05,47,17,0,64
10709,4.718250000002121,2568.9375,66,26,0,92
10710,-5.84324999999946,2583.75,26,30,0,56
10711,-13.569999999999302,2624.35,35,22,0,57
10712,6.2610000000007835,1904.2941176470588,41,37,0,78
10713,-10.690999999999203,1903.3125,28,28,1,56
10714,30.81675000000206,4352.210526315789,78,22,1,100
10715,35.70175000000154,5365.7,75,20,0,95
10716,33.42825000000117,4790.2,76,26,0,102
10717,23.69400000000166,4778.3,79,17,0,96
10718,-7.606749999999674,1929.5294117647059,33,29,1,62
10719,45.6480000000013,5094.2,67,25,0,92
10720,9.032250000000523,2415.0,66,17,0,83
10721,-22.458749999999476,1882.3333333333333,17,34,1,51
10722,3.4150000000020944,3913.3,55,30,0,85
10723,5.090500000000622,3008.5,34,28,2,62
10724,30.654000000002533,3134.5625,85,16,0,101
10725,-0.7517499999990902,3593.7368421052633,42,34,0,76
10726,-5.5944999999983835,2317.75,41,29,11,70
10727,10.740250000001376,3975.85,50,34,0,84
10728,53.61000000000231,5229.421052631579,93,30,0,123
10729,11.532000000001075,2748.4117647058824,52,25,0,77
10730,39.64950000000107,4826.7,64,33,0,97
10731,7.876250000000498,3132.2,40,29,0,69
10732,11.882750000001202,4067.4736842105262,66,18,0,84
10733,-1.0379999999984346,3603.65,55,21,0,76
10734,27.085000000001266,4877.65,85,29,0,114
10735,18.29000000000297,2363.764705882353,66,29,1,95
10736,8.899250000001256,3050.823529411765,48,26,0,74
10737,-22.21974999999891,2270.153846153846,17,42,0,59
10738,44.51425000000133,5498.2,86,17,0,103
10739,21.998750000000523,3754.45,56,31,0,87
10740,-0.9600000000000438,2370.1111111111113,44,32,2,76
10741,-19.093749999999396,2476.65,21,30,0,51
10742,21.970250000002565,3338.8125,63,26,0,89
10743,25.968250000000932,4097.473684210527,70,33,0,103
10744,-19.39049999999927,2560.0,31,19,1,50
10745,14.072750000001616,3587.85,59,18,0,77
10746,13.81200000000131,4298.1875,68,22,0,90
10747,-2.432749999999214,2829.2,57,27,0,84
10748,-24.093999999999706,1959.111111111111,17,36,2,53
10749,-4.171499999998994,2393.3125,51,32,1,83
10750,31.335750000001287,4952.85,74,18,0,92
10751,-0.9309999999990743,2735.7894736842104,38,24,0,62
10752,0.1112500000009657,2519.0555555555557,49,22,0,71
10753,-7.189999999999669,1950.1666666666667,42,39,1,81
10754,-25.855499999999136,2210.0,15,32,1,47
10755,5.511000000000187,1871.5,48,27,0,75
10756,4.402000000000585,2457.6666666666665,54,35,0,89
10757,11.256499999999955,2384.375,53,36,0,89
10758,-31.613749999999726,2032.25,7,37,1,44
10759,14.948250000001304,4489.35,62,29,0,91
10760,8.331000000000945,4194.15,53,38,0,91
10761,-13.751249999999143,2474.8888888888887,31,34,3,65
10762,1.693999999999776,1975.235294117647,51,36,0,87
10763,-6.547749999999313,2528.2,27,29,1,56
10764,-0.7132499999993344,2704.0,33,26,0,59
10765,-0.6677500000000459,1983.5882352941176,28,33,0,61
10766,43.13575000000131,5020.526315789473,81,27,1,108
10767,-12.938749999999226,2528.25,27,26,0,53
10768,-11.522749999998608,2986.529411764706,42,33,0,75
10769,31.182250000001524,2830.9375,89,23,0,112
10770,19.986250000001935,4537.85,69,26,1,95
10771,-9.875999999998484,2491.6315789473683,32,29,3,61
10772,11.047750000000637,4226.65,43,30,0,73
10773,12.390500000002088,2480.6875,72,17,0,89
10774,14.724000000001164,4258.4,53,37,0,90
10775,-32.01149999999974,1967.1052631578948,9,29,6,38
10776,12.165750000000697,3087.8,47,21,0,68
10777,18.297750000001443,4149.85,62,25,0,87
10778,43.439000000002075,4751.526315789473,85,26,0,111
10779,-1.8014999999984205,2955.5,39,30,0,69
10780,-25.389249999999343,2028.25,18,29,2,47
10781,-26.23499999999932,2560.1,23,36,0,59
10782,-5.848749999999255,2554.1875,38,28,0,66
10783,-28.661749999999273,2544.1,25,29,0,54
10784,-16.86299999999939,2504.705882352941,24,33,0,57
10785,4.81975000000106,3724.35,50,28,0,78
10786,6.553250000001567,3237.842105263158,47,35,3,82
10787,30.091500000001353,3113.5,77,21,0,98
10788,-19.927749999999676,2028.25,16,32,1,48
10789,27.016000000002386,4063.2631578947367,68,37,0,105
10790,-9.623250000000295,1429.0,27,30,8,57
10791,16.16525000000141,3219.222222222222,55,35,2,90
10792,-4.300749999999124,3881.45,58,27,0,85
10793,-21.511999999999322,2008.4,13,30,1,43
10794,-1.2184999999985222,3098.3684210526317,47,26,0,73
10795,-4.668249999999317,2691.125,30,31,0,61
10796,30.50875000000216,5255.4,75,20,0,95
10797,11.850250000001274,3832.35,50,37,0,87
10798,-2.4142499999989253,2373.176470588235,39,32,1,71
10799,11.1005000000012,3603.7,48,26,0,74
10800,9.327750000001197,3806.1,57,28,0,85
10801,8.859500000000612,4110.9,44,29,0,73
10802,17.57250000000178,4311.55,70,19,1,89
10803,16.324250000001534,3595.8,64,16,1,80
10804,38.49825000000085,4257.7,63,17,0,80
10805,-24.052999999999585,2198.5263157894738,19,34,5,53
10806,-8.808749999999398,1804.0625,27,30,0,57
10807,7.967000000000565,2756.6470588235293,71,32,0,103
10808,17.14625000000197,4461.65,67,29,0,96
10809,-34.01624999999961,2008.4,8,28,5,36
10810,4.077250000000716,1429.0,58,35,2,93
10811,1.6460000000013015,4544.85,61,41,1,102
10812,-22.321749999999074,2074.25,15,32,0,47
10813,-36.264999999999745,1438.5333333333333,15,37,0,52
10814,9.24150000000139,5323.55,59,36,0,95
10815,18.091000000000363,3044.722222222222,41,30,1,71
10816,31.842500000001024,5608.45,71,26,0,97
10817,11.005250000001851,4222.05,57,28,1,85
10818,-6.727999999999,3107.65,47,22,3,69
10819,18.505000000000635,4134.263157894737,66,29,5,95
10820,-6.707999999999187,2768.1,33,24,3,57
10821,4.056000000001072,3064.05,42,24,0,66
10822,5.338250000000416,3455.7894736842104,47,27,0,74
10823,6.05800000000171,4175.05,56,33,0,89
10824,-4.075749999998228,3367.15,49,26,0,75
10825,-13.80099999999888,2890.95,28,36,0,64
10826,30.975250000000916,4034.7894736842104,77,28,0,105
10827,-16.739499999999644,1947.5555555555557,26,35,1,61
10828,2.6707500000002864,2633.722222222222,39,33,5,72
10829,-36.03424999999986,1429.0,13,32,4,45
10830,22.948250000002023,4683.1,58,31,0,89
10831,-31.99124999999994,2032.25,7,39,0,46
10832,5.763000000000607,3565.65,37,32,0,69
10833,-15.174749999999431,2036.8823529411766,31,24,3,55
10834,24.930500000000684,4213.2,54,24,0,78
10835,12.279999999999905,2024.7058823529412,51,29,0,80
10836,16.88900000000083,3516.842105263158,69,32,1,101
10837,-20.894249999999353,2048.1,18,30,2,48
10838,-33.47549999999964,2226.7,17,30,1,47
10839,-1.0629999999994781,2552.9,27,32,0,59
10840,-3.5767499999994223,2648.266666666667,30,45,0,75
10841,3.882000000000963,3761.5789473684213,46,32,1,78
10842,-18.4015000000001,2071.529411764706,25,33,5,58
10843,1.029000000000765,2302.9411764705883,48,31,0,79
10844,-30.567749999999428,2079.9,19,21,3,40
10845,-14.22199999999934,3043.2631578947367,46,26,7,72
10846,-3.4562499999994585,2562.4666666666667,28,27,0,55
10847,31.232250000000526,4424.105263157895,77,28,0,105
10848,7.76750000000149,3607.65,56,26,0,82
10849,-3.4637499999991506,2007.4375,32,39,0,71
10850,23.209500000000844,2393.3125,69,33,0,102
10851,29.110500000001345,4761.6,70,27,0,97
10852,29.055250000000463,3042.705882352941,66,39,0,105
10853,0.3062500000005494,3273.6,32,34,1,66
10854,11.423750000002624,4697.45,68,33,0,101
10855,16.269750000001146,3603.7,60,19,0,79
10856,18.553750000001394,3927.0526315789475,57,32,0,89
10857,20.604750000001523,5266.4,67,24,1,91
10858,-19.47024999999954,1913.111111111111,16,34,4,50
10859,19.90000000000027,2924.823529411765,82,28,0,110
10860,-20.40449999999985,1909.7222222222222,24,36,3,60
10861,5.102000000000935,2639.0588235294117,54,44,0,98
10862,21.629500000002277,4775.8,67,35,0,102
10863,25.390750000001155,3828.875,66,30,1,96
10864,9.001500000000494,3333.8888888888887,64,22,0,86
10865,-11.644999999999225,3205.2,37,25,1,62
10866,9.081250000001164,3076.5,49,28,0,77
10867,15.08550000000281,5026.0,72,30,2,102
10868,-1.9307499999995188,2551.5714285714284,45,29,1,74
10869,10.982250000001763,4389.789473684211,65,27,1,92
10870,21.982500000002062,4536.15,78,27,0,105
10871,33.3342500000019,5475.95,88,22,0,110
10872,-26.471749999999226,2455.7894736842104,27,28,4,55
10873,21.717000000001537,4576.0,72,17,0,89
10874,33.38700000000198,4726.526315789473,89,19,0,108
10875,-14.738999999999484,2513.235294117647,29,25,0,54
10876,-8.25324999999923,3070.6315789473683,39,26,0,65
10877,18.64575000000132,3611.75,63,22,0,85
10878,4.144000000000032,1923.0625,46,25,3,71
10879,-14.841249999998894,2484.157894736842,38,17,2,55
10880,-12.71024999999937,2540.25,27,27,2,54
10881,-5.665999999998758,3074.6666666666665,34,43,0,77
10882,-17.70199999999781,2911.157894736842,46,23,7,69
10883,7.427750000001161,3701.214285714286,53,24,0,77
10884,14.678750000000381,2983.764705882353,69,36,0,105
10885,17.915500000000556,2751.0,52,29,0,81
10886,7.981500000000693,2491.722222222222,40,26,0,66
10887,28.171750000001463,3868.769230769231,68,22,0,90
10888,31.280000000001337,5096.55,75,29,0,104
10889,30.536500000001944,3393.4375,104,28,0,132
10890,-8.333999999999401,2563.95,32,25,0,57
10891,38.45475000000293,6011.6,96,18,0,114
10892,33.72125000000163,5230.6,78,23,0,101
10893,21.290000000001513,4135.55,64,25,0,89
10894,-5.511249999999413,2691.7,30,31,0,61
10895,14.237250000000708,2735.0555555555557,42,25,0,67
10896,-0.29974999999873064,2956.823529411765,54,32,0,86
10897,4.46600000000159,3820.3,53,26,0,79
10898,-18.66074999999957,1429.0,27,31,5,58
10899,-15.594749999999568,2810.85,31,31,1,62
10900,11.2615000000007,2050.0625,52,25,2,77
10901,-5.341749999999108,2464.8125,45,23,0,68
10902,-12.162499999999229,2616.8823529411766,26,31,0,57
10903,-0.3142499999986672,2931.8888888888887,52,21,1,73
10904,-23.751749999999568,2319.55,18,32,0,50
10905,-33.24724999999945,2087.315789473684,12,31,6,43
10906,18.226250000001407,4107.65,56,23,0,79
10907,-7.1269999999992235,2543.4,28,27,2,55
10908,-37.70550000000004,1429.0,23,50,0,73
10909,7.410000000001352,3723.55,54,28,0,82
10910,6.292500000001299,3322.277777777778,52,30,1,82
10911,20.62950000000239,4576.1578947368425,76,25,5,101
10912,-11.494749999999406,4282.8421052631575,51,36,1,87
10913,1.2205000000017043,3044.5555555555557,54,24,0,78
10914,-4.083749999999055,2598.7368421052633,31,30,0,61
10915,7.015500000001585,3031.4210526315787,45,23,3,68
10916,-17.447499999999636,2014.6842105263158,14,31,2,45
10917,-9.396749999999368,2370.3529411764707,32,37,0,69
10918,-11.539499999998977,3138.764705882353,39,35,3,74
10919,-2.1464999999993366,3385.4,36,29,2,65
10920,9.170500000000953,3643.4,47,26,0,73
10921,18.57850000000185,2715.8125,62,22,0,84
10922,13.813000000000972,3097.6470588235293,54,28,1,82
10923,-12.733249999999053,3309.2,39,29,1,68
10924,30.80250000000218,4143.3,72,25,0,97
10925,2.8195000000011716,3064.15,44,21,0,65
10926,-23.58149999999961,2008.5,13,33,0,46
10927,11.72525000000037,2708.6,51,32,0,83
10928,36.179500000001426,4538.578947368421,85,25,1,110
10929,10.37225000000134,3658.0526315789475,53,28,0,81
10930,-3.4754999999989913,3163.25,42,23,0,65
10931,3.1542500000009115,2427.0625,37,29,1,66
10932,25.90450000000242,4466.578947368421,85,21,0,106
10933,28.094000000001124,2830.8125,62,35,2,97
10934,38.095500000001195,4647.105263157895,76,16,1,92
10935,5.145750000000602,3124.8333333333335,37,37,0,74
10936,3.404749999999833,3021.5263157894738,45,30,7,75
10937,21.168750000001477,3026.0555555555557,52,31,0,83
10938,-7.350249999999727,2553.294117647059,39,28,1,67
10939,0.18199999999958863,1941.6470588235295,42,41,0,83
10940,16.316500000001067,3003.235294117647,55,25,0,80
10941,40.02750000000241,5234.7,78,22,0,100
10942,5.098750000000901,3188.6,38,26,0,64
10943,-14.887749999999267,2557.684210526316,32,28,1,60
10944,4.181250000001364,3080.6315789473683,46,29,1,75
10945,23.0402500000014,3609.0,71,27,0,98
10946,-0.2169999999989142,2956.705882352941,49,34,1,83
10947,47.62325000000102,5123.368421052632,78,35,0,113
10948,27.984250000002497,5592.45,78,41,0,119
10949,2.3882500000012064,3146.7368421052633,53,27,0,80
10950,-9.489999999999174,1880.4375,34,21,4,55
10951,20.115500000001386,3776.5789473684213,57,31,0,88
10952,-1.206749999998997,2524.3333333333335,45,23,0,68
10953,3.5935000000005304,3723.5,36,35,0,71
10954,9.17350000000081,2848.6875,58,29,0,87
10955,-9.050749999998562,3719.5,49,32,0,81
10956,15.724000000001306,3956.95,55,30,1,85
10957,-18.84524999999947,1983.6470588235295,21,39,0,60
10958,-7.306249999999193,2487.8823529411766,27,31,0,58
10959,-17.434499999998813,2583.85,33,27,0,60
10960,-0.981499999998084,3595.8,41,34,0,75
10961,17.76925000000171,3832.222222222222,71,26,2,97
10962,-0.7839999999991791,2965.4210526315787,27,35,2,62
10963,-6.66524999999861,2460.777777777778,30,35,0,65
10964,-0.5982499999989633,3979.05,54,20,0,74
10965,21.173500000001734,4155.3,63,23,0,86
10966,12.868250000000582,3064.0,41,20,0,61
10967,-10.713499999999456,2463.4210526315787,29,23,0,52
10968,22.67600000000089,3403.8823529411766,65,26,0,91
10969,36.09700000000059,3277.705882352941,67,21,1,88
10970,-0.7982499999993383,2668.0555555555557,30,28,0,58
10971,-6.530999999998675,3195.7,40,29,1,69
10972,-0.7797499999988063,2415.9411764705883,50,27,0,77
10973,12.809250000000665,3628.684210526316,63,22,10,85
10974,26.968250000000978,3627.157894736842,71,28,8,99
10975,10.261000000001712,4171.2,71,27,0,98
10976,-19.868750000000272,1944.578947368421,17,27,11,44
10977,-6.439499999999363,2500.5,35,31,0,66
10978,16.23875000000176,4065.55,51,27,0,78
10979,-2.348249999998886,3142.5789473684213,37,28,0,65
10980,34.901250000001,2181.5882352941176,66,26,0,92
10981,10.254250000001136,2290.9411764705883,61,33,0,94
10982,2.7825000000013214,3359.7368421052633,53,24,1,77
10983,-15.839999999999796,2247.3,21,28,1,49
10984,6.933750000001593,3941.0,61,22,0,83
10985,-23.72474999999897,2567.9,33,28,0,61
10986,9.660000000000815,3087.9,37,24,0,61
10987,-3.2477499999993698,2420.5882352941176,50,35,0,85
10988,7.084500000001293,3987.1052631578946,58,29,12,87
10989,24.643500000001552,2951.8823529411766,80,26,0,106
10990,28.428500000001748,4248.736842105263,71,15,0,86
10991,8.67450000000184,3388.4444444444443,55,27,0,82
10992,9.310250000000739,2244.5625,55,23,0,78
10993,10.825500000001501,4571.95,63,26,0,89
10994,17.01825000000168,3602.8333333333335,70,17,0,87
10995,16.403750000001644,3092.1666666666665,54,30,1,84
10996,10.533750000001586,4593.571428571428,65,21,2,86
10997,-9.497499999998851,3091.75,43,26,0,69
10998,29.032000000002416,4671.15,79,29,1,108
10999,9.61174999999989,1955.875,56,31,2,87
11000,-19.381249999999977,1429.0,13,33,2,46
11001,23.035750000001094,3591.85,58,21,0,79
11002,-5.935499999999283,2268.375,43,34,1,77
11003,18.057999999999996,2305.266666666667,75,34,0,109
11004,-6.985749999999415,3088.176470588235,38,27,7,65
11005,27.798750000002475,3398.4117647058824,84,21,0,105
11006,-3.4072499999992387,2427.222222222222,45,27,2,72
11007,14.60850000000094,3676.3684210526317,57,15,1,72
11008,-1.3442499999993054,2376.4375,39,23,0,62
11009,14.356750000002005,3977.8947368421054,66,25,1,91
11010,1.6310000000005034,3385.6315789473683,51,31,0,82
11011,-33.83950000000016,1429.0,13,45,2,58
11012,-27.12624999999941,2028.2,12,33,1,45
11013,11.379750000001206,3012.0,56,21,0,77
11014,8.459750000000557,2526.1176470588234,57,36,6,93
11015,44.036750000002606,5651.35,99,8,0,107
11016,16.53200000000108,3507.5555555555557,60,27,1,87
11017,2.1527500000004816,2563.0,49,23,0,72
11018,-28.200749999999324,2524.4,25,27,0,52
11019,10.81825000000136,4345.65,67,19,0,86
11020,10.455500000000907,2585.0,62,23,2,85
11021,-23.922249999999444,2030.4705882352941,32,27,1,59
11022,-6.1712499999989845,2899.6428571428573,40,25,0,65
11023,2.885749999999989,2226.6875,50,27,1,77
11024,-3.7439999999990334,3142.6,46,22,0,68
11025,-8.686749999999174,2786.277777777778,48,23,0,71
11026,-4.759249999999658,2129.3529411764707,26,27,0,53
11027,-4.592499999999142,2352.529411764706,39,23,1,62
11028,-18.002749999999438,2028.25,18,27,0,45
11029,-1.8109999999987387,3145.7,52,26,0,78
11030,-4.219999999999459,2492.529411764706,60,30,1,90
11031,6.791750000000631,2438.6,50,22,0,72
11032,27.319250000002008,4874.35,80,20,3,100
11033,-41.847999999999615,2210.7,15,29,3,44
11034,4.402750000001497,4316.315789473684,55,31,0,86
11035,-8.071999999999372,2521.529411764706,27,32,0,59
11036,-6.180749999999292,2831.7368421052633,44,22,4,66
11037,-32.83774999999901,1912.7058823529412,27,34,3,61
11038,-17.615499999999273,2563.8,22,27,0,49
11039,-13.492999999999048,1893.375,31,29,5,60
11040,-1.6347499999997694,3308.0,38,34,0,72
11041,20.732750000001293,4275.85,69,18,0,87
11042,16.604500000000943,1870.7058823529412,57,33,0,90
11043,6.973000000001282,3659.25,54,22,0,76
11044,25.10500000000123,2457.6,62,29,1,91
11045,-8.229249999999807,1971.388888888889,32,41,1,73
11046,6.42924999999953,1884.375,80,37,1,117
11047,-34.0577499999992,2811.6,26,33,4,59
11048,-5.32449999999869,2519.6470588235293,49,29,1,78
11049,-23.50274999999932,2024.25,14,28,1,42
11050,-8.886249999999565,2628.625,27,40,7,67
11051,17.858999999999863,2445.823529411765,68,24,0,92
11052,13.635250000001616,4302.2,73,27,0,100
11053,8.268500000001538,3698.9,56,26,0,82
11054,-23.935499999999653,2028.2,13,31,3,44
11055,-13.142249999999539,3713.95,39,40,1,79
11056,-11.980250000000702,1759.375,38,38,1,76
11057,21.970249999999943,2256.4375,63,29,0,92
11058,2.990500000001379,3822.75,46,33,0,79
11059,-21.879249999999363,2081.45,20,32,2,52
11060,-5.142249999999455,2619.625,48,28,2,76
11061,0.16350000000136244,3285.3,41,37,1,78
11062,21.47950000000132,4046.5789473684213,67,23,0,90
11063,-13.001249999998944,2468.722222222222,36,23,2,59
11064,21.87250000000116,2475.5714285714284,62,30,2,92
11065,11.637250000001464,3580.3684210526317,58,27,3,85
11066,19.652500000001474,4149.1578947368425,69,30,0,99
11067,24.868250000000742,3454.6111111111113,65,28,1,93
11068,-18.69799999999864,2487.8823529411766,30,33,0,63
11069,7.505000000000898,1889.375,61,29,3,90
11070,12.026750000001345,2407.25,53,25,1,78
11071,-5.204249999999215,3583.85,43,29,0,72
11072,16.583750000000453,2491.5625,62,37,0,99
11073,8.377750000000853,2500.4375,53,29,0,82
11074,13.437750000001007,3077.176470588235,55,21,1,76
11075,3.731000000001495,4155.1578947368425,58,30,1,88
11076,-1.638249999999261,3164.6111111111113,43,37,1,80
11077,-3.8749999999986997,2884.315789473684,37,27,0,64
11078,0.3087500000006245,3505.2631578947367,55,21,0,76
11079,32.006500000001026,4970.25,63,25,0,88
11080,39.00225000000142,5321.95,89,12,0,101
11081,36.08575000000129,3095.8125,76,27,0,103
11082,7.760000000001031,3071.9,50,24,0,74
11083,-20.042749999999415,2579.85,25,33,0,58
11084,15.509250000001725,3155.8947368421054,49,31,0,80
11085,12.826500000001095,4445.8,54,28,0,82
11086,-5.157499999999478,2452.9444444444443,30,29,0,59
11087,43.837250000001916,5257.6,81,29,0,110
11088,-7.818999999999015,2410.470588235294,38,22,1,60
11089,28.423000000002368,5350.55,92,16,0,108
11090,-3.257499999999329,3287.85,35,28,2,63
11091,-13.825999999999112,2170.1875,46,32,2,78
11092,3.200250000000017,1947.611111111111,43,37,0,80
11093,20.698250000002368,4655.25,75,27,0,102
11094,15.151750000000892,2544.8823529411766,59,40,0,99
11095,20.730000000000317,2616.5625,49,29,0,78
11096,-7.659749999999676,2063.0625,34,40,0,74
11097,-9.55924999999949,1980.0,47,32,2,79
11098,-4.244499999998223,4620.3,64,39,0,103
11099,13.289500000001652,3678.3529411764707,58,29,0,87
11100,-28.69324999999958,2044.15,16,28,0,44
11101,40.857000000003495,5718.8,102,20,0,122
11102,12.99675000000035,2410.0,67,39,0,106
11103,5.246750000000758,3376.0,51,20,0,71
11104,-21.186749999999975,1997.1052631578948,30,29,6,59
11105,7.1517500000020275,3675.95,52,31,0,83
11106,-20.139749999999566,2695.5789473684213,30,33,2,63
11107,10.56575000000108,2981.705882352941,42,32,4,74
11108,13.559000000000577,3405.3333333333335,48,35,0,83
11109,14.01725000000099,1943.3333333333333,58,34,2,92
11110,34.36700000000268,5999.75,80,39,0,119
11111,0.4362500000005879,2348.75,56,29,1,85
11112,-30.015749999999265,1887.5294117647059,21,34,4,55
11113,-23.18199999999953,2008.4,17,29,1,46
11114,5.449000000001468,2998.705882352941,44,25,0,69
11115,-13.20424999999988,2032.3,11,36,0,47
11116,8.695000000002391,3501.0526315789475,63,28,1,91
11117,-17.879249999999804,2008.5,13,32,2,45
11118,14.968750000001009,2121.5,46,29,1,75
11119,8.732250000001416,4260.85,56,31,0,87
11120,-4.193249999999233,3594.9,43,30,4,73
11121,46.45275000000148,5175.25,79,17,0,96
11122,8.467500000001191,3845.9473684210525,59,28,0,87
11123,11.461750000001171,3052.15,44,21,0,65
11124,-5.729999999997932,2978.176470588235,52,31,0,83
11125,8.169500000000737,3556.1052631578946,48,30,0,78
11126,4.973750000001209,3010.6315789473683,50,29,0,79
11127,-11.119999999999328,2668.8333333333335,31,28,1,59
11128,0.2245000000012006,1819.5333333333333,53,36,0,89
11129,-2.7757499999988666,3056.1,34,34,0,68
11130,-6.917749999999133,2681.1875,29,32,1,61
11131,16.24750000000069,3021.1176470588234,64,30,0,94
11132,-15.700749999999672,2991.315789473684,37,27,4,64
11133,34.693750000002076,5567.2,78,29,0,107
11134,34.41775000000174,3484.1176470588234,89,25,1,114
11135,4.269500000000807,3926.65,41,31,0,72
11136,-15.82899999999933,2249.705882352941,27,32,5,59
11137,24.391250000001463,2867.625,59,25,0,84
11138,15.258500000001002,3180.3333333333335,60,25,2,85
11139,32.07325000000192,3667.235294117647,70,28,0,98
11140,4.505500000000992,3349.05,44,29,0,73
11141,-24.47925000000013,1429.0,27,47,1,74
11142,-5.974499999998638,2670.125,48,33,0,81
11143,-4.869499999998887,3666.4,38,36,0,74
11144,11.2832500000019,2431.8823529411766,72,25,0,97
11145,43.162250000000896,4425.9473684210525,77,32,1,109
11146,32.01700000000151,4268.85,71,17,0,88
11147,21.825000000001374,2834.3529411764707,55,19,0,74
11148,-20.194249999999602,2008.5,16,30,0,46
11149,11.637000000001056,3393.315789473684,52,21,0,73
11150,-2.6237499999989757,3072.15,39,25,1,64
11151,46.3965000000009,3659.222222222222,82,25,0,107
11152,36.51950000000143,5452.1,67,38,0,105
11153,-28.06699999999909,1993.7368421052631,17,30,1,47
11154,21.85200000000144,4748.15,63,32,0,95
11155,17.429000000002805,5762.45,82,24,0,106
11156,-2.779249999998838,2515.823529411765,49,28,1,77
11157,-19.3289999999987,2733.277777777778,35,33,0,68
11158,5.733250000001068,3669.3333333333335,39,36,0,75
11159,-13.732499999999234,2124.705882352941,30,31,2,61
11160,8.56550000000071,2555.1176470588234,61,28,0,89
11161,6.758500000000533,2059.0,43,32,2,75
11162,1.645000000001269,2550.8,66,31,1,97
11163,3.799250000000785,3663.1052631578946,49,34,1,83
11164,-29.024749999999482,2599.65,21,35,1,56
11165,38.91425000000101,3844.3888888888887,67,27,0,94
11166,11.662250000001965,3878.0,59,28,0,87
11167,-27.66399999999906,2622.8947368421054,30,36,4,66
11168,23.842000000001295,4418.1,75,25,0,100
11169,-20.942749999999602,1978.842105263158,11,31,4,42
11170,28.761500000001377,4255.3,64,27,1,91
11171,-14.759750000000086,1917.611111111111,26,26,5,52
11172,3.0797500000014,3891.3529411764707,41,27,0,68
11173,3.5822500000001254,2457.222222222222,37,28,10,65
11174,16.40250000000149,3998.2,55,30,0,85
11175,-22.830749999999334,2555.9444444444443,29,40,2,69
11176,-11.514499999999321,1866.5,25,32,0,57
11177,21.268500000000856,3992.722222222222,78,32,0,110
11178,12.215500000000834,3720.7894736842104,44,37,0,81
11179,-4.797249999999939,1844.75,43,27,11,70
11180,25.5377500000017,4667.2,76,24,0,100
11181,2.6790000000014387,4407.6,58,33,0,91
11182,29.92275000000128,4454.45,71,18,3,89
11183,11.417500000000148,3056.0555555555557,65,35,3,100
11184,-11.138749999998975,2524.35,32,26,1,58
11185,30.21100000000161,4056.0,78,24,0,102
11186,11.33350000000126,3623.4,57,26,0,83
11187,-20.468999999998687,2277.25,38,36,2,74
11188,-34.49524999999976,2160.7,16,29,3,45
11189,16.68450000000182,3603.65,55,26,1,81
11190,36.019000000001725,5510.0,83,26,0,109
11191,-9.52649999999881,3960.8,48,20,0,68
11192,-28.876749999999753,1999.6315789473683,14,30,0,44
11193,11.545750000000528,2603.733333333333,69,26,1,95
11194,29.99100000000153,4551.0526315789475,71,32,0,103
11195,10.992500000000891,2541.266666666667,52,19,2,71
11196,23.145250000002953,5893.3,88,27,0,115
11197,31.295750000002705,5526.65,80,34,2,114
11198,-15.57249999999959,2126.529411764706,25,32,0,57
11199,1.527000000001513,2473.6875,49,34,0,83
11200,11.237000000001272,4357.7,61,31,1,92
11201,15.727500000002584,2875.4375,78,20,0,98
11202,-7.967749999999093,2786.285714285714,33,29,0,62
11203,-34.6284999999997,2048.0526315789475,18,28,2,46
11204,24.835250000000965,4690.684210526316,70,31,0,101
11205,-12.169749999999151,2687.8,24,42,0,66
11206,16.46600000000138,2532.705882352941,62,28,0,90
11207,1.30900000000055,2580.9375,31,26,0,57
11208,27.73700000000111,5882.35,75,21,0,96
11209,-25.688749999999477,2205.3,16,32,1,48
11210,6.287000000001268,3250.3333333333335,44,28,0,72
11211,17.91850000000145,3013.5882352941176,56,20,0,76
11212,-10.374000000000049,1925.5555555555557,34,33,5,67
11213,-33.62649999999995,1429.0,0,34,0,34
11214,0.40350000000178526,3619.65,60,23,0,83
11215,24.20600000000107,3623.55,54,22,0,76
11216,-18.035749999999993,2056.1,15,28,0,43
11217,9.266000000001164,3141.5789473684213,48,23,0,71
11218,-3.8394999999991923,2036.125,39,31,0,70
11219,-34.70075000000002,1429.0,3,28,5,31
11220,1.7397500000006794,3393.25,48,21,1,69
11221,-11.469249999999649,1839.8125,26,37,0,63
11222,-9.185999999999462,2499.315789473684,26,35,1,61
11223,32.99675000000121,4714.7,72,22,0,94
11224,-36.09549999999955,2243.35,14,33,4,47
11225,-0.32774999999936005,2429.294117647059,44,37,3,81
11226,-9.36874999999942,2413.1111111111113,41,25,0,66
11227,13.312750000000886,3484.1052631578946,57,23,0,80
11228,11.338500000001133,3703.7,51,21,0,72
11229,17.17100000000129,3760.7368421052633,59,30,0,89
11230,9.807000000001702,3210.0,84,33,0,117
11231,-2.990249999998953,2624.7368421052633,33,28,0,61
11232,25.58200000000118,2786.25,60,40,1,100
11233,-4.180749999999906,2565.3684210526317,42,35,2,77
11234,12.082500000001229,3544.3,57,19,0,76
11235,41.12175000000143,4169.421052631579,79,17,0,96
11236,-1.6972499999990327,3310.0,62,32,0,94
11237,2.6985000000006387,2023.25,48,23,3,71
11238,4.0035000000013286,3616.0,54,27,1,81
11239,20.28925000000117,3563.6315789473683,68,26,1,94
11240,12.858750000000509,2527.4375,45,33,0,78
11241,35.030500000001744,4154.45,80,16,0,96
11242,-7.8624999999988905,2334.705882352941,37,26,0,63
11243,-13.352999999999858,1966.888888888889,25,32,2,57
11244,-23.88324999999966,2048.1,15,17,6,32
11245,-36.27050000000048,1429.0,19,25,13,44
11246,-1.1372499999991088,2986.2631578947367,47,24,2,71
11247,-5.063249999999076,3259.3,42,27,0,69
11248,28.111250000001938,4806.9,84,13,0,97
11249,-8.634999999999074,3256.85,45,24,0,69
11250,-40.36100000000004,1429.0,0,30,1,30
11251,-10.608499999999296,2487.5789473684213,32,27,2,59
11252,-9.456499999999371,2601.75,29,26,0,55
11253,-21.909749999999786,1925.5555555555557,16,29,4,45
11254,15.154750000002258,4260.263157894737,78,35,0,113
11255,5.0982500000022615,2655.25,62,26,1,88
11256,-22.851249999999723,2349.722222222222,30,40,2,70
11257,26.46900000000146,4080.5789473684213,74,20,0,94
11258,-20.008249999999254,3103.65,37,27,0,64
11259,0.31925000000075554,2673.8947368421054,31,31,0,62
11260,8.130000000000683,3316.1666666666665,58,20,0,78
11261,-8.436749999999309,2489.1052631578946,35,22,0,57
11262,-29.509249999999604,2016.3,16,27,1,43
11263,-23.212999999999305,1958.0666666666666,39,26,8,65
11264,-20.213999999999576,2622.7,22,33,2,55
11265,31.091000000001138,5031.45,77,20,0,97
11266,-6.498499999999756,1944.4705882352941,35,37,5,72
11267,-6.018999999999265,2409.722222222222,36,25,0,61
11268,-22.693499999999677,2032.25,10,34,0,44
11269,-39.30924999999975,1429.0,12,33,0,45
11270,19.173750000000716,2505.3333333333335,57,34,0,91
11271,7.803500000000821,3598.5789473684213,50,35,0,85
11272,-4.180999999999118,3941.75,49,32,1,81
11273,18.34425000000281,2527.4666666666667,82,31,0,113
11274,31.028250000001748,3328.235294117647,84,21,0,105
11275,-25.765749999999468,2075.0,14,28,4,42
11276,33.72125000000261,4548.1,77,18,0,95
11277,-10.633249999999723,1907.1875,50,27,5,77
11278,18.103250000001278,3993.0526315789475,75,25,1,100
11279,-9.436999999999216,3076.0,44,23,0,67
11280,22.411500000003656,2675.5882352941176,78,28,1,106
11281,-1.3689999999984261,2074.8125,43,25,0,68
11282,-8.340249999999164,2933.294117647059,40,32,1,72
11283,28.187500000000625,3392.8888888888887,79,20,2,99
11284,12.323500000001616,4083.85,66,14,0,80
11285,21.045250000000877,4030.0,57,32,0,89
11286,-11.104749999999234,2545.1875,26,31,2,57
11287,-13.167999999999207,2655.25,32,30,1,62
11288,23.81175000000105,3711.1666666666665,61,29,1,90
11289,15.186750000003338,4984.631578947368,86,32,1,118
11290,6.690750000000993,2518.375,49,33,0,82
11291,-6.798249999999444,2726.5263157894738,29,32,5,61
11292,10.614250000000647,2005.1764705882354,44,15,5,59
11293,19.134750000001933,4322.9,63,29,1,92
11294,-3.073499999999172,2489.1111111111113,58,20,0,78
11295,-10.820999999998989,3615.6,42,28,0,70
11296,-3.5212499999994327,3040.1111111111113,41,40,1,81
11297,-14.666499999997336,2074.176470588235,40,35,2,75
11298,-27.06849999999946,2074.3,15,29,1,44
11299,-26.956249999999564,2040.2,17,32,3,49
11300,-13.098249999999322,2582.0526315789475,26,25,1,51
11301,-11.014249999998649,3052.2,39,25,0,64
11302,-0.4322499999986634,3805.7368421052633,51,40,0,91
11303,11.928500000000733,3147.8333333333335,52,27,1,79
11304,12.587500000001763,4093.3684210526317,61,24,0,85
11305,-14.308999999999495,2665.3888888888887,31,24,1,55
11306,45.72700000000212,5263.25,88,20,0,108
11307,21.124000000001423,3825.0,64,17,0,81
11308,4.126750000001087,3454.8125,75,18,0,93
11309,-3.8749999999989755,3528.3,45,20,3,65
11310,19.670500000001475,3828.722222222222,66,21,0,87
11311,44.88150000000216,5236.25,81,24,0,105
11312,27.324750000001178,4563.2,67,24,0,91
11313,5.068500000001088,3379.0,59,20,1,79
11314,25.072000000001566,4206.15,65,17,1,82
11315,9.714500000001234,3771.1,54,22,0,76
11316,-6.7727499999989025,2521.6111111111113,40,24,0,64
11317,0.6170000000004585,2400.25,37,26,0,63
11318,8.49725000000056,2967.0588235294117,44,29,1,73
11319,3.886000000001488,2448.0666666666666,54,24,0,78
11320,11.10025000000103,3748.315789473684,62,30,9,92
11321,20.03575000000088,2978.0588235294117,55,20,0,75
11322,30.00900000000064,2585.0588235294117,73,25,0,98
11323,23.981250000000877,2920.176470588235,67,23,0,90
11324,14.555250000001854,2093.6875,53,26,0,79
11325,12.092750000002017,4164.421052631579,68,22,0,90
11326,-18.07949999999944,1929.5294117647059,26,30,7,56
11327,43.516000000001775,5353.8,84,21,0,105
11328,-9.046999999999194,2546.9473684210525,31,26,1,57
11329,-1.1022499999991298,3182.25,45,22,1,67
11330,6.176250000001005,3270.35,40,30,0,70
11331,13.338250000000988,2950.3333333333335,49,21,1,70
11332,29.55150000000136,4940.315789473684,86,30,0,116
11333,25.0762500000023,4312.45,77,15,0,92
11334,-21.634249999999124,2082.6875,25,32,5,57
11335,26.313000000001363,2831.875,59,16,1,75
11336,5.686750000000832,2530.25,40,25,0,65
11337,-14.61124999999941,1953.7777777777778,26,24,3,50
11338,-3.8307499999990164,3544.95,35,31,2,66
11339,-8.920999999999001,3086.5789473684213,41,26,7,67
11340,-7.636249999999199,2420.705882352941,60,31,0,91
11341,25.235250000001816,4830.7,71,21,0,92
11342,25.00575000000155,2748.5625,64,17,0,81
11343,-8.536499999999268,2491.4375,27,41,0,68
11344,4.672500000000907,2534.5882352941176,48,32,1,80
11345,-27.314999999999475,2076.7,16,30,4,46
11346,5.214750000000689,2390.9333333333334,68,34,0,102
11347,-21.279000000000405,1429.0,24,33,3,57
11348,11.307000000000924,3209.5,63,31,3,94
11349,-1.8812499999993721,2023.3125,34,33,0,67
11350,-10.561749999999314,2454.875,38,24,0,62
11351,27.735250000001354,3095.875,71,17,0,88
11352,13.978500000001407,3857.8,67,15,0,82
11353,-20.663999999999845,2532.7368421052633,35,32,2,67
11354,-5.459749999998628,3088.6666666666665,54,25,4,79
11355,-2.719499999998894,2536.722222222222,34,27,0,61
11356,-5.5944999999996625,2030.2941176470588,39,27,4,66
11357,7.39900000000083,3010.4736842105262,49,25,0,74
11358,4.865750000000254,2440.7368421052633,41,22,9,63
11359,-16.699249999999644,2034.1176470588234,29,45,1,74
11360,-32.26425000000012,1429.0,0,33,4,33
11361,-10.048249999999205,2650.5789473684213,31,27,0,58
11362,15.16475000000121,3953.0,77,30,0,107
11363,-13.371250000000108,1429.0,21,31,2,52
11364,-16.193999999999644,1921.1764705882354,28,25,6,53
11365,6.239000000001097,2400.25,50,22,0,72
11366,-8.749999999998781,3623.6,49,27,0,76
11367,-28.650749999999626,2008.4,16,17,8,33
11368,7.142250000001125,3079.7894736842104,59,23,1,82
11369,14.209000000000406,3212.7368421052633,52,20,4,72
11370,16.018500000001062,2933.294117647059,53,38,0,91
11371,12.907500000001068,3350.5789473684213,63,27,2,90
11372,-3.7822499999990846,2050.0625,54,20,2,74
11373,23.939500000001253,4257.75,69,21,1,90
11374,-28.07899999999978,2008.5,12,27,2,39
11375,-16.401750000000202,1933.4444444444443,32,24,11,56
11376,-21.597499999999478,2114.1052631578946,21,29,1,50
11377,-7.861749999999278,2528.4736842105262,29,29,0,58
11378,-13.691499999999303,2564.05,28,27,0,55
11379,-4.963999999998488,3662.0526315789475,52,25,1,77
11380,-7.319999999999114,3068.05,37,29,1,66
11381,-5.078249999998888,3406.0,52,25,0,77
11382,13.955500000001232,3308.222222222222,60,23,0,83
11383,14.493750000001066,3680.6315789473683,62,30,0,92
11384,24.56800000000341,5452.1,88,29,1,117
11385,13.75550000000175,1974.75,51,25,4,76
11386,30.554750000002457,4282.777777777777,85,21,0,106
11387,-22.91124999999949,2032.25,17,24,5,41
11388,31.10775000000097,4714.8,76,15,0,91
11389,-1.7292499999993278,2841.9444444444443,47,24,0,71
11390,16.826250000001682,4459.2,65,19,6,84
11391,-17.621249999998984,4798.15,55,27,0,82
11392,13.954500000000888,4214.85,64,18,0,82
11393,7.410250000000742,3431.6315789473683,53,28,3,81
11394,12.315000000001245,4135.894736842105,61,24,1,85
11395,-13.152999999998846,3087.777777777778,41,35,0,76
11396,-16.403749999999206,2683.85,33,24,1,57
11397,3.342000000000778,3123.6,45,29,0,74
11398,5.7667500000012115,3698.1,61,17,0,78
11399,-14.700249999999485,2667.2,34,22,3,56
11400,43.54200000000155,6373.5,94,15,0,109
11401,4.688500000001589,3802.15,53,25,0,78
11402,-2.249749999998783,3343.4,50,28,0,78
11403,30.15150000000155,5331.45,81,20,0,101
11404,2.0280000000008966,3347.8823529411766,34,30,2,64
11405,-2.3577499999995597,2493.4736842105262,29,30,0,59
11406,6.379750000001659,2541.1111111111113,34,40,0,74
11407,9.673000000000654,4126.7,52,20,2,72
11408,20.326000000000604,2485.1176470588234,77,23,1,100
11409,31.93525000000141,4013.5625,76,20,1,96
11410,-34.677749999999584,2725.9,23,35,0,58
11411,-25.744499999999455,2083.75,22,20,5,42
11412,-5.22099999999846,3989.35,53,29,4,82
11413,-12.456999999999779,2059.235294117647,41,30,2,71
11414,1.994250000001233,3036.3,46,29,0,75
11415,3.7405000000007633,1929.4705882352941,55,27,1,82
11416,4.5960000000013865,4647.4,61,18,5,79
11417,26.716750000001657,4450.45,68,28,0,96
11418,-19.077749999998804,1871.5625,38,34,3,72
11419,7.431750000001982,3039.1875,50,33,0,83
11420,-4.7247499999992595,2070.529411764706,31,20,6,51
11421,-20.70024999999968,2053.705882352941,29,24,8,53
11422,-23.41799999999906,2544.15,31,26,0,57
11423,-28.1904999999994,2411.294117647059,31,35,4,66
11424,29.633250000001,2920.3125,78,28,0,106
11425,-2.8222499999984065,3906.0,53,29,2,82
11426,11.146250000001759,3332.1176470588234,66,25,0,91
11427,25.34625000000103,2917.25,65,16,1,81
11428,-4.717749999999899,1986.4705882352941,33,35,7,68
11429,16.146499999999705,1429.0,53,30,6,83
11430,39.97125000000132,5342.55,79,15,0,94
11431,9.02474999999989,2265.705882352941,55,17,2,72
11432,-9.836749999999174,2926.1052631578946,39,31,1,70
11433,-5.997999999999703,1857.5882352941176,51,29,3,80
11434,-9.616999999997955,2869.9444444444443,58,34,5,92
11435,6.690500000000687,3013.1052631578946,43,22,0,65
11436,-17.66499999999909,2674.684210526316,31,26,0,57
11437,21.541250000001607,3092.8823529411766,58,22,0,80
11438,-9.614999999998863,2500.5,52,27,0,79
11439,24.272000000001007,3841.6111111111113,62,27,0,89
11440,21.960000000000072,3115.0,104,22,1,126
11441,-33.4194999999996,1955.4444444444443,16,27,2,43
11442,-5.687999999998678,2413.1111111111113,39,28,0,67
11443,-27.680249999999795,1874.3529411764705,20,42,1,62
11444,7.167250000000647,1914.7333333333333,61,22,0,83
11445,-6.666249999999465,2585.8125,33,19,0,52
11446,-15.149749999999647,2606.3333333333335,36,28,10,64
11447,-26.212749999999506,2008.55,13,35,3,48
11448,-7.279499999998881,2451.8125,35,24,2,59
11449,24.16275000000054,3081.705882352941,76,33,2,109
11450,-7.1489999999990275,2512.8888888888887,33,22,3,55
11451,-35.21649999999985,1429.0,0,31,6,31
11452,18.922750000000466,2612.8571428571427,79,27,0,106
11453,35.306500000002835,5375.15,93,18,0,111
11454,5.42475000000158,3727.3888888888887,56,22,0,78
11455,-9.89974999999913,2538.4117647058824,34,31,1,65
11456,2.9070000000010263,3167.25,46,24,0,70
11457,-11.528749999999043,2500.5,34,28,0,62
11458,-7.247749999999499,1933.5,34,29,1,63
11459,20.205250000001065,2438.0,60,28,0,88
11460,1.866250000001451,2511.235294117647,50,23,1,73
11461,14.294000000000906,4774.35,72,21,0,93
11462,-3.116999999998845,3493.35,48,20,4,68
11463,4.087250000000802,2348.625,59,19,1,78
11464,-9.0377499999999,1996.888888888889,43,25,4,68
11465,-19.117749999999198,2496.4117647058824,28,26,2,54
11466,-11.093749999998957,3094.2,42,23,1,65
11467,11.642000000000818,2822.0,60,26,0,86
11468,-18.036749999998932,3464.2631578947367,40,33,2,73
11469,-0.4992499999991208,2011.6470588235295,37,23,1,60
11470,9.93600000000051,2512.176470588235,73,26,0,99
11471,-2.4117499999984378,3208.4,45,24,1,69
11472,-9.513499999999885,1975.3529411764705,26,32,2,58
11473,-0.5102499999998736,2698.0,73,30,0,103
11474,30.522499999999916,2457.733333333333,87,27,0,114
11475,9.021500000001273,3779.1,57,29,0,86
11476,-16.65749999999865,2667.9,31,26,3,57
11477,1.4080000000008994,2868.8823529411766,55,21,3,76
11478,-21.084750000000266,2131.6315789473683,33,32,5,65
11479,-25.12099999999949,2008.55,13,30,0,43
11480,3.7322500000005085,2977.777777777778,41,27,0,68
11481,-22.57874999999948,2028.3,18,23,5,41
11482,-18.84874999999933,2521.684210526316,27,28,1,55
11483,-14.796249999999606,1991.5,34,27,0,61
11484,6.604250000001779,3405.1666666666665,59,25,0,84
11485,-14.195499999999498,2405.3333333333335,28,27,1,55
11486,-14.193499999999924,2139.5882352941176,41,28,4,69
11487,-3.5642499999988146,4035.5263157894738,65,24,0,89
11488,-17.998999999999448,2528.25,28,23,0,51
11489,-4.914749999998912,2513.1176470588234,38,31,1,69
11490,11.806250000003377,1429.0,82,27,2,109
11491,4.786500000000858,3976.75,55,22,1,77
11492,-25.652249999998872,2647.529411764706,41,49,2,90
11493,-17.786749999999092,2528.2,32,23,2,55
11494,42.457250000002304,4433.263157894737,83,19,1,102
11495,-2.040999999998875,3338.55,46,29,1,75
11496,15.772500000000804,2568.0625,69,13,3,82
11497,19.498250000000848,4111.578947368421,81,16,1,97
11498,6.760750000000907,3236.9473684210525,43,28,0,71
11499,-34.68174999999912,2007.157894736842,17,29,4,46
11500,4.166750000000361,2587.777777777778,46,36,4,82
11501,-16.645999999999177,2923.55,36,24,0,60
11502,3.7652500000011324,3623.6,53,25,0,78
11503,14.895250000001761,3529.0,77,21,0,98
11504,2.61625000000103,2514.8,50,30,1,80
11505,-9.139999999999727,2589.5789473684213,30,25,1,55
11506,0.8447500000010194,3119.65,40,34,0,74
11507,-28.467249999999087,1944.4117647058824,27,35,0,62
11508,-5.887999999999424,2054.0,40,29,0,69
11509,-2.3909999999989275,3131.4,47,21,0,68
11510,13.441250000002023,4206.95,68,23,0,91
11511,34.003500000002035,4312.9473684210525,83,13,0,96
11512,39.82325000000136,4714.7,83,14,0,97
11513,-13.03674999999914,2473.1666666666665,27,26,3,53
11514,-24.206749999998923,2055.6315789473683,25,26,5,51
11515,10.214000000000599,2508.375,50,28,5,78
11516,-9.17649999999927,2632.15,32,26,0,58
11517,13.037000000001907,2702.6470588235293,62,18,4,80
11518,-9.31699999999906,2598.842105263158,31,27,1,58
11519,-4.4672499999986135,2608.1111111111113,46,28,2,74
11520,1.4145000000005459,2429.0666666666666,55,30,0,85
11521,1.9725000000025719,2550.8,57,28,2,85
11522,27.963250000002756,4532.631578947368,98,15,1,113
11523,-23.85949999999965,2003.1666666666667,24,29,9,53
11524,-17.311499999999082,2504.705882352941,29,29,0,58
11525,-16.509249999999337,2491.722222222222,30,29,0,59
11526,-19.22399999999999,2191.0526315789475,26,31,4,57
11527,-4.138249999999283,2560.05,28,32,2,60
11528,-11.937249999999292,2413.1111111111113,31,25,4,56
11529,-4.466249999999025,2462.6470588235293,46,30,0,76
11530,10.072500000001131,2510.6,56,20,2,76
11531,-26.16424999999959,2024.25,21,24,2,45
11532,7.67925000000066,3707.7,53,17,2,70
11533,7.567500000001404,5382.2,71,22,0,93
11534,-6.443999999998468,3213.5263157894738,47,29,2,76
11535,16.102750000002352,4067.95,73,21,0,94
11536,-10.19725000000007,1875.4375,52,33,0,85
11537,29.156250000001428,3185.3529411764707,68,26,0,94
11538,2.2730000000010415,2798.4444444444443,59,20,1,79
11539,18.034750000001132,4069.3333333333335,81,18,0,99
11540,12.26850000000137,4268.8,56,24,0,80
11541,-11.980999999998991,2650.3888888888887,40,22,1,62
11542,-29.857500000000044,1429.0,3,33,10,36
11543,-11.429999999998989,2454.235294117647,30,37,0,67
11544,-8.683249999999873,2306.5,28,22,9,50
11545,22.030500000001744,4647.35,79,21,0,100
11546,35.88750000000194,5592.45,84,20,0,104
11547,-21.406500000000257,1952.9444444444443,37,40,2,77
11548,-5.744749999999183,2633.285714285714,37,22,1,59
11549,-25.04024999999989,1925.5,18,34,10,52
11550,-8.821999999999022,2343.176470588235,36,32,3,68
11551,-21.926000000000027,2026.4736842105262,29,36,7,65
11552,-22.19349999999887,2579.3333333333335,31,31,0,62
11553,-10.295499999999084,2479.3888888888887,44,23,0,67
11554,-8.228999999999347,2631.705882352941,30,30,0,60
11555,-14.473749999999523,2018.375,33,31,0,64
11556,-13.634499999998766,3229.95,45,29,0,74
11557,-10.017249999999475,2482.8333333333335,40,26,7,66
11558,-5.657999999999584,2564.75,34,20,0,54
11559,-27.905749999999767,1997.1052631578948,21,26,13,47
11560,28.777750000002452,2897.9333333333334,87,10,0,97
11561,22.708500000001685,4549.75,72,19,0,91
11562,-11.593999999999792,1429.0,38,30,2,68
11563,4.0065000000007025,3038.9473684210525,43,22,2,65
11564,19.237000000001977,2192.0,63,18,0,81
11565,-9.864499999999625,1904.2941176470588,24,31,1,55
11566,-1.489749999999162,3655.35,59,19,0,78
11567,27.22075000000308,2875.3529411764707,86,17,1,103
11568,-1.1949999999986205,3175.15,51,21,0,72
11569,10.814500000001132,2391.0,67,27,1,94
11570,-13.331499999998893,3237.0,37,25,0,62
11571,15.602250000002613,4317.15,76,22,0,98
11572,-7.624499999999263,2892.7894736842104,36,31,2,67
11573,3.619250000001371,3138.65,51,24,0,75
11574,-13.349749999999423,2575.85,35,18,1,53
11575,5.621000000001144,2467.133333333333,53,23,2,76
11576,5.403250000000621,3574.25,49,30,1,79
11577,-10.2230000000001,1438.5333333333333,36,38,4,74
11578,-5.273999999999961,2595.75,35,20,0,55
11579,-6.223999999999422,2526.842105263158,36,29,2,65
11580,-17.667500000000032,1532.1875,33,32,9,65
11581,-14.592499999999784,1795.1176470588234,24,30,3,54
11582,-20.96774999999941,2601.2631578947367,29,34,5,63
11583,-3.3974999999989306,2756.764705882353,44,32,0,76
11584,-28.81374999999926,1975.8333333333333,21,26,4,47
11585,23.64375000000205,4281.5,82,18,0,100
11586,-8.797249999999007,3279.9,38,24,1,62
11587,-28.137499999999353,2034.7368421052631,16,31,0,47
11588,-20.377999999999776,1429.0,24,35,5,59
11589,2.6470000000012766,3508.45,44,22,5,66
11590,10.214000000000272,3523.5263157894738,61,32,0,93
11591,-6.5932499999990055,3195.7,42,26,0,68
11592,-3.112499999998928,3207.7894736842104,43,25,1,68
11593,5.54900000000016,1921.1176470588234,42,32,0,74
11594,25.984750000000258,3286.222222222222,73,28,0,101
11595,-10.985499999999188,2690.95,32,27,0,59
11596,-22.888749999999554,2040.15,11,36,0,47
11597,1.4012500000016304,2554.0,50,28,0,78
11598,7.899250000001551,4194.95,70,19,0,89
11599,-40.82649999999963,1429.0,0,34,3,34
11600,5.9505000000004244,2531.1052631578946,49,26,4,75
11601,10.63275000000083,2905.3529411764707,56,18,0,74
11602,8.837250000000447,2916.4117647058824,64,38,0,102
11603,23.711500000000886,3655.8333333333335,67,19,1,86
11604,-12.05974999999972,1984.5555555555557,30,27,2,57
11605,-5.608249999999015,2388.8823529411766,41,26,0,67
11606,10.831500000001117,2541.266666666667,55,23,0,78
11607,17.87200000000094,3231.4444444444443,63,30,0,93
11608,-7.546999999999173,1954.764705882353,35,26,1,61
11609,-20.825249999999738,2040.15,12,31,0,43
11610,-32.55624999999968,1933.388888888889,11,37,3,48
11611,-7.739499999999363,2880.65,28,32,1,60
11612,-38.30299999999953,2020.25,13,26,1,39
11613,-3.9464999999993395,3221.85,49,28,0,77
11614,13.619750000000442,2503.5625,64,22,4,86
11615,2.228250000001573,3243.1111111111113,55,24,0,79
11616,12.109500000000857,2561.785714285714,52,33,0,85
11617,-5.145999999999178,2623.0714285714284,35,28,4,63
11618,32.60000000000138,4735.736842105263,81,24,0,105
11619,-2.646749999999312,3052.1,33,29,0,62
11620,23.97575000000161,2011.764705882353,57,26,0,83
11621,8.477000000001505,2541.176470588235,52,32,1,84
11622,-10.206499999999334,2678.25,28,35,0,63
11623,0.4682500000007531,3309.35,49,20,0,69
11624,16.5790000000003,2479.470588235294,69,35,0,104
11625,19.864250000001697,4127.6,68,25,0,93
11626,25.9065000000019,4289.4,71,27,0,98
11627,-25.2712499999996,2169.55,14,36,0,50
11628,0.6985000000011026,3150.45,47,27,0,74
11629,-10.809749999999392,2630.5,32,21,0,53
11630,-8.888499999999441,2512.684210526316,28,28,1,56
11631,-18.33174999999941,1934.0,26,32,7,58
11632,20.539000000000406,3651.277777777778,56,23,0,79
11633,40.31050000000147,4697.210526315789,92,26,0,118
11634,21.713750000000864,3474.75,69,16,0,85
11635,-15.95549999999946,2652.85,30,27,1,57
11636,-7.745749999998654,3095.7,46,19,2,65
11637,6.126500000001572,3247.7368421052633,52,34,0,86
11638,18.77075000000098,3688.157894736842,53,33,0,86
11639,22.139000000000586,5119.6,72,19,0,91
11640,-7.818249999999473,2112.4444444444443,32,28,2,60
11641,24.233750000002487,2157.1875,76,20,0,96
11642,32.82600000000035,3152.375,84,10,0,94
11643,15.30700000000169,2862.294117647059,63,30,0,93
11644,13.722500000001101,3568.0,59,18,0,77
11645,36.173250000001055,2986.529411764706,88,25,0,113
11646,6.617750000001055,3793.3,50,26,0,76
11647,-9.145249999999507,2874.470588235294,72,36,0,108
11648,-13.307749999999519,2559.95,31,23,1,54
11649,10.146250000000801,3174.3,44,26,0,70
11650,21.075500000001618,4660.05,61,19,0,80
11651,21.184250000002102,4497.578947368421,71,19,0,90
11652,-25.328249999999237,1933.4444444444443,24,26,9,50
11653,-3.864749999999591,2591.85,31,28,0,59
11654,-3.794499999999192,1429.0,40,23,3,63
11655,-20.217499999999074,1481.9333333333334,27,30,0,57
11656,-31.040249999999382,1429.0,14,29,4,43
11657,27.90525000000133,3929.4210526315787,80,22,0,102
11658,-9.630999999999121,2554.125,35,23,0,58
11659,29.33550000000242,4278.4,77,21,0,98
11660,14.733500000001552,4679.95,72,23,0,95
11661,10.33900000000083,5364.8,56,26,0,82
11662,21.158250000001726,4147.3,71,17,0,88
11663,-12.894499999999601,1999.6315789473683,23,19,5,42
11664,24.39200000000106,3794.0555555555557,82,22,0,104
11665,-6.821499999998878,1947.611111111111,28,31,1,59
11666,32.18725000000215,4504.705882352941,97,19,0,116
11667,35.23300000000166,4837.05,82,22,0,104
11668,-15.50799999999948,2183.0,18,33,0,51
11669,3.5317500000015256,2920.25,52,28,0,80
11670,32.55825000000235,4852.95,80,16,1,96
11671,-1.7507499999994045,2520.9285714285716,45,26,0,71
11672,21.668000000001324,4509.3,73,16,0,89
11673,1.3080000000013436,2476.6875,57,24,1,81
11674,20.277750000000644,5035.4,63,28,0,91
11675,16.68200000000199,2491.5,58,28,0,86
11676,7.715250000001679,4035.4,61,27,0,88
11677,7.789500000000169,2528.0,46,22,1,68
11678,9.258250000000608,3392.3684210526317,60,28,0,88
11679,-25.12924999999995,2269.3529411764707,34,24,3,58
11680,-15.246999999999854,2964.75,29,30,0,59
11681,18.23625000000193,2482.625,81,27,0,108
11682,11.871500000001868,2246.4375,63,29,0,92
11683,27.03800000000055,3998.0,73,23,1,96
11684,47.31200000000301,5815.6,105,14,0,119
11685,5.363250000000893,2341.235294117647,44,35,0,79
11686,12.413000000001578,3745.8,67,18,0,85
11687,12.566500000001824,2955.705882352941,65,24,0,89
11688,-15.372500000000121,1438.5333333333333,39,40,0,79
11689,21.702750000001405,3599.7,55,28,0,83
11690,-16.719499999999126,3154.4,42,19,2,61
11691,-40.10849999999986,1429.0,0,31,1,31
11692,14.05900000000209,4619.5,67,24,0,91
11693,30.144250000001033,5460.8,89,19,0,108
11694,20.230250000000815,4102.421052631579,75,19,2,94
11695,-40.440499999999844,1429.0,0,37,1,37
11696,-12.779499999999206,2027.25,51,26,2,77
11697,12.268000000001171,4401.526315789473,71,28,3,99
11698,-22.262249999999607,2008.45,15,29,0,44
11699,-36.670749999999785,1429.0,14,28,3,42
11700,-20.098249999998764,2571.0,39,25,0,64
11701,15.174750000001712,4098.315789473684,75,23,1,98
11702,-0.7924999999990792,2467.2,63,34,0,97
11703,22.186250000001923,5555.3,77,34,1,111
11704,2.4820000000011633,1904.2941176470588,43,38,1,81
11705,-45.365250000000245,1429.0,15,36,15,51
11706,15.084500000001489,2994.625,65,16,0,81
11707,15.309500000001,4194.9,61,17,0,78
11708,11.613750000000719,2446.9375,57,30,0,87
11709,-17.04974999999903,2053.266666666667,31,29,2,60
11710,-16.3647499999997,2028.3,18,29,0,47
11711,-25.285249999999532,2028.3,14,29,4,43
11712,25.56625000000077,3378.705882352941,76,23,0,99
11713,20.26100000000042,2558.125,51,23,0,74
11714,9.28425000000087,2244.0588235294117,60,26,0,86
11715,7.702750000001446,3647.3,47,23,0,70
11716,2.5110000000010375,3274.3,44,27,0,71
11717,-7.5377499999983115,2575.133333333333,45,25,1,70
11718,13.871750000000791,3581.5,51,21,0,72
11719,4.318500000001253,3576.8947368421054,52,34,0,86
11720,3.515250000000575,2440.7368421052633,30,28,14,58
11721,-34.721999999999554,2076.277777777778,19,25,5,44
11722,29.295000000001853,3111.6875,86,20,0,106
11723,18.906250000000902,3057.529411764706,63,19,0,82
11724,2.699750000001037,2192.8823529411766,43,30,0,73
11725,5.461250000001257,3070.529411764706,60,13,0,73
11726,-4.670749999999147,2026.9444444444443,30,25,2,55
11727,-9.826249999999293,2556.05,29,28,0,57
11728,-5.0754999999993995,2993.842105263158,38,32,1,70
11729,-5.45799999999929,2519.4210526315787,29,30,0,59
11730,-23.586249999999364,2008.35,13,31,2,44
11731,56.50250000000226,6198.526315789473,107,28,0,135
11732,7.854750000000841,2989.0,47,23,5,70
11733,2.5535000000011556,3643.1052631578946,57,30,0,87
11734,12.934750000001802,5818.0,79,34,0,113
11735,-5.780499999999563,3066.5263157894738,39,28,6,67
11736,41.653750000002226,4183.944444444444,89,17,0,106
11737,19.218500000001345,4206.8,67,16,0,83
11738,28.01875000000198,4670.526315789473,78,27,0,105
11739,22.35325000000112,4199.8,60,22,0,82
11740,6.61225000000217,2480.6875,57,35,0,92
11741,-16.94374999999931,2413.1666666666665,31,35,1,66
11742,-5.734499999999356,3264.8,42,30,0,72
11743,-8.096499999999228,2497.5789473684213,26,33,1,59
11744,36.741250000001976,4675.25,83,20,0,103
11745,0.7470000000009607,2616.705882352941,44,23,0,67
11746,8.501750000001328,4075.0,65,21,0,86
11747,31.536250000001832,4691.85,86,17,0,103
11748,-1.2319999999983657,4038.2105263157896,62,23,0,85
11749,14.260250000000834,4531.0,77,34,0,111
11750,-18.57024999999931,2577.842105263158,28,24,0,52
11751,-11.767999999999352,1895.9411764705883,27,32,0,59
11752,-18.943249999999544,2110.85,14,35,0,49
11753,20.561000000001933,4859.2,67,26,0,93
11754,32.92050000000232,5895.0,93,18,0,111
11755,-9.043749999998564,1965.2777777777778,35,35,0,70
11756,1.4590000000016796,2920.25,67,33,0,100
11757,-3.9607499999990834,1969.75,37,30,0,67
11758,7.33825000000204,3904.45,64,28,0,92
11759,-4.769749999998842,3006.777777777778,49,36,0,85
11760,1.1055000000006254,2336.5882352941176,51,34,0,85
11761,25.77125000000283,4211.7,74,20,0,94
11762,-0.3727499999990827,3055.6315789473683,51,25,3,76
11763,34.35825000000165,3973.8947368421054,69,20,0,89
11764,15.7110000000015,3892.65,63,28,1,91
11765,9.454250000000275,3652.9473684210525,57,21,3,78
11766,-24.614749999999596,2122.7,13,33,0,46
11767,-3.1799999999992967,2841.722222222222,37,31,0,68
11768,-12.800749999999312,1956.5294117647059,29,28,1,57
11769,-12.021999999999126,2509.3333333333335,28,28,0,56
11770,15.59825000000188,4565.5,67,33,0,100
11771,-27.406749999999203,2503.3684210526317,32,29,1,61
11772,-32.36974999999936,1898.25,26,27,0,53
11773,-9.890249999999348,2489.8888888888887,29,29,0,58
11774,-6.704249999999268,2054.0,42,27,0,69
11775,-8.467499999999095,2513.1176470588234,35,28,0,63
11776,13.380500000001444,4558.5,60,30,0,90
11777,27.491750000001513,4718.75,79,16,0,95
11778,-29.00299999999852,3796.5,38,40,1,78
11779,9.91925000000074,3100.6,49,22,0,71
11780,-11.643749999999361,2005.4375,30,34,1,64
11781,25.227750000001386,4476.789473684211,71,28,0,99
11782,29.513500000001283,4603.75,65,18,0,83
11783,18.014250000001006,4340.95,55,20,0,75
11784,-19.297249999999188,2467.133333333333,31,32,4,63
11785,69.00100000000295,6528.2,118,13,0,131
11786,-8.745499999998902,2672.823529411765,51,32,0,83
11787,-14.049499999998943,2316.0588235294117,40,30,2,70
11788,46.51150000000169,5306.1,86,13,1,99
11789,-20.51549999999989,2241.1052631578946,34,31,2,65
11790,15.528000000000862,2505.266666666667,63,38,0,101
11791,-26.275249999999524,1959.4736842105262,13,30,5,43
11792,2.884500000000758,1991.5,43,35,0,78
11793,7.7980000000011955,4970.368421052632,66,38,0,104
11794,7.491250000001652,2499.0588235294117,64,36,2,100
11795,27.68025000000195,4932.35,71,34,0,105
11796,16.298000000000968,3536.35,51,19,0,70
11797,-34.133499999999614,1946.875,29,36,1,65
11798,34.66500000000226,5171.25,90,15,0,105
11799,27.236000000000665,3833.3529411764707,66,37,0,103
11800,-6.745999999999223,2530.3333333333335,25,34,0,59
11801,-5.535999999999166,3164.7,35,32,0,67
11802,0.7492500000007476,3272.8947368421054,47,30,3,77
11803,17.199750000001153,4018.2105263157896,76,21,2,97
11804,-21.846499999999658,2048.1,17,30,0,47
11805,3.3805000000021486,2492.5625,62,24,0,86
11806,19.250500000001033,3744.25,49,33,0,82
11807,15.474250000001627,3698.15,63,26,0,89
11808,-5.138499999999285,2544.15,27,33,0,60
11809,-26.478249999999804,1925.5,30,26,5,56
11810,-7.176499999999374,2490.777777777778,31,26,0,57
11811,4.512750000000541,2437.8888888888887,39,27,0,66
11812,-5.881249999998848,3080.1,39,27,0,66
11813,3.7017500000004993,2518.375,46,34,0,80
11814,-3.873749999999643,2568.125,35,30,0,65
11815,18.513000000001707,4736.631578947368,70,27,0,97
11816,-6.567499999997726,3595.315789473684,50,29,9,79
11817,50.0325000000031,6179.1,101,26,0,127
11818,29.738250000001518,4684.684210526316,82,27,0,109
11819,23.0370000000017,4872.8,78,32,0,110
11820,12.840000000001506,4707.55,73,25,0,98
11821,25.537750000001388,4011.7,64,20,0,84
11822,3.6867500000003366,2762.6153846153848,47,34,1,81
11823,-17.85775000000014,1429.0,34,25,0,59
11824,30.015750000001265,3597.1176470588234,68,30,0,98
11825,-5.545999999999677,2595.8,29,23,0,52
11826,-6.911249999999626,1996.764705882353,35,30,3,65
11827,-14.477499999999608,2454.1052631578946,21,30,1,51
11828,3.5255000000007293,3306.0,37,26,0,63
11829,19.769750000001956,3496.9444444444443,70,21,0,91
11830,34.97900000000133,4677.777777777777,83,16,0,99
11831,26.83225000000196,4687.15,77,21,0,98
11832,-2.0837499999985845,3317.0526315789475,54,24,0,78
11833,8.90425000000035,2758.846153846154,44,30,0,74
11834,-11.22350000000049,2183.0,39,29,1,68
11835,-13.396749999999079,2563.1,32,27,0,59
11836,10.479000000000466,3508.4736842105262,75,20,0,95
11837,-12.440249999998949,2721.05,39,28,0,67
11838,17.002500000001493,4282.894736842105,68,23,1,91
11839,5.253750000000567,3702.9,48,30,0,78
11840,5.87925000000058,3608.7894736842104,42,27,0,69
11841,-40.36899999999986,1429.0,0,36,0,36
11842,23.95600000000103,4171.2,66,21,0,87
11843,8.248750000001142,3112.5625,54,29,0,83
11844,-7.993999999999128,2616.9473684210525,41,35,9,76
11845,-0.40974999999892614,3787.8,61,23,0,84
11846,13.38125000000112,2750.176470588235,69,30,1,99
11847,9.12000000000196,2859.5625,53,35,0,88
11848,19.295000000001014,3018.3125,69,24,0,93
11849,0.7782500000004138,2018.25,42,34,0,76
11850,-1.3514999999990984,2476.733333333333,50,21,0,71
11851,-36.29399999999988,1429.0,0,35,1,35
11852,8.862250000001364,3471.3333333333335,44,40,0,84
11853,-13.133249999999649,1958.4705882352941,25,41,0,66
11854,-4.780499999999874,2328.3529411764707,34,32,0,66
11855,16.494500000002112,2766.235294117647,63,18,1,81
11856,-15.362249999998975,2500.4444444444443,25,39,0,64
11857,11.639000000000943,2967.764705882353,80,35,7,115
11858,2.9520000000005324,3116.6315789473683,48,30,1,78
11859,0.17550000000067145,2989.8333333333335,47,27,2,74
11860,6.354250000001358,3687.05,53,25,0,78
11861,-9.361749999998542,2499.5,47,33,0,80
11862,53.644500000002,5890.25,86,26,0,112
11863,-11.473999999999076,2444.8888888888887,29,32,0,61
11864,2.6852500000006794,3341.315789473684,70,25,2,95
11865,4.220000000000768,3150.157894736842,45,20,0,65
11866,-10.814750000000132,1429.0,32,41,0,73
11867,41.059000000002186,5171.25,82,19,0,101
11868,22.849500000001775,4898.85,79,15,1,94
11869,11.438750000002344,4103.75,74,20,0,94
11870,27.56225000000141,3592.277777777778,72,24,2,96
11871,18.267500000000595,3732.315789473684,59,24,0,83
11872,-22.251249999999676,2413.1666666666665,32,43,0,75
11873,7.187250000001515,3230.2631578947367,52,25,1,77
11874,28.365750000000798,4169.263157894737,62,25,0,87
11875,31.00625000000155,5310.05,81,20,0,101
11876,6.707250000001099,3506.7894736842104,50,28,0,78
11877,7.710250000000523,3462.45,38,33,0,71
11878,23.982000000001243,3980.4736842105262,88,22,2,110
11879,-9.09049999999964,3191.0526315789475,37,30,1,67
11880,-15.09524999999887,3024.35,34,25,0,59
11881,29.09900000000183,4778.3,72,28,0,100
11882,16.101250000001507,3591.85,50,31,0,81
11883,1.055000000000748,1929.4705882352941,48,28,0,76
11884,17.108000000002125,2614.0714285714284,62,24,0,86
11885,-26.36349999999944,1963.7894736842106,16,34,0,50
11886,-26.010749999999007,3154.5,29,42,0,71
11887,-8.159749999999159,3175.1666666666665,44,40,0,84
11888,14.67675000000084,4155.2,56,27,0,83
11889,6.249000000001712,4991.0,61,31,0,92
11890,14.843750000000961,4064.842105263158,70,30,2,100
11891,-17.53574999999963,2028.25,15,33,0,48
11892,23.637500000001197,4418.15,66,20,0,86
11893,17.266250000001186,2943.277777777778,52,22,0,74
11894,11.772250000000719,2201.875,81,22,0,103
11895,-15.054999999999183,2609.0555555555557,27,28,0,55
11896,2.9575000000012532,4920.4,70,27,0,97
11897,-4.834500000000137,2718.1052631578946,36,30,0,66
11898,6.078250000000903,2411.125,56,34,0,90
11899,21.755500000001405,4159.3,51,32,0,83
11900,29.016500000002303,6313.2,75,29,2,104
11901,14.877500000001518,3858.9285714285716,63,23,0,86
11902,-3.882499999999419,2486.3888888888887,24,33,2,57
11903,18.429750000001995,4413.35,70,30,0,100
11904,7.213000000002564,3017.3888888888887,62,33,0,95
11905,-15.671749999999204,2518.4210526315787,33,29,0,62
11906,24.035250000000612,2768.1875,78,23,0,101
11907,0.8812500000011344,2014.375,39,29,1,68
11908,4.97825000000171,2995.0588235294117,55,27,0,82
11909,-10.40149999999964,2063.0,29,29,0,58
11910,19.726000000000724,3328.5,47,25,1,72
11911,4.711000000001684,4299.05,54,27,0,81
11912,13.194500000001735,4660.15,65,24,0,89
11913,0.3382500000016835,4387.1,65,29,0,94
11914,23.43425000000186,4056.1111111111113,71,21,0,92
11915,21.822000000001772,4335.578947368421,62,26,0,88
11916,-8.696249999999111,3237.1,38,26,0,64
11917,-28.22074999999981,1967.1052631578948,17,27,5,44
11918,2.4665000000007065,4079.85,37,38,0,75
11919,33.70575000000069,4429.85,56,24,0,80
11920,23.162750000001303,3734.1666666666665,57,27,0,84
11921,-2.9217499999989025,3931.45,47,36,0,83
11922,13.226250000001874,4045.4736842105262,58,32,0,90
11923,30.7907500000024,4563.95,71,30,0,101
11924,12.94675000000206,4039.7894736842104,65,26,0,91
11925,11.938250000001798,3599.6,60,23,1,83
11926,4.983500000000718,3081.5263157894738,55,27,5,82
11927,-6.624999999998894,3266.4,39,31,0,70
11928,16.87700000000129,2610.625,54,28,0,82
11929,13.680250000001447,4396.526315789473,72,35,1,107
11930,23.93750000000118,4032.25,60,18,0,78
11931,27.46250000000224,4156.684210526316,59,36,0,95
11932,4.914750000001119,3095.8,41,28,0,69
11933,-4.259749999998399,3083.95,38,34,0,72
11934,23.364750000002214,5210.85,76,26,0,102
11935,5.926750000001013,2528.25,38,31,1,69
11936,11.520000000000206,2396.375,51,31,0,82
11937,-13.232749999999388,2421.0555555555557,25,42,0,67
11938,-3.0457499999991122,2992.2105263157896,33,31,1,64
11939,-9.067249999999351,2482.777777777778,30,28,2,58
11940,10.727500000001456,4264.0,51,39,0,90
11941,-10.87224999999839,3783.9,45,36,0,81
11942,-13.953999999999226,2552.05,25,34,0,59
11943,19.73225000000155,4310.95,65,26,1,91
11944,6.308250000001266,4566.0526315789475,61,41,0,102
11945,2.7895000000009853,2857.625,55,37,0,92
11946,-3.6592499999992967,3896.5,32,43,0,75
11947,18.30025000000156,2655.25,56,33,0,89
11948,14.532500000002205,5348.95,65,29,0,94
11949,37.259500000002255,5694.3,78,20,0,98
11950,21.032500000000777,4187.05,54,29,0,83
11951,19.332750000001077,3571.157894736842,49,32,0,81
11952,35.8637500000022,4687.0,75,18,0,93
11953,4.990000000000623,3128.2631578947367,40,35,0,75
11954,13.535750000002327,4577.6,63,24,0,87
11955,21.60225000000024,2721.75,68,30,0,98
11956,-13.520499999999222,2564.0,29,28,0,57
11957,-14.251750000000044,2119.4444444444443,29,33,1,62
11958,-14.12074999999837,2991.5625,55,37,0,92
11959,-14.929749999998986,2589.875,29,30,0,59
11960,21.43250000000062,2367.6666666666665,54,22,0,76
11961,13.458750000001189,3681.45,46,27,0,73
11962,29.198750000001176,4471.1,48,39,1,87
11963,15.924750000001087,4269.7,52,33,0,85
11964,13.772000000001366,3667.2,56,28,0,84
11965,8.017750000001616,4228.2,48,33,0,81
11966,-17.106249999999264,2949.6315789473683,29,39,0,68
11967,2.93000000000278,1853.3333333333333,57,37,0,94
11968,1.4135000000008087,3954.4,40,38,0,78
11969,41.034000000001576,3474.0,83,34,2,117
11970,-8.24574999999912,2989.6315789473683,36,36,3,72
11971,24.239000000001187,3798.4166666666665,48,34,0,82
11972,13.57325000000112,5279.85,68,28,0,96
11973,1.5487500000014423,3584.0,43,30,0,73
11974,17.217500000001234,3671.1,50,27,0,77
11975,-10.988249999999221,2487.1666666666665,30,32,2,62
11976,17.984250000000994,2923.9411764705883,51,24,0,75
11977,7.123750000001317,4044.7894736842104,58,37,1,95
11978,-1.6934999999991867,2727.823529411765,54,36,1,90
11979,-11.381249999999188,1928.0625,27,28,0,55
11980,10.07375000000097,4871.1,63,36,0,99
11981,-5.843999999999255,3651.3333333333335,45,37,0,82
11982,1.070500000001139,3742.6,44,31,0,75
11983,-11.502499999998538,3515.8947368421054,62,29,0,91
11984,16.264500000001796,4985.45,59,37,0,96
11985,-3.604999999998544,2543.4,54,24,0,78
11986,1.788250000000703,3027.5,51,44,0,95
11987,-7.850499999999234,3154.45,36,38,0,74
11988,4.932250000001132,2681.1176470588234,49,35,0,84
11989,19.936250000001788,4071.6315789473683,53,28,0,81
11990,24.078250000001102,4192.75,56,31,0,87
11991,26.387000000002057,4651.35,62,30,0,92
11992,32.5597500000015,2748.5625,65,25,1,90
11993,15.959250000000429,2803.529411764706,66,36,0,102
11994,-17.66699999999886,3347.25,35,34,1,69
11995,-1.5729999999995083,2345.1176470588234,35,43,0,78
11996,7.861250000001048,3059.0,44,30,0,74
11997,-2.586499999999908,2908.0588235294117,39,35,2,74
11998,12.359500000000775,2482.625,49,35,0,84
11999,3.7720000000002165,2364.6470588235293,64,31,1,95
12000,20.947000000001236,3826.7894736842104,67,34,1,101
12001,24.968750000001133,4127.5,60,28,0,88
12002,-0.536249999998795,3923.6315789473683,56,36,0,92
12003,-16.86549999999978,2318.8823529411766,28,35,0,63
12004,10.174000000001323,3471.0588235294117,61,37,0,98
12005,14.604500000001682,3563.9444444444443,63,31,0,94
12006,-15.492999999998968,2792.5263157894738,32,41,2,73
12007,6.803000000001849,4149.0,64,31,0,95
12008,-11.553499999998476,2828.4210526315787,34,25,5,59
12009,-5.660749999998897,3084.0,41,28,3,69
12010,4.031750000001159,2248.9411764705883,41,35,2,76
12011,16.12700000000171,4263.15,57,40,0,97
12012,33.098750000000734,4357.1578947368425,75,32,0,107
12013,25.516750000002887,3439.6666666666665,71,21,0,92
12014,-4.494249999999459,2028.4705882352941,33,35,0,68
12015,-3.026249999998786,3132.4736842105262,47,25,0,72
12016,22.474000000001382,4655.25,67,16,0,83
12017,5.304500000000121,3160.842105263158,56,29,0,85
12018,-13.62024999999915,2555.2105263157896,27,31,1,58
12019,-21.320999999999213,1992.1052631578948,19,33,1,52
12020,3.9410000000013445,4094.15,58,25,0,83
12021,-0.41774999999877105,3103.7,45,29,0,74
12022,-20.337500000000006,1996.9444444444443,20,33,2,53
12023,-10.247250000000005,1429.0,37,30,4,67
12024,55.43625000000259,5714.8,94,23,0,117
12025,17.967750000001626,4078.222222222222,75,23,0,98
12026,1.116000000000707,2947.6111111111113,40,33,3,73
12027,-2.7555000000001,2307.764705882353,60,34,3,94
12028,18.037500000000836,3412.4117647058824,64,35,0,99
12029,-5.333249999999244,2840.8947368421054,47,32,1,79
12030,21.117750000000974,3659.3,55,25,0,80
12031,-38.196499999999595,2703.7,18,29,0,47
12032,14.58075000000095,3815.6,54,22,0,76
12033,-7.611249999999619,2684.25,26,32,0,58
12034,-8.178249999999553,2410.684210526316,41,28,8,69
12035,-8.041249999999723,2082.705882352941,32,31,0,63
12036,15.478250000001216,4348.2,54,23,0,77
12037,6.262500000000727,3107.5,38,27,0,65
12038,1.4402500000008365,3586.9473684210525,52,38,0,90
12039,-7.834249999998529,2555.235294117647,34,31,0,65
12040,6.764750000000843,3104.1052631578946,51,20,0,71
12041,2.5922500000010187,3203.55,41,29,0,70
12042,-27.35124999999922,2024.25,14,34,1,48
12043,13.704750000001429,4270.3,61,27,0,88
12044,9.680000000002728,4713.9,64,19,0,83
12045,-11.470499999998964,2372.0,54,30,0,84
12046,24.26175000000128,2430.0666666666666,66,35,0,101
12047,14.259500000001562,4907.75,63,28,0,91
12048,-0.5679999999983558,3538.5263157894738,58,24,1,82
12049,9.597250000000313,2892.9444444444443,57,35,1,92
12050,8.218500000000962,2562.9375,75,19,0,94
12051,20.372750000000906,4204.368421052632,61,23,0,84
12052,16.350250000001555,4373.5,61,38,0,99
12053,27.612250000001517,2906.25,67,30,0,97
12054,-10.872499999997794,2269.25,52,35,1,87
12055,6.958750000000978,2909.6666666666665,49,23,0,72
12056,4.6975000000014955,2839.8823529411766,50,22,0,72
12057,8.184500000001346,4074.0526315789475,58,28,0,86
12058,15.650250000001046,4103.777777777777,53,38,0,91
12059,24.34675000000136,2936.1176470588234,64,30,0,94
12060,5.816500000001293,4052.1,52,34,0,86
12061,-4.703499999999023,2994.277777777778,58,26,1,84
12062,-8.182999999999153,2410.0666666666666,34,32,0,66
12063,20.30425000000207,4064.0,63,23,0,86
12064,18.226000000001974,4291.05,60,35,0,95
12065,24.2680000000015,4271.15,67,20,1,87
12066,6.444750000000859,3054.4444444444443,48,28,1,76
12067,-7.405249999999199,2974.5789473684213,48,28,3,76
12068,3.395250000001327,3079.9,41,29,0,70
12069,21.863500000001288,4260.9,59,29,0,88
12070,25.288750000001524,4627.6,59,20,0,79
12071,31.278250000000916,4761.631578947368,68,28,0,96
12072,-31.024249999999235,2028.2,15,31,0,46
12073,-14.449249999999756,2645.7,21,31,0,52
12074,41.62550000000233,5515.6,93,19,0,112
12075,6.920250000000541,3699.0,57,54,0,111
12076,-21.812999999999175,2580.9375,24,29,0,53
12077,24.95825000000084,3597.3529411764707,78,28,0,106
12078,37.51525000000147,5286.2,84,23,0,107
12079,6.417250000001543,2845.8125,56,28,1,84
12080,2.347500000001544,3484.2105263157896,48,35,3,83
12081,-34.189249999999774,2052.05,11,29,0,40
12082,0.9882500000037882,1921.0625,63,28,0,91
12083,23.19725000000236,5278.25,76,34,0,110
12084,-22.48174999999902,2433.5555555555557,26,37,1,63
12085,-12.772749999999114,2515.9473684210525,33,28,0,61
12086,-5.092749999999619,1924.3333333333333,45,34,0,79
12087,31.921500000001032,3070.4666666666667,69,29,0,98
12088,7.519250000001176,3806.05,52,29,0,81
12089,11.260500000001906,4370.3,62,28,0,90
12090,-6.728999999999229,2532.4,27,29,1,56
12091,-9.325999999997666,4131.4,50,36,0,86
12092,-14.404750000000272,1959.5263157894738,32,30,16,62
12093,19.37450000000128,2935.277777777778,67,34,0,101
12094,11.028000000001056,3809.3,45,32,0,77
12095,15.278500000001781,4496.6,62,35,1,97
12096,-7.075499999998833,3271.315789473684,48,25,0,73
12097,2.795250000001598,3643.4,50,34,0,84
12098,16.082250000000926,2750.4375,77,25,0,102
12099,1.738500000001548,3898.95,50,37,0,87
12100,-26.84024999999925,2397.222222222222,27,45,0,72
12101,2.618750000000786,3781.5,40,31,0,71
12102,22.869250000001053,4322.85,68,13,0,81
12103,16.79775000000241,2583.8125,67,29,1,96
12104,1.8422500000013797,3532.222222222222,48,40,0,88
12105,2.1990000000010896,3188.5263157894738,46,24,0,70
12106,-11.297249999999126,2475.842105263158,31,28,0,59
12107,37.570000000002054,5677.6,85,26,0,111
12108,26.479000000001502,4230.7,64,26,0,90
12109,0.6595000000011186,4998.15,65,39,0,104
12110,7.67425000000142,4314.9,67,18,0,85
12111,4.641250000001487,3756.9,52,33,0,85
12112,-6.780999999999436,2610.133333333333,26,33,0,59
12113,-21.83600000000002,1952.8823529411766,33,36,8,69
12114,-23.75649999999951,2028.3,16,32,0,48
12115,33.15350000000165,4675.1,72,24,0,96
12116,11.162500000001575,3138.8888888888887,51,32,1,83
12117,14.381250000001083,2973.222222222222,51,24,0,75
12118,-14.47449999999866,1961.235294117647,33,29,1,62
12119,-1.9814999999996548,2411.3125,33,37,1,70
12120,19.490250000001744,4158.315789473684,65,28,1,93
12121,-3.060999999999786,2028.6666666666667,37,28,0,65
12122,-8.99149999999916,2500.5,28,35,0,63
12123,37.33775000000091,3689.529411764706,92,34,0,126
12124,26.601000000001882,4730.7,76,21,0,97
12125,-1.0132499999987714,2959.5263157894738,42,28,0,70
12126,1.7717500000004498,3156.0,36,33,2,69
12127,8.261000000001435,3436.9444444444443,64,35,0,99
12128,-3.043249999999623,2504.764705882353,30,26,0,56
12129,26.093750000001087,3829.9,54,25,0,79
12130,3.1360000000007893,2766.8333333333335,55,30,2,85
12131,7.330750000001016,3719.6,43,34,0,77
12132,-0.5562499999996728,2536.2,23,31,0,54
12133,-11.321249999998853,2519.705882352941,29,36,1,65
12134,-0.41949999999918813,3220.315789473684,57,30,1,87
12135,22.119750000001268,4362.4,62,23,0,85
12136,-1.5239999999992164,2814.75,36,27,0,63
12137,11.929750000001317,4111.7,52,34,0,86
12138,0.9780000000002864,2471.4444444444443,39,32,2,71
12139,11.055000000000547,3269.3529411764707,65,29,0,94
12140,16.57450000000248,4157.75,65,23,0,88
12141,49.554000000001466,5343.0,87,33,0,120
12142,-5.5717499999989135,3166.842105263158,34,30,0,64
12143,-9.314999999999046,2519.2631578947367,29,32,0,61
12144,10.160500000001027,2277.1875,62,23,0,85
12145,-1.4624999999987813,3884.65,51,33,0,84
12146,16.622750000001577,4214.8,63,25,0,88
12147,22.644750000001565,4863.25,66,29,0,95
12148,5.28525000000119,2328.875,70,16,1,86
12149,-15.783499999999677,2198.777777777778,27,34,0,61
12150,-0.3854999999992391,2959.5789473684213,45,27,2,72
12151,-49.43500000000051,1429.0,0,31,21,31
12152,-9.778499999999863,1981.1666666666667,30,34,0,64
12153,12.35425000000133,4852.9,69,27,0,96
12154,-30.42274999999923,2037.0,13,33,0,46
12155,25.181000000001056,3813.4736842105262,65,28,0,93
12156,3.5802500000006594,2969.777777777778,43,26,1,69
12157,-27.063999999999275,2506.7894736842104,28,33,0,61
12158,-10.348999999998757,3187.95,46,25,0,71
12159,13.9605000000009,3556.1666666666665,63,30,0,93
12160,-3.3027499999993295,2007.0588235294117,42,34,0,76
12161,-14.713749999999468,2297.35,27,26,0,53
12162,8.90525000000127,3015.5,53,29,1,82
12163,-30.062999999999715,2023.842105263158,19,25,3,44
12164,2.434250000000943,3643.45,47,30,0,77
12165,-24.968499999999253,2599.6,24,31,0,55
12166,-21.4899999999983,3040.5789473684213,40,33,0,73
12167,-13.912999999999357,2693.0,26,37,0,63
12168,7.171250000001488,3027.5882352941176,59,23,0,82
12169,44.577750000002915,5706.9,91,19,0,110
12170,-9.659499999998523,4373.55,49,36,7,85
12171,23.54175000000149,3629.1111111111113,68,32,0,100
12172,-13.293749999999202,2548.6470588235293,34,24,0,58
12173,-13.430499999999247,2555.157894736842,29,25,0,54
12174,-24.61474999999954,2659.2,24,36,0,60
12175,2.0122500000009973,3199.0,45,25,0,70
12176,32.801250000000984,3053.6470588235293,69,32,0,101
12177,-11.989249999999027,2495.9473684210525,25,29,0,54
12178,-18.566749999999587,2294.529411764706,30,30,1,60
12179,-7.876749999999352,2567.95,28,30,0,58
12180,-37.495750000000136,1429.0,22,49,3,71
12181,-28.288499999999733,1959.4736842105262,20,28,9,48
12182,6.305500000000971,2400.6,47,28,0,75
12183,14.761750000001422,2660.25,73,23,0,96
12184,28.445000000001706,2865.6875,58,25,0,83
12185,8.784500000000566,2591.8125,58,25,0,83
12186,20.608250000002275,2175.0625,74,35,1,109
12187,-4.526499999999353,3194.2,42,24,0,66
12188,-5.7752499999984925,3032.315789473684,42,33,0,75
12189,15.89550000000132,4430.684210526316,75,24,0,99
12190,16.982500000000815,2950.1176470588234,68,29,0,97
12191,6.686750000001716,3672.2631578947367,60,27,0,87
12192,19.345000000001242,4087.85,49,32,0,81
12193,25.528250000000785,3638.0555555555557,86,18,2,104
12194,-5.862499999999107,3146.65,42,22,0,64
12195,43.938500000002236,6123.65,93,26,0,119
12196,13.472750000001318,4067.15,60,27,0,87
12197,-13.979999999999237,2765.176470588235,44,33,0,77
12198,17.616250000001674,4341.473684210527,69,27,0,96
12199,16.743750000001544,4272.0526315789475,68,28,1,96
12200,21.277250000002038,4631.55,65,28,0,93
12201,4.912500000000184,3155.0526315789475,54,31,13,85
12202,2.8255000000026405,3398.1111111111113,54,37,0,91
12203,-8.414249999999322,2520.7894736842104,31,28,0,59
12204,25.020500000000713,3108.8823529411766,68,23,0,91
12205,21.284000000001726,5306.05,71,35,1,106
12206,11.870500000001394,3690.95,54,23,0,77
12207,24.821000000002638,4929.85,74,29,0,103
12208,-19.32674999999918,2555.95,22,31,0,53
12209,16.598250000001496,4131.6,64,20,0,84
12210,-18.4487499999997,2044.1,17,33,0,50
12211,15.685750000000539,2982.8125,59,36,0,95
12212,1.4112500000012136,3229.2,45,25,0,70
12213,-12.693249999999564,2655.35,22,34,0,56
12214,2.197500000001501,2396.3125,48,33,0,81
12215,-0.44174999999933967,3095.8,35,32,0,67
12216,16.504250000000933,4420.3,50,35,0,85
12217,-18.148249999999162,2452.8333333333335,27,34,6,61
12218,-18.843249999999482,1967.9444444444443,21,30,1,51
12219,9.914250000001434,3328.0,44,26,0,70
12220,12.824500000000876,3468.722222222222,53,26,0,79
12221,-14.379000000000392,1429.0,36,46,2,82
12222,-15.797499999999093,2768.0,31,34,3,65
12223,-12.5507499999987,2371.1176470588234,44,29,0,73
12224,7.827750000001447,3217.3333333333335,54,37,0,91
12225,-21.28649999999943,2032.1764705882354,19,35,1,54
12226,-12.956749999999625,2668.0,28,27,0,55
12227,13.408000000000786,3603.85,43,31,0,74
12228,19.691250000001492,5234.6,66,29,0,95
12229,16.41550000000045,3103.2105263157896,48,31,0,79
12230,-21.606249999998855,2646.222222222222,30,24,1,54
12231,17.7087500000016,2658.6923076923076,61,32,1,93
12232,-31.728499999999393,2031.3333333333333,18,31,3,49
12233,-8.171749999999289,2400.0555555555557,43,34,0,77
12234,13.03225000000115,3819.5,50,28,0,78
12235,3.483000000000767,2940.6470588235293,53,27,6,80
12236,23.737750000002464,4422.9,67,42,0,109
12237,-24.080749999999757,2008.4,12,31,1,43
12238,13.400750000000329,2543.1176470588234,50,26,2,76
12239,-11.394499999998574,2235.5625,53,31,0,84
12240,9.719500000001691,3485.0,57,32,1,89
12241,23.86375000000152,5056.95,75,26,0,101
12242,23.361250000002332,5230.6,79,25,0,104
12243,12.967750000000773,3758.4,53,28,0,81
12244,18.609750000000925,3379.777777777778,55,27,0,82
12245,13.623000000001634,3844.25,53,29,0,82
12246,30.0635000000025,4647.5,83,21,0,104
12247,-8.03424999999929,2828.125,26,33,1,59
12248,18.11550000000167,2805.4117647058824,49,36,1,85
12249,12.358000000001509,3792.65,59,26,0,85
12250,19.580500000001088,2554.125,54,36,0,90
12251,36.09125000000161,3170.0625,77,32,0,109
12252,10.818500000001345,4221.3,55,24,0,79
12253,-9.282249999999824,1946.9375,25,33,1,58
12254,3.501750000001258,2519.0666666666666,46,22,0,68
12255,29.504500000002217,5175.3,68,34,0,102
12256,28.822500000000964,4298.2,65,23,0,88
12257,-27.147749999999018,2470.7894736842104,31,29,13,60
12258,40.79425000000221,4710.8,76,27,0,103
12259,32.21575000000204,6062.3,78,35,0,113
12260,-0.432999999998673,3625.15,45,33,0,78
12261,6.517500000000327,2602.6428571428573,35,35,0,70
12262,-35.10449999999993,1952.8333333333333,13,35,1,48
12263,12.577500000000228,2620.785714285714,65,31,4,96
12264,20.364000000001067,1987.5625,58,24,0,82
12265,32.25900000000199,5430.7,76,21,0,97
12266,4.317250000001044,2448.2,46,36,0,82
12267,-9.491250000000083,2595.6666666666665,33,31,1,64
12268,1.0450000000007018,2450.705882352941,34,31,0,65
12269,3.263000000001006,3833.8,49,29,1,78
12270,4.308000000000744,5093.35,62,33,0,95
12271,23.571000000001284,3757.65,51,25,0,76
12272,-12.572499999999113,2857.6666666666665,48,28,3,76
12273,24.514250000002388,3916.529411764706,76,32,1,108
12274,26.497000000001623,4131.35,59,29,0,88
12275,12.630750000001578,3910.2,52,35,0,87
12276,16.383500000000886,3444.8888888888887,61,34,0,95
12277,-29.719999999999686,1429.0,23,34,4,57
12278,25.923000000001508,4139.35,64,23,0,87
12279,-20.12049999999929,2789.4,25,34,1,59
12280,15.028250000001012,3443.4210526315787,61,40,2,101
12281,26.081750000001204,4131.45,64,23,0,87
12282,-15.538499999999493,2603.7,29,27,2,56
12283,-28.962749999999495,1959.5263157894738,13,33,2,46
12284,20.25250000000164,4731.45,56,36,0,92
12285,-24.19999999999941,2056.05,12,37,0,49
12286,-12.116499999999618,2627.45,28,24,0,52
12287,31.724250000002257,5825.3,80,30,0,110
12288,-9.928499999998586,3198.6315789473683,47,25,1,72
12289,13.21750000000076,3807.75,45,30,0,75
12290,7.222250000000716,1973.75,51,34,0,85
12291,19.20625000000121,2880.823529411765,52,36,0,88
12292,46.424000000002074,4829.05,77,26,0,103
12293,-21.71200000000018,1429.0,36,34,2,70
12294,31.62725000000318,5274.4,95,30,0,125
12295,43.951000000001635,4714.8,81,26,0,107
12296,3.3662500000007265,3271.9,35,28,1,63
12297,1.8917500000013832,3145.842105263158,37,31,0,68
12298,19.706000000001353,3829.9,62,29,0,91
12299,21.21625000000134,3914.7,55,33,0,88
12300,42.99650000000209,3347.8888888888887,71,16,0,87
12301,2.6500000000012642,2505.266666666667,43,26,1,69
12302,19.08500000000104,2802.125,60,30,0,90
12303,13.703750000001156,4171.0526315789475,58,41,0,99
12304,3.935500000000919,3187.75,40,28,0,68
12305,32.439000000001116,5279.473684210527,89,37,0,126
12306,9.542750000002098,3741.6875,46,34,0,80
12307,23.355750000001635,4123.5,64,23,0,87
12308,14.859250000001015,4099.8,55,26,0,81
12309,19.263000000001053,3998.722222222222,54,52,0,106
12310,10.701750000001184,3315.5263157894738,53,41,0,94
12311,12.34275000000038,3643.842105263158,58,30,0,88
12312,-11.37799999999916,2635.4,28,32,0,60
12313,-20.569499999999206,2519.157894736842,27,32,1,59
12314,6.355250000000011,2353.75,63,23,2,86
12315,7.079750000001385,3663.25,60,21,0,81
12316,-21.375749999999265,1923.0,20,35,0,55
12317,1.2902500000004693,2420.125,56,34,0,90
12318,16.698000000001368,3042.9444444444443,51,26,0,77
12319,-25.578499999999682,2493.4210526315787,24,35,0,59
12320,-25.459749999999573,1429.0,8,37,1,45
12321,8.185000000000468,3659.25,56,20,0,76
12322,13.25875000000182,3322.4444444444443,67,33,1,100
12323,-5.860499999999124,3391.5263157894738,39,36,0,75
12324,10.046500000000927,3189.9285714285716,54,28,0,82
12325,-30.892499999999814,2079.7894736842104,17,36,4,53
12326,6.597250000003899,2898.222222222222,74,28,1,102
12327,5.477750000001126,3683.05,56,25,1,81
12328,-13.313000000000082,2593.6315789473683,28,30,2,58
12329,8.594000000001085,2095.6666666666665,51,37,0,88
12330,11.491000000001076,3651.25,54,28,0,82
12331,17.91850000000081,2448.8125,55,24,0,79
12332,20.907500000001665,4118.315789473684,67,24,0,91
12333,-8.733499999999143,2643.7368421052633,33,30,1,63
12334,-29.913749999999396,1986.2105263157894,15,24,1,39
12335,20.34500000000179,4234.6,56,28,1,84
12336,3.05525000000071,2964.5789473684213,59,19,8,78
12337,-17.56324999999866,1979.0588235294117,30,35,2,65
12338,29.037000000001562,5257.7,77,25,0,102
12339,-10.805499999999466,2574.9375,25,33,0,58
12340,24.378750000001556,4241.1,65,26,0,91
12341,25.093500000000777,2929.0625,78,27,0,105
12342,34.608500000001186,4025.684210526316,96,14,2,110
12343,-1.821999999998584,2755.0,45,33,1,78
12344,25.647250000002565,4641.8,74,32,0,106
12345,13.795250000001682,3651.3,54,28,0,82
12346,-0.47874999999943124,2554.3888888888887,29,22,0,51
12347,4.150500000001175,3571.9,55,22,0,77
12348,2.8525000000003238,4899.65,54,28,1,82
12349,17.299000000002543,2962.9375,74,22,0,96
12350,18.219250000001118,4262.8421052631575,66,24,0,90
12351,8.89775000000128,3531.0,75,27,0,102
12352,21.55475000000137,4579.1,70,25,0,95
12353,0.17450000000058888,3821.95,61,21,0,82
12354,25.564000000000775,3624.0555555555557,69,20,2,89
12355,-35.57324999999978,1925.5,15,25,3,40
12356,35.828000000001666,5652.1,80,29,0,109
12357,9.421000000000658,2505.266666666667,43,29,0,72
12358,17.386250000000913,3414.0,62,17,0,79
12359,0.3385000000009807,3166.1875,51,27,0,78
12360,5.372250000000669,3985.4,44,28,0,72
12361,-26.135249999999594,2052.9,13,26,0,39
12362,-11.011749999999024,2491.7368421052633,28,31,0,59
12363,-13.371999999997735,3826.75,55,30,0,85
12364,10.20100000000139,3071.470588235294,60,34,0,94
12365,-11.354999999998052,3707.7,55,26,1,81
12366,11.693750000001081,3343.842105263158,50,30,0,80
12367,0.5580000000009215,2561.785714285714,49,17,2,66
12368,9.97925000000089,3911.55,56,21,1,77
12369,-17.996749999999334,2449.3333333333335,56,26,3,82
12370,-1.529499999999334,2867.2,36,30,0,66
12371,7.709000000002193,3384.1666666666665,61,22,0,83
12372,-6.444499999998856,2450.470588235294,46,28,1,74
12373,12.357750000001129,3091.85,55,17,0,72
12374,-10.494749999999332,2429.0,32,31,0,63
12375,9.378500000001555,4267.85,80,20,0,100
12376,29.755000000002234,4627.45,86,17,0,103
12377,23.305750000002128,5175.2,79,22,1,101
12378,24.791750000001514,3166.8823529411766,78,24,0,102
12379,-2.394999999998787,2830.5882352941176,44,28,0,72
12380,23.28600000000115,3572.0625,70,36,0,106
12381,15.09800000000106,3591.75,53,21,0,74
12382,11.609000000001206,4787.75,65,22,0,87
12383,10.163000000001336,2605.75,56,27,0,83
12384,-15.004499999999362,2514.8,24,34,0,58
12385,-10.236000000000589,1429.0,39,37,2,76
12386,-0.5622499999988319,2505.266666666667,58,24,0,82
12387,-12.758249999999133,2513.1176470588234,28,29,0,57
12388,1.4425000000015924,2448.2,57,31,0,88
12389,-12.9947499999992,3152.15,39,23,0,62
12390,-5.411499999999274,2429.0,37,30,0,67
12391,-6.071749999999538,2583.5789473684213,41,33,5,74
12392,15.055250000002172,3114.470588235294,64,31,0,95
12393,1.0195000000008132,3107.6,35,32,0,67
12394,0.2612500000009977,2564.8888888888887,33,32,0,65
12395,30.870750000000925,4206.833333333333,76,22,0,98
12396,26.075000000002035,4855.263157894737,78,21,0,99
12397,10.282000000001762,4280.7,70,17,0,87
12398,2.6185000000012755,3957.5,54,32,0,86
12399,-19.565249999999278,2000.5,35,41,1,76
12400,11.598750000001498,3611.7,58,20,0,78
12401,-7.712249999999076,2552.1,32,28,1,60
12402,12.135250000001271,4746.5,60,25,0,85
12403,7.093500000000719,3077.1666666666665,45,35,2,80
12404,9.83350000000139,4685.45,50,24,1,74
12405,16.28325000000115,3517.6315789473683,63,25,0,88
12406,21.65175000000145,4248.05,63,24,0,87
12407,-16.773999999999326,2519.2631578947367,36,27,3,63
12408,28.95400000000053,3881.8947368421054,88,31,0,119
12409,4.954250000000895,3037.0,54,27,0,81
12410,0.4277500000017566,2900.0,57,30,0,87
12411,14.911000000001195,2956.705882352941,69,27,0,96
12412,10.701750000001216,3892.0,52,36,1,88
12413,6.974500000001574,3235.777777777778,64,23,0,87
12414,-40.72775000000018,1989.578947368421,12,32,14,44
12415,-4.504499999999535,2794.1666666666665,52,28,1,80
12416,24.682000000002265,4826.05,74,24,1,98
12417,-6.406249999999521,2765.235294117647,39,29,0,68
12418,-23.239249999999807,2488.4736842105262,27,33,2,60
12419,-4.775499999999228,2496.3529411764707,36,25,0,61
12420,-13.387999999999192,2114.222222222222,28,25,0,53
12421,22.262250000000847,4131.4,56,29,0,85
12422,2.65475000000112,3435.35,43,31,0,74
12423,-8.192750000000133,2454.5,37,32,21,69
12424,4.826000000001701,3663.8947368421054,62,22,0,84
12425,35.25150000000186,4742.7,85,18,0,103
12426,-6.5919999999995795,3190.95,40,24,0,64
12427,12.988250000001017,4226.75,63,23,0,86
12428,36.907250000002215,5679.05,83,21,0,104
12429,-19.933499999999448,2593.684210526316,29,29,0,58
12430,-2.8660000000001546,3000.5,51,36,1,87
12431,1.4817500000017976,3092.3684210526317,56,27,0,83
12432,17.04800000000054,2525.3125,60,28,0,88
12433,-11.484999999999873,1992.0588235294117,30,42,0,72
12434,-8.791749999999466,2615.55,34,26,0,60
12435,0.10475000000120768,3772.75,58,20,1,78
12436,13.102000000001542,4083.95,68,19,2,87
12437,-19.201499999999406,2076.4736842105262,22,28,1,50
12438,9.847250000001004,2467.294117647059,59,18,1,77
12439,-0.02649999999871371,3444.1,53,21,0,74
12440,-6.3634999999984005,2990.777777777778,56,25,0,81
12441,-12.337999999999465,2436.9444444444443,25,29,1,54
12442,-9.847499999999496,3691.85,40,31,0,71
12443,29.836250000001648,4540.1578947368425,89,16,0,105
12444,-17.31524999999923,2644.15,28,31,1,59
12445,12.42825000000094,3129.470588235294,67,32,0,99
12446,-16.4517499999991,1959.0,35,30,2,65
12447,-25.397999999999723,1429.0,18,32,0,50
12448,-20.862999999999804,2165.0526315789475,19,26,1,45
12449,-24.84674999999906,2663.9,30,27,0,57
12450,-10.7374999999989,1963.1176470588234,32,31,0,63
12451,44.56075000000262,5493.35,96,17,1,113
12452,12.87225000000106,2741.5625,71,32,0,103
12453,4.452500000000812,3968.7894736842104,58,21,0,79
12454,7.638500000001019,2352.6875,47,32,0,79
12455,4.787000000000887,2923.722222222222,63,19,0,82
12456,9.980000000001793,3599.7,65,18,0,83
12457,24.809500000001567,4191.1,72,20,0,92
12458,-2.646249999999948,2603.6666666666665,46,26,0,72
12459,5.753500000001047,3279.1,43,27,0,70
12460,39.29325000000214,4984.684210526316,105,14,0,119
12461,-9.532249999998857,2383.294117647059,47,33,3,80
12462,-16.929749999999686,2552.05,30,24,0,54
12463,4.784500000000374,2302.0625,59,27,0,86
12464,-4.694999999999238,2419.6666666666665,47,21,0,68
12465,12.033750000000566,3496.222222222222,58,20,0,78
12466,25.727250000001476,4770.3,74,20,0,94
12467,1.7140000000021356,4237.684210526316,72,23,0,95
12468,10.1920000000008,3074.8947368421054,59,23,1,82
12469,5.307750000000668,3071.8,41,23,0,64
12470,12.965750000000432,3629.6315789473683,69,23,0,92
12471,25.457500000001954,4742.6,77,15,0,92
12472,19.564750000001474,4365.6,68,18,0,86
12473,-7.2637499999986375,1481.9333333333334,45,26,3,71
12474,-3.1629999999990432,3303.7894736842104,48,26,0,74
12475,-11.276749999999074,2545.9473684210525,40,18,0,58
12476,22.613000000001797,3862.0,85,16,1,101
12477,16.418000000000536,3513.176470588235,73,23,0,96
12478,-9.413499999999777,2040.1666666666667,31,31,1,62
12479,-9.63099999999928,2770.0666666666666,31,30,0,61
12480,-0.8464999999998855,2328.235294117647,59,31,0,90
12481,11.465000000001258,4210.9,66,24,0,90
12482,-27.40449999999941,2286.235294117647,33,34,0,67
12483,-10.878749999999494,2487.823529411765,48,35,0,83
12484,-32.308750000000416,2068.9473684210525,31,21,14,52
12485,-16.75099999999943,2930.7,32,30,0,62
12486,-12.700499999999465,2527.3125,27,25,2,52
12487,1.2067500000015212,3585.2631578947367,59,27,0,86
12488,-5.293249999999721,2559.95,29,24,0,53
12489,-11.290999999998913,2598.8125,35,27,0,62
12490,-15.100499999998945,2540.15,31,28,0,59
12491,28.188000000001512,3446.823529411765,74,16,0,90
12492,1.9397500000010275,2499.5555555555557,47,34,0,81
12493,-14.086999999999682,1941.4444444444443,34,33,0,67
12494,0.03350000000068931,2510.1666666666665,48,27,3,75
12495,47.27100000000157,5242.65,89,16,0,105
12496,17.9985000000017,4920.3,72,15,0,87
12497,6.605000000000842,3087.85,47,19,0,66
12498,-25.672749999999116,1871.4375,26,25,1,51
12499,27.54825000000173,4683.25,72,20,0,92
12500,10.477500000001724,3671.25,66,17,0,83
12501,3.658500000001105,3864.05,54,29,0,83
12502,-31.89499999999963,1971.3684210526317,16,27,7,43
12503,25.34450000000127,3363.0555555555557,71,27,0,98
12504,-5.2489999999996275,2620.5882352941176,25,32,0,57
12505,13.226750000000902,3909.95,46,31,0,77
12506,-0.5862499999991919,2708.6666666666665,42,34,0,76
12507,-28.27099999999902,2855.8333333333335,44,35,0,79
12508,-6.531999999998668,3631.4,47,30,0,77
12509,16.853250000001438,4940.2,76,19,0,95
12510,-6.1609999999989515,2739.4444444444443,39,27,0,66
12511,12.355000000000826,3896.5,52,25,0,77
12512,-11.650249999999314,2532.2,34,21,0,55
12513,-8.81699999999935,2460.777777777778,35,26,0,61
12514,-18.19550000000004,2400.8333333333335,29,42,2,71
12515,-1.9507499999993445,2094.75,42,31,0,73
12516,-26.417999999999502,2299.8,16,29,1,45
12517,16.35850000000088,3997.842105263158,55,28,0,83
12518,-20.86224999999954,2024.25,13,33,0,46
12519,7.499250000000657,2912.3333333333335,59,27,7,86
12520,-9.548499999999155,3226.0,39,35,0,74
12521,20.56300000000132,3619.65,57,23,0,80
12522,-0.9147499999986908,2958.277777777778,58,20,1,78
12523,-10.593249999999452,2544.25,26,33,1,59
12524,24.687250000000112,3109.8823529411766,74,21,0,95
12525,-8.707999999999169,2504.764705882353,29,29,0,58
12526,-4.983749999998301,3388.65,51,24,0,75
12527,-38.76324999999931,2012.35,13,30,0,43
12528,-1.571749999999088,3075.95,40,25,0,65
12529,-2.642749999998107,3831.4,61,34,0,95
12530,12.873750000001476,4581.45,62,19,0,81
12531,1.6030000000009217,4340.2,60,26,0,86
12532,35.19550000000116,4219.421052631579,84,24,0,108
12533,-9.011749999999399,2028.5294117647059,33,30,0,63
12534,-6.086749999999006,3587.85,49,25,1,74
12535,8.179250000000485,2990.5625,73,29,2,102
12536,12.367250000000892,2473.6875,61,37,0,98
12537,18.050500000001183,4934.6,70,15,1,85
12538,-34.50750000000029,1429.0,18,30,9,48
12539,24.143250000001455,4095.75,70,21,0,91
12540,37.880750000001576,4722.8,78,22,0,100
12541,-22.56149999999903,2499.5555555555557,31,33,1,64
12542,31.379250000001168,4994.25,76,22,2,98
12543,47.430500000002965,3669.9411764705883,90,18,0,108
12544,11.520750000001282,3860.05,59,25,0,84
12545,-21.037249999999933,1981.3157894736842,16,33,2,49
12546,-29.030999999999516,1795.0625,24,44,1,68
12547,-21.109749999999813,1972.8947368421052,12,35,0,47
12548,-3.8987499999987905,2486.266666666667,51,28,0,79
12549,11.450750000000463,3119.6111111111113,59,32,0,91
12550,-27.36574999999935,2048.05,14,39,0,53
12551,26.363250000001706,4690.95,81,18,0,99
12552,-8.39274999999993,1866.0588235294117,38,38,0,76
12553,0.3797500000009041,2486.0588235294117,38,37,0,75
12554,20.753000000000675,2612.5625,93,21,2,114
12555,14.019500000000914,2505.5,61,20,1,81
12556,-9.601749999998463,2449.3333333333335,42,24,1,66
12557,23.15000000000166,3566.8333333333335,61,36,0,97
12558,3.815000000000373,2505.705882352941,63,26,0,89
12559,5.540750000000632,2589.8125,55,30,1,85
12560,5.528250000000708,3039.222222222222,44,38,0,82
12561,7.388250000000828,3047.222222222222,48,29,0,77
12562,-7.8474999999993695,2054.0625,32,27,0,59
12563,-13.468499999998812,2489.0555555555557,34,25,1,59
12564,-15.96849999999983,1975.3529411764705,30,28,0,58
12565,38.26450000000187,5140.894736842105,95,15,0,110
12566,-8.933249999998974,2474.823529411765,38,30,0,68
12567,7.421000000000864,2920.3333333333335,50,23,0,73
12568,12.285500000000496,3134.8823529411766,59,17,0,76
12569,-11.76649999999968,2109.705882352941,36,32,0,68
12570,26.54075000000085,3028.8333333333335,75,16,0,91
12571,2.7437500000013486,2892.0555555555557,48,25,0,73
12572,14.736500000001126,4349.7,68,24,0,92
12573,32.401750000002224,5242.55,87,16,0,103
12574,29.82650000000161,1795.125,73,38,0,111
12575,-6.653999999999127,2502.6315789473683,33,24,1,57
12576,-3.0237499999990356,1840.75,35,30,0,65
12577,-23.8839999999998,1429.0,22,30,1,52
12578,41.03175000000173,4886.95,85,15,0,100
12579,9.987750000001906,4726.8,75,23,0,98
12580,39.709000000000955,3078.8823529411766,79,25,0,104
12581,-1.1732499999987542,3810.7,51,28,1,79
12582,-31.626750000000293,1429.0,15,33,1,48
12583,-29.702749999999334,2172.7,16,31,0,47
12584,5.541000000002092,3599.75,67,17,0,84
12585,7.497000000000099,2143.4117647058824,42,32,0,74
12586,6.4970000000022425,4193.4,69,18,0,87
12587,-5.558249999998784,3217.2,38,27,1,65
12588,2.4387500000015474,4017.85,51,21,0,72
12589,-5.172249999999096,3099.65,49,16,0,65
12590,37.43875000000228,3982.8888888888887,86,18,0,104
12591,-31.44199999999912,2032.15,12,34,0,46
12592,4.808500000000801,3173.6,43,23,1,66
12593,4.323250000000599,2817.8888888888887,50,39,0,89
12594,31.648250000002342,4659.3,85,17,0,102
12595,-4.3224999999991045,3090.7894736842104,47,28,0,75
12596,-34.87299999999955,2089.842105263158,15,31,1,46
12597,17.53250000000211,5155.3,87,24,0,111
12598,8.301250000001511,4260.05,67,25,0,92
12599,13.094000000000426,2723.8125,52,19,0,71
12600,-15.223499999999941,2179.8,19,31,1,50
12601,-7.3857499999994,2152.6470588235293,24,34,0,58
12602,-16.231999999998926,2544.25,28,32,0,60
12603,-39.84950000000004,1947.5,25,28,17,53
12604,2.4192500000005963,3388.1428571428573,39,25,0,64
12605,38.9150000000015,5421.9,70,26,0,96
12606,28.090750000001712,4884.7,91,15,0,106
12607,3.5447500000005783,2981.1111111111113,52,20,1,72
12608,-1.152499999999764,2686.0625,32,27,0,59
12609,-11.843999999999337,2572.0,23,34,0,57
12610,-19.100749999999056,2838.6,39,26,0,65
12611,8.8855000000011,3624.35,56,17,0,73
12612,-11.731999999998774,3035.5789473684213,46,25,1,71
12613,6.527000000000856,3090.3888888888887,61,26,0,87
12614,27.390000000001738,4121.736842105263,77,22,0,99
12615,41.86075000000224,4388.1578947368425,95,16,1,111
12616,13.968000000000439,2580.4666666666667,57,25,0,82
12617,-7.3217499999994455,2531.0,39,28,0,67
12618,10.726250000000435,2975.8333333333335,51,28,0,79
12619,9.99900000000088,2362.4666666666667,56,26,1,82
12620,-15.819999999999817,2106.9,15,32,0,47
12621,17.11050000000116,3023.823529411765,60,27,0,87
12622,3.372500000004,3485.5555555555557,76,32,2,108
12623,25.727250000001067,3409.722222222222,53,27,0,80
12624,17.036000000000257,2500.625,55,28,0,83
12625,-7.204999999998412,3537.470588235294,59,31,2,90
12626,25.092250000001393,3403.9411764705883,76,23,0,99
12627,-1.358749999999164,2938.777777777778,40,32,0,72
12628,-0.5924999999985674,2050.125,42,35,1,77
12629,24.986000000001244,4874.4,70,21,0,91
12630,3.9217500000022496,2523.3125,75,19,0,94
12631,-3.942499999999323,2616.6875,29,30,0,59
12632,4.216500000000918,4564.05,57,27,0,84
12633,7.421750000001149,3046.4444444444443,48,25,1,73
12634,17.105000000001308,4512.35,63,25,0,88
12635,-4.763249999999299,2400.6,45,35,1,80
12636,8.431750000001236,4206.9,62,23,0,85
12637,-7.499749999999895,1902.1875,40,29,1,69
12638,-1.930249999999028,3099.8,48,20,0,68
12639,38.71350000000156,3168.1875,79,26,0,105
12640,5.12600000000108,2477.6666666666665,44,23,0,67
12641,-1.9204999999992645,2504.8888888888887,46,18,0,64
12642,-13.26699999999919,2474.8888888888887,37,32,0,69
12643,-4.864999999999814,2945.0555555555557,42,23,1,65
12644,-10.447999999998926,2451.9375,47,33,8,80
12645,-28.52624999999933,2008.4,11,32,0,43
12646,1.9780000000008684,2661.8333333333335,49,39,0,88
12647,11.080750000001064,2925.764705882353,64,17,0,81
12648,-4.841499999999085,2536.777777777778,36,25,3,61
12649,10.438250000001236,4040.15,50,31,1,81
12650,13.37750000000015,2657.764705882353,70,21,1,91
12651,4.644500000000322,2412.294117647059,53,42,0,95
12652,16.736500000002216,2446.823529411765,67,18,1,85
12653,38.63850000000175,4293.277777777777,94,18,0,112
12654,0.1265000000016041,2780.3125,46,33,0,79
12655,-3.9764999999985386,3705.3,54,25,1,79
12656,-12.299499999998961,2536.2,31,26,1,57
12657,-19.89974999999929,2485.1052631578946,24,32,0,56
12658,0.08600000000059671,3083.9,48,17,1,65
12659,-6.49274999999744,1963.8125,52,33,1,85
12660,3.926750000002161,3259.176470588235,49,33,1,82
12661,2.469750000000784,3180.8,45,20,1,65
12662,-9.851999999999062,1951.875,48,21,3,69
12663,-3.155749999999652,3029.5,42,19,0,61
12664,19.848500000001323,4257.7,60,26,0,86
12665,3.9290000000019547,2329.875,48,31,0,79
12666,25.53125000000071,3651.4,56,19,0,75
12667,33.36750000000157,4536.95,66,30,0,96
12668,10.399250000000775,2941.705882352941,61,27,0,88
12669,1.987250000000693,3104.2105263157896,45,25,0,70
12670,26.272500000000264,4191.789473684211,61,30,0,91
12671,42.82975000000224,5135.55,92,15,0,107
12672,20.98225000000141,3929.1,58,27,0,85
12673,11.76450000000071,5106.15,68,21,0,89
12674,-17.219999999999168,3143.315789473684,46,30,4,76
12675,4.131500000000903,3202.9,42,29,0,71
12676,-6.356249999999699,2567.5,60,24,0,84
12677,-11.328999999999109,2520.25,26,28,1,54
12678,16.23650000000169,4007.157894736842,61,22,0,83
12679,18.095000000000343,3000.4444444444443,73,29,0,102
12680,40.65875000000176,4116.944444444444,73,27,0,100
12681,11.06875000000147,2332.8823529411766,51,21,1,72
12682,-9.993499999999113,2543.4,33,28,0,61
12683,-10.397749999999347,2529.9411764705883,28,28,0,56
12684,21.409250000000764,3170.25,68,17,0,85
12685,-24.787249999999375,2007.157894736842,20,24,2,44
12686,-27.273249999999383,2003.7894736842106,16,31,0,47
12687,26.493250000001172,3022.0,86,20,0,106
12688,-2.89674999999894,2425.5555555555557,45,26,1,71
12689,-10.853249999999258,2260.1176470588234,31,37,0,68
12690,37.07475000000093,3143.285714285714,84,33,0,117
12691,27.33450000000115,4815.55,79,19,0,98
12692,27.150000000002507,5421.2,94,23,0,117
12693,-14.639499999998511,2521.842105263158,35,27,1,62
12694,15.014000000001712,3497.1111111111113,64,21,0,85
12695,27.69975000000241,4719.6,85,20,0,105
12696,26.484250000000532,3262.25,61,27,1,88
12697,11.948500000001742,4180.6,67,20,0,87
12698,9.012750000000901,2139.3125,72,22,3,94
12699,-8.89449999999943,2524.3684210526317,27,35,0,62
12700,25.258250000001304,3063.125,90,34,0,124
12701,-8.035249999998905,3157.5789473684213,46,29,0,75
12702,0.5907500000004193,2586.0,49,23,2,72
12703,-17.20299999999967,2036.2,18,29,4,47
12704,16.940500000001542,4900.55,64,22,0,86
12705,0.4800000000019106,2377.266666666667,57,22,1,79
12706,-18.98749999999937,3836.1,39,35,0,74
12707,27.686250000002065,5198.95,76,29,0,105
12708,30.006750000002096,4831.4,80,16,0,96
12709,-19.722249999998375,2159.1666666666665,27,38,1,65
12710,24.69775000000204,4790.25,82,17,0,99
12711,-17.263249999999633,2040.1,18,28,0,46
12712,-6.525999999999181,2521.529411764706,34,37,0,71
12713,18.543000000002127,2480.75,76,24,0,100
12714,-21.607999999998608,2296.3529411764707,43,26,1,69
12715,-12.752249999999384,2572.0,27,30,0,57
12716,25.207250000003018,4631.45,85,23,0,108
12717,8.844000000001262,2390.705882352941,50,24,0,74
12718,-5.006499999999646,2695.125,28,25,1,53
12719,0.9047500000009607,3230.65,46,23,0,69
12720,9.009250000000876,2583.75,59,24,1,83
12721,9.887000000001681,4598.15,67,39,0,106
12722,-28.48424999999985,1977.1052631578948,13,34,1,47
12723,-1.4699999999998083,2702.2105263157896,39,24,0,63
12724,-11.94724999999904,2429.0625,30,32,0,62
12725,-30.19375000000007,1429.0,18,32,0,50
12726,9.066500000000913,3694.95,44,22,0,66
12727,28.253000000001187,5377.5,70,24,0,94
12728,-4.802749999999316,2999.6315789473683,44,20,1,64
12729,4.383500000000968,3115.7,41,22,0,63
12730,31.936250000002058,5340.2,90,24,0,114
12731,9.881250000000474,3737.8,56,17,0,73
12732,33.72700000000206,5254.5,90,15,0,105
12733,-16.32049999999954,2639.5263157894738,27,35,1,62
12734,0.6907500000008032,3643.35,45,27,0,72
12735,14.022750000001697,3819.5,62,22,0,84
12736,19.11575000000072,3641.315789473684,62,21,1,83
12737,-13.45524999999983,2116.5,28,40,3,68
12738,21.104750000000628,3531.0,63,20,2,83
12739,-1.1097499999991443,3478.4210526315787,46,40,0,86
12740,8.497250000001372,3017.294117647059,73,38,1,111
12741,22.236250000002535,4728.3,80,17,0,97
12742,24.650750000001675,4117.473684210527,81,27,0,108
12743,1.8182500000002637,3044.842105263158,37,28,0,65
12744,3.5100000000010008,2472.5333333333333,42,29,0,71
12745,19.390500000001563,2723.625,67,32,0,99
12746,12.098250000001089,3363.15,55,16,0,71
12747,-8.789249999999104,2679.3529411764707,35,26,0,61
12748,-5.821499999999131,2877.9444444444443,44,35,1,79
12749,5.600500000001395,3725.2,55,29,1,84
12750,-0.010999999999125088,2975.470588235294,40,30,0,70
12751,18.555500000001114,3462.705882352941,73,26,0,99
12752,1.4642500000007872,3134.8947368421054,48,22,0,70
12753,19.384250000000566,2457.6,60,25,1,85
12754,5.412750000000853,2509.4375,50,40,0,90
12755,-16.339999999999588,2750.45,22,33,2,55
12756,-1.491499999999513,2899.5263157894738,42,26,2,68
12757,24.527500000001798,4679.1,75,18,1,93
12758,31.28900000000228,5089.9473684210525,85,19,0,104
12759,9.356000000001526,4237.05,66,25,0,91
12760,21.517250000000423,3568.6315789473683,49,22,0,71
12761,-4.937999999998848,3183.85,39,35,0,74
12762,10.300500000001175,4035.5,65,19,1,84
12763,-24.530749999999067,2559.95,33,21,0,54
12764,0.4742500000013023,2976.3684210526317,46,26,0,72
12765,28.54225000000243,4617.833333333333,79,23,0,102
12766,-36.07675000000015,1429.0,8,38,2,46
12767,8.198500000001825,3611.55,55,30,0,85
12768,12.591250000000999,4552.85,64,29,1,93
12769,-27.24499999999956,2008.4,10,29,1,39
12770,8.094750000001522,2768.4375,58,31,0,89
12771,4.300500000001637,3056.05,50,23,0,73
12772,1.855500000000537,3253.6,44,26,0,70
12773,-19.225250000000113,1967.0,18,27,5,45
12774,2.0352500000015317,3777.4736842105262,70,26,2,96
12775,6.996000000001599,3172.684210526316,65,12,0,77
12776,14.120000000001443,4377.210526315789,63,23,3,86
12777,26.98625000000128,5266.4,74,16,0,90
12778,-27.962999999999436,2568.05,28,28,1,56
12779,-11.066999999999203,3401.25,45,24,1,69
12780,28.265750000000992,3953.684210526316,64,26,0,90
12781,-18.2582499999997,1866.4375,28,33,1,61
12782,13.185500000000653,3586.0526315789475,66,24,0,90
12783,10.065249999999937,2275.8823529411766,45,32,1,77
12784,9.837500000001674,3298.294117647059,74,18,2,92
12785,4.970250000002098,4298.1,73,28,0,101
12786,13.804000000001725,4429.05,61,27,3,88
12787,-29.433499999999306,2008.4,15,25,3,40
12788,-21.33449999999953,2016.3,13,28,2,41
12789,-25.86574999999892,2633.85,35,26,0,61
12790,0.22350000000092188,3778.25,53,31,2,84
12791,-15.478499999999372,2670.3,34,23,0,57
12792,8.654500000000542,3079.95,44,23,0,67
12793,24.13975000000116,4059.9473684210525,83,22,0,105
12794,-27.621499999999525,2218.7,14,35,0,49
12795,29.270250000001603,4929.9,70,27,1,97
12796,2.014750000001183,2869.625,53,26,0,79
12797,-15.746249999999364,2544.15,32,18,4,50
12798,-11.000749999999986,2437.0,41,34,2,75
12799,35.44350000000208,5274.3,87,21,0,108
12800,16.866749999999616,2042.5882352941176,64,26,0,90
12801,-11.42599999999955,2512.8333333333335,35,26,26,61
12802,-3.9102499999996283,2488.1666666666665,32,26,2,58
12803,-13.026249999998821,2080.8125,46,40,0,86
12804,-3.5962499999985598,3072.05,46,23,0,69
12805,-21.595499999999767,2621.2105263157896,28,33,6,61
12806,7.341250000001345,2416.125,70,21,0,91
12807,20.63225000000096,2987.3888888888887,62,22,0,84
12808,16.26299999999994,2572.0,51,46,1,97
12809,-27.423499999999525,2106.9,9,34,0,43
12810,-0.07874999999892758,3132.4,47,21,0,68
12811,8.480000000001178,2462.6470588235293,48,27,0,75
12812,9.922250000001277,3826.0,56,24,0,80
12813,-9.752249999998629,2388.5,36,25,0,61
12814,15.768500000000563,3084.529411764706,61,34,0,95
12815,12.98200000000094,3476.6666666666665,60,31,0,91
12816,-19.557249999999772,2048.1,17,27,3,44
12817,-24.91249999999944,2024.3,14,27,1,41
12818,31.51050000000156,3523.5555555555557,82,24,1,106
12819,18.550000000002008,4971.15,78,18,0,96
12820,-2.0102499999989294,3352.2105263157896,48,18,3,66
12821,6.719500000000528,2362.764705882353,50,26,3,76
12822,-24.183249999999763,2052.1,14,31,2,45
12823,-22.637999999999504,2771.2,22,34,1,56
12824,33.642750000001016,5262.4,78,24,2,102
12825,30.62200000000148,3030.470588235294,73,23,1,96
12826,31.386500000001583,4096.631578947368,74,24,0,98
12827,-43.87224999999967,2089.0,13,34,1,47
12828,19.131250000001106,3754.5,60,20,0,80
12829,0.2647500000012128,3887.15,54,26,0,80
12830,17.924750000001374,4233.05,68,20,0,88
12831,26.33400000000044,2949.3333333333335,69,26,0,95
12832,6.894250000000824,2572.0,49,37,0,86
12833,-1.5344999999993587,2978.8947368421054,39,24,0,63
12834,-9.690999999999464,2556.0,24,31,0,55
12835,14.304000000001675,3576.0526315789475,63,22,0,85
12836,-11.907499999999411,2721.2,27,29,0,56
12837,-25.747999999999195,2528.45,25,28,1,53
12838,-7.035999999999317,2548.15,35,22,2,57
12839,-7.391499999999562,3143.3888888888887,50,27,0,77
12840,24.787000000002244,5277.55,75,22,0,97
12841,-9.997999999999315,2440.842105263158,30,27,3,57
12842,-2.4747499999992364,3095.8,39,21,0,60
12843,-15.413250000000152,2628.3333333333335,29,31,1,60
12844,42.11325000000173,4250.1578947368425,90,20,2,110
12845,13.420250000001776,4481.35,60,26,0,86
12846,-12.011249999999144,2419.3888888888887,50,32,9,82
12847,-4.44099999999933,2573.684210526316,30,24,1,54
12848,24.114250000001512,4167.15,66,20,0,86
12849,-12.485749999999092,2906.9473684210525,38,25,3,63
12850,-2.367749999998883,2571.9375,47,26,0,73
12851,-5.208999999997744,4480.0,61,38,0,99
12852,34.54450000000104,5498.95,74,19,0,93
12853,-20.826499999999637,2008.5,12,34,0,46
12854,-4.143499999999515,2572.0,27,33,0,60
12855,18.391750000002695,5105.3,93,9,0,102
12856,-5.808999999999072,3295.9,41,21,0,62
12857,-16.583499999998796,2649.7,30,31,0,61
12858,-3.2159999999989237,2532.3,30,26,4,56
12859,-35.54724999999955,2530.0526315789475,21,31,0,52
12860,1.5395000000001033,2317.9444444444443,37,35,0,72
12861,3.0662500000011343,3362.4,48,29,0,77
12862,-3.4717499999984995,3236.2,46,34,0,80
12863,-18.584999999999024,2047.1176470588234,35,31,0,66
12864,9.939500000001248,3992.1052631578946,53,39,1,92
12865,-5.904249999999584,2543.4,33,23,1,56
12866,-1.6782499999991547,3044.6111111111113,42,28,0,70
12867,5.423750000000217,2161.1875,58,31,0,89
12868,4.01025000000016,2479.4117647058824,34,36,0,70
12869,-28.31124999999946,2097.3,13,35,1,48
12870,-0.6752499999989153,2681.277777777778,43,27,1,70
12871,8.379000000000975,2527.25,57,39,0,96
12872,0.9125000000011976,3473.277777777778,46,33,0,79
12873,17.10075000000113,2828.9333333333334,61,26,0,87
12874,-1.2507499999989948,3337.1,40,28,0,68
12875,7.97125000000141,3375.5,48,32,0,80
12876,-16.699499999999503,2483.3684210526317,26,33,1,59
12877,-8.321999999999475,2517.9411764705883,35,31,0,66
12878,0.2550000000007374,2865.6111111111113,43,38,0,81
12879,-7.624499999999289,2562.3333333333335,28,26,1,54
12880,-9.839249999999215,2552.15,29,32,0,61
12881,0.12350000000045495,2476.6666666666665,60,35,0,95
12882,6.031750000000304,2514.0,45,30,0,75
12883,5.230750000000802,2583.5333333333333,54,32,0,86
12884,-5.507499999998887,3229.0,43,28,0,71
12885,28.08725000000114,4099.8,64,21,0,85
12886,28.281750000001928,5168.75,73,24,0,97
12887,45.685000000002894,6203.75,102,21,0,123
12888,38.319250000001915,5402.1,90,21,0,111
12889,8.739000000001914,2422.733333333333,64,25,0,89
12890,3.684000000000431,2967.1052631578946,55,28,2,83
12891,-17.538749999998952,3119.65,39,20,1,59
12892,9.107750000000674,2545.25,52,30,0,82
12893,-14.58649999999913,2643.7894736842104,33,30,8,63
12894,-3.782499999998046,4096.5,59,31,0,90
12895,19.94300000000165,4104.210526315789,67,36,0,103
12896,-2.7599999999988603,3731.5882352941176,66,45,0,111
12897,-2.1409999999988814,2534.3125,54,28,1,82
12898,-5.410249999998918,4983.8,55,32,1,87
12899,-6.033499999999433,2544.2,24,32,0,56
12900,6.202250000001576,4029.0,67,25,1,92
12901,30.80525000000145,2787.6470588235293,65,28,0,93
12902,-8.859749999998966,1996.5,41,28,0,69
12903,26.43975000000207,4273.6,73,24,0,97
12904,-13.083999999998984,2478.5882352941176,54,29,2,83
12905,1.815750000000915,2995.5789473684213,43,21,1,64
12906,19.151000000000746,3803.3684210526317,77,26,2,103
12907,-3.9429999999994245,3068.157894736842,48,33,4,81
12908,-2.9924999999995565,2269.4117647058824,37,34,0,71
12909,32.24550000000198,4809.35,86,17,0,103
12910,14.861000000001372,2952.9411764705883,54,25,0,79
12911,-9.083249999999104,2914.25,31,31,1,62
12912,-6.069999999999015,2928.277777777778,46,27,1,73
12913,-34.86249999999954,3037.85,24,31,2,55
12914,-19.910999999999294,2653.375,27,30,1,57
12915,53.492250000002,5283.0,85,23,0,108
12916,15.148000000000982,2882.8823529411766,69,28,0,97
12917,1.7257500000011974,3546.5,46,37,0,83
12918,15.27075000000023,5096.578947368421,66,31,8,97
12919,-3.915249999999207,3319.9411764705883,57,36,1,93
12920,0.3415000000008823,2550.1875,38,25,0,63
12921,6.017250000001541,4108.4,57,21,0,78
12922,22.896750000001475,4742.55,61,30,0,91
12923,1.5532500000005414,2698.777777777778,46,26,0,72
12924,18.199000000001906,4273.55,65,33,0,98
12925,12.453500000000778,2412.235294117647,61,35,0,96
12926,-3.6837499999987626,3341.75,40,30,2,70
12927,25.00450000000181,2333.8,71,34,0,105
12928,0.2647500000007906,1870.7058823529412,45,28,1,73
12929,-14.072999999998956,3251.1052631578946,41,37,0,78
12930,26.164750000001703,5225.0,81,26,0,107
12931,23.372500000001853,4171.05,69,21,0,90
12932,-13.910249999999555,2054.0625,39,27,1,66
12933,6.272500000001271,2381.4,58,35,0,93
12934,-22.52449999999994,1429.0,25,34,0,59
12935,20.873250000001867,2969.705882352941,70,24,0,94
12936,10.022750000000885,3389.8947368421054,57,28,1,85
12937,-17.07124999999991,2028.4705882352941,27,27,4,54
12938,31.82450000000076,3420.764705882353,79,22,0,101
12939,0.9662500000014301,4300.55,53,21,1,74
12940,5.949250000000698,3183.9,49,21,0,70
12941,-9.223749999999821,2230.315789473684,23,29,1,52
12942,4.091750000001004,2885.8888888888887,38,34,1,72
12943,19.72700000000149,3938.6,57,28,0,85
12944,-4.177249999998923,2837.3888888888887,42,33,1,75
12945,-22.63649999999934,2028.25,19,30,0,49
12946,-5.553499999999088,3185.5,42,16,5,58
12947,20.493000000000272,2616.5,76,27,1,103
12948,-13.038749999999329,2528.3,24,26,3,50
12949,-24.633999999999393,1974.5263157894738,15,31,4,46
12950,29.772000000001277,2929.0625,63,29,0,92
12951,-2.575249999998636,2447.6111111111113,41,21,1,62
12952,-14.55624999999917,2540.25,26,32,1,58
12953,-18.94924999999973,2118.176470588235,18,36,0,54
12954,23.96000000000113,4423.6,59,28,0,87
12955,19.469500000001567,2637.4375,64,23,0,87
12956,13.735500000001343,3960.4736842105262,51,37,0,88
12957,27.59750000000215,5217.95,81,27,0,108
12958,-8.282999999998653,2972.4444444444443,39,30,0,69
12959,10.735250000001074,3090.176470588235,64,26,0,90
12960,-17.021749999999464,2139.4,17,29,2,46
12961,30.15600000000142,4675.15,73,22,0,95
12962,0.5140000000006377,3728.157894736842,42,38,0,80
12963,-24.854749999999193,2008.45,19,25,4,44
12964,-18.23299999999877,2607.294117647059,27,24,11,51
12965,-2.105999999998564,3109.9473684210525,43,29,2,72
12966,24.271500000001563,3968.8947368421054,78,33,1,111
12967,39.47300000000193,4714.85,77,22,0,99
12968,-8.555999999999354,2500.5,30,29,0,59
12969,34.2775000000025,2434.4666666666667,71,26,0,97
12970,-5.2479999999996885,2805.714285714286,55,30,3,85
12971,35.65075000000182,4667.2,90,9,0,99
12972,53.39725000000086,4752.9,77,19,0,96
12973,26.280000000001866,4739.35,77,22,0,99
12974,-29.99774999999977,1967.157894736842,15,31,7,46
12975,31.858750000002278,4783.1,76,27,0,103
12976,-25.99699999999968,2264.4736842105262,22,29,2,51
12977,13.549250000000551,3904.45,46,28,0,74
12978,16.425000000001194,3793.4,59,21,0,80
12979,27.208250000001254,4425.1,61,26,0,87
12980,-29.867249999999466,2072.7,16,24,2,40
12981,38.67200000000169,5441.65,90,35,0,125
12982,0.31450000000105083,2383.4375,50,29,0,79
12983,-0.6942499999990476,3113.35,42,25,0,67
12984,26.148000000002696,2887.5,73,25,0,98
12985,36.55875000000261,2913.3125,85,19,0,104
12986,17.712250000001312,2839.8125,58,24,0,82
12987,5.846250000001758,2736.176470588235,54,20,1,74
12988,-4.432749999999087,3100.7368421052633,39,32,0,71
12989,-23.83874999999979,1958.4117647058824,18,28,7,46
12990,-19.40274999999972,1839.75,26,32,1,58
12991,13.426000000001505,3552.15,54,25,0,79
12992,20.225750000001263,3753.2105263157896,64,22,0,86
12993,-19.33824999999855,2570.1176470588234,33,31,0,64
12994,9.001750000001183,3796.8333333333335,68,29,0,97
12995,-3.3677499999993676,2560.25,30,29,0,59
12996,-10.965999999999436,2552.0,25,30,0,55
12997,27.605500000002003,5261.117647058823,69,28,0,97
12998,14.849000000000714,3788.2631578947367,76,23,2,99
12999,4.613000000001617,3883.9,44,32,0,76
13000,-4.788999999998621,2476.6666666666665,35,29,0,64
13001,14.721500000001233,2925.1875,53,19,0,72
13002,-18.278999999999236,2691.75,33,23,4,56
13003,27.77075000000305,2912.0,79,22,0,101
13004,-5.652999999998898,3469.157894736842,62,15,1,77
13005,-16.93574999999924,2015.4117647058824,27,31,0,58
13006,13.460000000000113,3104.1052631578946,67,30,1,97
13007,17.473750000000923,2964.8125,68,28,0,96
13008,-9.167249999999358,2513.235294117647,33,26,3,59
13009,8.180750000001778,3688.9473684210525,56,28,0,84
13010,-5.960999999999622,3028.0526315789475,46,24,7,70
13011,10.304750000000602,2490.285714285714,50,26,0,76
13012,37.10075000000101,4283.05,68,25,0,93
13013,8.723000000000935,2410.133333333333,55,26,2,81
13014,18.661750000001412,3905.315789473684,63,27,0,90
13015,11.404500000000727,3749.8947368421054,73,19,1,92
13016,-13.257499999999585,2703.842105263158,36,23,7,59
13017,-0.03749999999978328,3818.0,64,35,0,99
13018,-1.615499999997888,2912.764705882353,68,27,1,95
13019,4.155000000000414,2765.176470588235,50,25,0,75
13020,2.7010000000011654,2744.5,53,28,1,81
13021,22.592000000001388,3788.65,66,18,0,84
13022,3.2167500000008444,2429.0666666666666,44,31,0,75
13023,12.618000000001421,3084.222222222222,58,21,0,79
13024,-44.17075000000025,1429.0,0,34,11,34
13025,44.06850000000268,5198.9,102,19,0,121
13026,-9.330749999999203,2714.0,26,36,0,62
13027,3.0582500000008572,3165.55,50,16,0,66
13028,12.723000000001745,3466.0555555555557,55,26,0,81
13029,-20.559249999998993,2005.4375,28,29,2,57
13030,-4.8412499999993175,2455.8947368421054,31,29,2,60
13031,5.5315000000004755,2312.9375,51,38,1,89
13032,16.462750000001538,3639.3,64,17,0,81
13033,-2.2529999999985546,2643.3333333333335,43,33,1,76
13034,-5.208749999999054,4135.45,64,15,1,79
13035,30.94000000000122,2467.133333333333,89,18,2,107
13036,-14.612499999999557,2671.85,31,24,0,55
13037,-13.215499999998794,1954.6470588235295,42,33,1,75
13038,24.68800000000099,3405.3888888888887,95,18,5,113
13039,16.516250000001552,3301.1666666666665,61,22,0,83
13040,-23.98974999999971,2044.1,14,29,1,43
13041,7.836750000002127,3423.470588235294,62,27,2,89
13042,-5.60100000000057,1866.0,54,30,0,84
13043,27.12400000000168,4744.95,68,27,0,95
13044,0.3637500000004599,2570.2631578947367,42,27,1,69
13045,14.670750000001027,3328.4117647058824,75,16,0,91
13046,16.064500000002248,4783.9,89,19,0,108
13047,-7.889249999999869,2101.3529411764707,25,47,0,72
13048,-37.29074999999962,2071.8,16,28,5,44
13049,18.53900000000158,3036.25,73,28,0,101
13050,-6.470749999999396,2741.1428571428573,28,28,2,56
13051,-6.3379999999998375,1857.625,41,31,0,72
13052,16.40450000000027,3056.0555555555557,53,30,0,83
13053,7.278750000000885,3149.2105263157896,49,24,2,73
13054,29.90125000000229,2079.8823529411766,64,25,1,89
13055,-22.763749999999757,1980.421052631579,18,32,1,50
13056,-0.13099999999982703,2218.8823529411766,34,38,0,72
13057,13.664750000000566,3729.1,51,20,0,71
13058,23.308000000002757,3624.0,83,28,4,111
13059,51.27725000000301,3100.8125,95,17,0,112
13060,-8.54749999999862,3060.15,52,18,0,70
13061,16.842750000001445,4363.8421052631575,68,22,0,90
13062,-0.526749999998447,3087.75,50,22,0,72
13063,-19.969249999999608,2078.3,17,29,1,46
13064,1.3567500000010235,3368.8,48,19,0,67
13065,15.179250000001947,4472.9,82,22,0,104
13066,-16.06949999999926,2492.4210526315787,32,26,1,58
13067,47.277500000000664,3412.1875,108,15,0,123
13068,35.331000000001836,5771.9,77,28,0,105
13069,-5.460499999999207,2161.125,38,28,0,66
13070,5.741750000001614,2615.1666666666665,52,22,0,74
13071,14.408250000001653,2892.5,65,22,0,87
13072,-0.17874999999958607,2009.3125,42,43,0,85
13073,34.99125000000182,4825.9,85,21,0,106
13074,2.0585000000004054,3545.9,41,26,0,67
13075,-15.85449999999947,2113.5625,31,23,0,54
13076,-1.5124999999994322,2623.8888888888887,63,28,3,91
13077,41.03525000000105,5313.0,89,28,1,117
13078,21.548750000001796,4115.0,61,23,0,84
13079,6.6462500000007765,3054.1052631578946,46,29,0,75
13080,12.969750000001984,4119.7,72,17,0,89
13081,-2.738749999999002,3601.2631578947367,55,25,2,80
13082,1.7177500000016657,2914.25,67,15,0,82
13083,24.373000000002108,4407.65,81,17,0,98
13084,55.18550000000189,5774.45,94,24,1,118
13085,-25.347249999999608,2024.25,17,22,2,39
13086,22.060750000001594,4718.95,72,27,0,99
13087,-9.752999999998606,2438.6,40,29,0,69
13088,3.6392500000008368,3198.9,48,27,0,75
13089,5.783750000000974,2251.6470588235293,49,20,1,69
13090,1.5675000000007067,2380.5,46,22,13,68
13091,-2.954999999998527,2847.6875,51,30,0,81
13092,3.39575000000159,2777.25,65,34,0,99
13093,-2.915249999999182,3215.5,47,28,2,75
13094,1.6102500000009505,3214.0,40,24,0,64
13095,-6.091499999998918,3215.6,41,33,0,74
13096,27.852750000000782,4726.473684210527,73,27,0,100
13097,7.73150000000112,3197.5882352941176,52,21,0,73
13098,4.509750000000994,3984.5789473684213,60,26,1,86
13099,4.213500000000609,2945.0,52,30,1,82
13100,-29.35825000000002,1429.0,11,28,2,39
13101,12.015500000000626,2777.3125,53,17,0,70
13102,18.48600000000095,2260.1176470588234,57,36,0,93
13103,34.72275000000172,4683.15,83,19,0,102
13104,5.3272500000010705,2826.764705882353,63,27,0,90
13105,-38.41900000000011,1429.0,10,26,6,36
13106,-18.151250000000168,1959.5263157894738,10,34,11,44
13107,26.283750000001113,5567.2,75,25,0,100
13108,24.75175000000178,4679.2,86,15,0,101
13109,21.882500000001905,4115.55,66,22,0,88
13110,0.3345000000010313,2391.4375,41,24,3,65
13111,14.463250000001434,4428.45,70,20,0,90
13112,32.26200000000173,4408.1578947368425,83,12,1,95
13113,3.9170000000006304,3338.0,52,36,0,88
13114,5.031500000001068,2572.0,50,30,1,80
13115,-14.527249999998787,2232.0588235294117,40,42,0,82
13116,-18.60674999999972,1929.5294117647059,26,26,4,52
13117,12.69400000000094,3148.25,50,20,0,70
13118,32.163000000001986,5742.65,84,10,1,94
13119,9.278250000001163,3119.5,52,19,0,71
13120,20.362250000001346,4184.55,70,15,0,85
13121,20.834000000000138,3840.1052631578946,73,32,0,105
13122,4.759250000000849,1481.9333333333334,52,25,1,77
13123,7.405250000000946,3342.2631578947367,50,30,0,80
13124,-2.3707499999998527,2313.235294117647,57,31,0,88
13125,-2.0809999999990145,2942.3333333333335,47,24,2,71
13126,10.413500000001516,3808.294117647059,52,21,0,73
13127,-13.354749999999438,2673.6,28,28,1,56
13128,-9.439499999999482,2028.7777777777778,37,35,0,72
13129,5.209750000000613,3071.4736842105262,39,28,0,67
13130,-17.74900000000013,1429.0,54,35,2,89
13131,-24.1357499999992,2136.95,22,30,0,52
13132,-9.808749999998996,2135.4375,42,28,1,70
13133,1.9562500000005927,3135.3,42,24,0,66
13134,-49.844250000000244,1429.0,0,27,5,27
13135,26.93075000000156,2894.0588235294117,70,15,1,85
13136,-2.2432499999984463,2449.875,49,26,0,75
13137,31.10725000000185,3142.214285714286,75,25,0,100
13138,-24.280999999999512,2037.0,15,26,2,41
13139,-5.987749999998711,1945.8333333333333,34,28,1,62
13140,37.644500000002026,3951.1176470588234,101,21,0,122
13141,-14.131249999999213,2508.5,27,28,0,55
13142,40.259000000001905,3519.375,93,13,0,106
13143,13.708500000001056,2832.3529411764707,71,23,1,94
13144,-2.9827499999992426,3216.45,43,24,0,67
13145,11.231250000001841,4229.1,74,16,0,90
13146,10.695750000001329,3146.9444444444443,52,30,1,82
13147,10.115500000000711,3882.7368421052633,57,32,0,89
13148,23.127250000001503,4224.4,71,18,0,89
13149,9.46825000000193,2914.8,73,32,0,105
13150,1.786500000001452,3399.9473684210525,53,19,1,72
13151,-9.261249999999608,2618.05,29,25,0,54
13152,11.310499999999966,2536.8333333333335,55,34,0,89
13153,16.61000000000123,3445.0,60,27,0,87
13154,-21.29250000000015,2413.0555555555557,44,34,6,78
13155,29.027250000002,4691.05,73,20,0,93
13156,4.494750000001444,2896.4375,59,24,0,83
13157,23.40475000000101,3953.6315789473683,66,18,0,84
13158,-10.712999999999349,3014.5333333333333,28,32,0,60
13159,10.515000000001118,2960.8333333333335,74,28,0,102
13160,-21.53149999999995,1944.6315789473683,15,30,4,45
13161,-1.4527499999991815,2453.3529411764707,40,26,0,66
13162,14.404000000001767,4958.45,70,24,0,94
13163,1.6242500000013245,4148.2,59,29,0,88
13164,-12.065499999998492,3119.0526315789475,50,33,0,83
13165,-15.319749999999559,2697.35,29,26,1,55
13166,-7.905999999999897,2134.4375,50,37,1,87
13167,-12.333749999998837,2500.5,53,39,0,92
13168,-6.203249999998539,2908.0588235294117,65,30,0,95
13169,25.83275000000243,5403.210526315789,112,23,2,135
13170,11.629000000000897,3350.5263157894738,53,22,2,75
13171,28.313500000001323,3368.470588235294,70,7,0,77
13172,-1.6054999999993982,3512.55,41,32,0,73
13173,-8.445749999999364,2388.6111111111113,38,27,0,65
13174,12.200500000001064,4408.45,60,23,0,83
13175,7.896250000001627,2319.875,59,16,1,75
13176,13.158500000000975,3663.9473684210525,58,27,0,85
13177,-1.0264999999995417,2667.3571428571427,34,25,0,59
13178,-15.364249999999263,2437.0,37,27,0,64
13179,-20.289499999999656,2126.7,20,27,1,47
13180,-4.654499999999336,2544.315789473684,28,35,3,63
13181,31.052000000001026,4337.85,67,20,0,87
13182,-14.396249999999554,2572.0,33,39,0,72
13183,-3.766249999999321,3139.4,41,26,0,67
13184,-8.90649999999906,2227.3529411764707,38,33,0,71
13185,22.999750000001306,2605.75,58,21,0,79
13186,14.132250000001028,3822.6315789473683,56,25,0,81
13187,-2.4397499999984342,3164.65,48,23,0,71
13188,4.359500000001532,3822.0,55,23,0,78
13189,-17.29874999999878,2525.0526315789475,36,27,0,63
13190,25.02400000000124,4099.1578947368425,74,18,0,92
13191,19.535750000001304,4005.4,64,17,1,81
13192,-24.759249999999533,2059.25,17,32,0,49
13193,45.95550000000169,3990.235294117647,94,10,0,104
13194,-9.02874999999955,2439.6111111111113,42,36,0,78
13195,-9.307249999999174,3054.7368421052633,46,25,1,71
13196,37.29025000000193,5302.1,105,6,0,111
13197,4.3467500000012755,4190.25,65,16,0,81
13198,-15.332249999998961,2851.6875,44,26,1,70
13199,16.045000000001355,3552.05,60,21,1,81
13200,2.3517500000024336,4198.473684210527,76,17,0,93
13201,15.348500000001568,2786.25,81,17,0,98
13202,-23.29774999999936,2512.6315789473683,33,26,0,59
13203,14.664000000001598,2954.823529411765,63,21,0,84
13204,22.869500000000777,2585.0588235294117,56,21,0,77
13205,9.080500000001742,2215.266666666667,73,15,0,88
13206,17.423000000001345,3336.705882352941,78,27,0,105
13207,-6.377249999999313,2546.3888888888887,35,23,1,58
13208,5.382500000000934,3681.45,58,18,0,76
13209,-5.570249999999042,2419.6666666666665,44,28,0,72
13210,-4.226999999998072,1974.0,44,14,7,58
13211,-11.978749999998943,2794.15,35,33,1,68
13212,-26.309249999999736,1967.0526315789473,17,27,3,44
13213,25.284750000000894,3464.9375,74,25,1,99
13214,-12.598249999999405,2505.266666666667,37,32,1,69
13215,-3.8454999999991175,2053.9375,39,31,0,70
13216,1.1115000000005997,3145.7,46,19,1,65
13217,12.746750000000244,5262.45,62,13,0,75
13218,-3.066250000000245,1952.888888888889,46,40,2,86
13219,-16.149499999998923,3019.7894736842104,42,22,0,64
13220,27.972000000002186,5065.55,89,13,3,102
13221,-13.918249999999244,2455.7894736842104,35,22,0,57
13222,-8.332749999999919,1857.6470588235295,32,37,2,69
13223,27.11250000000054,2618.625,68,28,0,96
13224,-16.21574999999975,1976.2105263157894,18,27,3,45
13225,-3.9289999999991805,3611.6,43,26,0,69
13226,-9.833249999998895,4397.3,60,31,0,91
13227,-12.808999999999182,3087.8333333333335,44,30,1,74
13228,15.716500000001767,1987.5625,81,26,0,107
13229,23.4472500000009,4147.526315789473,78,25,1,103
13230,-9.38699999999859,3183.0,51,32,0,83
13231,3.870000000000701,3554.125,69,32,0,101
13232,1.3987500000010133,1951.9375,46,30,2,76
13233,16.426750000001313,4228.25,62,22,0,84
13234,-4.527499999999021,2534.25,51,30,1,81
13235,-15.930499999998526,2495.1111111111113,36,28,0,64
13236,16.292250000001324,2980.1176470588234,60,13,0,73
13237,31.4965000000018,5294.1,94,10,0,104
13238,11.314250000001085,3754.0,64,36,0,100
13239,34.21425000000225,4797.473684210527,94,18,0,112
13240,-25.16049999999941,2020.25,16,31,1,47
13241,29.8040000000022,4754.5,84,25,0,109
13242,3.9430000000012866,2537.6111111111113,49,30,0,79
13243,-10.707749999999294,2616.4666666666667,31,27,1,58
13244,12.625000000000536,2531.733333333333,65,19,2,84
13245,20.178750000000868,2588.823529411765,64,29,0,93
13246,10.906250000001933,4384.7,73,20,0,93
13247,-6.749999999999856,1848.6875,64,32,0,96
13248,6.026750000000633,2393.375,54,37,0,91
13249,22.947250000002377,2949.875,82,12,0,94
13250,9.066750000001395,2974.0,48,23,1,71
13251,12.357000000000928,1920.0625,75,29,1,104
13252,-13.809749999999287,2531.842105263158,31,31,1,62
13253,-0.8099999999987324,2445.777777777778,46,26,0,72
13254,-14.16099999999928,2381.4666666666667,47,33,1,80
13255,-21.911249999999477,2037.05,15,28,0,43
13256,-30.321749999999525,2769.4285714285716,26,34,0,60
13257,12.763500000000517,2943.222222222222,53,19,0,72
13258,-1.865249999998964,3099.4444444444443,48,25,0,73
13259,12.42175000000086,2598.75,79,19,0,98
13260,16.737000000001498,2157.3125,58,27,3,85
13261,33.387250000001686,4702.95,81,18,0,99
13262,8.096000000000926,3464.2105263157896,54,18,3,72
13263,9.894250000000694,3119.65,49,19,1,68
13264,-2.1122499999989044,3064.0,49,18,0,67
13265,-0.5742499999991642,2400.4666666666667,51,29,0,80
13266,17.19450000000088,4103.2,56,19,1,75
13267,-23.598249999999695,1429.0,17,35,0,52
13268,3.7310000000007535,2125.4375,43,34,0,77
13269,-2.5229999999994446,3219.315789473684,52,26,6,78
13270,28.576500000000998,3940.2631578947367,81,17,0,98
13271,-15.336249999999183,2568.0,30,29,0,59
13272,-2.89849999999904,2559.9,34,27,0,61
13273,29.129000000002236,2570.9375,72,23,0,95
13274,25.49175000000235,4593.4,84,23,1,107
13275,-0.7309999999993657,2556.05,31,23,1,54
13276,-4.133749999999678,2277.25,58,35,1,93
13277,-8.300249999999966,1963.1176470588234,47,26,4,73
13278,4.481000000000635,3072.1,49,21,0,70
13279,9.52750000000141,3329.3333333333335,73,23,0,96
13280,0.25275000000097786,3164.9,40,31,0,71
13281,-18.414249999999498,2496.6315789473683,37,18,7,55
13282,37.171750000002596,4691.0,88,13,0,101
13283,32.7882500000011,4556.15,73,8,0,81
13284,18.180500000001487,2924.823529411765,69,22,0,91
13285,23.355750000000377,2777.294117647059,69,20,0,89
13286,16.28950000000101,2709.1176470588234,65,28,0,93
13287,-1.1369999999999476,2751.9333333333334,37,38,12,75
13288,-16.66949999999948,2617.0,28,27,0,55
13289,-8.50274999999984,2023.25,54,26,3,80
13290,-5.5082499999992205,2518.375,33,31,0,64
13291,34.476000000001136,2719.6875,77,20,1,97
13292,12.521750000000228,2944.222222222222,74,28,2,102
13293,21.026250000001685,3575.8,68,16,0,84
13294,9.765750000002729,3013.5,79,26,2,105
13295,-26.981499999999453,1995.111111111111,18,38,2,56
13296,-33.01100000000049,1429.0,14,39,0,53
13297,5.847250000000125,2572.0,47,37,0,84
13298,17.65300000000196,2745.5,72,26,0,98
13299,17.97600000000218,4064.842105263158,76,18,0,94
13300,0.3517500000010342,2371.5625,47,16,0,63
13301,27.16850000000066,3445.9411764705883,77,17,0,94
13302,-2.9384999999990526,3181.4,50,20,0,70
13303,-15.370249999999137,2561.764705882353,30,24,1,54
13304,9.079000000001063,3553.5789473684213,56,18,1,74
13305,15.034500000002023,4205.105263157895,73,31,0,104
13306,-10.607999999999109,3082.3684210526317,46,26,1,72
13307,-0.5582499999986014,3125.85,43,21,2,64
13308,-16.832749999999244,2196.5882352941176,34,25,0,59
13309,-1.8392499999996956,1985.5625,44,25,1,69
13310,24.994750000000842,3274.235294117647,82,29,2,111
13311,-11.169499999999184,2694.2,30,37,0,67
13312,18.81175000000152,3685.3,67,17,0,84
13313,6.834000000001434,2688.6470588235293,62,24,0,86
13314,-27.238499999999455,1429.0,10,43,4,53
13315,2.2955000000011667,2477.6111111111113,38,31,0,69
13316,0.8987500000011177,2448.266666666667,50,32,0,82
13317,-4.780249999998821,3417.2,44,26,0,70
13318,0.7405000000012878,2436.1666666666665,42,27,0,69
13319,-30.93574999999952,2103.6111111111113,25,37,1,62
13320,13.47300000000197,2438.470588235294,59,23,1,82
13321,1.4802500000007206,3224.4210526315787,45,21,0,66
13322,-1.0437499999994144,2582.214285714286,46,23,0,69
13323,2.4005000000000103,2618.625,46,27,0,73
13324,-5.404999999998409,2433.5,58,36,0,94
13325,0.8065000000008451,2476.75,51,18,0,69
13326,22.33900000000136,3607.6,60,26,0,86
13327,2.540000000000852,3374.0,57,21,0,78
13328,0.7452500000006164,2969.684210526316,44,20,1,64
13329,-18.988499999999988,1973.111111111111,17,34,12,51
13330,16.93300000000135,3999.684210526316,64,20,0,84
13331,10.718000000002176,3491.722222222222,68,17,0,85
13332,4.614500000000643,2345.0,48,29,0,77
13333,-12.845999999999265,2566.3529411764707,29,28,0,57
13334,-14.738249999999232,2563.0625,34,26,1,60
13335,-15.318749999999577,2028.6666666666667,26,24,2,50
13336,19.319250000002313,4948.2,83,26,0,109
13337,29.745500000001634,2824.0625,71,12,0,83
13338,-10.758749999999322,2496.294117647059,33,24,1,57
13339,6.59650000000016,2480.0714285714284,71,32,0,103
13340,-12.85150000000026,2014.5555555555557,28,31,5,59
13341,12.906000000001097,2964.9375,70,25,0,95
13342,-20.6224999999994,2487.5263157894738,34,30,2,64
13343,-9.813499999999006,3082.3,37,32,0,69
13344,7.132250000001358,3786.2,62,18,0,80
13345,4.320500000000729,3052.5555555555557,54,21,0,75
13346,24.45025000000172,2467.266666666667,75,26,0,101
13347,-4.080999999999731,3143.3684210526317,56,25,0,81
13348,1.4777500000008315,3123.6,45,25,0,70
13349,-18.21924999999919,2567.9,33,32,0,65
13350,-28.28099999999976,1429.0,13,30,2,43
13351,-12.996749999999102,2602.9473684210525,30,26,0,56
13352,23.566250000001595,4216.0526315789475,66,22,1,88
13353,-47.05274999999998,1429.0,0,30,1,30
13354,-26.322749999999523,2028.25,16,25,2,41
13355,-0.4319999999994019,3588.705882352941,67,22,0,89
13356,3.9510000000004646,2125.4375,69,24,0,93
13357,13.128500000001328,3578.1666666666665,71,21,2,92
13358,-0.7534999999995021,3103.6111111111113,68,24,0,92
13359,1.9169999999998821,1429.0,61,28,4,89
13360,-10.095749999999217,2485.842105263158,34,29,1,63
13361,-21.441749999999555,2166.7894736842104,15,35,1,50
13362,1.1430000000008445,3044.7368421052633,46,24,0,70
13363,-2.0917499999985094,2493.529411764706,47,28,0,75
13364,-18.960499999999143,2050.125,28,21,0,49
13365,15.239000000001857,3574.5555555555557,59,23,0,82
13366,-4.843499999999285,2509.4375,32,28,0,60
13367,39.77975000000142,5314.0,94,10,0,104
13368,-2.5529999999985393,2064.9375,61,27,2,88
13369,-4.119249999998412,3707.45,56,25,0,81
13370,13.160500000001369,4619.6,66,16,0,82
13371,-3.336249999998679,1940.5555555555557,37,30,0,67
13372,15.130750000000697,4101.3,53,22,1,75
13373,20.96725000000162,3027.1875,71,20,0,91
13374,21.25675000000111,3227.3529411764707,68,18,0,86
13375,9.833000000000592,2491.625,57,23,0,80
13376,-11.066999999998988,2528.722222222222,36,31,1,67
13377,-14.363749999999603,2733.1,31,28,0,59
13378,22.1122500000022,4287.05,78,18,0,96
13379,15.90750000000133,2793.25,65,17,0,82
13380,-18.201249999999277,2528.15,33,23,0,56
13381,11.04050000000018,2361.823529411765,71,33,0,104
13382,-24.5979999999998,2086.25,13,31,0,44
13383,21.491500000002528,3363.6666666666665,76,15,0,91
13384,-2.683499999999565,2630.823529411765,56,33,0,89
13385,-4.711749999999698,2193.705882352941,33,34,0,67
13386,12.878750000001185,2411.25,73,33,0,106
13387,-22.547750000000228,1429.0,42,29,5,71
13388,4.132500000000604,2021.375,41,25,0,66
13389,-3.750249999999384,2672.75,32,28,0,60
13390,-9.429749999998599,3222.7,46,24,0,70
13391,12.145500000001398,3451.9444444444443,65,21,0,86
13392,18.85325000000135,2696.0,65,19,1,84
13393,34.30475000000167,4635.45,84,13,0,97
13394,0.5875000000017796,3297.35,46,25,0,71
13395,-17.182499999998807,2509.315789473684,32,30,0,62
13396,2.4292500000009154,3018.1052631578946,42,30,0,72
13397,-18.53599999999946,2172.7,22,27,0,49
13398,-26.320749999999386,1528.25,15,32,3,47
13399,-3.417749999999304,3352.875,41,29,0,70
13400,20.958000000002073,4617.15,79,20,2,99
13401,-2.9749999999997936,1862.3529411764705,44,35,0,79
13402,-8.991749999999788,1918.2941176470588,29,31,2,60
13403,33.09675000000193,6215.7,96,17,0,113
13404,0.8562500000009523,3060.5263157894738,51,23,1,74
13405,25.641000000001725,3058.470588235294,74,26,0,100
13406,21.287750000002013,4103.65,69,32,0,101
13407,17.18600000000144,3626.6666666666665,63,27,0,90
13408,-13.26874999999902,2713.3,34,25,0,59
13409,6.602750000001096,2784.4444444444443,41,29,0,70
13410,44.34325000000099,5534.05,79,26,0,105
13411,-13.89399999999947,2669.55,29,26,0,55
13412,20.875250000001788,4464.0,65,24,0,89
13413,3.0610000000010844,2076.0588235294117,88,37,1,125
13414,-21.016749999999554,2615.5,26,27,0,53
13415,8.114250000002007,2701.8125,73,23,0,96
13416,-17.831249999998725,2199.875,35,29,0,64
13417,30.88925000000242,3289.3125,85,25,0,110
13418,-0.06499999999900004,3314.0,42,30,1,72
13419,23.08175000000312,2595.6875,83,17,0,100
13420,0.22500000000071935,2602.6428571428573,47,23,2,70
13421,23.655500000001698,4790.25,75,18,0,93
13422,18.27400000000106,2872.5,69,20,0,89
13423,-20.513499999999105,2074.8947368421054,20,28,4,48
13424,-5.612499999999266,3040.6315789473683,42,25,0,67
13425,-1.4844999999993251,3336.9,46,28,0,74
13426,23.32675000000193,4476.65,72,26,0,98
13427,11.811750000001037,2964.875,57,24,0,81
13428,-0.9627499999985805,3274.722222222222,57,31,0,88
13429,1.8910000000010048,3052.2,46,23,0,69
13430,5.375000000001534,4093.157894736842,63,28,0,91
13431,15.13050000000023,2384.4375,67,29,0,96
13432,21.121750000000652,4214.85,63,20,0,83
13433,17.32300000000108,3733.1,58,17,0,75
13434,-4.661499999999908,2707.722222222222,44,31,4,75
13435,24.501000000001913,4287.9473684210525,74,26,0,100
13436,8.130000000000999,3060.0,49,17,0,66
13437,33.60025000000111,4199.05,64,20,0,84
13438,5.247500000000973,3072.05,54,18,0,72
13439,1.5500000000022882,2500.9333333333334,66,23,0,89
13440,43.13175000000089,5889.4,72,23,0,95
13441,-7.562499999998614,2536.2,34,29,0,63
13442,-10.09949999999947,2509.4375,30,36,0,66
13443,-18.647499999998978,2594.9,30,25,2,55
13444,7.655750000000928,2933.470588235294,51,20,0,71
13445,-4.130749999999361,2581.5333333333333,39,35,1,74
13446,4.582250000000589,2222.6470588235293,46,23,3,69
13447,-11.25699999999919,3985.35,44,33,1,77
13448,-12.9172499999992,2586.2105263157896,28,25,1,53
13449,10.93700000000065,3042.3684210526317,51,27,0,78
13450,-27.056499999999215,1990.7777777777778,25,29,2,54
13451,16.44500000000054,3193.8823529411766,64,22,0,86
13452,-1.5174999999992678,4036.15,50,27,0,77
13453,14.12675000000207,1993.0,53,25,0,78
13454,-14.275749999999652,2077.875,36,22,0,58
13455,15.245250000000397,3471.25,40,33,0,73
13456,-8.415499999999408,2498.722222222222,26,32,2,58
13457,-31.66024999999903,2386.6666666666665,27,39,2,66
13458,26.606500000000807,2482.8333333333335,61,28,1,89
13459,-27.628749999999542,2158.4,13,33,1,46
13460,-21.990749999999576,2703.8947368421054,33,26,1,59
13461,9.253000000001128,1481.9333333333334,56,28,0,84
13462,-8.83549999999931,2519.0555555555557,30,33,0,63
13463,-21.950499999999444,1948.1764705882354,23,28,1,51
13464,12.518500000001538,3530.7,50,28,0,78
13465,18.73825000000101,5250.65,72,28,0,100
13466,-8.386249999998942,2547.95,28,30,0,58
13467,-29.50275000000002,2075.8,12,27,2,39
13468,-12.189249999999287,2547.6315789473683,29,33,0,62
13469,-31.668999999999386,2016.2777777777778,16,37,1,53
13470,11.711500000000592,2454.3529411764707,46,30,0,76
13471,13.594750000001081,3765.8888888888887,67,26,0,93
13472,38.30975000000237,5806.05,94,29,0,123
13473,5.33450000000162,4215.6,67,16,0,83
13474,2.2465000000017286,3992.7,63,28,0,91
13475,-8.269499999999544,2706.5789473684213,29,29,0,58
13476,11.821500000001281,2488.823529411765,50,22,1,72
13477,-24.498999999999604,1986.2631578947369,14,25,3,39
13478,22.190250000000916,2670.125,76,24,0,100
13479,-18.27974999999976,2027.2105263157894,15,32,1,47
13480,2.5287500000004415,2387.176470588235,44,30,0,74
13481,-0.6124999999979079,4357.6,72,21,0,93
13482,18.402250000002947,4528.25,78,20,1,98
13483,16.85900000000145,4087.9,64,12,0,76
13484,1.4027500000005098,3745.7,48,27,0,75
13485,13.83325000000014,2899.705882352941,64,25,0,89
13486,2.8030000000013864,2278.3125,47,22,0,69
13487,-22.822999999999762,2027.0,15,33,2,48
13488,16.08875000000158,3906.2631578947367,60,20,0,80
13489,9.44000000000149,4267.8421052631575,64,23,0,87
13490,13.15175000000157,3028.705882352941,62,19,0,81
13491,-35.43999999999913,2208.45,18,31,0,49
13492,16.43250000000132,4322.571428571428,60,20,0,80
13493,27.45525000000249,4669.65,87,13,0,100
13494,8.626750000000897,4123.45,48,38,0,86
13495,36.12000000000209,5845.75,88,19,0,107
13496,24.3257500000013,4883.85,79,17,0,96
13497,-30.952499999999496,2317.9444444444443,30,32,0,62
13498,2.409000000000988,2991.777777777778,56,19,0,75
13499,-13.895249999999816,1941.388888888889,37,36,2,73
13500,25.642250000001713,2753.0588235294117,76,23,0,99
13501,9.91775000000124,3070.7368421052633,58,18,1,76
13502,16.40425000000148,3739.842105263158,66,18,0,84
13503,-6.428499999998638,2960.8333333333335,44,22,0,66
13504,-9.4597499999993,2807.3888888888887,45,28,0,73
13505,-31.586999999999527,1908.0,27,42,0,69
13506,-5.1102499999995015,2607.0526315789475,33,24,1,57
13507,-10.790749999998821,3087.85,42,23,0,65
13508,7.888500000001568,4521.95,68,24,0,92
13509,27.31000000000151,4218.75,72,23,0,95
13510,21.97175000000157,4750.6,67,18,0,85
13511,3.781750000000602,2341.3529411764707,57,32,1,89
13512,21.106750000001306,4273.6,63,35,0,98
13513,3.257000000002011,5192.55,68,28,0,96
13514,-21.931999999999686,2161.55,17,34,0,51
13515,-13.26749999999926,3886.2,50,26,1,76
13516,-12.25725000000006,1991.4375,60,32,0,92
13517,8.094250000000368,4247.35,47,26,0,73
13518,-2.5149999999995725,2564.1,32,25,0,57
13519,9.733000000002246,2498.5,71,27,0,98
13520,-8.45699999999896,1810.0,58,26,3,84
13521,8.340750000000778,2975.0555555555557,49,22,0,71
13522,-18.04624999999948,2008.4,15,31,0,46
13523,-10.617999999999398,2525.9473684210525,27,27,0,54
13524,-21.555999999999162,2024.3,19,31,1,50
13525,6.983250000000271,1933.9375,53,28,0,81
13526,15.21800000000112,2433.0,59,26,0,85
13527,14.75850000000288,4694.95,80,29,0,109
13528,-25.202499999999482,2008.45,21,21,1,42
13529,-18.081999999999073,1947.9375,26,30,0,56
13530,18.408000000001376,3161.25,76,28,0,104
13531,-2.9294999999994196,2778.222222222222,41,33,0,74
13532,11.021000000001075,3561.0526315789475,55,29,1,84
13533,-8.482249999999821,2415.1176470588234,35,31,10,66
13534,10.27675000000035,2995.3333333333335,71,23,0,94
13535,5.310250000000969,3036.35,36,30,1,66
13536,0.5905000000020604,3780.7894736842104,58,30,0,88
13537,22.883250000002235,4203.75,74,22,0,96
13538,7.292500000001003,2103.75,45,26,0,71
13539,20.866250000001664,3901.6923076923076,70,30,0,100
13540,22.682750000000972,3120.0588235294117,68,17,0,85
13541,-13.422749999999079,2487.8823529411766,25,34,0,59
13542,1.945000000000531,3282.9473684210525,46,33,0,79
13543,-12.79899999999935,2424.1052631578946,27,31,0,58
13544,14.037750000000921,3368.3529411764707,64,28,0,92
13545,20.687500000001684,4771.25,73,21,0,94
13546,16.816750000001058,2848.133333333333,77,27,0,104
13547,47.45500000000176,5940.4,94,17,0,111
13548,-21.711749999999864,2028.3,14,29,0,43
13549,16.111500000000277,2759.5625,49,37,0,86
13550,37.15450000000195,2880.4375,96,25,0,121
13551,6.140250000001903,4282.25,63,31,0,94
13552,-18.569249999999037,2635.4210526315787,32,30,1,62
13553,13.430000000001035,3607.65,53,21,0,74
13554,25.19650000000123,2905.25,70,26,0,96
13555,13.208000000000903,4140.95,58,22,0,80
13556,4.484250000000739,3728.157894736842,56,22,0,78
13557,15.207000000000585,3116.0555555555557,57,30,0,87
13558,5.60375000000098,3410.7368421052633,56,29,0,85
13559,-6.115249999999324,3294.25,37,26,0,63
13560,-7.679249999999809,1875.4375,46,42,0,88
13561,-1.1659999999995816,2521.529411764706,44,43,0,87
13562,17.13400000000198,4292.5,70,28,0,98
13563,21.364750000001795,4333.05,71,30,0,101
13564,-18.571999999999726,2000.5263157894738,14,35,1,49
13565,-13.159499999999563,2657.8,35,38,0,73
13566,30.147000000002,5291.8,90,19,0,109
13567,-14.96299999999844,1997.888888888889,35,23,2,58
13568,21.06925000000178,4261.7,65,33,0,98
13569,6.795250000000555,2438.5333333333333,61,28,0,89
13570,8.923000000001613,4348.9,61,24,0,85
13571,13.360000000000785,3717.15,61,22,0,83
13572,-9.719499999999492,1992.0588235294117,33,35,0,68
13573,-24.58599999999981,2020.5263157894738,11,37,0,48
13574,25.160250000001746,5379.8,76,25,0,101
13575,-24.187749999999433,1933.4444444444443,25,38,3,63
13576,12.813750000002155,3934.65,68,24,0,92
13577,14.886250000000283,2312.9375,76,39,0,115
13578,-13.495999999999707,2455.9473684210525,33,32,7,65
13579,-1.723249999999308,2393.3125,53,39,0,92
13580,20.13925000000167,4198.8,59,30,0,89
13581,34.62075000000255,5765.65,90,24,0,114
13582,-7.191999999999302,2581.5333333333333,32,35,0,67
13583,0.17650000000109065,3555.2105263157896,53,29,0,82
13584,19.264000000001463,4035.6315789473683,57,31,0,88
13585,4.548750000000977,3102.722222222222,52,30,0,82
13586,-14.500499999999567,2231.9411764705883,38,29,4,67
13587,0.4237500000020846,4595.75,60,35,0,95
13588,-6.8919999999989585,3024.3333333333335,40,32,0,72
13589,11.210500000000396,2306.0,60,25,1,85
13590,-8.373749999998918,3317.9473684210525,35,35,0,70
13591,-7.886499999999127,3088.2105263157896,50,32,0,82
13592,15.253750000001602,3754.5,61,22,0,83
13593,-13.579499999998987,2524.35,28,29,0,57
13594,-6.713749999999432,2177.8333333333335,33,29,0,62
13595,-8.19149999999917,2570.1176470588234,38,22,0,60
13596,42.675250000002855,5021.526315789473,101,23,0,124
13597,14.618250000001007,4829.9,57,27,0,84
13598,-15.688749999999306,2531.0,44,22,3,66
13599,21.633750000001427,4579.85,71,27,0,98
13600,5.6980000000006665,3234.4736842105262,45,25,0,70
13601,1.224250000000773,2157.3529411764707,35,26,0,61
13602,21.997500000001615,4785.4,63,24,0,87
13603,-26.04324999999833,1963.7894736842106,22,33,11,55
13604,6.2480000000011655,2570.0,41,29,1,70
13605,25.692250000001387,4195.05,68,22,0,90
13606,19.835250000001015,3731.705882352941,76,29,0,105
13607,6.928750000001017,3416.4,53,23,0,76
13608,27.67200000000069,2132.5,60,25,1,85
13609,11.127000000000262,2413.235294117647,51,35,0,86
13610,6.869500000000981,4416.5,52,27,0,79
13611,21.30925000000139,5016.45,61,29,0,90
13612,32.50225000000159,4842.6,77,24,0,101
13613,29.086000000001548,5413.2,82,18,0,100
13614,-9.408000000000111,1950.0588235294117,30,36,2,66
13615,48.62200000000172,4675.0,76,22,0,98
13616,33.20175000000184,4271.2,68,29,0,97
13617,34.832250000001494,2502.8823529411766,58,23,0,81
13618,17.880750000001235,2958.529411764706,58,29,0,87
13619,-4.674749999999321,2788.777777777778,36,26,0,62
13620,5.01525000000032,2503.222222222222,45,36,0,81
13621,3.3870000000009624,3156.7368421052633,49,27,0,76
13622,-17.099249999998584,2566.6666666666665,29,32,0,61
13623,16.955250000001147,3392.222222222222,65,21,1,86
13624,49.81150000000265,5718.8,101,26,0,127
13625,-1.6522499999991473,3552.05,45,29,0,74
13626,51.20900000000178,4299.388888888889,76,28,0,104
13627,29.316750000001548,5138.65,75,22,0,97
13628,-1.50799999999928,2532.15,31,27,0,58
13629,-11.238749999998667,2422.470588235294,41,36,0,77
13630,-26.796999999999628,2068.2631578947367,14,37,1,51
13631,26.942750000001574,4723.65,54,30,0,84
13632,15.785000000001881,4778.25,66,29,0,95
13633,-24.733499999998553,2021.8823529411766,20,35,0,55
13634,-1.6327499999994757,1481.9333333333334,33,36,2,69
13635,20.984000000001647,4369.6,61,38,0,99
13636,22.20700000000181,3592.4117647058824,78,33,2,111
13637,-1.14874999999934,3075.95,37,28,2,65
13638,8.51975000000163,2936.1176470588234,39,36,0,75
13639,15.188500000002023,4617.25,73,24,0,97
13640,12.532500000001312,2932.1875,57,30,0,87
13641,35.79725000000077,4584.7,60,30,1,90
13642,10.178750000001248,4240.15,59,27,0,86
13643,9.666750000002219,3097.6470588235293,68,25,1,93
13644,14.894750000001988,3965.65,60,31,0,91
13645,3.7022500000010687,3232.1176470588234,38,26,0,64
13646,3.615250000001754,2804.0,58,31,0,89
13647,11.153250000001874,4450.55,58,31,1,89
13648,-21.829499999999282,2509.5,28,30,0,58
13649,12.94350000000174,1824.8,55,33,0,88
13650,-18.487749999998904,2617.8947368421054,36,32,0,68
13651,-34.013999999999,1951.1176470588234,18,33,5,51
13652,-6.821499999999536,1429.0,53,25,5,78
13653,-22.001749999999824,2040.2,14,33,0,47
13654,-2.412999999999188,3231.5,35,38,0,73
13655,18.9570000000008,3687.1,51,26,0,77
13656,-32.35249999999973,1429.0,18,30,3,48
13657,39.30925000000173,5257.65,71,35,0,106
13658,-15.155249999999251,2550.8333333333335,25,33,1,58
13659,22.628750000001794,4087.9,71,22,0,93
13660,12.220750000001498,4326.368421052632,66,31,4,97
13661,43.18850000000401,3099.875,97,23,0,120
13662,33.60950000000169,5082.35,73,25,0,98
13663,23.450750000001413,4796.736842105263,72,29,0,101
13664,3.3195000000014083,3349.5555555555557,50,32,0,82
13665,15.612250000000646,2684.0,57,28,14,85
13666,8.166500000000934,4041.8,54,30,0,84
13667,10.333000000002322,4771.1,71,30,0,101
13668,17.192000000001922,4667.1,75,27,0,102
13669,14.388500000002136,4506.8,60,38,0,98
13670,21.187750000001667,3581.6111111111113,49,33,0,82
13671,4.849250000001757,4820.35,60,32,0,92
13672,23.954750000002143,4649.631578947368,74,28,0,102
13673,46.24100000000265,5293.35,89,30,0,119
13674,-13.663999999998481,3056.1,38,27,0,65
13675,14.495750000001843,4235.45,60,24,0,84
13676,15.951000000000878,3467.6315789473683,51,26,0,77
13677,-9.98299999999833,2505.3333333333335,35,35,0,70
13678,-23.674749999999445,2314.235294117647,46,30,2,76
13679,10.025750000001773,4115.75,74,15,0,89
13680,35.905250000000834,5714.8,66,37,0,103
13681,8.699000000001877,2437.529411764706,50,37,0,87
13682,10.808250000001074,3521.842105263158,55,25,0,80
13683,-21.408749999999554,1857.5625,27,36,1,63
13684,-2.7177499999988983,3818.8,49,23,0,72
13685,15.579250000001148,2741.5625,62,24,0,86
13686,-3.5217499999995083,2495.8,36,36,0,72
13687,-24.354249999999446,2008.35,18,26,0,44
13688,9.36375000000112,2862.470588235294,43,27,0,70
13689,-6.501999999999468,2548.529411764706,40,30,1,70
13690,17.82875000000162,4430.0,67,28,0,95
13691,3.430250000001364,2569.0588235294117,39,31,0,70
13692,5.556000000001555,3507.6315789473683,53,29,1,82
13693,-2.513249999998942,3195.315789473684,49,27,0,76
13694,22.775500000000687,3365.777777777778,60,22,0,82
13695,3.243250000001197,3038.2105263157896,50,22,0,72
13696,-15.195249999999124,2733.8,35,26,0,61
13697,21.957250000001096,2702.5,61,23,0,84
13698,7.983500000001419,2382.375,52,19,0,71
13699,-16.157249999999145,2841.0,30,32,1,62
13700,4.9250000000010505,2135.4375,42,23,1,65
13701,-35.683499999999775,1972.9473684210527,17,30,11,47
13702,18.09900000000212,4077.45,61,29,0,90
13703,-21.01324999999955,2030.2941176470588,29,30,6,59
13704,-6.248999999999663,3964.85,45,29,0,74
13705,26.511000000001417,2964.6875,67,26,0,93
13706,6.182750000003198,1969.5555555555557,60,25,0,85
13707,-7.888249999999213,2521.529411764706,32,30,0,62
13708,26.60450000000309,3869.8888888888887,75,22,1,97
13709,-15.048999999999632,2870.4,23,33,0,56
13710,-12.847499999998723,2965.1666666666665,41,36,0,77
13711,9.773000000000703,2830.3333333333335,53,31,0,84
13712,-11.506499999999642,2041.0625,23,29,0,52
13713,25.484500000002107,4738.65,69,28,0,97
13714,28.194750000001182,3372.1176470588234,61,20,0,81
13715,12.989250000001272,3532.684210526316,57,27,0,84
13716,-3.829249999998207,2332.8823529411766,76,32,2,108
13717,3.5657500000017537,3948.0,56,34,0,90
13718,13.684750000001443,3785.45,56,25,0,81
13719,16.36775000000201,4127.65,71,25,0,96
13720,-3.718499999999218,3306.05,34,29,0,63
13721,8.456750000001549,2677.470588235294,64,27,0,91
13722,7.9905000000013615,4179.05,65,19,0,84
13723,0.9130000000006337,3718.75,43,23,0,66
13724,35.39575000000094,6560.95,79,32,0,111
13725,11.608250000000947,2792.3529411764707,54,32,1,86
13726,-8.050499999999202,1831.875,28,32,0,60
13727,-17.73049999999926,2772.4210526315787,23,44,1,67
13728,-17.090499999999185,2437.0,31,29,1,60
13729,0.7165000000013585,3615.7,53,20,0,73
13730,-7.870749999999186,3103.2631578947367,48,24,7,72
13731,16.341500000001396,3480.1052631578946,62,20,0,82
13732,22.598250000000952,3829.95,55,23,0,78
13733,6.176000000001495,3742.6,55,30,0,85
13734,7.014250000001132,2973.470588235294,52,21,0,73
13735,28.38575000000111,2917.5555555555557,70,28,0,98
13736,-7.631499999999782,2269.3529411764707,47,36,0,83
13737,22.72825000000151,4886.25,78,25,0,103
13738,9.915750000000253,5179.05,50,30,0,80
13739,20.761750000002316,4758.55,87,22,0,109
13740,9.935000000001372,4083.0,49,23,0,72
13741,6.553500000001035,2587.866666666667,61,28,1,89
13742,20.02950000000209,4095.6,68,13,0,81
13743,3.249500000000893,3064.05,38,30,0,68
13744,-28.95874999999959,2002.9473684210527,14,29,1,43
13745,22.36775000000205,4663.15,63,26,0,89
13746,24.32550000000179,3667.1111111111113,76,19,0,95
13747,2.636750000001083,3072.05,46,17,0,63
13748,34.441000000001594,4730.65,88,20,0,108
13749,15.321000000001906,3827.6666666666665,71,27,0,98
13750,-17.262999999998534,2010.7058823529412,40,24,0,64
13751,19.70850000000051,2769.823529411765,62,23,0,85
13752,-0.44024999999811776,2431.8823529411766,48,29,0,77
13753,18.75550000000198,3045.3529411764707,66,15,0,81
13754,6.96025000000125,2488.9444444444443,54,29,0,83
13755,-15.704999999999867,2032.3,15,31,0,46
13756,30.894250000001712,4826.736842105263,83,19,0,102
13757,7.1890000000013785,4131.45,73,9,1,82
13758,20.597000000001593,5226.75,73,27,0,100
13759,30.727000000001603,2982.5625,86,20,0,106
13760,48.79450000000244,4534.888888888889,97,16,0,113
13761,15.543750000000326,3762.4736842105262,67,32,1,99
13762,1.2845000000004574,2554.3333333333335,32,25,0,57
13763,9.647250000000346,2464.8125,57,19,0,76
13764,-21.31499999999952,1959.5263157894738,16,35,1,51
13765,20.581750000002067,3616.823529411765,84,17,0,101
13766,-8.26349999999915,2927.7894736842104,49,27,5,76
13767,-1.1689999999994132,2471.4444444444443,29,30,0,59
13768,45.65300000000095,2503.4375,89,20,0,109
13769,18.16650000000153,3605.35,66,16,0,82
13770,11.828500000001682,4498.2,63,28,0,91
13771,-10.765999999998751,2353.4117647058824,43,36,0,79
13772,20.104500000001856,4699.85,75,15,0,90
13773,-9.679999999998838,2527.3125,36,28,1,64
13774,13.416500000001307,3483.3684210526317,44,33,0,77
13775,-38.21824999999943,2074.3,11,30,5,41
13776,13.065000000001174,3310.1111111111113,56,29,0,85
13777,25.495500000000803,4548.631578947368,87,24,0,111
13778,-5.13025000000023,1933.4444444444443,47,22,2,69
13779,-12.792749999999403,2604.4,29,28,1,57
13780,10.291750000000551,3191.0555555555557,56,40,0,96
13781,-24.782749999999208,2528.3,29,23,0,52
13782,18.12975000000084,2937.8823529411766,70,25,0,95
13783,24.343250000001785,4856.9,69,32,0,101
13784,29.928250000001015,4062.35,61,23,0,84
13785,-14.649749999999912,2538.294117647059,27,35,0,62
13786,17.426500000002275,4737.85,67,26,0,93
13787,3.5792500000011196,3152.95,46,24,0,70
13788,6.973250000001107,3052.1,49,21,1,70
13789,27.07875000000079,2830.875,69,18,0,87
13790,-8.208999999999321,2558.777777777778,30,26,0,56
13791,3.950750000001547,3868.85,55,36,0,91
13792,-33.50274999999952,2034.6842105263158,16,27,4,43
13793,33.242750000001465,4595.833333333333,93,22,0,115
13794,-16.906999999999492,2021.8823529411766,27,34,2,61
13795,-8.022249999999683,2548.25,27,25,0,52
13796,-26.291249999999245,2044.1,18,30,0,48
13797,-6.9024999999992245,2619.6875,32,26,0,58
13798,16.59525000000066,3900.55,58,26,0,84
13799,13.479750000001172,3962.4,53,29,1,82
13800,-14.679499999999091,2433.823529411765,41,23,1,64
13801,-24.318749999999802,1969.611111111111,21,29,1,50
13802,-16.54774999999963,2568.684210526316,26,35,0,61
13803,-5.302999999998487,1953.7222222222222,35,33,0,68
13804,5.575000000000953,2438.0,47,31,0,78
13805,11.893500000001689,4160.0,54,25,0,79
13806,10.738750000002591,4997.35,81,24,0,105
13807,13.75275000000243,3805.1052631578946,68,21,0,89
13808,7.4112500000011625,3690.3,55,21,0,76
13809,-30.13724999999969,1984.578947368421,16,33,1,49
13810,-14.22749999999929,2661.2105263157896,41,33,0,74
13811,-7.861999999999135,1960.8125,36,27,0,63
13812,-18.69324999999953,2109.705882352941,27,35,0,62
13813,18.953500000000723,3465.8947368421054,44,37,0,81
13814,47.76075000000167,6458.55,95,27,0,122
13815,29.169750000001166,4858.45,74,23,0,97
13816,35.894250000001755,4729.15,71,23,0,94
13817,-11.191249999998673,3163.25,34,37,0,71
13818,1.9905000000011537,4392.55,50,25,0,75
13819,-9.261249999999388,1862.625,39,26,1,65
13820,15.935000000001349,3783.85,54,29,0,83
13821,38.27400000000177,4138.166666666667,84,30,0,114
13822,8.109250000001152,4102.05,42,39,0,81
13823,7.181500000001522,3776.7,47,30,0,77
13824,3.4847500000012794,3287.8,42,31,0,73
13825,17.51475000000154,2608.625,58,40,0,98
13826,16.256750000000817,4324.25,59,27,0,86
13827,8.750750000000782,2297.4117647058824,54,43,1,97
13828,41.59625000000109,3942.705882352941,71,18,0,89
13829,-15.323249999999035,2561.785714285714,35,30,2,65
13830,-7.387249999998581,1961.7222222222222,29,32,0,61
13831,-30.342499999999262,1871.625,25,31,1,56
13832,-12.556999999999421,2480.0,33,33,0,66
13833,22.370250000001413,4801.35,69,22,0,91
13834,25.469750000001472,5330.0,78,20,0,98
13835,11.971500000000812,2400.4666666666667,66,33,0,99
13836,16.621000000001708,3819.722222222222,78,24,0,102
13837,11.22750000000104,3056.0,40,25,0,65
13838,-3.720249999999332,2495.8,40,29,0,69
13839,12.28400000000188,4694.9,65,30,0,95
13840,31.418500000001597,4758.55,80,15,0,95
13841,-6.386999999999249,2675.3125,28,25,3,53
13842,-29.785249999999383,2044.15,19,29,1,48
13843,17.594000000001344,4159.2,65,21,0,86
13844,41.26575000000183,5278.35,79,22,0,101
13845,-13.576749999999302,2457.4736842105262,39,23,1,62
13846,-6.3569999999988545,2399.9444444444443,37,34,0,71
13847,3.748250000001165,4741.0,69,20,1,89
13848,-12.329249999999611,3024.7368421052633,56,33,2,89
13849,4.503500000001248,3747.35,46,27,0,73
13850,6.045750000001608,4372.210526315789,58,27,0,85
13851,36.03425000000094,3833.8333333333335,86,25,0,111
13852,3.315749999999651,2007.5555555555557,44,35,0,79
13853,13.476500000001371,5144.15,59,32,0,91
13854,56.00625000000267,5762.45,108,14,0,122
13855,28.627750000000646,2299.3529411764707,61,27,3,88
13856,-8.294749999999578,1979.9411764705883,33,23,2,56
13857,15.50100000000215,4151.4,70,20,0,90
13858,22.20625000000142,4833.85,71,26,0,97
13859,18.19300000000179,4214.7,65,33,0,98
13860,-8.57549999999906,2509.4375,28,28,1,56
13861,-25.078249999999223,2290.6666666666665,24,34,8,58
13862,-6.18524999999895,2997.8888888888887,40,30,3,70
13863,18.0200000000016,2586.875,60,20,0,80
13864,21.276500000001228,2825.9375,62,21,0,83
13865,-6.96699999999881,3718.65,46,31,0,77
13866,15.616250000001054,3561.842105263158,59,24,0,83
13867,20.23475000000162,3430.0,61,22,0,83
13868,-23.654499999999338,2008.4,12,33,2,45
13869,22.637750000001265,2616.0,70,26,1,96
13870,19.89225000000152,4229.05,67,20,1,87
13871,7.001000000001025,2067.9375,46,25,2,71
13872,12.000750000001151,2457.75,75,32,3,107
13873,-10.365999999999312,3264.85,32,29,0,61
13874,-6.4519999999991455,2316.0,59,31,6,90
13875,37.97700000000111,4102.777777777777,83,24,0,107
13876,-15.409249999999082,2591.2105263157896,31,26,0,57
13877,-11.333999999999506,2912.842105263158,38,25,5,63
13878,-7.568500000000093,2482.6875,35,40,0,75
13879,-7.486999999998703,2965.4736842105262,48,24,2,72
13880,0.8687500000014101,2634.4375,53,30,0,83
13881,-34.76249999999929,2849.722222222222,30,37,0,67
13882,-8.214249999999472,2429.8947368421054,25,30,0,55
13883,14.151750000000495,3899.65,54,32,0,86
13884,-14.22549999999938,2621.15,32,22,0,54
13885,-25.61374999999964,2042.2631578947369,13,40,4,53
13886,-16.70399999999953,1902.3125,44,29,1,73
13887,-4.733749999999537,2360.277777777778,63,32,0,95
13888,9.989750000000887,2686.0625,58,18,0,76
13889,-1.55924999999928,3254.45,44,25,0,69
13890,-13.042749999998824,1429.0,24,28,0,52
13891,19.191500000001493,4032.315789473684,67,21,0,88
13892,0.31375000000120884,3052.15,43,23,0,66
13893,-0.04199999999802362,3410.6111111111113,67,24,5,91
13894,-6.7532499999992215,3018.0526315789475,43,31,2,74
13895,-25.36524999999961,2028.2,13,29,0,42
13896,8.438500000001033,2419.4666666666667,56,30,2,86
13897,-8.840999999999125,2618.75,36,24,1,60
13898,-22.082499999998202,3246.45,41,37,0,78
13899,31.991750000002433,3518.3125,79,24,0,103
13900,-4.675749999999567,2510.714285714286,39,33,0,72
13901,13.634500000001026,4210.9,70,20,0,90
13902,-15.525999999998955,2152.25,45,31,2,76
13903,-2.263749999999407,1993.5,34,28,0,62
13904,7.4007500000015565,2124.5882352941176,46,27,0,73
13905,-11.237749999999592,2381.5333333333333,34,40,0,74
13906,11.430250000000232,2357.5625,51,32,0,83
13907,-5.900999999999781,1603.625,43,26,0,69
13908,-26.01199999999925,1970.4444444444443,22,27,1,49
13909,-23.803999999999863,2003.842105263158,12,30,0,42
13910,6.700250000002699,3623.5,83,26,0,109
13911,22.9035000000005,2546.764705882353,73,32,0,105
13912,-7.743999999997736,3266.157894736842,59,33,1,92
13913,-18.511749999999303,2423.722222222222,32,28,4,60
13914,11.239750000001642,2346.75,62,26,1,88
13915,2.310750000000587,2523.375,45,30,0,75
13916,-18.487999999998717,2617.8947368421054,28,31,4,59
13917,5.971250000000568,2541.176470588235,45,35,1,80
13918,23.527750000001255,5140.3,78,27,0,105
13919,-17.61674999999943,1911.1875,33,28,0,61
13920,-25.19674999999937,1997.157894736842,18,28,2,46
13921,-9.26174999999903,3007.2631578947367,51,23,0,74
13922,31.038250000001465,2848.6875,82,21,0,103
13923,-0.20249999999884877,2592.5,56,20,1,76
13924,34.00425000000195,4860.0,82,21,0,103
13925,29.03250000000158,4154.833333333333,73,18,0,91
13926,-6.629999999999244,2464.3333333333335,44,36,0,80
13927,-21.14074999999909,2532.3,32,22,1,54
13928,-12.418500000000728,1429.0,33,32,4,65
13929,-1.2177499999987684,2957.4444444444443,55,25,1,80
13930,-4.0767499999993495,2516.375,43,27,2,70
13931,4.795250000000342,2571.9411764705883,48,33,0,81
13932,28.296750000001044,3631.5,65,15,0,80
13933,24.041750000002622,5283.0,91,13,1,104
13934,9.445250000001177,3561.2105263157896,66,18,2,84
13935,0.02250000000037673,2438.6666666666665,63,19,0,82
13936,19.537500000001266,5038.6,75,14,0,89
13937,-1.1764999999994838,2449.277777777778,42,28,1,70
13938,36.199250000001754,3057.529411764706,84,18,2,102
13939,51.39675000000235,6933.0,119,13,1,132
13940,17.588000000000655,4527.5,68,23,0,91
13941,-6.7949999999991535,3256.05,41,28,0,69
13942,14.930750000000577,2510.6,84,19,2,103
13943,-5.560749999998634,4006.05,57,32,0,89
13944,-8.500749999998753,3263.95,52,26,0,78
13945,-13.703999999999407,2249.9444444444443,27,31,2,58
13946,21.503500000001708,4498.9,56,29,0,85
13947,25.82250000000233,5115.55,88,15,0,103
13948,42.99525000000149,4290.473684210527,81,20,1,101
13949,-0.06824999999914975,2376.1666666666665,31,31,1,62
13950,11.143250000001865,5116.35,74,31,0,105
13951,-20.962999999999433,1974.7777777777778,23,27,5,50
13952,23.09600000000193,2859.75,77,15,0,92
13953,2.351500000002036,1875.4117647058824,52,26,0,78
13954,12.103500000001556,4452.8,67,29,0,96
13955,10.901500000001722,4009.2,69,21,0,90
13956,-10.710249999998616,3256.2105263157896,43,23,0,66
13957,6.543250000001359,4009.4,54,35,2,89
13958,25.324750000002165,4587.8,74,17,0,91
13959,11.613000000001367,3543.5263157894738,61,22,0,83
13960,0.8107500000014631,4335.35,61,26,0,87
13961,3.5380000000008907,3025.5789473684213,48,22,0,70
13962,24.176750000002436,3139.375,75,22,0,97
13963,-9.906999999999755,2485.842105263158,30,19,0,49
13964,-3.6102499999988256,3155.1052631578946,50,30,9,80
13965,-6.537749999999472,3065.0,40,26,1,66
13966,13.069500000001975,3444.1111111111113,79,14,0,93
13967,2.3860000000013857,2723.875,67,36,0,103
13968,-12.791499999998615,3003.6,41,25,1,66
13969,-7.655499999999485,1946.875,37,27,0,64
13970,10.279000000001243,2576.6470588235293,47,38,0,85
13971,29.3130000000012,2143.375,65,24,1,89
13972,2.8560000000010395,3206.0,46,24,0,70
13973,18.79225000000167,2457.875,60,26,0,86
13974,18.333000000000617,2536.1875,68,27,0,95
13975,24.015250000000194,1836.75,54,28,0,82
13976,18.87575000000144,4356.95,69,13,0,82
13977,-6.189249999999388,2444.8888888888887,30,24,1,54
13978,4.49425000000035,2332.9411764705883,60,30,0,90
13979,-34.65249999999991,2060.684210526316,16,35,3,51
13980,19.089500000001088,4043.5,53,25,1,78
13981,3.2455000000011163,1824.9375,45,23,0,68
13982,-3.2427499999984635,3073.45,41,29,0,70
13983,30.655500000002537,4624.578947368421,108,30,3,138
13984,25.800500000001183,3867.7368421052633,70,19,0,89
13985,-4.2409999999994215,2992.2105263157896,36,23,0,59
13986,-23.361249999999274,1953.7777777777778,23,27,0,50
13987,-0.2974999999993452,1909.7222222222222,28,38,4,66
13988,7.766000000001254,3463.3684210526317,56,21,0,77
13989,-22.70599999999977,1888.5,15,36,0,51
13990,1.5817500000009617,3261.1176470588234,62,26,0,88
13991,6.911500000001385,2536.5882352941176,55,36,0,91
13992,23.684000000002328,4528.35,71,21,0,92
13993,3.4065000000009222,3409.0666666666666,39,24,0,63
13994,11.049500000000481,3025.705882352941,65,28,0,93
13995,21.473250000002537,3035.1176470588234,79,22,0,101
13996,4.813000000000853,3094.8888888888887,34,37,0,71
13997,-7.744999999999105,2383.375,37,32,0,69
13998,-18.630999999999453,1429.0,27,34,2,61
13999,2.5992500000014096,4493.4,66,25,0,91
14000,10.824500000001464,1848.625,69,36,0,105
14001,-17.933499999998908,3099.6,38,34,0,72
14002,-7.561249999999278,2536.25,30,28,0,58
14003,-10.803749999999006,2030.235294117647,27,31,1,58
14004,12.783500000000695,2634.4375,75,21,0,96
14005,-12.932499999999763,2502.6315789473683,31,28,16,59
14006,-31.076499999999406,2012.3,11,34,0,45
14007,3.8310000000009863,2583.6315789473683,40,23,0,63
14008,-12.68324999999913,2460.777777777778,28,36,1,64
14009,3.165000000000459,3187.05,36,35,1,71
14010,3.9310000000013865,3630.3684210526317,50,26,0,76
14011,4.722250000001062,4514.8,62,27,0,89
14012,-4.4982499999999295,1933.388888888889,32,31,0,63
14013,-4.245499999999515,2462.6470588235293,50,39,0,89
14014,15.753000000000725,3720.6,61,13,0,74
14015,-2.770499999999411,2786.3333333333335,45,33,1,78
14016,42.56375000000217,5227.55,90,19,0,109
14017,-13.834500000000071,1997.0,38,34,4,72
14018,3.7642500000019554,3230.722222222222,59,22,0,81
14019,10.1172500000009,2328.1176470588234,63,31,0,94
14020,8.786500000000446,2543.4,55,23,0,78
14021,14.20050000000128,3010.0,56,19,0,75
14022,-0.48424999999941026,3570.2631578947367,58,28,0,86
14023,2.769500000001014,2419.6,78,32,0,110
14024,49.90525000000159,5375.85,86,15,0,101
14025,11.981500000001741,3962.45,61,18,0,79
14026,15.607500000001584,4379.95,69,25,0,94
14027,4.7242500000005165,3606.2105263157896,49,32,0,81
14028,13.591750000001323,3879.8,65,22,0,87
14029,7.853250000000857,2411.1875,61,35,0,96
14030,17.751750000001813,3345.0588235294117,75,23,0,98
14031,0.13850000000099455,2587.823529411765,47,26,0,73
14032,12.746250000001153,2726.6875,48,32,1,80
14033,47.50775000000165,4639.5,92,11,0,103
14034,4.025250000001004,3015.4117647058824,54,23,1,77
14035,-27.775250000000035,1929.111111111111,20,43,0,63
14036,-21.5244999999993,2024.25,20,28,0,48
14037,-10.2147499999999,1869.9444444444443,34,26,2,60
14038,16.155750000001174,3655.3,54,23,0,77
14039,33.33675000000125,3664.5,76,28,0,104
14040,3.4707500000013574,3694.95,59,24,0,83
14041,-26.035249999999117,2024.25,19,31,0,50
14042,-1.5349999999993955,3138.315789473684,55,33,13,88
14043,22.180500000001135,5640.95,83,25,0,108
14044,10.326500000001067,3193.777777777778,62,12,0,74
14045,-11.48549999999852,3990.9,43,39,0,82
14046,12.765000000002804,2322.9375,64,30,2,94
14047,-12.351999999999274,2491.5625,32,28,0,60
14048,22.491250000001532,4083.75,66,27,0,93
14049,-6.693999999999042,3048.1,41,22,2,63
14050,15.990500000001465,4107.75,72,10,0,82
14051,22.45300000000106,4563.9,72,13,0,85
14052,32.28100000000154,3175.1875,85,14,0,99
14053,-7.808249999998968,2494.3529411764707,34,34,0,68
14054,21.541750000000576,2437.9375,63,32,0,95
14055,41.532250000001554,4027.3684210526317,87,22,1,109
14056,52.71675000000151,5094.0,83,26,0,109
14057,36.334000000002234,5306.1,96,25,0,121
14058,-10.934749999999369,2554.3888888888887,27,30,0,57
14059,41.96050000000142,5353.6,94,13,0,107
14060,24.379500000001112,4691.05,76,18,0,94
14061,5.9962500000007894,2979.3333333333335,68,26,1,94
14062,20.332000000001035,2927.764705882353,60,26,0,86
14063,3.7005000000006474,2573.875,45,23,0,68
14064,10.056250000000876,4286.95,49,30,0,79
14065,8.621500000000912,3611.7,49,21,0,70
14066,0.699000000000702,3108.2105263157896,62,23,5,85
14067,-16.724999999999334,2610.85,27,30,0,57
14068,18.047750000000914,2959.0625,64,13,0,77
14069,-20.588249999999352,2044.1,16,33,0,49
14070,23.972500000000544,3905.277777777778,96,24,0,120
14071,17.86250000000137,2421.0555555555557,41,31,0,72
14072,-14.021499999999008,2567.95,32,28,0,60
14073,22.192250000001923,5349.7,75,30,0,105
14074,26.115750000001054,2821.0,58,22,0,80
14075,22.30925000000067,3681.176470588235,91,21,1,112
14076,-32.09699999999971,2599.75,24,27,0,51
14077,3.794500000001021,2904.4117647058824,61,32,0,93
14078,15.29575000000139,2407.25,58,14,0,72
14079,20.258500000001515,4387.95,57,29,0,86
14080,6.823000000001661,4266.4,68,37,0,105
14081,-14.742999999998977,3791.75,47,30,0,77
14082,1.3862500000007962,3087.85,42,24,1,66
14083,6.456750000000501,2344.8125,43,25,0,68
14084,11.006250000001064,2457.733333333333,58,24,0,82
14085,-7.664999999998391,3238.5333333333333,41,30,0,71
14086,13.005500000001183,4008.5,55,23,0,78
14087,13.6547500000024,2499.4375,67,24,0,91
14088,-2.858999999999042,3927.45,56,33,0,89
14089,-0.33674999999959637,2462.6470588235293,38,30,4,68
14090,-10.976249999999045,2963.4444444444443,37,35,1,72
14091,16.850250000000656,2467.2,64,25,0,89
14092,19.60725000000172,5422.7,65,35,0,100
14093,9.53500000000123,3523.4736842105262,57,19,1,76
14094,11.226000000001964,3583.9,58,20,0,78
14095,-26.891000000000467,1429.0,17,27,7,44
14096,6.862750000000777,2545.1875,46,26,0,72
14097,-21.78249999999972,2491.7368421052633,30,25,2,55
14098,0.8167500000011007,3655.4210526315787,45,29,0,74
14099,-0.7279999999994109,2463.9375,38,31,1,69
14100,-2.080749999999077,2484.0588235294117,42,22,2,64
14101,-0.10549999999895583,2979.277777777778,49,28,1,77
14102,-17.30449999999912,2542.0,27,31,0,58
14103,-12.744249999999676,1944.9444444444443,26,31,0,57
14104,8.07650000000082,3996.55,47,27,0,74
14105,30.27375000000132,3725.3333333333335,67,29,0,96
14106,7.844750000001875,2180.0,50,26,0,76
14107,-18.863499999999675,2420.705882352941,30,38,0,68
14108,7.711000000001245,3833.85,49,31,0,80
14109,14.741250000000738,3477.6315789473683,51,27,0,78
14110,1.2860000000010487,2504.9444444444443,32,34,0,66
14111,13.060250000002247,4294.15,68,23,0,91
14112,39.528500000002126,4692.55,83,25,0,108
14113,-12.15675000000037,1429.0,22,39,4,61
14114,-3.7324999999985615,3245.285714285714,39,36,0,75
14115,-12.032749999999771,2559.3684210526317,29,31,2,60
14116,19.87775000000274,4580.75,68,27,0,95
14117,33.60775000000113,4494.25,60,29,0,89
14118,-2.0897499999989964,3140.9473684210525,36,35,0,71
14119,11.185250000002434,2448.823529411765,60,23,0,83
14120,25.540499999999966,3635.4444444444443,69,37,0,106
14121,-2.56049999999915,3208.55,40,27,0,67
14122,1.6025000000008227,2462.5882352941176,41,31,1,72
14123,19.37825000000238,3078.8125,70,25,0,95
14124,-11.574749999998911,3079.9,28,38,0,66
14125,-0.271999999998837,1886.2,50,29,0,79
14126,-1.850999999998838,3045.4117647058824,50,32,0,82
14127,-27.61199999999958,1683.9444444444443,10,32,2,42
14128,13.97000000000115,3615.75,54,22,0,76
14129,5.582250000000956,2358.1176470588234,45,30,1,75
14130,-16.229249999999695,2467.8888888888887,21,37,6,58
14131,1.0885000000014204,1947.875,48,28,0,76
14132,-0.2747499999985834,3869.5,42,34,0,76
14133,25.686750000001393,4179.15,56,24,0,80
14134,8.27250000000077,2891.294117647059,52,33,0,85
14135,2.6952500000027806,2041.1875,59,35,0,94
14136,19.775500000001493,4009.0588235294117,63,31,0,94
14137,9.219000000001085,4303.7,59,21,0,80
14138,-14.54674999999933,2496.294117647059,19,33,0,52
14139,7.04275000000104,4400.833333333333,63,38,0,101
14140,-13.849749999999204,2553.4444444444443,29,30,3,59
14141,16.090000000000497,5876.7,55,46,0,101
14142,4.561499999999912,2012.8333333333333,46,28,0,74
14143,7.809000000001487,3425.4117647058824,59,36,0,95
14144,18.38250000000115,4213.25,65,17,0,82
14145,26.34950000000153,4069.7368421052633,72,26,0,98
14146,6.302250000000685,2561.785714285714,41,29,0,70
14147,-13.862499999999326,2650.470588235294,23,32,1,55
14148,11.29150000000094,3095.777777777778,60,32,0,92
14149,-9.56574999999923,2400.176470588235,38,31,3,69
14150,43.661500000001794,6040.15,86,28,0,114
14151,27.32825000000228,4206.941176470588,59,39,0,98
14152,5.240250000001024,3738.157894736842,51,34,0,85
14153,-9.868499999999504,2258.8888888888887,25,29,0,54
14154,1.3897500000007725,3099.7,40,26,0,66
14155,-31.452249999999175,2024.3,20,28,3,48
14156,3.6082500000009725,2938.7894736842104,39,26,0,65
14157,16.501500000001073,3957.5,61,29,0,90
14158,1.8774999999998818,2190.0,72,25,0,97
14159,20.135250000000998,3794.2105263157896,64,29,2,93
14160,-21.210499999999538,2008.5,16,31,0,47
14161,20.48275000000114,3682.95,60,24,0,84
14162,6.237750000000984,3119.6,47,23,0,70
14163,-0.42549999999978355,2636.315789473684,38,28,0,66
14164,-7.164999999999592,2806.294117647059,53,34,2,87
14165,25.282500000002617,3055.529411764706,83,28,0,111
14166,-23.208000000000357,2000.4705882352941,28,36,5,64
14167,19.7782500000018,4340.2,66,29,0,95
14168,2.2160000000007707,1889.3125,52,26,1,78
14169,-24.192999999999216,2690.8888888888887,31,43,0,74
14170,-1.6339999999990198,3345.3333333333335,45,26,0,71
14171,-25.43924999999982,2168.3684210526317,16,33,0,49
14172,15.523250000000948,2328.235294117647,74,21,1,95
14173,-10.065749999999335,2410.6315789473683,31,24,0,55
14174,-3.063749999998742,3292.764705882353,52,40,0,92
14175,37.00750000000119,3362.5625,77,10,0,87
14176,-26.52449999999962,2202.9,17,34,0,51
14177,-4.266249999998804,3222.65,42,27,0,69
14178,-26.60849999999964,1971.3333333333333,21,31,1,52
14179,4.735000000000892,3137.0,47,24,0,71
14180,21.64475000000192,5206.85,71,29,0,100
14181,10.382500000001436,3756.764705882353,74,29,0,103
14182,7.366750000001323,4460.0,68,26,0,94
14183,12.499000000001207,3941.1052631578946,65,31,0,96
14184,27.342250000000966,5367.95,68,17,0,85
14185,-19.736750000000118,1824.0,16,37,0,53
14186,-9.565249999999093,2532.3,27,35,0,62
14187,-21.45749999999943,2032.3,14,34,0,48
14188,4.060500000001367,3667.25,51,24,0,75
14189,18.570250000001618,4271.35,61,33,0,94
14190,-5.135249999999276,3059.1052631578946,42,26,0,68
14191,26.676500000001518,3761.5555555555557,57,34,0,91
14192,22.736250000000968,4722.75,52,28,0,80
14193,-6.623999999999363,2643.3333333333335,35,31,0,66
14194,17.32050000000199,4699.0,68,27,0,95
14195,3.679500000000573,3415.65,47,28,0,75
14196,-13.70324999999987,1807.1764705882354,26,35,0,61
14197,-0.8687499999993833,3023.842105263158,40,30,0,70
14198,-37.861999999999256,2094.9,16,25,4,41
14199,-8.181999999998988,2581.5333333333333,33,31,0,64
14200,-3.999249999999793,2619.6875,39,29,4,68
14201,12.934250000001509,3358.842105263158,49,27,0,76
14202,13.846500000001473,3599.65,61,18,0,79
14203,-2.005249999999175,2455.875,50,23,1,73
14204,-30.60600000000011,1429.0,20,34,4,54
14205,-4.765999999998981,3089.0526315789475,46,30,0,76
14206,20.1722500000006,2266.6470588235293,51,34,0,85
14207,12.17525000000084,4270.45,54,30,0,84
14208,3.409500000000721,3078.2631578947367,47,25,1,72
14209,22.868000000002386,4448.15,77,24,0,101
14210,9.278750000001187,2908.777777777778,53,16,0,69
14211,-14.632999999999345,2871.1,31,33,0,64
14212,52.97025000000234,5528.35,85,15,0,100
14213,-1.1864999999992094,3068.0,41,24,0,65
14214,-1.7265000000005295,2036.6666666666667,43,32,2,75
14215,13.158000000000126,3303.842105263158,59,31,3,90
14216,-15.769499999999685,2482.625,26,26,2,52
14217,-14.54174999999933,2484.9473684210525,34,21,2,55
14218,-11.533749999999497,2659.25,31,25,0,56
14219,29.794500000001687,5135.5,77,13,0,90
14220,-18.303749999998892,2006.611111111111,29,39,2,68
14221,20.293000000002415,4516.9473684210525,92,13,0,105
14222,-26.926749999999352,2028.3,19,25,1,44
14223,6.186500000001045,3341.0,42,32,0,74
14224,14.68650000000255,2317.875,81,21,0,102
14225,-5.775249999998536,2728.625,58,21,1,79
14226,-26.36074999999921,2008.4,15,31,0,46
14227,5.530750000001038,2495.8,46,28,0,74
14228,21.120750000002953,1849.1333333333334,70,23,1,93
14229,-2.618249999998973,3903.7,64,17,0,81
14230,-14.035999999999898,1821.875,41,32,0,73
14231,-11.119500000000343,1958.9444444444443,22,28,17,50
14232,3.503250000000822,1937.9411764705883,45,39,1,84
14233,8.695750000001578,4121.95,65,19,0,84
14234,0.3520000000004141,3057.3684210526317,36,26,0,62
14235,23.2120000000017,5330.7,94,15,1,109
14236,13.327500000001127,3821.85,61,19,0,80
14237,3.5432500000014926,5007.55,71,25,3,96
14238,0.27825000000264294,1534.8666666666666,63,27,0,90
14239,30.39775000000234,4210.1,80,19,0,99
14240,12.965750000000188,2471.1176470588234,61,27,0,88
14241,-22.0297499999995,2024.3,13,32,1,45
14242,6.043000000000539,3339.45,47,25,0,72
14243,-1.845499999998447,3794.05,55,26,0,81
14244,-0.38749999999902657,3136.2,45,21,0,66
14245,-10.517999999999335,2583.1,29,28,0,57
14246,14.220250000001567,3943.7894736842104,64,24,0,88
14247,18.685000000001374,2815.0,54,23,0,77
14248,-22.731999999999523,2071.1,15,27,1,42
14249,45.70875000000322,6156.0,96,19,0,115
14250,-4.059999999999062,2702.2631578947367,32,36,0,68
14251,1.6515000000015807,2957.529411764706,58,30,0,88
14252,-0.3842499999991992,3860.2105263157896,51,31,0,82
14253,-29.717749999999462,2075.05,15,26,1,41
14254,51.769000000002656,5720.35,105,9,0,114
14255,0.933250000000632,2000.4,57,31,0,88
14256,-23.13774999999967,1918.5,25,31,5,56
14257,-16.993749999999316,2579.8,23,34,1,57
14258,9.031750000000457,2730.6666666666665,64,26,0,90
14259,34.14200000000224,3183.529411764706,86,25,1,111
14260,27.287250000001496,3518.9444444444443,72,21,0,93
14261,3.8085000000009708,2563.0625,57,34,0,91
14262,-31.40750000000034,1429.0,17,33,4,50
14263,-8.97349999999881,2960.315789473684,51,21,2,72
14264,18.190250000001985,3120.9411764705883,66,36,0,102
14265,-28.654999999999824,1959.5263157894738,12,32,3,44
14266,15.382000000001389,5018.8,74,25,0,99
14267,3.0032500000011133,3646.6,65,21,0,86
14268,11.522000000001139,4343.4,50,30,0,80
14269,-29.05974999999948,2024.35,15,28,5,43
14270,3.4602500000004426,3096.7368421052633,37,33,1,70
14271,-8.650749999998924,2468.722222222222,30,29,0,59
14272,21.287250000000867,5244.95,71,31,0,102
14273,-30.26899999999953,2008.55,12,35,1,47
14274,5.34150000000126,3460.0,53,27,0,80
14275,-22.666999999999724,2028.3,15,32,0,47
14276,-2.0114999999990544,1916.1875,45,27,1,72
14277,-19.64174999999943,2008.4,17,28,1,45
14278,8.576250000000803,3095.8,39,28,0,67
14279,-4.090999999999135,3056.5263157894738,35,28,0,63
14280,-3.199249999999437,2045.235294117647,46,26,0,72
14281,-1.9562499999986716,3883.05,52,30,0,82
14282,9.906750000000692,3297.777777777778,57,38,1,95
14283,-4.894749999999532,2513.1176470588234,27,27,0,54
14284,-0.004499999998881066,2838.277777777778,54,27,0,81
14285,12.774500000002124,4278.25,67,20,0,87
14286,-32.750999999999635,2020.2,14,21,5,35
14287,12.30575000000077,4236.1578947368425,62,25,0,87
14288,-23.42699999999954,1875.5625,28,33,0,61
14289,-8.23699999999848,2675.4736842105262,40,35,3,75
14290,-6.64524999999833,3206.05,53,21,1,74
14291,-10.957250000000723,1429.0,63,34,4,97
14292,6.853000000000331,3154.2105263157896,52,21,0,73
14293,-13.062999999999828,1967.0526315789473,19,31,9,50
14294,20.356000000001764,3561.9473684210525,65,20,0,85
14295,0.329250000001167,2975.0555555555557,53,17,0,70
14296,-0.47474999999946393,2704.842105263158,39,34,0,73
14297,24.242750000001152,2839.8125,76,28,0,104
14298,11.426750000000593,2714.705882352941,53,37,0,90
14299,4.588500000001114,3282.8947368421054,53,25,1,78
14300,14.462000000002131,3588.684210526316,58,28,0,86
14301,4.020500000000461,2910.5555555555557,51,26,1,77
14302,-2.7919999999991054,2429.0,45,27,0,72
14303,7.637250000000731,3625.95,52,26,0,78
14304,-20.789249999999605,2012.2105263157894,19,32,0,51
14305,33.23775000000181,5237.85,80,18,0,98
14306,25.862250000001517,2491.5,71,31,0,102
14307,11.672250000000982,3069.0,60,22,1,82
14308,32.98325000000259,5875.1,90,31,0,121
14309,9.214250000001318,3202.684210526316,53,23,0,76
14310,19.98725000000127,2814.6470588235293,64,31,0,95
14311,12.336500000000862,3203.6,50,26,0,76
14312,29.249500000002904,4937.0,84,19,0,103
14313,59.20700000000187,5573.55,89,17,0,106
14314,-20.91750000000005,2030.5263157894738,16,30,0,46
14315,12.199250000000793,3560.3333333333335,68,29,5,97
14316,-27.217499999999557,2002.9473684210527,17,27,1,44
14317,-1.9214999999987696,4363.95,59,25,0,84
14318,2.0290000000006274,2494.4117647058824,54,29,0,83
14319,6.653750000001148,2534.529411764706,52,26,1,78
14320,-32.834499999999366,2009.6315789473683,13,32,1,45
14321,-18.528999999999385,2419.3888888888887,37,27,2,64
14322,-4.7029999999994825,3004.7368421052633,32,30,1,62
14323,17.579000000000892,3437.1111111111113,65,23,0,88
14324,16.826250000000808,1809.9333333333334,58,36,1,94
14325,-3.851249999998406,2993.9411764705883,57,25,0,82
14326,15.486750000001326,2917.470588235294,70,25,0,95
14327,1.1285000000002645,2585.9375,29,29,2,58
14328,19.751000000002183,2613.0,58,28,0,86
14329,17.53575000000058,3717.85,44,31,0,75
14330,-2.1879999999991453,4037.0,44,25,1,69
14331,24.167000000001313,3712.55,54,27,0,81
14332,-7.896749999999166,2417.6111111111113,28,30,3,58
14333,1.0430000000012796,3379.0,54,23,0,77
14334,1.8425000000003577,1481.9333333333334,60,25,4,85
14335,7.450749999999829,1884.375,75,35,0,110
14336,6.418000000001352,3730.0,57,22,0,79
14337,13.11600000000181,4217.15,72,25,0,97
14338,45.96825000000203,5368.05,77,24,0,101
14339,1.2492500000015148,3648.9,57,22,0,79
14340,2.85225000000131,3009.0,46,26,1,72
14341,-6.074999999998859,3348.15,49,24,0,73
14342,22.184750000001287,2896.375,75,17,0,92
14343,19.658500000000195,3612.8947368421054,62,26,0,88
14344,11.521750000002564,4421.9,58,35,1,93
14345,4.4110000000010015,3127.55,46,26,0,72
14346,34.67850000000104,3027.529411764706,90,24,0,114
14347,5.907750000000954,2999.6470588235293,49,23,0,72
14348,-26.93649999999941,2007.9473684210527,17,26,3,43
14349,54.635500000001606,4386.294117647059,102,21,0,123
14350,-11.740499999999368,2532.2,29,29,1,58
14351,-10.383749999999834,2529.6111111111113,45,35,3,80
14352,2.4340000000020456,3665.6315789473683,61,27,0,88
14353,16.34050000000138,4148.05,63,28,0,91
14354,-17.585749999999393,3084.6470588235293,51,48,0,99
14355,14.221750000001482,4163.15,67,17,0,84
14356,-39.02674999999924,2008.55,14,37,0,51
14357,-32.59974999999951,2080.6315789473683,15,33,0,48
14358,-9.217249999999204,2567.95,25,32,0,57
14359,18.61125000000152,4882.2,72,17,0,89
14360,1.2632500000006495,2619.6875,46,31,0,77
14361,-6.510999999999454,3151.35,37,27,0,64
14362,23.40650000000124,3202.3529411764707,58,31,0,89
14363,-1.0314999999975991,3644.684210526316,62,28,1,90
14364,-8.167249999999848,2012.2631578947369,26,35,8,61
14365,29.57400000000161,3880.6666666666665,84,12,0,96
14366,-6.280999999999432,1853.625,46,29,1,75
14367,20.97400000000182,3591.9,55,32,2,87
14368,5.39200000000144,3866.7894736842104,54,36,0,90
14369,5.904500000001186,2715.0,59,30,0,89
14370,14.984250000000987,3262.7894736842104,38,35,0,73
14371,-23.97299999999975,1959.5263157894738,21,33,11,54
14372,41.91625000000301,4744.0,97,27,0,124
14373,24.672750000001557,4127.55,67,23,0,90
14374,15.494000000001918,3099.529411764706,63,29,0,92
14375,-22.95599999999917,2190.0,23,31,3,54
14376,1.838000000001223,3033.157894736842,48,19,3,67
14377,-1.9039999999982264,4436.25,54,25,0,79
14378,6.547000000001364,3034.9444444444443,58,27,0,85
14379,-12.366249999999836,2570.222222222222,26,30,6,56
14380,28.828250000001493,4186.95,57,37,0,94
14381,18.258000000000877,3465.1052631578946,54,23,1,77
14382,-4.651499999999428,3049.842105263158,37,30,4,67
14383,11.615250000000746,3019.6,59,29,0,88
14384,-11.034249999999327,2563.0,36,24,5,60
14385,-19.69249999999937,1912.6470588235295,35,30,5,65
14386,12.922500000001289,3560.1,53,21,0,74
14387,26.36700000000085,4397.3,56,27,0,83
14388,57.25400000000165,5813.95,85,30,0,115
14389,-26.062249999999644,2145.0526315789475,17,35,1,52
14390,0.37225000000063985,2015.2666666666667,36,28,2,64
14391,-4.215999999999214,2651.3333333333335,31,26,2,57
14392,-18.61724999999887,3314.5789473684213,33,47,2,80
14393,-19.066249999998888,2660.05,31,30,1,61
14394,11.788500000001042,2408.5882352941176,59,24,3,83
14395,8.030500000001576,2521.3125,54,24,1,78
14396,-1.9747499999989961,3087.75,45,20,0,65
14397,7.797000000000862,2870.8888888888887,57,32,1,89
14398,8.663750000001611,2975.8125,42,32,0,74
14399,27.62775000000177,4631.55,72,27,1,99
14400,-14.301249999999337,2583.5789473684213,31,23,2,54
14401,-11.186749999999615,2802.0555555555557,28,44,0,72
14402,0.34450000000159176,3810.1,61,27,0,88
14403,-10.591749999998969,3075.95,41,28,0,69
14404,9.896250000000881,3709.7894736842104,53,19,0,72
14405,16.385000000001767,4148.85,61,26,0,87
14406,27.932750000001725,4989.4,69,30,0,99
14407,-4.68349999999908,3044.0,45,21,0,66
14408,5.1667500000001,3175.222222222222,64,42,0,106
14409,19.048000000001572,4226.65,75,17,1,92
14410,-22.92575000000006,2055.6315789473683,15,35,3,50
14411,-19.115749999999736,2053.6470588235293,23,36,11,59
14412,29.844250000002695,4275.777777777777,87,17,0,104
14413,-13.820500000000138,1429.0,31,31,2,62
14414,8.292750000001726,4210.15,66,21,0,87
14415,-12.397499999999502,1916.125,24,24,4,48
14416,3.9070000000015015,3087.75,50,24,2,74
14417,8.900000000001016,3694.2,55,25,0,80
14418,9.399250000001363,4751.25,66,26,0,92
14419,-5.562749999999875,1959.0,44,30,2,74
14420,25.47375000000133,5211.6,78,27,0,105
14421,-25.39799999999972,2013.7368421052631,14,27,5,41
14422,-7.253999999999723,2393.375,29,34,0,63
14423,17.153750000001565,4154.263157894737,61,35,0,96
14424,-7.463999999999098,3083.85,35,35,0,70
14425,29.92175000000187,5601.263157894737,89,23,0,112
14426,-3.499249999998841,3936.3,44,37,3,81
14427,21.32925000000119,4029.684210526316,70,25,0,95
14428,-17.38624999999903,2513.176470588235,32,26,0,58
14429,32.83650000000214,5103.65,87,19,0,106
14430,18.05125000000131,2840.8125,74,25,0,99
14431,15.324750000001146,3697.35,51,24,0,75
14432,-9.82374999999917,2889.315789473684,36,26,1,62
14433,-16.334999999999976,2011.0555555555557,26,35,4,61
14434,-1.35974999999952,2707.75,30,30,2,60
14435,19.522000000001164,4129.2,64,21,0,85
14436,-6.741999999999339,2712.9375,34,29,5,63
14437,5.163000000000831,2718.133333333333,45,34,0,79
14438,30.369500000002006,5566.35,84,24,0,108
14439,-0.7989999999985321,2991.315789473684,50,24,1,74
14440,13.270000000001573,4499.65,71,23,0,94
14441,-10.38574999999928,2554.3333333333335,25,27,0,52
14442,-3.366999999999707,2571.8333333333335,42,31,0,73
14443,6.600500000000951,3698.9,50,27,0,77
14444,2.246000000001207,3389.7368421052633,69,38,0,107
14445,12.854750000001669,3802.95,61,30,2,91
14446,9.859000000000666,3025.764705882353,53,25,0,78
14447,5.689750000001187,3070.684210526316,53,18,0,71
14448,-3.874500000000167,1786.25,30,34,0,64
14449,-3.2537499999991746,2512.8888888888887,32,26,0,58
14450,19.855000000001127,3499.6666666666665,55,32,0,87
14451,-1.1244999999986898,3182.0625,47,30,2,77
14452,17.6580000000013,3370.235294117647,62,28,0,90
14453,-17.44174999999952,1924.8235294117646,37,32,2,69
14454,33.223500000001906,6153.7,85,27,0,112
14455,11.340000000001302,2610.5714285714284,77,27,2,104
14456,-6.328249999999272,2286.0,42,36,0,78
14457,1.367500000001947,3667.2,53,34,1,87
14458,10.053250000000462,4944.95,58,28,0,86
14459,-13.17399999999866,3699.75,54,33,0,87
14460,26.308750000001822,4095.75,61,26,0,87
14461,19.78350000000166,4280.65,65,25,0,90
14462,-42.790749999999925,1429.0,0,29,1,29
14463,31.20550000000224,4787.75,87,13,0,100
14464,-3.353499999998982,2277.1875,45,28,0,73
14465,19.540500000000538,3346.1666666666665,70,32,0,102
14466,16.993500000001482,3180.764705882353,65,18,0,83
14467,-23.292749999999142,1657.1875,33,25,6,58
14468,6.505000000000285,2428.9375,42,26,0,68
14469,-24.483499999999584,2011.1666666666667,20,33,0,53
14470,-30.90874999999994,1429.0,11,26,3,37
14471,29.94650000000093,4543.4,70,22,0,92
14472,20.27524999999964,2643.4375,77,33,1,110
14473,32.512500000002525,4121.3,82,17,0,99
14474,1.4050000000003409,2889.3333333333335,56,33,0,89
14475,6.413500000000913,3109.823529411765,65,23,0,88
14476,48.231250000001864,5234.7,89,20,0,109
14477,-0.2124999999985672,5233.05,52,35,3,87
14478,30.94800000000277,5279.85,86,34,0,120
14479,2.4452500000006756,2485.6875,34,29,1,63
14480,41.36550000000189,3951.8823529411766,77,23,0,100
14481,3.2817500000010433,2963.1176470588234,49,32,6,81
14482,-2.906499999999293,2581.5333333333333,36,29,0,65
14483,14.078750000001373,3611.6111111111113,61,31,0,92
14484,12.099000000001602,3561.764705882353,63,16,0,79
14485,-21.107749999999587,2044.15,14,37,0,51
14486,-18.37999999999972,1952.0526315789473,18,28,1,46
14487,-24.616999999999514,1429.0,21,33,1,54
14488,24.479250000002008,3455.294117647059,81,20,3,101
14489,-2.027499999998309,1867.5625,41,28,1,69
14490,-5.747999999998881,3003.0555555555557,49,27,0,76
14491,0.8595000000013695,2978.7894736842104,41,30,0,71
14492,34.0225000000025,6087.9,87,29,0,116
14493,8.153250000001217,3279.1666666666665,59,27,3,86
14494,-6.664499999999554,2996.5263157894738,35,27,2,62
14495,7.16450000000165,2830.5882352941176,62,20,1,82
14496,-11.932499999999804,1947.5555555555557,37,35,1,72
14497,17.464000000000333,1679.0,56,29,3,85
14498,28.418500000001416,4208.55,64,30,0,94
14499,29.880750000003427,5074.25,87,24,0,111
14500,-5.4524999999991834,2738.6111111111113,38,41,0,79
14501,-6.20599999999852,3129.25,34,35,0,69
14502,17.518750000001287,4746.55,64,30,0,94
14503,4.982000000000412,2250.4375,35,33,0,68
14504,23.626000000001113,2891.3529411764707,86,37,1,123
14505,-34.337499999999395,2069.0526315789475,13,33,1,46
14506,-16.433999999999525,2765.65,25,31,2,56
14507,27.653250000001083,3336.6470588235293,63,29,0,92
14508,8.074000000000671,3135.55,45,25,0,70
14509,3.429500000000945,3782.25,54,23,0,77
14510,21.948000000001805,4254.55,74,28,0,102
14511,-15.203499999999476,2555.8888888888887,50,26,0,76
14512,-17.97299999999883,2509.5,28,30,0,58
14513,-6.270999999998898,3653.842105263158,53,29,2,82
14514,16.544500000001797,2062.875,68,27,0,95
14515,-6.209249999999157,3135.35,40,29,0,69
14516,-3.941749999999529,2581.5333333333333,30,31,2,61
14517,-20.80049999999924,2530.9473684210525,29,27,0,56
14518,-18.7697499999989,2602.0,33,30,1,63
14519,8.121000000000924,3017.3529411764707,38,28,2,66
14520,1.7727500000003389,2489.1666666666665,45,30,4,75
14521,8.576000000002526,4251.35,65,24,2,89
14522,11.282000000000915,2524.3333333333335,62,32,0,94
14523,-20.345499999999568,2079.842105263158,16,32,1,48
14524,32.365000000001615,3830.842105263158,75,17,0,92
14525,43.48250000000117,3490.705882352941,92,24,0,116
14526,3.6667500000008415,2510.6428571428573,40,31,1,71
14527,-1.6384999999987895,3254.3888888888887,46,36,0,82
14528,-11.68824999999931,2130.5,32,29,0,61
14529,17.17225000000122,3615.65,51,26,0,77
14530,37.00125000000274,5714.75,96,12,0,108
14531,-4.10324999999914,1971.8666666666666,45,32,0,77
14532,11.360750000001314,5176.65,66,27,0,93
14533,29.11150000000116,2151.3125,72,19,1,91
14534,10.69325000000096,4363.25,57,25,0,82
14535,8.281500000001454,3038.4444444444443,58,24,0,82
14536,24.568750000001167,4944.95,73,27,0,100
14537,-17.187499999999677,2640.9,26,25,1,51
14538,39.96675000000199,4655.3,78,18,0,96
14539,31.591500000000643,3508.6111111111113,72,21,1,93
14540,-2.4409999999998475,2389.3333333333335,47,33,0,80
14541,16.649000000001504,4195.1,62,25,0,87
14542,-3.3049999999990534,3139.45,37,28,0,65
14543,21.637000000001365,3185.4117647058824,73,24,0,97
14544,6.921000000001025,2598.6875,65,23,0,88
14545,-12.898999999999095,2589.875,30,27,0,57
14546,5.5597500000003,3225.3684210526317,46,35,1,81
14547,-11.876999999999985,1933.5,49,33,2,82
14548,8.112000000002192,4162.4,66,23,2,89
14549,-33.54299999999962,1967.0526315789473,15,26,4,41
14550,-24.619499999999526,2040.15,19,27,0,46
14551,1.2560000000012779,3302.8947368421054,47,27,0,74
14552,-9.323999999998888,3285.55,47,25,0,72
14553,5.274750000001395,3058.125,69,31,3,100
14554,21.45900000000244,4657.75,81,17,0,98
14555,10.829750000001264,3544.3684210526317,56,28,0,84
14556,-11.3099999999997,2017.235294117647,24,33,0,57
14557,8.54200000000135,1892.3125,53,21,2,74
14558,20.129500000001315,4604.45,68,21,0,89
14559,-11.847249999999502,2429.0,29,29,0,58
14560,-9.73499999999984,3184.2631578947367,36,47,0,83
14561,-17.56249999999943,1945.8333333333333,18,33,1,51
14562,12.774750000000527,2530.0,54,33,1,87
14563,35.98250000000228,2937.1176470588234,74,19,0,93
14564,2.3660000000004233,3407.3684210526317,43,32,1,75
14565,26.5937500000014,4887.75,68,23,0,91
14566,17.95150000000059,3704.45,50,27,0,77
14567,10.221750000000965,3277.823529411765,64,18,0,82
14568,-31.86099999999961,2311.4117647058824,21,44,0,65
14569,8.921500000001881,4475.0526315789475,53,30,0,83
14570,19.80300000000176,2230.625,74,26,0,100
14571,-3.7882499999996093,2552.05,21,33,0,54
14572,28.85700000000126,4718.75,70,22,0,92
14573,-0.7244999999983653,3449.3333333333335,47,29,0,76
14574,-4.563749999998273,3495.0,46,42,1,88
14575,20.00400000000162,4261.263157894737,55,25,0,80
14576,-12.30674999999916,2504.764705882353,31,28,0,59
14577,37.38500000000232,4639.3,74,33,0,107
14578,27.714000000000816,2329.5333333333333,58,27,0,85
14579,-0.25149999999934475,3164.0,44,28,1,72
14580,-4.335749999998564,3510.2105263157896,54,35,1,89
14581,-2.996999999999691,2527.4375,44,26,0,70
14582,11.73850000000063,3041.9444444444443,45,29,1,74
14583,18.13600000000103,3185.4117647058824,65,26,0,91
14584,-23.68249999999955,2032.25,10,32,1,42
14585,-6.43449999999879,2478.705882352941,39,31,3,70
14586,15.270750000001405,3772.75,63,16,0,79
14587,30.51475000000128,3798.6111111111113,68,25,1,93
14588,32.346250000002485,5620.3,85,28,0,113
14589,15.875750000000522,3758.2105263157896,56,29,0,85
14590,-16.906249999999094,2003.4375,35,30,2,65
14591,3.175250000000962,2952.777777777778,43,28,0,71
14592,-3.774749999999088,3251.2,30,31,0,61
14593,17.24350000000112,3282.722222222222,83,23,2,106
14594,9.791750000001167,2903.4444444444443,55,31,0,86
14595,-9.00899999999922,2504.2105263157896,33,32,1,65
14596,3.6682500000007985,3233.4736842105262,42,25,0,67
14597,-8.493749999999554,2539.3684210526317,33,21,0,54
14598,13.670000000002034,3250.705882352941,70,38,0,108
14599,10.651750000000828,2303.9375,64,33,0,97
14600,-8.047499999998314,3627.45,47,30,0,77
14601,-10.584999999999045,2536.3,27,31,1,58
14602,51.56625000000126,5980.75,103,30,0,133
14603,11.028500000000921,3072.05,53,18,0,71
14604,11.181000000001115,2891.235294117647,65,35,0,100
14605,24.940500000001165,3018.4375,77,28,0,105
14606,10.071750000001275,4409.25,59,28,0,87
14607,0.8567500000010628,3215.65,40,27,0,67
14608,5.605250000001165,4050.45,59,19,0,78
14609,-22.022749999999583,2045.5,18,32,2,50
14610,-14.013500000000084,1925.0625,35,27,16,62
14611,-9.332999999998304,2957.9473684210525,41,33,1,74
14612,-7.399499999999092,2045.235294117647,65,35,1,100
14613,-22.701499999999566,2028.2,12,34,0,46
14614,15.145750000002144,4573.0,71,14,0,85
14615,-5.139749999999664,3079.9,36,29,0,65
14616,1.091750000001257,3807.7,45,28,0,73
14617,-22.006749999999723,2032.25,16,26,3,42
14618,13.596250000001442,4453.65,62,26,0,88
14619,2.0620000000015017,3674.3,50,27,1,77
14620,-0.33874999999951516,1862.625,49,34,1,83
14621,28.038250000001767,4447.25,66,28,0,94
14622,8.462000000000787,3816.3,49,37,0,86
14623,3.2427500000009566,4023.0526315789475,58,37,1,95
14624,-23.598999999999144,2813.15,29,29,0,58
14625,13.997500000000665,3894.4210526315787,55,31,0,86
14626,-8.400749999999073,3668.7894736842104,47,28,1,75
14627,-9.324249999999628,2587.85,28,29,0,57
14628,-8.065499999999036,2632.5625,35,26,3,61
14629,0.8325000000014182,3352.4444444444443,61,28,4,89
14630,2.06525000000106,2552.9333333333334,47,23,1,70
14631,8.654750000001124,3521.842105263158,50,30,0,80
14632,32.67500000000162,4707.65,76,23,0,99
14633,-10.438999999998959,2495.294117647059,38,27,0,65
14634,-1.6894999999992855,3195.8,39,23,0,62
14635,-5.464249999999806,2465.842105263158,24,32,0,56
14636,41.722250000001836,4980.7,80,20,0,100
14637,-2.4774999999987863,3071.95,33,35,0,68
14638,-12.502499999999522,2441.3888888888887,33,33,4,66
14639,-11.350499999999005,2472.4736842105262,28,35,0,63
14640,-1.4202499999992444,3145.8947368421054,42,30,0,72
14641,-23.239999999999846,1429.0,13,38,1,51
14642,-25.88574999999952,1980.3684210526317,21,24,1,45
14643,9.681250000000531,2094.6875,44,33,0,77
14644,32.88625000000229,4794.3,74,27,0,101
14645,7.361000000002676,4060.1,70,30,0,100
14646,19.141500000000708,3455.8947368421054,65,25,0,90
14647,33.79625000000232,4364.0,88,15,0,103
14648,13.962750000001659,4858.35,80,22,1,102
14649,-19.921749999999726,2040.15,12,32,1,44
14650,-6.485500000000035,2054.0625,34,33,1,67
14651,17.459500000001263,3677.55,52,26,0,78
14652,-12.624999999999355,2479.470588235294,28,31,15,59
14653,-24.341249999999032,1539.235294117647,18,29,4,47
14654,8.834250000000825,2496.5,66,26,7,92
14655,31.880500000001568,5214.0,70,31,0,101
14656,12.929500000001019,3627.1052631578946,60,37,0,97
14657,29.178000000001628,4627.55,69,28,0,97
14658,7.778750000001503,4175.25,61,21,0,82
14659,22.95625000000121,4028.9473684210525,86,18,0,104
14660,-13.66174999999932,2521.529411764706,25,30,1,55
14661,17.599000000001546,2788.6470588235293,65,18,0,83
14662,-23.298749999999565,1933.1764705882354,26,34,2,60
14663,9.995500000000636,3734.65,50,25,0,75
14664,8.072500000001074,3869.1111111111113,72,25,0,97
14665,-5.956999999999219,2191.8823529411766,33,24,2,57
14666,-12.940499999999128,2495.733333333333,32,29,0,61
14667,-21.19874999999945,2028.2,13,32,1,45
14668,51.25900000000176,6639.4,117,15,0,132
14669,21.082500000001634,4215.6,68,22,1,90
14670,9.40925000000026,2431.777777777778,41,34,0,75
14671,19.707000000000892,4413.15,54,25,2,79
14672,-16.005000000000017,2171.6111111111113,22,37,20,59
14673,-0.8717499999991635,2330.0588235294117,47,27,1,74
14674,3.7697500000016317,2595.785714285714,54,22,0,76
14675,-2.9437499999988566,2562.4666666666667,35,29,0,64
14676,0.9832500000004488,3183.0,65,30,0,95
14677,-9.234499999999883,2454.235294117647,51,34,0,85
14678,29.798750000002563,3616.8823529411766,79,28,0,107
14679,8.570000000001098,2704.529411764706,47,23,0,70
14680,1.0342500000001418,2313.0625,46,26,1,72
14681,15.83450000000179,2732.5882352941176,54,28,0,82
14682,29.374500000002314,4829.05,73,31,0,104
14683,13.895750000001584,2833.9375,55,25,0,80
14684,-31.336749999999494,2010.421052631579,18,30,0,48
14685,-15.691499999999177,2529.6666666666665,32,25,0,57
14686,13.06200000000106,4036.4736842105262,62,25,0,87
14687,-3.932249999999759,2206.823529411765,46,21,5,67
14688,15.030500000001192,4605.35,69,22,0,91
14689,47.65000000000176,3402.3125,76,15,0,91
14690,-13.482999999999569,2775.3333333333335,25,26,1,51
14691,10.975750000000874,3500.6666666666665,53,30,0,83
14692,-14.47799999999881,2618.684210526316,27,35,0,62
14693,10.38300000000118,4140.789473684211,59,30,0,89
14694,-35.16850000000047,1429.0,14,25,7,39
14695,6.937750000000792,3028.6666666666665,68,27,2,95
14696,29.907500000002784,3931.6666666666665,91,18,0,109
14697,-0.7649999999985377,3335.5789473684213,50,24,1,74
14698,27.761000000000735,3706.8888888888887,73,21,0,94
14699,-12.57249999999975,2600.6,27,28,4,55
14700,7.858750000001038,3706.0555555555557,64,25,0,89
14701,-16.88274999999884,1961.6666666666667,31,29,2,60
14702,36.489500000001456,4119.65,72,18,0,90
14703,35.123750000001785,5922.75,88,19,0,107
14704,24.049250000001575,3691.1666666666665,70,13,0,83
14705,13.918750000001534,4110.0,59,27,0,86
14706,-2.3049999999989517,2614.3888888888887,39,31,0,70
14707,-6.753749999999573,2429.0,37,31,0,68
14708,17.860250000000576,4213.578947368421,67,27,0,94
14709,56.60275000000176,2803.0625,107,17,0,124
14710,-14.97574999999967,1919.2941176470588,26,30,2,56
14711,11.957250000001306,3501.8947368421054,46,27,0,73
14712,17.673750000001295,2448.133333333333,69,28,0,97
14713,-0.5922499999984671,3190.2,50,28,0,78
14714,15.764500000000373,2515.4444444444443,56,23,1,79
14715,12.314250000001245,2778.294117647059,74,18,0,92
14716,6.522000000001107,2393.375,53,31,0,84
14717,-6.301999999999435,2562.4666666666667,33,29,0,62
14718,5.1592500000014345,3214.3529411764707,46,22,1,68
14719,-4.346999999999101,3087.75,35,27,1,62
14720,-0.1272499999987559,3020.8333333333335,46,32,0,78
14721,0.47750000000088555,3018.0,51,15,0,66
14722,25.66075000000122,4175.15,62,16,0,78
14723,6.0712500000007505,2546.6470588235293,38,43,0,81
14724,11.776750000001032,4908.5,58,29,0,87
14725,6.611000000001122,3802.05,53,34,0,87
14726,4.485500000000688,2524.4117647058824,44,24,0,68
14727,11.942500000000823,2634.4375,68,26,0,94
14728,-10.803749999998683,3952.1,55,28,0,83
14729,23.410750000000917,3611.6666666666665,68,24,0,92
14730,7.517750000000563,2455.9375,46,17,0,63
14731,46.72800000000066,3908.0,90,16,0,106
14732,-1.545999999999109,2533.866666666667,49,19,0,68
14733,8.56375000000028,2551.294117647059,53,23,1,76
14734,7.474250000001793,2366.375,66,29,0,95
14735,0.9085000000003085,2592.8125,35,27,1,62
14736,34.7920000000019,4725.25,77,25,0,102
14737,37.87350000000132,4837.8,69,29,1,98
14738,9.520500000001448,4514.85,59,32,0,91
14739,-6.768749999999118,2582.842105263158,32,33,0,65
14740,25.883499999999962,2210.529411764706,78,23,0,101
14741,35.391750000002,3319.9375,79,12,0,91
14742,29.778500000002225,4744.2,82,26,0,108
14743,-12.070499999999203,2032.125,34,34,1,68
14744,-2.356999999998456,3192.0555555555557,44,31,0,75
14745,28.95875000000202,6314.05,81,26,1,107
14746,-5.145749999999657,2436.8888888888887,41,27,0,68
14747,-4.111749999999382,1973.111111111111,38,31,1,69
14748,-13.504999999999253,2737.1,32,30,0,62
14749,10.65900000000049,3424.8947368421054,56,31,0,87
14750,-1.1957500000001564,2319.823529411765,50,28,1,78
14751,-10.079749999999297,2611.722222222222,28,32,0,60
14752,-8.204749999999915,2471.0,49,35,0,84
14753,-21.019499999999503,2044.1,15,34,1,49
14754,-5.2524999999991735,2620.5882352941176,33,24,0,57
14755,-12.770749999999198,2629.133333333333,39,24,0,63
14756,22.75000000000162,4933.0,75,22,2,97
14757,-10.91749999999931,2373.4444444444443,37,24,0,61
14758,-20.136499999999877,2067.85,16,32,1,48
14759,50.033000000002126,3786.277777777778,77,18,0,95
14760,-13.60399999999964,1652.25,42,41,1,83
14761,20.47575000000157,3737.75,60,18,1,78
14762,-6.692999999999044,3959.6315789473683,47,37,0,84
14763,58.002000000002816,6418.05,103,21,0,124
14764,-10.411499999999354,3010.65,35,29,0,64
14765,14.372750000001068,3447.5555555555557,59,24,0,83
14766,-4.196499999999245,2635.4444444444443,50,33,0,83
14767,10.234500000001232,4258.5,68,19,0,87
14768,-13.052000000000442,1429.0,29,35,1,64
14769,15.707250000001352,3319.076923076923,66,38,0,104
14770,1.332500000001764,3117.214285714286,53,24,1,77
14771,-24.448499999999836,2448.5,35,31,19,66
14772,35.93675000000148,4315.421052631579,74,21,0,95
14773,47.89050000000199,5318.05,93,17,0,110
14774,16.606500000001837,3364.6470588235293,79,20,0,99
14775,19.46275000000042,2989.684210526316,66,28,1,94
14776,19.320750000001457,3771.375,52,29,0,81
14777,-31.6904999999992,2028.25,16,30,1,46
14778,29.087750000000135,2504.6470588235293,56,27,0,83
14779,8.91650000000206,2507.4117647058824,57,24,0,81
14780,-1.090749999999097,3147.25,42,23,1,65
14781,17.736500000001932,4540.2,75,22,0,97
14782,-12.398499999999398,2607.1052631578946,27,26,0,53
14783,-22.833749999999466,2012.4,10,37,0,47
14784,11.947750000002447,2445.9444444444443,60,21,1,81
14785,18.15650000000105,2439.9375,61,25,1,86
14786,-18.814499999998894,1961.6666666666667,24,30,4,54
14787,39.41575000000279,5663.3,97,16,0,113
14788,11.97625000000093,4306.05,64,21,0,85
14789,8.189000000001275,4067.95,60,32,0,92
14790,2.6457500000012866,2823.0588235294117,65,30,3,95
14791,4.300250000000547,3028.7894736842104,53,31,1,84
14792,16.573750000001382,3174.1875,64,19,0,83
14793,38.96500000000375,3781.1176470588234,101,23,0,124
14794,-3.332749999998711,3263.15,49,23,0,72
14795,18.554500000001035,4268.0,57,28,0,85
14796,-20.736749999999496,2063.95,20,27,1,47
14797,0.5862500000009617,3098.25,51,16,0,67
14798,28.918250000001287,5045.8,70,28,0,98
14799,-8.247499999998809,3499.65,54,25,1,79
14800,22.37075000000087,2750.5625,68,25,0,93
14801,-31.18849999999957,1913.111111111111,19,34,0,53
14802,11.607500000001059,3589.6666666666665,65,26,1,91
14803,-9.6064999999994,2520.9285714285716,31,26,1,57
14804,-15.338249999999144,2640.95,30,31,0,61
14805,24.42450000000369,3668.9411764705883,100,14,0,114
14806,28.491250000001592,3580.4117647058824,87,26,0,113
14807,4.096250000001285,3702.85,55,34,0,89
14808,3.7857500000019835,4341.1,64,25,0,89
14809,-7.809999999998865,3056.15,44,20,0,64
14810,-10.018999999999462,2244.176470588235,34,29,0,63
14811,0.9280000000007798,2378.5,48,26,0,74
14812,1.7227500000006788,3508.4210526315787,65,14,13,79
14813,4.970250000000502,2881.9411764705883,43,39,0,82
14814,13.187750000001131,3688.842105263158,54,21,0,75
14815,25.44200000000158,4683.1,79,19,0,98
14816,16.966250000000123,2509.4375,54,32,0,86
14817,14.313750000001344,3663.3,56,26,0,82
14818,-3.226499999998552,3151.3333333333335,46,27,0,73
14819,-9.223749999999331,2500.5,32,30,0,62
14820,-21.652749999999777,2024.25,13,31,0,44
14821,41.59275000000169,3708.294117647059,87,14,0,101
14822,-13.813749999998947,3446.5,36,33,1,69
14823,21.739250000002393,5317.2,73,25,0,98
14824,25.713750000001028,4430.65,63,25,0,88
14825,23.002000000001633,3978.25,65,22,0,87
14826,-12.57549999999932,2532.25,31,26,0,57
14827,29.858750000001965,3998.777777777778,82,27,0,109
14828,40.0317500000018,4750.65,86,11,0,97
14829,3.091000000000738,2596.8125,43,24,4,67
14830,-6.854499999999493,2652.85,33,24,3,57
14831,20.437500000001954,4794.1,80,16,0,96
14832,-5.355749999998894,3456.85,43,28,0,71
14833,23.24175000000314,5451.25,87,34,1,121
14834,-20.165749999999477,2147.25,18,25,1,43
14835,-4.616499999999393,2024.764705882353,40,34,0,74
14836,24.983500000001584,4821.2,67,24,0,91
14837,16.821250000000756,3683.05,54,26,0,80
14838,11.109750000001332,3925.0,52,32,0,84
14839,3.8717500000009344,2844.4444444444443,58,27,7,85
14840,-16.77874999999915,2522.6315789473683,34,27,0,61
14841,-4.3854999999993165,3047.277777777778,47,28,1,75
14842,36.315750000001756,4496.789473684211,77,23,0,100
14843,-24.49999999999969,2064.0,14,35,0,49
14844,15.264250000001457,5309.25,76,22,0,98
14845,16.462000000001613,2852.3333333333335,56,31,0,87
14846,19.43725000000112,4606.263157894737,65,23,0,88
14847,-2.6049999999991433,3529.4210526315787,49,24,1,73
14848,15.562000000001149,3829.2,55,26,0,81
14849,-22.262250000000403,2053.0526315789475,29,30,15,59
14850,38.65450000000253,5391.8,99,20,0,119
14851,24.533750000000193,2750.5625,74,30,0,104
14852,-14.72024999999995,2799.65,26,28,0,54
14853,-2.0127499999995004,2698.0526315789475,39,32,0,71
14854,-11.53724999999849,2475.625,42,32,1,74
14855,-2.817749999999528,2509.5,44,30,0,74
14856,12.015000000000722,2446.875,51,31,0,82
14857,-14.589999999999131,2455.5555555555557,31,28,0,59
14858,-11.127499999999184,2497.5789473684213,34,24,0,58
14859,0.9372500000003491,3953.0,60,18,2,78
14860,5.9847500000012115,2478.8,51,27,0,78
14861,10.850500000001372,3798.2,65,21,0,86
14862,22.24500000000169,3780.235294117647,83,20,0,103
14863,39.88450000000204,2803.529411764706,92,23,0,115
14864,20.141750000002126,4948.1,81,24,1,105
14865,-14.313249999999721,2678.25,27,28,0,55
14866,9.687000000001031,3082.6111111111113,52,27,0,79
14867,19.00775000000076,2849.3529411764707,69,28,0,97
14868,21.233250000002677,5077.65,93,23,0,116
14869,16.793750000000298,2778.5833333333335,65,28,0,93
14870,0.004000000001262638,3505.9473684210525,56,20,0,76
14871,9.764250000001368,3439.0,54,28,1,82
14872,0.5682500000007222,2901.777777777778,56,27,0,83
14873,10.41650000000134,3686.35,59,14,3,73
14874,9.246500000001472,3956.875,51,22,0,73
14875,6.759000000001018,3072.1,49,20,0,69
14876,-1.069249999998344,4525.9,61,24,2,85
14877,17.27100000000041,2513.1176470588234,56,28,0,84
14878,-9.783499999998238,2099.6875,42,25,0,67
14879,-10.535499999999626,2990.9,34,28,2,62
14880,31.868750000001825,3698.0,92,25,0,117
14881,-19.51899999999938,1862.5625,28,30,5,58
14882,-4.741749999999416,2552.1,33,19,1,52
14883,-2.460499999998871,2621.75,49,33,3,82
14884,-8.79774999999928,2421.222222222222,33,25,4,58
14885,-28.532749999999663,1997.1052631578948,15,26,4,41
14886,22.74200000000156,3840.0555555555557,70,23,1,93
14887,-19.380500000000318,1429.0,13,29,13,42
14888,55.85975000000104,4986.368421052632,81,20,0,101
14889,41.41625000000152,5349.7,87,22,1,109
14890,14.544000000001793,4179.1,69,19,0,88
14891,9.468250000000618,3075.9,44,19,2,63
14892,-9.46449999999924,2554.3333333333335,34,27,3,61
14893,-25.011749999999335,2022.7,17,26,0,43
14894,-16.612999999999086,2530.5555555555557,32,25,0,57
14895,-4.242749999998809,3255.4285714285716,45,21,0,66
14896,-23.149249999999906,1944.8333333333333,32,36,2,68
14897,-10.020249999999603,2490.0526315789475,32,30,1,62
14898,-17.632999999999697,2028.3,13,33,0,46
14899,-13.230249999999604,1957.5882352941176,29,27,2,56
14900,38.93425000000187,5547.45,89,18,0,107
14901,-14.313249999999352,2552.1,25,27,0,52
14902,30.29425000000137,4155.1578947368425,79,17,0,96
14903,2.07525000000095,2976.3684210526317,46,23,1,69
14904,29.040750000001424,4462.45,79,19,0,98
14905,12.483250000001453,4206.8,61,25,0,86
14906,13.165750000001612,4022.2105263157896,65,29,1,94
14907,-24.146500000000312,1980.421052631579,18,32,10,50
14908,-2.056249999999646,3123.6,37,23,1,60
14909,-50.47000000000076,1429.0,2,29,28,31
14910,-17.724999999999717,2007.5555555555557,17,34,1,51
14911,16.705750000001085,3699.8,53,27,0,80
14912,-16.269999999999115,1963.0588235294117,30,29,0,59
14913,8.21300000000127,2848.3529411764707,69,20,0,89
14914,14.795500000000796,3677.2631578947367,58,20,0,78
14915,9.55300000000063,2425.529411764706,57,26,0,83
14916,17.346000000000863,5421.1,82,24,0,106
14917,9.955250000000705,2848.75,68,30,0,98
14918,-27.10049999999967,1990.7777777777778,23,23,3,46
14919,-21.809499999999623,2008.5,15,31,2,46
14920,-21.11249999999939,2126.65,16,30,2,46
14921,41.541000000000835,3635.5,99,11,0,110
14922,22.24275000000143,3996.1111111111113,68,22,0,90
14923,-10.513749999999062,2663.25,34,24,2,58
14924,13.637750000000741,2836.5555555555557,53,30,1,83
14925,12.62550000000056,2561.785714285714,59,23,4,82
14926,-24.276749999999492,2028.3,17,32,2,49
14927,-9.396249999999299,2579.85,28,28,0,56
14928,-25.023999999999116,2463.2631578947367,28,23,3,51
14929,12.667500000001372,3542.6315789473683,52,28,0,80
14930,-2.146249999999936,2921.0,57,33,0,90
14931,-5.209499999999574,2324.9444444444443,50,35,0,85
14932,9.122250000001122,2933.294117647059,60,25,0,85
14933,-10.353499999999109,2488.2631578947367,32,29,0,61
14934,-9.019499999999969,1933.388888888889,55,26,1,81
14935,-33.26674999999949,2048.1,13,29,3,42
14936,-15.553999999999178,2950.2631578947367,48,14,1,62
14937,-20.75124999999907,3372.8,47,28,1,75
14938,-3.758499999999425,2591.0666666666666,47,33,2,80
14939,-5.416249999999039,2552.15,27,37,0,64
14940,-15.767749999999438,2464.9473684210525,36,27,12,63
14941,-3.2792499999987137,2302.9411764705883,62,43,0,105
14942,2.054250000000942,3485.1052631578946,56,26,2,82
14943,8.869500000001683,3539.294117647059,63,25,0,88
14944,-5.897249999999113,3060.05,31,27,3,58
14945,-16.238999999999905,2482.5789473684213,29,33,7,62
14946,-13.842499999999385,2610.0,31,26,0,57
14947,-29.862499999999365,2176.75,18,34,0,52
14948,-13.993749999998576,3065.6315789473683,52,33,4,85
14949,-26.58499999999958,2040.15,18,26,1,44
14950,45.60225000000254,4993.3,86,20,0,106
14951,29.501250000001903,4738.65,83,20,0,103
14952,31.981250000001875,4725.95,77,16,1,93
14953,17.944250000001137,2882.764705882353,62,34,1,96
14954,-12.958749999998656,2556.0,37,26,1,63
14955,-24.34999999999902,2145.1666666666665,19,44,5,63
14956,-2.537249999998929,2406.705882352941,40,29,0,69
14957,8.912000000001402,4213.2,60,26,0,86
14958,6.618500000000483,2768.4375,69,24,0,93
14959,40.56325000000091,4405.277777777777,83,34,0,117
14960,-6.307999999999043,3260.85,42,32,0,74
14961,10.37175000000114,2795.1875,52,35,0,87
14962,-6.80324999999903,2277.25,49,26,0,75
14963,11.145749999999865,3111.5789473684213,61,24,0,85
14964,12.89350000000169,5063.25,78,32,0,110
14965,-7.736249999998935,3117.4210526315787,55,30,2,85
14966,16.07200000000082,3655.5789473684213,47,32,0,79
14967,-13.332749999999155,2608.3529411764707,31,24,3,55
14968,25.49750000000112,3740.0588235294117,66,27,0,93
14969,-19.133249999999542,2659.15,21,33,0,54
14970,7.867500000001101,3010.6315789473683,44,36,3,80
14971,27.368750000001675,5061.473684210527,68,34,1,102
14972,-25.974499999999807,1977.1052631578948,16,34,2,50
14973,22.237750000001032,2091.5333333333333,66,27,0,93
14974,5.486750000001382,4088.6,53,38,0,91
14975,-5.841749999999495,2418.2105263157896,31,25,1,56
14976,10.004750000000564,3465.0526315789475,47,28,0,75
14977,0.613250000000778,3079.95,41,24,0,65
14978,23.410750000002132,4816.4,74,28,0,102
14979,11.338250000000667,2017.3529411764705,54,35,2,89
14980,-11.98374999999909,2750.470588235294,31,27,1,58
14981,-22.11974999999979,1959.4736842105262,19,26,2,45
14982,-45.8624999999998,1429.0,0,29,0,29
14983,17.78600000000156,4075.7368421052633,66,28,0,94
14984,5.037500000000849,4172.75,51,39,1,90
14985,-9.953249999999233,2500.5625,27,31,2,58
14986,-31.88349999999978,1943.1666666666667,23,35,3,58
14987,-22.319999999999432,2489.2105263157896,32,28,1,60
14988,5.24825000000115,3718.8,52,27,0,79
14989,49.01050000000195,5478.15,82,24,0,106
14990,30.857750000001392,4561.210526315789,67,25,0,92
14991,2.972250000001044,2014.375,66,31,3,97
14992,-6.684749999999815,3164.315789473684,37,30,0,67
14993,7.817750000001453,3210.157894736842,47,27,0,74
14994,-12.547249999999234,2556.1,26,34,0,60
14995,-0.2064999999989329,2648.6666666666665,41,35,1,76
14996,22.537000000002077,4009.764705882353,78,19,0,97
14997,26.648250000001507,4429.1,73,20,1,93
14998,-2.7289999999993477,2491.5625,37,34,0,71
14999,29.581000000001847,4702.15,79,17,0,96
15000,-28.103749999999128,2997.1052631578946,29,44,0,73
