Episode,Average Reward,Average Lifespan,True Location Count,False Location Count,Explore Actions,Target Actions
1,-46.70425000000016,1429.0,6,4,30,10
2,-22.710499999998163,2908.777777777778,28,9,33,37
3,-47.21574999999858,1640.0588235294117,13,13,27,26
4,-29.172749999998825,1733.625,17,5,37,22
5,-45.71874999999999,2779.157894736842,22,13,29,35
6,-45.56024999999906,1429.0,17,12,33,29
7,-38.58399999999939,3175.0526315789475,21,12,27,33
8,-49.60424999999849,4368.75,25,10,40,35
9,-59.08199999999814,2662.722222222222,20,12,36,32
10,-33.82349999999996,2020.8333333333333,15,8,36,23
11,-31.14999999999913,3147.5263157894738,17,7,32,24
12,-27.947749999999143,3223.6,22,10,22,32
13,-19.60674999999862,3267.842105263158,29,11,23,40
14,-16.230499999998887,1887.5294117647059,22,6,31,28
15,-28.662500000000552,1429.0,11,11,37,22
16,-37.009999999999906,1822.3333333333333,5,3,42,8
17,-21.821249999998795,3735.5,19,11,26,30
18,-47.44975000000019,2332.0555555555557,19,12,37,31
19,-27.050999999999597,2445.823529411765,25,11,30,36
20,-44.227499999999175,1496.5,8,12,26,20
21,-36.8574999999994,2823.3684210526317,14,4,32,18
22,-15.375750000000133,2508.5,27,15,29,42
23,-29.630749999998795,2661.3684210526317,15,8,30,23
24,-43.32299999999945,2723.6111111111113,19,14,31,33
25,-38.44749999999978,2758.9444444444443,19,12,32,31
26,-41.05949999999963,4142.6,16,12,31,28
27,-35.92300000000033,1706.7777777777778,18,5,33,23
28,-30.502999999997133,4758.5,27,6,45,33
29,-29.366499999999284,2153.375,20,9,31,29
30,-43.65774999999877,2443.2631578947367,14,7,28,21
31,-17.871749999999334,1724.6875,12,8,33,20
32,-17.854999999998547,4471.95,23,6,36,29
33,-24.39024999999942,2235.0555555555557,20,6,38,26
34,-40.98724999999928,2799.1052631578946,13,10,27,23
35,-26.672249999999373,1630.4375,21,3,39,24
36,-4.499250000000012,2534.5882352941176,43,13,33,56
37,-42.221249999999216,2827.5263157894738,18,12,24,30
38,-26.78599999999929,2937.0,18,13,25,31
39,-34.3624999999993,3426.75,16,8,32,24
40,-33.819500000000204,2206.777777777778,12,4,48,16
41,-43.931249999998755,2316.2105263157896,11,8,31,19
42,-19.59249999999865,3314.05,24,12,26,36
43,-26.068499999999823,4033.9473684210525,37,15,31,52
44,-24.782499999998794,4017.9,27,16,24,43
45,-30.11724999999928,2640.4210526315787,14,4,37,18
46,-52.364249999999615,1682.1176470588234,2,4,39,6
47,-44.19324999999988,1893.375,23,12,27,35
48,-28.426249999999506,3169.315789473684,29,8,39,37
49,-24.014749999999484,4527.45,23,8,31,31
50,-23.678999999999633,1791.4117647058824,8,8,27,16
51,-15.324749999998403,2724.842105263158,28,5,25,33
52,-29.96199999999869,2790.842105263158,19,3,30,22
53,-51.38600000000058,1545.125,16,8,38,24
54,-31.909499999998797,2565.315789473684,14,4,39,18
55,-40.387499999999605,2057.2631578947367,10,11,30,21
56,-39.37899999999903,2457.3888888888887,18,2,56,20
57,-23.67074999999955,2125.4375,24,12,32,36
58,-49.60175000000027,2580.3529411764707,25,19,36,44
59,-39.504249999998954,2000.625,22,13,44,35
60,-30.326749999998675,4327.9473684210525,34,16,32,50
61,-18.84624999999806,2051.9411764705883,33,4,27,37
62,-22.726999999999855,2084.529411764706,26,14,30,40
63,-51.35474999999965,3743.35,12,6,34,18
64,-16.449499999998917,4148.95,25,8,32,33
65,-46.24949999999872,2560.5,15,8,35,23
66,-15.408999999998619,5087.8,36,11,34,47
67,-51.60274999999977,1628.3333333333333,1,3,32,4
68,-26.923999999999342,2350.6875,25,7,36,32
69,-40.10000000000012,2309.1111111111113,18,15,26,33
70,-13.122249999998738,2394.375,30,6,25,36
71,-8.014499999997978,2497.235294117647,32,8,34,40
72,-40.83449999999962,1853.8235294117646,13,1,39,14
73,-36.231499999998974,2948.684210526316,14,6,32,20
74,-35.65649999999893,3748.95,20,10,26,30
75,-35.187999999999434,3140.0526315789475,13,10,26,23
76,-35.77375000000004,1541.125,20,11,35,31
77,-36.36399999999977,1744.6470588235295,9,12,28,21
78,-34.83249999999964,3137.0,14,7,25,21
79,-46.705499999999915,1429.0,0,4,31,4
80,-23.30699999999784,3280.3684210526317,20,7,38,27
81,-38.19350000000008,2036.7222222222222,26,9,36,35
82,-48.04900000000028,1748.3529411764705,12,11,23,23
83,-53.58774999999993,1438.5333333333333,23,13,34,36
84,-65.41650000000027,1949.2777777777778,3,9,53,12
85,-18.828499999999146,2887.05,17,8,27,25
86,-39.180000000000106,1621.5,15,9,30,24
87,-40.53274999999882,1617.5625,18,11,24,29
88,-17.33624999999906,2534.5882352941176,28,13,25,41
89,-40.431749999999084,2337.3888888888887,11,2,41,13
90,-38.74124999999849,3586.9473684210525,26,5,35,31
91,-34.257749999999234,2449.8947368421054,18,2,24,20
92,-26.640749999999578,3523.4736842105262,19,8,30,27
93,-32.107999999999414,4155.105263157895,26,15,18,41
94,-41.25749999999991,2501.0,33,9,33,42
95,-33.7067499999981,4054.1052631578946,33,4,27,37
96,-60.00799999999914,3859.25,10,7,38,17
97,-33.692499999999114,2906.1052631578946,16,8,29,24
98,-40.41899999999878,1559.0,16,3,34,19
99,-29.29599999999963,2072.0555555555557,10,3,38,13
100,-17.57474999999933,2550.0625,37,10,29,47
101,-32.934999999999704,1585.75,15,14,20,29
102,-19.45775000000092,3048.1111111111113,33,16,38,49
103,-26.840750000000007,1820.2941176470588,12,12,33,24
104,-36.16150000000012,1926.7058823529412,23,15,21,38
105,-21.991749999996674,2818.9444444444443,35,8,29,43
106,-44.61649999999966,2522.75,8,6,25,14
107,-33.49224999999932,3588.5,15,17,19,32
108,-35.954499999999726,1973.111111111111,16,10,30,26
109,-33.39774999999911,2504.8888888888887,14,3,37,17
110,-35.56874999999941,3165.9473684210525,11,11,43,22
111,-20.55349999999907,2589.6470588235293,24,14,30,38
112,-28.455999999998717,2995.1666666666665,32,15,34,47
113,-18.486249999999,2326.9375,37,13,33,50
114,-50.93274999999914,3766.5263157894738,19,10,28,29
115,-59.80825000000014,1798.5555555555557,17,16,27,33
116,-43.17125000000072,2219.0,29,25,30,54
117,-34.96474999999947,3411.65,15,11,32,26
118,-46.723499999999994,2568.4444444444443,10,12,26,22
119,-25.897499999999816,1532.25,14,6,36,20
120,-28.403249999998714,3748.9,20,16,27,36
121,-36.24200000000063,2269.4117647058824,23,15,32,38
122,-26.253249999997813,2945.8888888888887,25,7,39,32
123,-11.444249999998652,2153.375,28,10,32,38
124,-34.025749999999086,3343.1052631578946,17,11,30,28
125,-23.973749999999693,2485.842105263158,15,9,25,24
126,-21.067999999998733,2416.9411764705883,39,13,33,52
127,-33.77924999999921,2811.684210526316,12,13,29,25
128,-35.451249999999334,2639.8888888888887,19,7,33,26
129,-28.16699999999774,3565.315789473684,32,10,27,42
130,-18.86800000000057,2111.6111111111113,29,10,39,39
131,-38.87199999999909,3478.3684210526317,23,8,26,31
132,-13.458499999999571,2416.8823529411766,31,9,28,40
133,-27.77249999999882,2072.3529411764707,36,7,34,43
134,-39.569749999999935,3613.684210526316,21,9,43,30
135,-37.74649999999956,2712.315789473684,20,10,22,30
136,-31.63699999999891,1724.6875,18,5,31,23
137,-26.72774999999907,2043.5294117647059,19,10,27,29
138,-43.68499999999947,1590.8125,4,12,26,16
139,-21.62675000000036,2311.3529411764707,36,9,40,45
140,-36.23774999999926,1429.0,6,8,33,14
141,-28.608749999999606,1528.25,8,5,28,13
142,-18.895999999999425,3750.9444444444443,28,6,25,34
143,-31.16749999999893,4516.3,19,13,31,32
144,-25.54899999999966,2756.222222222222,23,7,33,30
145,-48.80324999999998,2148.0,14,7,42,21
146,-33.175999999999114,4069.842105263158,23,12,38,35
147,-33.36375000000025,1744.6470588235295,19,14,37,33
148,-39.429249999997936,3301.3,23,5,33,28
149,-31.25149999999966,3795.842105263158,24,12,37,36
150,-32.02149999999907,1694.235294117647,15,10,30,25
151,-13.678499999999385,1805.0625,15,12,22,27
152,-16.95349999999861,3472.277777777778,35,1,25,36
153,-22.137249999997742,3204.222222222222,31,13,31,44
154,-14.199000000000007,2841.8333333333335,31,8,31,39
155,-28.531499999998925,2240.470588235294,21,15,35,36
156,-37.36199999999947,2651.235294117647,17,9,32,26
157,-29.447249999997787,2806.5,26,4,41,30
158,-41.22449999999985,2331.222222222222,22,14,21,36
159,-42.14049999999994,1429.0,2,3,40,5
160,-27.827749999999746,2807.235294117647,33,15,32,48
161,-27.295749999999277,2831.7368421052633,25,13,30,38
162,-36.12899999999923,3327.45,18,8,24,26
163,-30.36674999999919,2467.294117647059,19,12,28,31
164,-37.84024999999863,3765.0,23,14,30,37
165,-27.249249999999158,4316.263157894737,24,10,38,34
166,-27.55049999999985,2054.1875,29,12,28,41
167,-30.91999999999789,2469.6666666666665,23,7,33,30
168,-38.62424999999975,3059.0,26,15,29,41
169,-45.34850000000035,1922.0,12,3,36,15
170,-29.51099999999853,3898.9,23,12,36,35
171,-20.138999999998514,2895.6111111111113,25,10,26,35
172,-39.28899999999851,1799.764705882353,14,11,27,25
173,-43.185499999999806,1705.8125,4,11,29,15
174,-38.118750000000276,1509.4375,21,15,29,36
175,-47.614999999998275,2761.4444444444443,24,14,29,38
176,-28.522999999998593,3436.5789473684213,22,6,32,28
177,-11.555999999999422,2646.705882352941,39,8,29,47
178,-24.4917499999983,3409.1052631578946,25,7,36,32
179,-36.36750000000041,1429.0,22,7,37,29
180,-40.8422499999997,2357.6875,30,18,27,48
181,-12.539999999998843,3861.0526315789475,34,7,20,41
182,-38.48374999999984,2561.1052631578946,18,6,29,24
183,-27.830499999999,4712.4,28,21,19,49
184,-35.71974999999943,2330.277777777778,13,14,21,27
185,-41.204249999999156,1666.1875,13,12,27,25
186,-39.57425000000037,2581.5555555555557,30,14,24,44
187,-47.36849999999973,3615.6,14,11,27,25
188,-21.866249999999575,2152.375,28,12,39,40
189,-36.189749999998405,2814.4444444444443,22,15,23,37
190,-38.658750000000126,2204.0,22,6,34,28
191,-34.56499999999952,1652.1764705882354,17,11,38,28
192,-39.180749999999776,2404.5,6,13,23,19
193,-31.94699999999956,3684.65,14,10,30,24
194,-33.745749999998935,2143.4117647058824,28,20,23,48
195,-50.28224999999951,2248.8823529411766,11,5,64,16
196,-38.357499999999824,1568.1176470588234,15,8,37,23
197,-42.55549999999964,2884.3684210526317,23,6,47,29
198,-40.40225000000016,1834.8125,21,11,32,32
199,-16.940749999999394,2993.4444444444443,28,9,31,37
200,-34.531499999999184,2629.222222222222,15,8,32,23
201,-37.744749999999506,2601.3,10,5,25,15
202,-62.25674999999988,2520.777777777778,14,11,33,25
203,-43.405249999999576,1849.235294117647,12,11,22,23
204,-18.191250000000394,2851.0,30,6,33,36
205,-20.591749999998477,3147.6666666666665,25,4,48,29
206,-19.72925000000019,2986.2631578947367,19,8,29,27
207,-27.599999999999277,3135.0,18,8,28,26
208,-38.031249999998494,1580.7222222222222,9,11,33,20
209,-25.380999999999325,3351.3684210526317,25,6,27,31
210,-23.317749999999045,4310.8,25,9,28,34
211,-51.08099999999962,3396.5263157894738,18,12,29,30
212,-32.38699999999906,2603.722222222222,12,11,33,23
213,-38.096749999999744,1589.75,15,15,33,30
214,-35.44099999999995,2601.157894736842,21,12,27,33
215,-50.4642499999996,1606.4705882352941,4,7,26,11
216,-30.361749999998402,3883.0,26,5,32,31
217,-22.71624999999905,3493.315789473684,30,13,31,43
218,-39.39799999999958,1818.0,11,7,26,18
219,-40.519999999999136,2380.470588235294,15,8,28,23
220,-40.38324999999947,2157.5789473684213,3,6,29,9
221,-27.764749999999935,3566.0526315789475,28,15,40,43
222,-33.510999999999164,2505.0526315789475,14,3,33,17
223,-35.34499999999808,3139.777777777778,29,3,39,32
224,-26.724249999999095,1617.5625,13,3,35,16
225,-15.45824999999875,4027.2105263157896,29,11,38,40
226,-45.37125000000013,1429.0,6,6,29,12
227,-41.302249999999376,1614.8823529411766,7,7,29,14
228,-19.842249999997605,3069.0,29,14,26,43
229,-30.080999999999584,2059.0625,22,3,39,25
230,-38.01924999999922,3663.25,22,6,20,28
231,-26.551000000000506,2117.722222222222,37,5,41,42
232,-37.52174999999896,3487.1,15,10,27,25
233,-43.499749999999054,2408.529411764706,17,9,29,26
234,-36.05874999999946,2216.8947368421054,10,9,27,19
235,-28.33324999999877,3163.2,20,11,27,31
236,-25.105249999999238,3363.9473684210525,25,11,26,36
237,-34.40249999999931,1740.9411764705883,10,3,31,13
238,-23.010499999999077,3185.157894736842,23,5,41,28
239,-32.8374999999994,2616.0,29,6,33,35
240,-29.357749999999537,2409.6111111111113,19,18,35,37
241,-30.44674999999912,1608.625,8,13,29,21
242,-42.55700000000026,1505.4375,7,5,38,12
243,-39.11874999999888,2047.235294117647,20,8,35,28
244,-52.255999999999496,2489.0,13,6,31,19
245,-52.764000000000195,1703.2777777777778,7,15,31,22
246,-38.84774999999924,1671.125,10,5,30,15
247,-30.15849999999877,2719.222222222222,22,15,25,37
248,-40.90224999999988,1664.2941176470588,7,5,38,12
249,-14.086999999996905,2081.8125,37,15,29,52
250,-45.386249999999464,2193.5555555555557,10,11,29,21
251,-37.26399999999855,2529.8823529411766,28,14,29,42
252,-42.63724999999895,2616.0,18,4,46,22
253,-30.862499999999642,3094.2,17,17,23,34
254,-28.256249999999504,2304.8823529411766,31,7,30,38
255,-32.690249999999054,2711.277777777778,19,9,34,28
256,-31.64774999999845,1715.8125,19,11,27,30
257,-37.432999999998785,1594.75,11,9,28,20
258,-46.04575000000089,1681.1764705882354,18,15,25,33
259,-40.94724999999939,2579.05,9,7,31,16
260,-26.286749999999017,2785.0,16,8,32,24
261,-42.15999999999901,3602.842105263158,35,10,24,45
262,-27.251249999998333,3155.0,14,7,39,21
263,-58.039500000000245,1429.0,9,8,29,17
264,-42.919999999999966,1922.9411764705883,14,11,32,25
265,-34.85075000000013,2101.4117647058824,27,4,49,31
266,-42.4817499999986,3251.8333333333335,21,3,33,24
267,-26.153999999999286,2808.315789473684,14,7,24,21
268,-35.20999999999895,1906.111111111111,13,3,33,16
269,-31.866249999999763,3714.684210526316,35,19,38,54
270,-47.05499999999987,2222.7368421052633,6,15,23,21
271,-36.5249999999978,4150.45,31,10,34,41
272,-19.751749999997976,4315.65,34,10,26,44
273,-27.582000000000058,3160.157894736842,21,3,51,24
274,-31.041499999999246,3274.5263157894738,23,12,25,35
275,-38.13000000000047,1429.0,21,3,39,24
276,-31.403749999999654,2605.5882352941176,33,7,44,40
277,-41.02899999999964,2523.4736842105262,8,7,30,15
278,-7.186499999998256,2514.375,32,12,37,44
279,-46.80349999999981,1730.6315789473683,3,5,29,8
280,-29.755749999998898,2091.277777777778,14,13,24,27
281,-30.62049999999895,3976.75,26,8,33,34
282,-27.592499999999156,2598.75,38,20,39,58
283,-35.22724999999914,2401.777777777778,22,10,20,32
284,-19.051749999999203,3316.3684210526317,24,14,29,38
285,-52.5159999999977,2223.6470588235293,12,15,45,27
286,-33.94924999999958,2076.5789473684213,8,10,25,18
287,-46.82975000000005,1545.0625,12,7,42,19
288,-34.034249999999034,2409.777777777778,10,4,42,14
289,-30.67049999999802,2895.8823529411766,30,10,45,40
290,-41.6117499999991,1809.0,17,12,33,29
291,-16.98899999999815,1598.0588235294117,22,3,32,25
292,-31.365999999999822,1786.6470588235295,24,11,30,35
293,-24.86499999999842,2331.9411764705883,22,14,25,36
294,-42.84000000000003,2452.8333333333335,9,6,28,15
295,-25.896749999998587,3155.0526315789475,32,7,30,39
296,-36.126499999998224,2572.842105263158,20,7,33,27
297,-33.59825000000004,1753.0,17,3,39,20
298,-47.051749999998435,3497.0,26,19,31,45
299,-23.461499999999088,2215.235294117647,32,8,33,40
300,-51.180999999998335,1707.3529411764705,8,13,33,21
301,-37.21874999999903,2240.4117647058824,35,12,37,47
302,-43.16349999999958,3357.5555555555557,27,7,41,34
303,-23.124249999998675,1799.764705882353,18,6,32,24
304,-27.109999999998628,2135.4375,20,7,31,27
305,-20.05899999999831,3352.4444444444443,27,7,39,34
306,-38.837749999999275,2605.3888888888887,12,10,35,22
307,-41.93774999999927,1888.375,8,11,31,19
308,-21.57525000000002,3004.8888888888887,40,12,31,52
309,-33.97074999999948,1989.0,8,9,26,17
310,-34.633749999999196,2874.315789473684,19,10,36,29
311,-31.363749999999918,1429.0,22,9,30,31
312,-30.421499999999234,3087.3684210526317,25,12,19,37
313,-18.888749999999455,2099.75,18,9,27,27
314,-27.357999999999485,3261.0526315789475,15,14,28,29
315,-43.7685000000001,2814.3888888888887,15,7,35,22
316,-34.848249999998345,2235.1111111111113,21,10,33,31
317,-27.126499999998657,3550.2631578947367,24,9,28,33
318,-50.04875000000004,1944.888888888889,18,9,35,27
319,-38.64449999999955,2959.0,28,22,27,50
320,-31.442999999999433,3275.3684210526317,20,13,43,33
321,-34.44950000000006,1901.7222222222222,24,6,38,30
322,-22.085499999999236,2790.0,19,7,28,26
323,-40.43624999999987,1661.1875,20,14,33,34
324,-23.20099999999756,2388.0,30,10,35,40
325,-42.99349999999989,1429.0,8,10,29,18
326,-25.0087500000001,2024.2777777777778,29,13,30,42
327,-34.451999999999074,4058.157894736842,37,15,26,52
328,-24.55999999999903,2254.3888888888887,16,9,29,25
329,-41.72449999999914,3908.55,13,7,36,20
330,-39.09300000000013,1898.375,20,11,37,31
331,-39.19099999999905,1680.0625,12,2,33,14
332,-25.195499999998532,2703.470588235294,32,4,30,36
333,-20.687499999999318,1778.2941176470588,24,12,32,36
334,-32.964749999998844,4017.2,15,15,25,30
335,-34.456999999999525,2324.529411764706,15,3,35,18
336,-47.937999999999946,2025.6470588235295,11,15,30,26
337,-32.05174999999902,3001.3684210526317,12,18,27,30
338,-29.622499999998876,2089.1176470588234,17,5,32,22
339,-1.7049999999980983,5171.1,37,7,34,44
340,-35.759499999999676,2370.0,16,13,23,29
341,-29.080999999999413,2836.5,17,10,29,27
342,-28.59699999999861,4783.85,34,16,25,50
343,-27.866499999999697,2604.529411764706,38,9,29,47
344,-27.215749999999314,3253.684210526316,23,5,32,28
345,-31.594499999998256,3032.277777777778,27,10,24,37
346,-30.32499999999925,2497.5263157894738,17,10,23,27
347,-49.070999999999216,1639.3125,12,8,32,20
348,-9.587249999997828,2219.75,31,12,34,43
349,-29.695500000000955,2333.8888888888887,38,13,43,51
350,-51.28049999999922,2461.6666666666665,11,9,28,20
351,-34.54724999999898,2777.4444444444443,16,19,30,35
352,-38.962999999999326,2136.684210526316,7,13,22,20
353,-38.19199999999948,1879.1176470588234,8,9,33,17
354,-40.77949999999941,2937.0,17,8,41,25
355,-21.31724999999873,3523.5263157894738,44,5,34,49
356,-25.096999999998836,2168.125,26,8,25,34
357,-33.247749999999456,2626.0588235294117,27,4,49,31
358,-54.70374999999925,2455.842105263158,9,10,37,19
359,-42.71799999999975,2944.5789473684213,18,11,25,29
360,-38.73349999999867,2805.5555555555557,32,12,24,44
361,-47.557749999999245,2786.6315789473683,9,11,34,20
362,-30.614749999999322,3304.5263157894738,18,9,30,27
363,-49.7097499999997,2243.6315789473683,7,5,35,12
364,-34.437499999999126,3110.7368421052633,23,7,37,30
365,-35.87699999999955,2598.684210526316,23,5,38,28
366,-29.370249999999924,1710.75,31,20,27,51
367,-34.966499999999826,3698.8947368421054,29,6,40,35
368,-34.57399999999865,1688.9375,18,9,30,27
369,-33.80999999999965,3627.45,20,11,25,31
370,-34.27699999999933,3433.85,17,13,28,30
371,-31.796249999998857,3380.5555555555557,25,10,34,35
372,-43.15874999999953,2357.294117647059,10,9,38,19
373,-36.84999999999963,1912.7058823529412,13,4,36,17
374,-28.379999999999264,3065.7368421052633,20,12,25,32
375,-26.46374999999898,3550.5,16,3,41,19
376,-28.429249999999996,1702.5882352941176,11,14,23,25
377,-36.78949999999942,2168.8888888888887,12,5,31,17
378,-32.738499999999604,2726.5263157894738,17,12,22,29
379,-28.041499999999708,3286.1666666666665,33,12,29,45
380,-37.88124999999969,3084.0,17,7,27,24
381,-29.622249999999383,2934.3888888888887,19,8,25,27
382,-48.26649999999834,3556.0,28,5,32,33
383,-33.58050000000038,1616.5625,13,19,23,32
384,-29.185999999998096,1744.5625,21,11,32,32
385,-27.546249999999265,3499.7,18,16,24,34
386,-45.28424999999869,1684.0,14,10,46,24
387,-36.4867499999999,1826.875,17,16,29,33
388,-40.06674999999929,2616.35,9,9,26,18
389,-9.23624999999964,2408.529411764706,28,5,32,33
390,-10.117499999999788,2300.125,35,5,38,40
391,-24.51349999999872,1743.4375,18,11,31,29
392,-25.47199999999957,1993.0588235294117,10,13,22,23
393,-18.506749999999393,3691.7,16,7,30,23
394,-19.032499999998628,2636.3333333333335,26,7,25,33
395,-27.596499999999413,3433.2631578947367,41,19,26,60
396,-42.39974999999888,2690.15,11,9,29,20
397,-23.259999999999337,1938.9375,20,12,29,32
398,-40.472999999999004,2397.277777777778,11,11,32,22
399,-37.84749999999901,2576.3888888888887,15,14,29,29
400,-14.260999999999651,3016.4444444444443,28,15,29,43
401,-29.604499999999824,2235.0555555555557,30,8,27,38
402,-40.14724999999871,2678.0526315789475,13,14,27,27
403,-43.33924999999942,2779.1052631578946,8,7,32,15
404,-28.292499999998977,2690.8888888888887,24,12,25,36
405,-40.745749999999006,2959.6315789473683,22,12,27,34
406,-43.58774999999925,3009.6315789473683,18,8,27,26
407,-42.50275000000001,1567.9375,18,5,34,23
408,-34.33049999999911,3248.5789473684213,32,14,27,46
409,-49.37899999999944,2204.9411764705883,16,6,35,22
410,-32.97099999999931,3219.222222222222,21,10,35,31
411,-40.985499999998574,3338.9473684210525,26,20,17,46
412,-42.75899999999889,2755.823529411765,29,21,26,50
413,-38.967749999999306,2290.8823529411766,15,10,28,25
414,-25.46524999999998,2606.2105263157896,16,11,30,27
415,-35.30899999999967,1830.2777777777778,5,5,39,10
416,-33.47724999999861,2077.875,30,10,31,40
417,-37.19824999999951,3295.0555555555557,23,9,33,32
418,-42.137749999998775,4455.95,29,12,27,41
419,-9.300999999998908,2612.5,25,8,22,33
420,-37.964999999998675,2496.9444444444443,15,16,31,31
421,-31.084499999999235,2418.5,18,15,19,33
422,-7.822249999998573,3325.8888888888887,32,11,32,43
423,-13.913249999999204,2419.3333333333335,20,10,22,30
424,-31.85374999999997,2029.5555555555557,19,7,27,26
425,-38.913499999998926,2847.5789473684213,23,9,24,32
426,-26.44574999999861,1680.0625,16,12,25,28
427,-24.80424999999945,1898.2222222222222,13,8,27,21
428,-4.624749999998542,2220.0588235294117,26,6,31,32
429,-33.044749999999965,1793.125,17,11,29,28
430,-34.239999999999796,2097.6470588235293,23,10,24,33
431,-31.24474999999986,2408.0,15,17,32,32
432,-31.641749999999302,2416.9411764705883,19,7,28,26
433,-45.88450000000036,1438.5333333333333,19,9,33,28
434,-23.507499999999816,2505.777777777778,42,7,41,49
435,-37.795249999999946,2666.3684210526317,15,7,29,22
436,-30.989999999999593,2733.157894736842,15,11,30,26
437,-40.826749999999436,2692.6,14,11,24,25
438,-30.81674999999935,2619.5,20,13,25,33
439,-33.972749999999444,1612.5625,9,8,28,17
440,-48.99599999999964,2709.7894736842104,15,19,19,34
441,-48.87375000000012,1625.4375,12,14,21,26
442,-46.724249999998975,2740.684210526316,17,12,26,29
443,-39.44924999999973,2473.1111111111113,20,9,38,29
444,-35.30624999999911,3107.4210526315787,21,8,25,29
445,-34.02824999999994,2139.777777777778,13,4,36,17
446,-32.954749999999315,1778.2941176470588,14,8,40,22
447,-21.086749999998688,1539.235294117647,17,11,25,28
448,-50.88775000000009,2510.9473684210525,15,12,37,27
449,-18.819749999999296,2139.375,41,9,25,50
450,-33.631999999999756,2066.6111111111113,9,9,22,18
451,-26.31124999999894,3410.1,22,9,24,31
452,-27.470999999999652,2521.0,11,7,32,18
453,-29.375249999998175,4879.1,43,13,22,56
454,-28.96924999999929,2536.6111111111113,20,3,27,23
455,-41.565749999998566,1764.375,20,14,27,34
456,-34.805499999998666,2866.5,21,7,31,28
457,-48.45099999999983,2936.9444444444443,23,15,32,38
458,-41.5117499999988,3446.5,19,12,25,31
459,-47.65224999999962,2485.9473684210525,10,15,31,25
460,-41.80924999999901,2814.4444444444443,16,12,29,28
461,-47.31974999999919,2426.235294117647,18,14,23,32
462,-20.538999999998587,2791.25,50,13,23,63
463,-31.676999999999516,3410.8,17,11,22,28
464,-34.69824999999852,2971.315789473684,20,7,29,27
465,-30.26749999999988,2113.3888888888887,13,8,25,21
466,-40.02824999999942,2094.9473684210525,10,12,20,22
467,-26.638499999999407,2467.3529411764707,22,7,32,29
468,-32.887749999999855,1523.25,5,6,28,11
469,-35.195499999999285,2903.6315789473683,17,12,30,29
470,-18.786499999998817,3763.222222222222,26,4,33,30
471,-41.01724999999951,1778.2941176470588,9,12,32,21
472,-26.200249999999038,2247.5,13,15,21,28
473,-25.0794999999999,3225.157894736842,32,12,31,44
474,-1.3359999999984775,5296.315789473684,56,9,32,65
475,-37.665499999997344,2661.0,33,5,40,38
476,-31.559500000000554,1741.5,30,22,21,52
477,-23.530249999999064,1724.1176470588234,23,5,22,28
478,-4.560749999998911,2973.222222222222,36,8,32,44
479,-30.561749999999524,1889.4117647058824,21,12,27,33
480,-23.15624999999836,2550.2105263157896,27,4,29,31
481,-26.84299999999962,2959.5789473684213,26,11,28,37
482,-37.27574999999939,1556.0588235294117,9,12,24,21
483,-29.454250000000123,2433.315789473684,24,11,25,35
484,-29.848749999999455,1940.5555555555557,5,16,24,21
485,-24.379749999999643,3040.1,14,9,27,23
486,-22.779249999998562,3869.3684210526317,35,15,27,50
487,-32.808999999999024,3477.5263157894738,23,18,23,41
488,-37.41399999999866,2302.1052631578946,14,9,29,23
489,-48.370500000000185,2579.8888888888887,26,11,39,37
490,-37.335249999999874,2863.4736842105262,16,10,20,26
491,-42.200250000000025,1429.0,3,14,23,17
492,-43.40974999999874,2926.9473684210525,18,13,20,31
493,-22.133749999998194,2934.294117647059,36,12,23,48
494,-39.00799999999938,2049.7894736842104,9,12,25,21
495,-41.47274999999955,2211.0526315789475,7,13,23,20
496,-39.8800000000001,2510.157894736842,23,13,29,36
497,-27.486999999998194,3163.6111111111113,32,6,34,38
498,-34.082999999998776,2805.842105263158,21,8,24,29
499,-12.11824999999978,2621.157894736842,27,8,23,35
500,-49.4414999999996,1596.5555555555557,3,12,23,15
501,-28.282749999999957,2260.2631578947367,14,7,29,21
502,-23.97474999999863,3755.7368421052633,35,5,26,40
503,-34.69774999999943,3042.2631578947367,12,12,52,24
504,-32.1959999999989,2689.529411764706,27,15,30,42
505,-25.41100000000022,3320.4210526315787,33,27,24,60
506,-22.998749999999248,1800.125,22,15,26,37
507,-25.42199999999871,2499.9411764705883,32,20,20,52
508,-23.234499999999564,2925.5,29,5,30,34
509,-44.147249999999694,2640.722222222222,22,11,25,33
510,-31.725249999999136,2735.1666666666665,20,13,18,33
511,-33.406000000000084,1922.0,10,15,20,25
512,-14.7094999999991,2569.277777777778,25,9,23,34
513,-40.441999999999986,1429.0,6,12,36,18
514,-30.614749999999344,2875.1,12,9,26,21
515,-19.865749999998908,4237.05,27,8,25,35
516,-37.79399999999934,2647.722222222222,26,14,31,40
517,-24.288249999997774,3771.6315789473683,38,11,28,49
518,-23.4142500000002,2202.1176470588234,26,14,28,40
519,-29.288249999999056,2654.0588235294117,20,7,31,27
520,-35.56349999999962,2831.7368421052633,19,16,24,35
521,-37.732749999998475,3299.0,31,11,23,42
522,-16.370249999999714,3526.842105263158,27,13,24,40
523,-36.23824999999931,3289.35,20,4,27,24
524,-24.391749999999018,2363.6470588235293,20,8,25,28
525,-17.06049999999972,2489.0,26,7,27,33
526,-38.34675000000054,1759.375,31,15,37,46
527,-21.1544999999998,3425.7368421052633,32,12,34,44
528,-40.80649999999949,4595.7,24,15,25,39
529,-51.609249999999896,1660.0555555555557,1,13,18,14
530,1.0790000000022402,3625.4736842105262,38,5,32,43
531,-40.96824999999953,1908.0,25,23,21,48
532,-22.616749999998373,5631.55,43,12,30,55
533,-26.042749999999238,2226.277777777778,16,13,24,29
534,-32.81149999999927,4398.15,27,25,13,52
535,-39.54000000000025,1429.0,2,4,34,6
536,-32.72024999999956,2520.777777777778,22,14,32,36
537,-30.408250000000017,2884.4210526315787,22,9,25,31
538,-16.303999999999387,2129.1666666666665,15,14,20,29
539,-27.933499999999007,2488.8823529411766,20,5,31,25
540,-38.047750000000676,3246.5555555555557,45,23,29,68
541,-43.40549999999867,2675.85,16,11,27,27
542,-22.24524999999769,3092.3333333333335,42,10,30,52
543,-28.587749999999573,2103.6875,24,7,34,31
544,-1.93049999999842,3425.3529411764707,42,8,26,50
545,-38.829999999999174,2222.722222222222,15,8,28,23
546,-37.427999999999294,2727.0555555555557,20,9,23,29
547,-24.17999999999858,2670.823529411765,30,11,25,41
548,-28.284749999999,4090.9,35,15,22,50
549,-40.74974999999965,3469.1052631578946,29,22,16,51
550,-37.29974999999838,3885.157894736842,35,15,27,50
551,-36.02349999999949,2481.1111111111113,23,9,22,32
552,-34.72724999999873,1984.6470588235295,14,9,28,23
553,-35.517499999999494,4028.35,29,10,25,39
554,-13.176749999999313,2610.1176470588234,37,6,33,43
555,-15.537249999998547,3160.1666666666665,30,8,25,38
556,-39.82549999999837,1621.5,21,12,20,33
557,-33.845499999999575,2889.3888888888887,19,20,27,39
558,-44.65050000000041,1429.0,11,21,20,32
559,-37.022499999999,3544.2,19,16,24,35
560,-6.068499999997941,2153.375,40,0,29,40
561,-28.504749999998648,2855.8947368421054,29,14,15,43
562,-49.69449999999963,2166.7368421052633,2,12,26,14
563,-35.00549999999909,3064.842105263158,29,14,17,43
564,-18.257749999998808,2918.684210526316,22,7,23,29
565,-34.73074999999962,1862.2941176470588,18,13,28,31
566,-53.83999999999968,2084.222222222222,13,14,23,27
567,-20.99174999999756,2068.9375,38,10,23,48
568,-23.726999999999922,2965.1666666666665,32,6,31,38
569,-13.049749999998445,3020.777777777778,41,11,29,52
570,-29.056999999999373,2223.6470588235293,27,13,29,40
571,-31.045750000000243,2003.2941176470588,30,17,21,47
572,-24.682249999999023,3666.315789473684,29,9,25,38
573,-12.10424999999859,3455.8947368421054,45,16,28,61
574,-26.03899999999888,2181.705882352941,23,12,26,35
575,-28.113249999998665,2819.722222222222,22,8,33,30
576,-25.20099999999815,2549.0555555555557,32,6,24,38
577,-29.585749999998363,3597.35,34,12,22,46
578,-18.055999999999557,2344.3333333333335,28,7,36,35
579,-12.655749999998296,5555.3,44,7,30,51
580,-36.47249999999949,2249.5263157894738,9,9,23,18
581,-17.748499999999684,3362.2105263157896,32,23,20,55
582,-35.58974999999925,3421.95,19,12,22,31
583,-31.952999999999275,2596.157894736842,12,16,25,28
584,-32.72474999999902,2237.6111111111113,19,9,23,28
585,-40.03799999999892,3376.75,19,12,27,31
586,-35.80774999999984,2317.8888888888887,21,5,46,26
587,-24.69024999999921,2621.4117647058824,17,15,22,32
588,-20.223499999997458,3475.777777777778,37,16,22,53
589,-18.26599999999888,5164.0,41,7,29,48
590,-39.17800000000043,1429.0,13,8,25,21
591,-24.058749999999524,3177.5789473684213,34,15,23,49
592,-10.184999999999032,2228.294117647059,21,0,39,21
593,-34.89474999999875,1969.8125,29,12,19,41
594,-2.600999999997358,4407.421052631579,50,8,29,58
595,-28.449749999999444,2117.235294117647,17,17,15,34
596,-37.55874999999946,3290.6111111111113,30,14,30,44
597,-26.039999999999146,2943.3,24,14,15,38
598,-32.25299999999934,1639.375,10,4,32,14
599,-25.621749999999757,2441.4444444444443,25,14,29,39
600,-21.699749999998673,2085.470588235294,27,11,25,38
601,-30.373249999999665,2630.8823529411766,37,21,21,58
602,-26.382749999999152,1429.0,10,11,29,21
603,-23.580999999997893,4188.526315789473,43,14,24,57
604,-18.352249999999035,3944.6315789473683,44,9,16,53
605,-43.71074999999979,2147.722222222222,19,15,23,34
606,-29.050749999999788,1761.4117647058824,23,5,33,28
607,-41.79024999999988,3295.0,13,16,18,29
608,-6.580249999998425,3544.5555555555557,45,9,28,54
609,-21.909249999999176,3147.5263157894738,24,13,19,37
610,-27.10774999999908,2181.8947368421054,15,7,28,22
611,-26.27049999999876,2652.2105263157896,26,13,17,39
612,-36.76424999999915,2656.85,17,8,23,25
613,-33.85749999999953,2548.1666666666665,26,8,32,34
614,-37.883499999999245,2786.2,15,9,28,24
615,-17.190499999998487,3337.3888888888887,31,17,25,48
616,-28.200750000000948,2445.823529411765,44,17,32,61
617,-25.42649999999943,3077.4210526315787,24,17,30,41
618,-45.31699999999936,3292.0,20,17,23,37
619,-42.7674999999992,1541.125,13,16,15,29
620,-38.17999999999943,2337.15,9,12,24,21
621,-11.059999999999576,1523.3125,27,17,26,44
622,-24.692999999998136,1614.8823529411766,24,10,28,34
623,-12.24824999999821,3489.0555555555557,48,13,26,61
624,-5.9457499999980525,2619.529411764706,45,11,24,56
625,-38.31749999999914,3127.5,19,21,13,40
626,-30.039249999999328,3554.3684210526317,28,20,24,48
627,-32.70999999999904,3206.85,21,9,24,30
628,-21.3084999999973,3986.315789473684,45,8,27,53
629,-36.09024999999916,3130.0,24,9,23,33
630,-28.549250000000217,1679.4444444444443,18,14,19,32
631,-7.584999999998478,2430.0,37,7,22,44
632,-31.426999999998806,2625.4210526315787,15,12,25,27
633,-13.305249999998782,4108.45,28,10,21,38
634,-27.750499999999384,3677.157894736842,41,24,17,65
635,3.129750000001964,2474.75,41,3,28,44
636,-34.19524999999935,3139.8333333333335,29,13,25,42
637,-29.21149999999998,2012.8333333333333,20,15,13,35
638,-17.453499999997852,2455.176470588235,33,9,27,42
639,-22.779000000000245,2921.1666666666665,47,17,23,64
640,-21.82524999999984,2929.1666666666665,32,19,30,51
641,-24.404249999998676,3384.0,36,10,20,46
642,-23.352749999999542,2157.25,30,12,19,42
643,-39.490749999999736,2328.0526315789475,22,11,22,33
644,-30.77899999999978,2247.842105263158,11,26,10,37
645,-20.657249999997198,2413.235294117647,44,12,25,56
646,-35.141249999999175,4278.25,24,21,18,45
647,-30.742499999998813,3401.25,31,10,23,41
648,-38.757249999999125,1900.5882352941176,13,13,21,26
649,-11.460999999998943,1697.9375,25,14,21,39
650,-22.145749999999715,2932.7368421052633,27,16,29,43
651,-36.20349999999895,1769.3125,20,5,23,25
652,-36.223749999999896,2476.6111111111113,32,13,23,45
653,-42.01899999999962,1567.9375,7,18,20,25
654,-26.397499999999404,2553.5263157894738,20,13,15,33
655,-33.420499999999485,2964.8,17,10,25,27
656,-13.45199999999933,3455.7894736842104,36,13,22,49
657,-30.069749999999022,1429.0,16,9,30,25
658,-42.583249999999154,2829.95,18,12,19,30
659,-20.2339999999991,2727.1666666666665,27,12,34,39
660,-40.91824999999973,2298.5555555555557,23,18,18,41
661,-50.471500000000034,1429.0,2,15,9,17
662,-27.576749999998157,1917.4117647058824,27,10,27,37
663,-32.688999999999524,3187.5,29,12,27,41
664,-29.4937499999994,2666.315789473684,14,14,22,28
665,-40.58175000000029,2554.3684210526317,27,17,24,44
666,-9.433499999999928,3102.3684210526317,47,7,31,54
667,-26.10049999999844,3188.3684210526317,29,13,25,42
668,-35.978249999998894,2788.8888888888887,25,10,26,35
669,-27.985249999999393,2127.4736842105262,18,7,22,25
670,-26.75399999999969,1706.875,21,12,15,33
671,-38.32874999999946,1603.625,12,12,22,24
672,-21.420249999999253,4387.315789473684,39,18,18,57
673,-23.37674999999907,2520.8333333333335,26,14,16,40
674,-17.351499999999405,2465.222222222222,30,13,25,43
675,-22.60999999999899,3094.0526315789475,30,25,18,55
676,-30.625499999999384,2187.0,11,21,12,32
677,-40.99999999999973,1703.2777777777778,2,12,24,14
678,-17.22224999999883,1626.5,19,15,18,34
679,-32.91099999999867,1617.5625,27,9,16,36
680,-24.38624999999951,2914.5263157894738,23,18,15,41
681,-40.256999999998996,3502.95,27,21,17,48
682,-22.027250000000173,3113.2631578947367,29,12,27,41
683,-34.30549999999943,2310.9444444444443,25,8,22,33
684,-31.463999999999224,3281.45,28,12,16,40
685,-37.550499999998266,3817.4736842105262,32,22,22,54
686,-28.08974999999839,2433.764705882353,29,16,15,45
687,-21.182749999999814,2487.823529411765,29,14,21,43
688,-36.096749999998025,2185.1052631578946,22,15,23,37
689,-22.18999999999793,1903.25,32,12,29,44
690,-24.921499999998822,2440.7894736842104,23,17,15,40
691,-37.27824999999923,1635.4375,11,15,15,26
692,-27.247499999998904,3718.7,32,14,19,46
693,-38.05124999999994,2322.3333333333335,23,10,28,33
694,-49.949749999999305,2475.15,18,14,19,32
695,-13.271999999999272,3024.222222222222,37,7,32,44
696,-31.597499999999492,1550.0625,9,5,35,14
697,-44.80624999999924,3561.0526315789475,32,17,17,49
698,-39.085750000000004,2333.8888888888887,14,8,29,22
699,-6.938749999999887,2576.3333333333335,36,8,38,44
700,0.8395000000010221,2271.277777777778,29,16,17,45
701,-32.448749999999215,2669.0,30,6,14,36
702,-24.361499999998717,2546.125,30,9,26,39
703,-24.02474999999945,2729.8,19,13,12,32
704,-18.555499999999036,3470.4,28,13,17,41
705,-31.75599999999963,2425.7894736842104,19,10,20,29
706,-27.390249999998492,3794.2105263157896,40,13,23,53
707,-26.215749999998696,1710.75,25,15,27,40
708,-25.949499999999,3123.1111111111113,29,14,17,43
709,-29.27249999999821,3023.8947368421054,29,9,21,38
710,-23.445749999999645,2108.1666666666665,24,19,20,43
711,-35.56324999999957,2158.35,11,18,10,29
712,-16.138999999999278,4067.2631578947367,39,18,21,57
713,-14.388749999999096,3776.75,35,15,13,50
714,-24.34874999999931,3119.6,24,14,18,38
715,-21.551999999998856,3535.4,27,7,36,34
716,-42.772499999999624,2976.2631578947367,19,17,33,36
717,-27.824249999999275,1755.375,17,16,19,33
718,-18.227000000000004,3657.2105263157896,48,17,24,65
719,-39.837750000000185,1695.388888888889,8,13,19,21
720,-34.096749999999034,1894.375,19,11,25,30
721,-15.152749999999951,2282.6666666666665,32,20,13,52
722,-20.49949999999902,2211.470588235294,23,13,17,36
723,-26.937999999999157,3099.0526315789475,35,20,18,55
724,-19.832749999999386,2349.705882352941,34,12,19,46
725,-20.085999999998446,3304.6315789473683,31,17,15,48
726,-12.900999999999737,2866.0,53,20,20,73
727,-32.40650000000003,2218.5789473684213,20,13,18,33
728,-16.43049999999934,3198.0555555555557,26,6,27,32
729,-40.14375000000015,1652.25,18,5,33,23
730,-22.413499999999665,2274.0588235294117,35,13,16,48
731,-29.496499999998484,1867.0,23,11,24,34
732,-27.8519999999995,2760.7368421052633,33,7,23,40
733,-36.499499999998854,2207.722222222222,16,11,22,27
734,-25.578750000000095,1744.7058823529412,29,22,21,51
735,-45.35200000000016,1496.5,4,3,33,7
736,-12.142249999998441,3551.35,34,15,16,49
737,-30.74624999999951,2672.705882352941,30,8,31,38
738,-14.523249999997692,4917.25,43,10,28,53
739,-28.846249999999877,3443.35,17,15,20,32
740,-34.90750000000008,1983.7058823529412,35,10,23,45
741,-38.63149999999847,2215.294117647059,31,12,27,43
742,-19.204499999997743,2085.529411764706,36,8,25,44
743,-30.89399999999849,2264.375,46,20,22,66
744,-33.08449999999928,1583.8125,8,11,24,19
745,-10.705249999999674,2490.764705882353,40,19,17,59
746,-7.64174999999859,4118.75,44,21,11,65
747,-41.563249999999485,1429.0,7,16,17,23
748,-28.156999999999453,3185.9473684210525,24,15,16,39
749,-29.348000000000138,2095.722222222222,20,9,38,29
750,-28.529999999999568,2556.1111111111113,23,15,24,38
751,-22.344250000000265,2470.7894736842104,30,12,21,42
752,-9.13049999999749,2438.470588235294,41,10,22,51
753,-33.621750000000084,3265.6,21,13,20,34
754,-27.681249999999814,2405.684210526316,21,17,4,38
755,-25.253500000000134,2063.8888888888887,29,13,19,42
756,-7.778999999999042,3932.0526315789475,39,13,26,52
757,-25.71849999999979,2251.0,21,7,23,28
758,-16.041499999998926,2183.9444444444443,22,5,30,27
759,-48.349749999999986,1429.0,0,7,22,7
760,-37.94574999999941,2437.9444444444443,12,13,25,25
761,-26.155749999999536,2336.6470588235293,28,19,12,47
762,-23.92599999999893,3524.315789473684,30,14,20,44
763,-27.074749999998897,3364.7894736842104,33,7,24,40
764,-29.513749999999483,1429.0,13,22,19,35
765,-35.146749999998704,2417.6666666666665,38,12,22,50
766,-51.145750000000476,1608.0555555555557,0,10,38,10
767,-20.166749999998085,2206.8125,28,19,20,47
768,-21.2877499999983,2766.176470588235,30,19,18,49
769,-35.23749999999974,3005.95,13,12,19,25
770,-38.43549999999952,2072.3529411764707,12,18,15,30
771,-31.03550000000027,1429.0,14,15,25,29
772,-21.677499999999696,2104.9473684210525,15,16,15,31
773,-26.562749999998836,2531.3333333333335,23,8,29,31
774,-23.40875000000037,2444.8888888888887,36,16,27,52
775,-4.461249999998445,2922.0555555555557,34,16,19,50
776,-23.542249999999846,2173.5263157894738,12,12,17,24
777,-23.491249999998548,3175.9,36,13,13,49
778,-30.3829999999993,3194.15,25,15,10,40
779,-32.68700000000015,2365.5555555555557,26,11,23,37
780,-41.14499999999965,2121.6315789473683,8,13,20,21
781,-12.517749999999719,3033.0526315789475,48,10,21,58
782,-11.034999999999721,2425.3529411764707,27,11,27,38
783,-28.222249999999303,2844.3888888888887,20,10,29,30
784,-41.803250000000354,1500.4375,15,22,16,37
785,-36.230749999999816,2222.684210526316,14,10,19,24
786,-29.918999999999606,2900.2105263157896,33,7,28,40
787,-36.86374999999956,1514.375,8,9,28,17
788,-18.495249999998457,4575.1,42,10,19,52
789,-22.94099999999967,2162.6315789473683,21,10,22,31
790,-18.124999999998785,2862.3529411764707,44,16,26,60
791,-30.76374999999942,2417.6111111111113,24,16,30,40
792,-32.86624999999951,2300.45,14,17,13,31
793,-34.21049999999907,2273.1176470588234,28,6,26,34
794,-24.47224999999876,2422.0,20,12,24,32
795,-42.028249999999375,2055.5882352941176,20,24,24,44
796,-16.999249999999762,2627.1176470588234,32,7,27,39
797,-42.30399999999976,1652.1764705882354,8,14,19,22
798,-30.841999999999548,2899.3684210526317,21,22,18,43
799,-22.29924999999924,3076.277777777778,37,11,24,48
800,-14.30949999999994,3508.4210526315787,30,7,28,37
801,-23.079999999999455,2861.8947368421054,48,13,28,61
802,-26.751249999999516,2076.5263157894738,13,11,24,24
803,-23.80049999999895,3585.2631578947367,33,13,17,46
804,-33.79174999999907,1805.9375,26,20,12,46
805,-42.61499999999952,1707.2941176470588,5,20,21,25
806,-8.830249999998992,3560.4444444444443,47,8,19,55
807,-22.1859999999994,2401.777777777778,24,14,24,38
808,2.5810000000016693,2820.4117647058824,46,12,20,58
809,-12.388999999999102,2508.55,25,8,21,33
810,-12.195249999999152,3128.4,27,12,22,39
811,-16.309749999998978,3099.1052631578946,24,13,22,37
812,-2.9174999999994204,3425.6111111111113,41,7,33,48
813,-18.997499999998936,3061.55,25,9,22,34
814,-35.53824999999977,1921.9444444444443,12,10,21,22
815,-32.86724999999955,3250.45,26,12,20,38
816,-28.055999999999536,3864.8,31,8,23,39
817,-26.35099999999996,1761.4705882352941,21,15,15,36
818,-17.25449999999919,2610.235294117647,39,9,15,48
819,-27.759749999999446,1937.8823529411766,41,11,26,52
820,-24.421999999998814,2975.4210526315787,27,10,19,37
821,-27.300499999999943,1854.111111111111,28,6,24,34
822,-17.99324999999868,2858.4444444444443,35,15,25,50
823,-28.87449999999989,2469.9473684210525,19,13,24,32
824,-4.106249999999106,3350.4736842105262,56,7,28,63
825,-6.155499999999923,2251.0,44,10,22,54
826,4.489500000001184,3377.9444444444443,49,13,22,62
827,-4.111249999998792,2717.6470588235293,40,10,23,50
828,-13.918999999999901,2161.1875,32,15,21,47
829,-34.53899999999988,3103.6666666666665,32,20,18,52
830,-24.57574999999877,2088.722222222222,21,17,18,38
831,-9.244749999999534,2779.157894736842,41,10,18,51
832,-33.41699999999954,2064.0,13,20,22,33
833,-1.5762499999981008,5001.4,50,17,11,67
834,-11.239499999999028,3359.3333333333335,35,5,19,40
835,-9.729999999998226,2131.8333333333335,26,12,27,38
836,-23.542749999999575,2147.722222222222,16,18,17,34
837,-27.45299999999882,3769.9473684210525,31,6,29,37
838,-44.21299999999907,1608.625,13,7,30,20
839,-25.60299999999924,2802.1111111111113,26,8,29,34
840,-62.63824999999984,2437.0,17,16,28,33
841,-21.805499999999082,2596.5555555555557,25,18,20,43
842,-30.665499999999405,1537.1875,11,9,21,20
843,-17.495749999999052,2564.05,20,19,14,39
844,-36.14349999999959,1965.1666666666667,13,2,34,15
845,-20.076499999998816,3223.6666666666665,30,8,22,38
846,-42.02475000000029,1790.4117647058824,16,19,18,35
847,-25.786749999999643,3041.8333333333335,41,8,22,49
848,-3.286249999999979,2576.0526315789475,31,16,18,47
849,-17.184250000000095,2545.9411764705883,37,21,18,58
850,-29.32924999999903,3041.05,24,17,14,41
851,-6.493999999999299,2489.0555555555557,36,15,28,51
852,-13.575999999999024,2830.277777777778,48,8,27,56
853,-31.34174999999923,2908.4,25,5,22,30
854,4.829750000000771,2192.9375,54,14,23,68
855,-29.780999999999324,2099.157894736842,20,10,15,30
856,-12.288499999998965,2685.8823529411766,41,15,23,56
857,-26.780249999999093,2345.0,19,12,19,31
858,-25.24149999999876,3636.2,36,7,20,43
859,-23.20875000000014,2370.0555555555557,33,14,25,47
860,1.9137500000018193,2809.0,46,9,29,55
861,-27.678249999998872,2654.1875,34,14,18,48
862,-44.60174999999943,1893.7777777777778,9,23,14,32
863,-12.429499999998873,2389.4444444444443,31,15,15,46
864,-51.36349999999957,1429.0,4,16,18,20
865,2.1247500000006396,4515.9473684210525,53,16,23,69
866,-9.580249999999722,2874.4117647058824,49,16,23,65
867,-36.64574999999907,1429.0,13,14,24,27
868,-21.12299999999724,3662.9473684210525,45,15,19,60
869,-12.932749999999709,2923.8333333333335,33,23,13,56
870,-17.500499999998347,1429.0,11,13,39,24
871,-44.88824999999933,3141.75,16,15,21,31
872,-22.538499999999292,2223.6470588235293,31,12,21,43
873,-21.241999999998615,1996.7058823529412,32,12,20,44
874,-19.07649999999873,3470.8947368421054,44,8,17,52
875,-16.83549999999894,4013.2,41,11,16,52
876,-38.82399999999937,2854.315789473684,14,21,23,35
877,-31.907499999999413,3116.5789473684213,29,15,26,44
878,-20.30900000000028,2774.722222222222,33,8,31,41
879,-24.62724999999902,3152.1666666666665,31,10,20,41
880,-16.885499999998057,2303.9411764705883,31,14,25,45
881,-16.118749999999856,3263.6315789473683,28,14,21,42
882,-25.654499999998684,4522.7,34,18,24,52
883,-19.655000000000072,2508.4444444444443,30,15,20,45
884,-20.402249999998244,4958.5,39,1,29,40
885,-33.866749999999946,2643.277777777778,37,17,22,54
886,-14.235999999998194,1858.625,31,10,25,41
887,-19.099249999999422,2418.8823529411766,37,13,18,50
888,-34.07299999999967,1662.125,20,12,17,32
889,-23.63374999999972,3175.9473684210525,30,6,20,36
890,-10.61474999999681,1965.875,50,15,25,65
891,-22.248249999999537,2215.294117647059,19,10,21,29
892,-22.462749999999907,1988.3529411764705,24,18,15,42
893,-30.09874999999898,3980.65,37,18,12,55
894,-37.029500000000596,1429.0,21,17,22,38
895,-7.812999999998633,2143.4117647058824,36,8,23,44
896,-24.860249999996988,3477.6111111111113,41,12,21,53
897,-8.920249999999825,2503.705882352941,40,12,16,52
898,-10.123499999998653,3287.85,36,13,17,49
899,-36.763499999999794,1496.5,6,19,29,25
900,-24.614499999998365,1687.2666666666667,26,14,22,40
901,-39.90549999999942,2450.529411764706,23,19,18,42
902,-22.22074999999871,3591.7,39,17,12,56
903,5.2087500000018405,4629.1,51,11,20,62
904,-18.860249999998988,3261.1052631578946,28,11,21,39
905,-15.227749999999073,2342.6111111111113,26,15,19,41
906,-19.660249999999312,3059.842105263158,26,23,15,49
907,-17.530249999998883,2726.4210526315787,21,12,23,33
908,-7.34074999999919,2695.4444444444443,30,13,22,43
909,-26.41524999999941,2682.2105263157896,23,11,21,34
910,-23.167499999999116,3072.315789473684,24,25,11,49
911,-25.681249999999494,1496.5,17,5,30,22
912,-18.39674999999896,3222.7368421052633,34,9,23,43
913,-58.458999999999605,1993.1176470588234,5,11,22,16
914,-28.517249999999752,1669.0588235294117,25,9,25,34
915,-21.55474999999886,2552.5,29,13,22,42
916,-29.64099999999889,2199.8888888888887,20,10,23,30
917,-29.390749999999777,2564.3684210526317,20,8,19,28
918,-14.033499999999867,4167.631578947368,31,17,27,48
919,-21.941999999999723,2815.705882352941,32,19,18,51
920,-17.65774999999976,2909.6111111111113,40,14,16,54
921,-26.88174999999968,3725.1,24,18,14,42
922,-43.69499999999901,2076.277777777778,11,9,34,20
923,-15.016499999998937,3582.842105263158,59,9,24,68
924,-37.15624999999905,1644.2222222222222,13,15,23,28
925,-43.330249999998884,3803.65,29,12,22,41
926,-37.81099999999947,2324.5882352941176,30,14,23,44
927,-47.67624999999904,2076.3333333333335,12,22,15,34
928,-7.036499999998862,4508.368421052632,46,19,23,65
929,-49.7907500000002,1429.0,9,17,27,26
930,-11.40349999999862,2013.375,24,13,25,37
931,-20.53400000000051,1777.25,30,11,25,41
932,-42.490749999999096,2122.7,13,7,25,20
933,-32.23124999999935,2161.1176470588234,19,12,22,31
934,-14.337499999997835,4420.35,46,13,17,59
935,-44.28324999999967,1675.9444444444443,0,20,17,20
936,-21.576999999999465,1821.875,25,15,13,40
937,-18.621749999999064,4636.95,35,15,19,50
938,-26.602749999998867,2715.6315789473683,24,20,21,44
939,-23.213249999999444,2274.722222222222,19,15,19,34
940,-35.92949999999915,2911.8947368421054,31,20,22,51
941,-23.13549999999818,2575.2631578947367,27,9,22,36
942,-22.199499999999322,2511.0,20,8,24,28
943,-15.998249999999492,2774.722222222222,28,15,18,43
944,-35.60549999999963,2250.9444444444443,20,6,26,26
945,-18.444499999998946,2747.4444444444443,28,14,19,42
946,-18.1462499999991,2039.7058823529412,25,12,22,37
947,-18.62324999999878,2929.4736842105262,36,2,57,38
948,-27.563500000000317,2667.222222222222,38,20,19,58
949,-50.84800000000005,1429.0,1,15,17,16
950,-33.40574999999946,2340.1,10,5,29,15
951,-17.46374999999957,2336.705882352941,36,18,12,54
952,-16.995749999999724,1778.2941176470588,22,12,21,34
953,-31.15074999999974,1668.9411764705883,15,15,14,30
954,4.489500000002811,2480.470588235294,57,10,21,67
955,-21.611999999997785,2370.235294117647,42,16,25,58
956,-3.188499999998668,3963.2,35,11,28,46
957,-12.722249999998988,3365.6,27,13,15,40
958,-28.16299999999905,1630.4375,28,25,18,53
959,-31.289749999999987,2553.3333333333335,19,11,31,30
960,-5.603999999998527,4629.95,43,16,20,59
961,-18.634749999999578,2501.823529411765,28,9,23,37
962,8.863500000002812,2746.625,60,11,43,71
963,-33.192249999999625,1757.7058823529412,8,10,22,18
964,-7.541749999999004,3784.157894736842,54,20,23,74
965,-11.263499999999055,3237.75,31,11,16,42
966,-26.40849999999939,2790.2,22,15,18,37
967,-12.848999999999696,3147.5263157894738,33,18,17,51
968,-13.520749999998936,3448.2631578947367,45,17,18,62
969,-46.57549999999985,2638.6,14,9,23,23
970,-34.089499999999376,2766.777777777778,27,15,19,42
971,-13.020749999999472,2206.823529411765,42,21,13,63
972,-32.276499999999395,1688.0,27,17,21,44
973,-41.34024999999961,1429.0,6,22,10,28
974,-53.18899999999978,1429.0,0,10,27,10
975,-9.778249999999485,2693.6111111111113,44,20,11,64
976,-27.708249999999197,2550.2105263157896,23,16,14,39
977,-24.37824999999774,1956.8125,31,7,32,38
978,-7.169499999998651,3823.315789473684,48,12,20,60
979,-29.54974999999976,2960.777777777778,40,13,27,53
980,-20.494499999999782,1612.5625,21,7,23,28
981,-33.22150000000036,1505.4375,32,7,29,39
982,-32.50024999999944,2072.2631578947367,13,8,26,21
983,-11.174499999999377,2981.823529411765,39,13,14,52
984,-14.583499999999171,2585.0,37,10,21,47
985,-33.30524999999788,2090.5555555555557,12,5,49,17
986,-30.90675000000014,1496.5,24,12,24,36
987,-17.748499999998995,3036.5555555555557,32,23,14,55
988,-21.06749999999859,3168.8,26,13,20,39
989,-29.464999999998913,2139.6470588235293,24,12,19,36
990,-22.477249999998786,3862.4,32,11,30,43
991,-9.555999999998896,3131.9444444444443,43,11,34,54
992,-7.842999999999202,3169.2631578947367,37,10,12,47
993,-33.31074999999944,2264.4736842105262,13,8,22,21
994,-26.18250000000004,2126.5882352941176,24,19,17,43
995,-40.47249999999826,2715.705882352941,29,15,27,44
996,-14.875249999998502,4252.15,42,6,20,48
997,-5.4110000000001275,2218.9411764705883,31,9,40,40
998,-28.492249999999807,2050.0625,34,5,41,39
999,-36.68149999999978,1702.6470588235295,26,13,30,39
1000,-9.991499999999325,2782.722222222222,47,15,21,62
1001,-20.315999999999047,2576.5882352941176,52,17,37,69
1002,-32.645999999999574,2771.6315789473683,24,11,25,35
1003,-33.32624999999904,2492.470588235294,29,13,22,42
1004,-26.94649999999934,3101.3,22,9,23,31
1005,-24.88999999999883,4537.8,29,10,24,39
1006,-36.33899999999956,2825.8947368421054,25,20,24,45
1007,-24.995749999999155,2598.684210526316,22,12,25,34
1008,-6.252499999998051,2620.3888888888887,37,11,18,48
1009,-44.49974999999967,2060.4444444444443,15,14,19,29
1010,-33.603749999998925,2806.4444444444443,41,12,31,53
1011,-33.21024999999985,3200.2105263157896,33,11,28,44
1012,-9.796249999999585,2929.5882352941176,38,19,13,57
1013,-35.84249999999958,1666.1875,13,11,22,24
1014,-26.697499999999906,2131.8333333333335,17,10,32,27
1015,-43.62674999999963,2562.4,11,22,14,33
1016,-27.845250000000476,1696.875,24,17,22,41
1017,-6.656749999998911,3771.95,38,12,12,50
1018,-13.823749999998986,4038.6,35,15,22,50
1019,-11.0077499999983,2245.1176470588234,39,7,23,46
1020,-12.674249999999743,2563.0,41,10,25,51
1021,-15.224249999999808,4111.65,34,12,21,46
1022,-33.09650000000004,1429.0,16,17,24,33
1023,-27.368749999998442,2996.8888888888887,42,11,20,53
1024,-44.05449999999932,2163.6666666666665,15,13,27,28
1025,-21.489999999998016,3692.65,38,12,25,50
1026,-2.368249999998665,2698.9411764705883,40,7,14,47
1027,-13.382999999998622,2787.4736842105262,29,20,13,49
1028,-24.63825000000003,2479.470588235294,67,25,29,92
1029,-41.99099999999922,2814.157894736842,17,17,20,34
1030,-20.57974999999964,2655.6666666666665,35,17,17,52
1031,-16.03924999999815,2146.176470588235,36,8,20,44
1032,-16.124999999999726,2584.222222222222,40,8,26,48
1033,-23.208249999998316,2341.294117647059,27,17,16,44
1034,-20.861249999998844,2613.684210526316,36,5,20,41
1035,-9.472249999998741,2867.3333333333335,39,5,24,44
1036,-36.05174999999947,1429.0,8,13,29,21
1037,-39.997499999999356,2050.9411764705883,11,13,38,24
1038,-36.271999999999466,2166.0625,25,6,35,31
1039,-20.083499999998736,3104.5555555555557,28,9,21,37
1040,-20.00249999999994,2441.4444444444443,20,9,21,29
1041,-26.220999999999123,2116.8888888888887,23,11,18,34
1042,-11.629999999999939,2124.6470588235293,32,9,27,41
1043,-24.454249999999327,2668.9444444444443,39,14,27,53
1044,5.879500000001812,3805.842105263158,50,9,13,59
1045,-15.566499999999559,2254.3888888888887,15,17,29,32
1046,-12.10649999999851,2290.8823529411766,30,17,19,47
1047,-33.314499999998745,2096.6111111111113,16,14,24,30
1048,-19.101749999998624,4208.5,46,7,11,53
1049,-16.382499999998508,3354.1666666666665,48,15,11,63
1050,-36.51324999999941,4025.1,33,4,30,37
1051,-27.446749999998946,4648.15,40,12,18,52
1052,-23.305499999998652,3513.4210526315787,39,9,18,48
1053,-21.43224999999923,2550.157894736842,21,11,16,32
1054,-17.630499999999547,1862.5625,25,17,18,42
1055,-34.19949999999961,1627.0,19,13,25,32
1056,-22.369249999999912,1514.375,34,8,26,42
1057,-41.94150000000003,1984.611111111111,12,7,33,19
1058,-33.092749999999576,1728.625,22,11,21,33
1059,-37.5437499999996,1429.0,7,14,17,21
1060,-12.12774999999722,2334.764705882353,49,15,20,64
1061,-21.680249999998995,3106.05,28,17,13,45
1062,-18.963749999999592,3087.8333333333335,30,20,18,50
1063,-16.02724999999907,4124.35,38,13,20,51
1064,-31.324499999999894,2109.6470588235293,23,16,20,39
1065,-18.99274999999887,2176.777777777778,25,13,20,38
1066,-38.80399999999944,1974.4736842105262,9,8,28,17
1067,-7.253999999999235,3706.8888888888887,67,14,23,81
1068,-22.780999999999025,3187.5555555555557,39,10,27,49
1069,-27.244999999999102,3196.6,29,12,17,41
1070,-26.542499999999997,2302.1111111111113,27,15,23,42
1071,-1.5919999999994634,3545.157894736842,41,7,23,48
1072,1.1572500000019945,3559.4210526315787,55,12,9,67
1073,-11.383999999999777,2227.294117647059,46,14,22,60
1074,-10.678999999998782,3264.8,33,5,25,38
1075,-22.2254999999996,1576.875,18,21,17,39
1076,-37.57324999999945,1993.7894736842106,10,8,24,18
1077,-9.95524999999911,3149.157894736842,40,14,14,54
1078,-24.50999999999972,3177.6315789473683,39,16,19,55
1079,-29.01999999999874,2207.777777777778,23,15,19,38
1080,-40.410749999999794,2021.3157894736842,8,16,13,24
1081,-25.740249999998646,3568.5789473684213,35,11,24,46
1082,-16.004999999998912,2038.764705882353,32,9,23,41
1083,-26.32549999999888,3433.0,27,9,28,36
1084,-13.751249999998521,3674.35,36,8,20,44
1085,-6.033999999998352,3494.3888888888887,52,11,18,63
1086,-14.362249999999856,2281.470588235294,36,8,31,44
1087,-25.996249999999357,2976.65,28,12,17,40
1088,-30.287749999999257,2757.4210526315787,18,12,25,30
1089,-10.359749999999625,2317.1052631578946,23,8,19,31
1090,-23.35974999999836,2480.3529411764707,28,7,26,35
1091,-21.250249999998644,2169.470588235294,28,10,16,38
1092,-24.850499999999478,3087.85,25,13,18,38
1093,-11.623749999999182,3944.95,37,8,16,45
1094,-18.742999999997874,3220.1111111111113,44,12,22,56
1095,-5.889749999998946,2354.3529411764707,35,11,16,46
1096,-41.660500000000205,1429.0,7,14,30,21
1097,-14.376249999999562,3546.65,27,12,22,39
1098,-32.22924999999974,1992.0,13,18,20,31
1099,-32.01324999999926,1817.9375,27,14,22,41
1100,-39.38199999999971,1505.4375,15,19,21,34
1101,-12.5802499999993,2880.2105263157896,32,11,16,43
1102,-12.370999999999418,3844.2631578947367,35,15,20,50
1103,-22.8214999999992,2572.8333333333335,28,17,22,45
1104,-33.231499999997084,3104.5555555555557,33,6,34,39
1105,-10.454999999999805,1893.3125,46,27,17,73
1106,-24.304999999999147,3372.2105263157896,30,21,16,51
1107,-27.915249999999855,2526.7894736842104,19,10,23,29
1108,-31.540249999999503,3052.315789473684,36,6,28,42
1109,12.794750000001596,3601.8823529411766,67,8,18,75
1110,-28.71299999999885,4042.5,40,15,21,55
1111,-4.489249999999394,2361.764705882353,33,8,36,41
1112,-31.95674999999941,1913.6470588235295,20,14,16,34
1113,-38.90499999999916,2156.470588235294,23,14,27,37
1114,-39.6814999999999,3127.4444444444443,39,24,17,63
1115,-32.96549999999942,1612.5625,15,16,15,31
1116,-34.33124999999903,3282.3,24,15,15,39
1117,-7.112749999998357,2996.8888888888887,37,8,21,45
1118,-24.48949999999961,2068.9473684210525,15,8,21,23
1119,-26.763749999999817,2030.3529411764705,41,14,36,55
1120,-26.647749999999,2684.65,26,16,14,42
1121,-25.955749999999732,3064.0,26,23,19,49
1122,-9.389749999999305,3976.722222222222,51,26,18,77
1123,-13.618749999999192,2282.25,37,12,15,49
1124,-8.68049999999859,2260.5,31,18,16,49
1125,-18.9147499999989,3163.722222222222,34,16,24,50
1126,-31.50999999999966,2171.6111111111113,17,6,32,23
1127,-7.304249999997955,5465.5,53,8,17,61
1128,-16.35849999999861,2850.6666666666665,32,14,19,46
1129,-23.57424999999923,2538.5263157894738,26,14,13,40
1130,-17.150499999998516,2309.0,35,11,27,46
1131,-34.779499999998336,1657.1875,11,19,42,30
1132,-5.828999999999032,3561.2105263157896,42,5,34,47
1133,-29.218499999999466,2330.277777777778,18,6,38,24
1134,-22.99249999999866,2905.2105263157896,33,16,18,49
1135,-20.769749999999284,3194.15,20,11,24,31
1136,-0.28824999999887735,2996.9444444444443,35,17,25,52
1137,-21.314749999999137,2816.7368421052633,24,11,17,35
1138,-8.230750000000342,2345.1176470588234,42,16,29,58
1139,-28.47974999999936,1853.9411764705883,19,22,13,41
1140,-18.088999999998936,3425.7368421052633,31,12,25,43
1141,-10.677999999999194,3228.5789473684213,36,4,21,40
1142,-19.252249999999172,2952.9444444444443,40,22,15,62
1143,-22.860499999999874,2348.6875,39,21,23,60
1144,-28.985499999999526,2603.6111111111113,31,6,31,37
1145,-35.88624999999958,2945.75,14,15,21,29
1146,-24.962250000000072,2101.4117647058824,23,16,19,39
1147,-19.59699999999895,2727.1111111111113,32,10,22,42
1148,-32.79249999999941,2663.777777777778,44,9,30,53
1149,-32.02674999999984,1680.125,16,10,12,26
1150,-24.72674999999976,2328.176470588235,34,22,14,56
1151,-41.86499999999922,1567.9375,7,11,29,18
1152,-15.208249999999149,3470.842105263158,46,19,20,65
1153,-16.861499999998802,3144.15,26,11,21,37
1154,-34.799499999998716,2610.3684210526317,23,16,20,39
1155,-4.728749999998877,3418.0,36,15,21,51
1156,-26.170749999999362,1933.388888888889,9,14,26,23
1157,-38.4222499999997,1429.0,11,13,23,24
1158,-8.243999999998774,4493.368421052632,52,14,20,66
1159,-26.351000000000443,2311.4117647058824,39,22,19,61
1160,-39.76600000000026,1546.7058823529412,14,12,18,26
1161,-27.499749999999022,2175.1,18,13,21,31
1162,-18.70424999999889,3106.6315789473683,40,13,24,53
1163,-9.537999999998025,2421.6470588235293,38,6,24,44
1164,-1.9652499999984876,4735.684210526316,55,19,22,74
1165,-19.37024999999923,3092.277777777778,40,10,25,50
1166,-25.84974999999909,2843.5263157894738,30,14,23,44
1167,10.401500000003498,2961.777777777778,71,5,16,76
1168,-33.787750000000344,1592.2222222222222,11,12,28,23
1169,-9.543749999999381,2756.6315789473683,36,18,14,54
1170,-22.136499999999977,2028.6666666666667,45,13,23,58
1171,-41.849750000000085,1429.0,6,14,30,20
1172,-2.921999999998267,2521.6111111111113,39,14,16,53
1173,-13.282249999999332,3658.5,30,9,15,39
1174,-17.687749999998594,2899.1666666666665,36,13,16,49
1175,-2.26074999999893,3643.7368421052633,48,9,20,57
1176,-41.328999999999205,2166.7894736842104,10,19,22,29
1177,-26.940749999999316,1715.75,16,20,12,36
1178,-10.520499999998373,4272.7,38,8,18,46
1179,-11.343749999998414,3685.5789473684213,42,17,14,59
1180,-30.030499999999314,2258.5,16,15,19,31
1181,-20.62374999999863,2810.9444444444443,34,9,18,43
1182,-13.64924999999904,3251.1052631578946,39,10,20,49
1183,-26.30549999999992,2746.5555555555557,21,22,16,43
1184,-2.0292499999977727,2084.470588235294,42,18,17,60
1185,-14.868499999998722,1868.2,37,8,19,45
1186,5.736750000000313,2655.9411764705883,49,12,15,61
1187,-21.050750000000228,4211.0,45,15,25,60
1188,-0.7055000000000688,2529.9411764705883,38,11,18,49
1189,-10.95674999999952,2933.5,35,10,25,45
1190,-15.122749999997856,2459.8823529411766,43,14,16,57
1191,-14.916249999999351,3755.3,25,11,18,36
1192,-16.664249999999196,2448.315789473684,30,12,18,42
1193,-24.24649999999891,3809.35,39,18,11,57
1194,-19.041999999998804,2707.2631578947367,25,13,18,38
1195,-5.699249999998156,3389.8947368421054,45,8,17,53
1196,-18.094749999999504,4184.65,38,11,15,49
1197,-12.188499999998935,1612.5625,46,10,30,56
1198,-33.325249999999265,3340.3,23,11,28,34
1199,-23.34599999999879,1528.25,19,17,20,36
1200,-32.23799999999931,3365.6315789473683,31,11,36,42
1201,-21.971499999999406,2198.5882352941176,43,13,19,56
1202,-21.022249999999495,3761.65,28,17,14,45
1203,-26.094249999999562,2143.3529411764707,21,13,24,34
1204,-17.31675000000005,2718.277777777778,32,21,17,53
1205,-26.987249999997914,1619.5625,33,18,20,51
1206,-7.306250000000235,2045.0625,39,21,13,60
1207,-16.511999999999414,4268.7,34,15,17,49
1208,-32.615749999999224,2039.0,10,12,22,22
1209,-11.246499999997084,2914.1111111111113,43,11,24,54
1210,-5.26649999999878,2677.529411764706,49,10,29,59
1211,-33.29749999999815,3538.5263157894738,48,16,28,64
1212,-34.73799999999887,2565.2631578947367,19,11,25,30
1213,-17.309249999998528,4228.35,44,14,20,58
1214,-16.57724999999814,4079.95,41,10,23,51
1215,-2.436749999999589,1907.3125,43,7,34,50
1216,-16.416749999999844,2647.777777777778,26,17,14,43
1217,-12.444499999998605,2598.0588235294117,29,6,43,35
1218,-51.94600000000023,2143.3333333333335,17,27,17,44
1219,-30.706500000000148,2196.0,17,16,24,33
1220,-19.08274999999943,4924.25,57,10,25,67
1221,-41.066999999999865,2363.0526315789475,12,13,16,25
1222,-22.254499999999346,2565.6,24,10,14,34
1223,-24.46949999999935,3079.8947368421054,38,12,17,50
1224,-17.789000000000254,2719.7368421052633,28,12,20,40
1225,-3.9724999999984356,2845.5882352941176,47,13,25,60
1226,-17.383749999999814,2794.157894736842,27,18,15,45
1227,9.86875000000133,4218.526315789473,52,10,20,62
1228,-36.08249999999911,1590.75,18,18,19,36
1229,-36.086499999998324,1528.25,19,12,27,31
1230,-24.38299999999858,3047.176470588235,47,17,30,64
1231,15.27125000000159,2735.3529411764707,51,12,10,63
1232,-32.41974999999873,2374.823529411765,27,19,15,46
1233,-5.993499999999363,3845.1052631578946,47,19,15,66
1234,-21.595249999999275,2610.8333333333335,30,12,20,42
1235,-8.887249999998012,3740.2,44,14,15,58
1236,-26.446999999999043,2892.0,30,16,15,46
1237,-21.059999999998247,3046.4736842105262,41,6,21,47
1238,-9.83499999999994,2106.1176470588234,30,13,21,43
1239,9.025250000002146,4286.9,53,5,20,58
1240,-37.39149999999829,2069.1052631578946,14,12,34,26
1241,-34.093249999999365,2299.235294117647,17,21,26,38
1242,-23.356499999998793,3794.2105263157896,44,18,16,62
1243,-19.16299999999865,2320.8823529411766,31,18,14,49
1244,-32.29199999999964,2578.1111111111113,32,14,21,46
1245,-19.376749999999607,3714.722222222222,49,17,25,66
1246,-12.431749999999061,2852.0588235294117,41,12,12,53
1247,-24.410749999999574,3585.2631578947367,30,18,24,48
1248,-5.471249999998397,3110.722222222222,50,12,15,62
1249,-19.51800000000021,2779.1052631578946,27,15,24,42
1250,-16.8149999999994,3135.4,25,5,24,30
1251,-40.179250000000174,2095.777777777778,29,7,25,36
1252,-28.289750000000048,2185.3529411764707,38,14,23,52
1253,9.200500000003078,3247.4444444444443,58,16,14,74
1254,-13.495999999999464,2944.5263157894738,24,15,22,39
1255,-19.30674999999762,2332.9444444444443,37,12,30,49
1256,-13.658999999998448,4781.55,47,9,21,56
1257,-21.848499999998705,2568.7,25,12,15,37
1258,-22.164500000000054,2983.684210526316,24,14,29,38
1259,-9.451499999999852,1813.0,32,11,27,43
1260,-43.867249999998904,2076.5263157894738,12,17,24,29
1261,-33.77549999999942,2099.0526315789475,10,11,21,21
1262,-42.04975000000011,2403.157894736842,15,9,42,24
1263,-55.79799999999976,1429.0,0,15,23,15
1264,-32.12924999999996,1762.3529411764705,13,5,33,18
1265,-33.07649999999887,3434.55,30,15,24,45
1266,-17.346499999999757,3246.5555555555557,40,6,26,46
1267,-8.388999999998022,3577.842105263158,47,7,20,54
1268,-10.52999999999866,2176.0,28,13,14,41
1269,-11.734749999999044,3060.5555555555557,44,11,15,55
1270,8.352250000001277,5431.5,52,14,19,66
1271,-18.863750000000046,1486.1333333333334,34,14,26,48
1272,-32.25974999999942,2174.1176470588234,16,7,27,23
1273,-29.190999999999825,1429.0,15,14,23,29
1274,-25.7112499999989,2430.0555555555557,22,16,19,38
1275,-20.32549999999862,2160.1111111111113,26,8,23,34
1276,-6.848749999998316,2383.3529411764707,47,17,14,64
1277,-13.245749999998651,3765.75,34,14,14,48
1278,-3.009499999999425,3045.4444444444443,46,8,22,54
1279,-11.840999999999422,2995.4736842105262,42,14,23,56
1280,-3.4862499999990475,3111.5789473684213,36,10,16,46
1281,-19.181749999999315,3137.5263157894738,36,7,21,43
1282,-11.315749999998562,4379.0526315789475,41,11,24,52
1283,-2.55599999999867,2618.705882352941,38,15,19,53
1284,-3.855499999999199,2114.3529411764707,46,7,34,53
1285,-24.32949999999986,1992.611111111111,16,18,19,34
1286,-19.966999999999135,2564.8333333333335,38,10,19,48
1287,-34.90449999999913,2508.45,19,12,23,31
1288,-22.34149999999962,1750.4375,24,20,21,44
1289,-17.49699999999876,2151.3333333333335,30,13,20,43
1290,-35.262999999999316,1429.0,12,14,17,26
1291,12.095750000001127,2344.8125,46,10,19,56
1292,-24.603000000000048,1949.3333333333333,35,25,13,60
1293,-17.90799999999924,2790.5555555555557,33,11,30,44
1294,0.8485000000005058,2996.764705882353,48,11,27,59
1295,-16.642999999999592,2257.294117647059,41,12,25,53
1296,-17.108499999998195,2421.0625,35,14,23,49
1297,-14.77599999999877,3591.7,40,10,13,50
1298,-32.53224999999921,2695.6315789473683,18,8,27,26
1299,-25.001749999999383,3016.45,17,12,25,29
1300,-3.376749999999393,2597.1176470588234,42,19,18,61
1301,-9.924999999998535,4517.3,47,12,34,59
1302,-27.092750000000187,1429.0,23,13,25,36
1303,-18.981499999999194,2274.722222222222,27,6,18,33
1304,-14.707499999998143,2654.777777777778,36,11,19,47
1305,-41.5014999999994,1698.8823529411766,7,8,29,15
1306,-9.73549999999872,2534.705882352941,37,19,21,56
1307,-18.444999999999663,1429.0,27,16,24,43
1308,-11.202999999999507,2681.4444444444443,39,9,14,48
1309,-13.099999999998378,3967.2631578947367,49,10,23,59
1310,-14.605999999999932,1701.875,43,14,28,57
1311,-24.909999999999343,2592.222222222222,20,12,28,32
1312,-24.894749999998076,1824.9411764705883,27,6,27,33
1313,-18.36399999999947,1821.875,23,14,25,37
1314,-0.47449999999726983,3843.4210526315787,48,9,23,57
1315,-10.952499999998206,4950.5,51,13,29,64
1316,-23.907499999998997,2646.3684210526317,23,19,16,42
1317,-11.854499999999938,3191.0555555555557,46,16,21,62
1318,-32.517499999999565,2667.1666666666665,23,13,22,36
1319,-12.372999999999145,1550.0625,24,3,28,27
1320,-21.694749999998084,3718.8,45,12,21,57
1321,-6.673999999999532,2198.470588235294,35,16,19,51
1322,5.02050000000177,4718.9473684210525,60,3,19,63
1323,-22.21399999999978,1567.9375,17,6,26,23
1324,-41.08474999999841,1665.2941176470588,18,15,24,33
1325,0.8872500000000834,3982.0526315789475,57,13,22,70
1326,-27.71274999999948,2151.4,16,14,15,30
1327,-12.390499999999701,3517.6315789473683,36,11,26,47
1328,-12.783499999999302,3266.8333333333335,39,15,18,54
1329,-20.763249999999346,2944.4210526315787,33,19,14,52
1330,-22.634499999999473,2516.3888888888887,30,23,19,53
1331,-33.93399999999936,2258.8333333333335,21,8,27,29
1332,-7.256249999999271,2927.842105263158,41,11,20,52
1333,-14.208249999999385,1648.25,46,18,31,64
1334,-8.948749999997041,3941.315789473684,51,8,27,59
1335,-25.168749999998813,2489.0555555555557,26,16,18,42
1336,-7.621499999999682,2672.823529411765,40,16,17,56
1337,-8.08074999999848,4394.95,43,17,19,60
1338,-22.531999999998455,3482.5263157894738,30,13,27,43
1339,-13.712749999999122,3073.157894736842,33,11,18,44
1340,-19.1357500000001,3301.157894736842,38,9,24,47
1341,3.6075000000017723,3817.5263157894738,56,7,15,63
1342,-35.41699999999982,2621.2105263157896,18,12,30,30
1343,-25.849749999999982,1429.0,19,12,17,31
1344,-7.2764999999985465,2076.875,39,12,22,51
1345,0.34225000000187017,1534.8666666666666,35,23,16,58
1346,-11.517749999999268,2433.705882352941,46,9,26,55
1347,-13.099999999998037,2001.4375,40,16,18,56
1348,-16.195749999999784,2683.1111111111113,27,20,10,47
1349,-40.17474999999885,2159.2105263157896,11,14,27,25
1350,-20.29199999999918,2156.4117647058824,31,9,37,40
1351,-10.079999999999123,2173.176470588235,28,14,20,42
1352,-4.337249999999275,3127.6111111111113,40,18,20,58
1353,13.798250000000778,2393.4375,51,16,16,67
1354,-11.08149999999969,2959.6315789473683,38,8,22,46
1355,-8.634499999998555,3019.1666666666665,42,12,12,54
1356,-39.08249999999948,3515.9473684210525,30,13,29,43
1357,-34.73125000000009,2036.611111111111,13,18,22,31
1358,-30.42249999999974,1523.25,23,22,18,45
1359,-12.425499999999001,3438.722222222222,54,11,18,65
1360,-24.96699999999949,1963.1176470588234,21,24,18,45
1361,24.593000000001144,4423.1578947368425,60,25,19,85
1362,-18.81749999999825,2225.470588235294,30,21,18,51
1363,-17.776249999999244,2326.875,31,7,30,38
1364,-17.860749999998795,2374.8823529411766,24,17,24,41
1365,-33.072500000000495,1429.0,10,15,20,25
1366,7.6222500000031275,5168.75,64,12,17,76
1367,-28.786499999999272,3344.95,25,11,15,36
1368,-33.56749999999955,1948.6315789473683,12,11,19,23
1369,2.1762500000006417,4117.526315789473,69,12,16,81
1370,-21.913999999999028,2249.4736842105262,22,9,26,31
1371,-19.559999999999953,3151.7894736842104,27,16,21,43
1372,-1.917499999997645,5151.25,52,8,16,60
1373,-16.526749999999236,2762.294117647059,46,15,21,61
1374,2.7127500000019857,3059.5555555555557,59,13,15,72
1375,-16.97824999999928,2828.3,24,15,23,39
1376,2.9727500000014864,4260.368421052632,72,17,15,89
1377,-12.047499999998596,3134.9411764705883,47,9,23,56
1378,-2.275499999996937,4717.95,54,11,37,65
1379,-14.850249999997512,1733.625,24,15,33,39
1380,-0.14449999999706478,2904.294117647059,72,14,18,86
1381,-24.11849999999965,1586.7333333333333,22,14,21,36
1382,-31.943499999998615,2864.722222222222,35,9,27,44
1383,-5.122249999997668,2295.6470588235293,41,12,20,53
1384,-29.728499999998682,3552.05,30,18,21,48
1385,-32.587999999998786,1606.4705882352941,13,18,20,31
1386,-21.493999999998785,1614.8823529411766,20,11,24,31
1387,-5.981749999999141,3831.684210526316,60,7,25,67
1388,-38.42524999999967,3125.85,21,15,18,36
1389,-15.115249999999255,2749.277777777778,38,13,24,51
1390,-0.5167499999979199,3287.1052631578946,40,16,16,56
1391,-39.69425000000028,1625.4375,17,11,30,28
1392,-8.159249999999043,3282.8947368421054,47,15,18,62
1393,-26.545999999999275,2850.9473684210525,24,12,20,36
1394,-1.062249999997431,3179.5,60,17,24,77
1395,-30.45925000000012,2301.1111111111113,19,14,18,33
1396,-9.579999999998808,3792.5263157894738,36,4,25,40
1397,-15.620749999998988,2719.277777777778,42,7,15,49
1398,-11.474499999998196,3001.470588235294,50,9,19,59
1399,-4.145999999998407,5048.9,52,8,17,60
1400,-9.165249999998716,3561.277777777778,44,15,19,59
1401,-29.4352499999994,1438.5333333333333,13,11,23,24
1402,-6.843749999998562,5375.1,45,18,18,63
1403,-9.459500000000086,3887.684210526316,48,23,23,71
1404,-38.09124999999962,2087.4736842105262,13,18,19,31
1405,-16.85799999999957,2237.6875,27,11,32,38
1406,-16.955249999998006,3721.4210526315787,53,13,19,66
1407,-12.599999999998888,1987.6875,45,28,9,73
1408,-0.58649999999855,2870.6470588235293,54,13,22,67
1409,-6.509499999998451,2496.9444444444443,43,13,16,56
1410,-18.200499999998588,2279.222222222222,26,11,22,37
1411,-20.630499999999152,2391.4736842105262,21,17,17,38
1412,-30.007999999998752,2207.722222222222,21,14,18,35
1413,1.7260000000010745,2802.529411764706,43,9,23,52
1414,-29.520499999999817,1839.75,23,16,23,39
1415,-13.282749999998904,1751.5,22,14,19,36
1416,-32.115499999999045,2366.5,21,15,18,36
1417,-28.310749999998727,2072.722222222222,22,17,19,39
1418,3.0287500000015357,3500.842105263158,42,18,17,60
1419,-41.3689999999992,1614.8823529411766,9,14,21,23
1420,-19.334249999999635,1939.764705882353,24,11,21,35
1421,-9.63924999999832,2618.6666666666665,36,8,23,44
1422,-36.159249999998984,1614.8823529411766,10,9,31,19
1423,-22.246749999999317,3395.6315789473683,38,18,22,56
1424,-28.52174999999903,3053.9473684210525,27,9,32,36
1425,-35.15349999999935,1429.0,33,9,32,42
1426,-29.34999999999975,3240.85,27,5,28,32
1427,-11.66324999999958,3198.4736842105262,40,12,19,52
1428,-26.602499999999452,3137.05,23,16,14,39
1429,-17.73774999999879,2371.235294117647,29,12,17,41
1430,-0.08574999999937764,2660.5882352941176,54,9,28,63
1431,-42.33124999999962,1429.0,1,14,26,15
1432,-11.097249999999445,2651.315789473684,34,8,21,42
1433,-29.822499999998506,2973.1111111111113,31,13,19,44
1434,0.7110000000015203,3347.0555555555557,54,17,17,71
1435,-36.5229999999989,3322.8947368421054,28,13,22,41
1436,-21.326749999999826,2563.9444444444443,40,14,24,54
1437,0.023750000000309957,2569.0588235294117,41,16,18,57
1438,-36.16925000000007,2365.6111111111113,28,4,40,32
1439,-19.160249999998758,3577.55,34,13,21,47
1440,-8.379999999998422,4443.5,53,13,19,66
1441,-31.38624999999926,1916.4705882352941,23,14,17,37
1442,7.630000000001992,3986.315789473684,47,15,20,62
1443,-31.528249999999293,2292.3333333333335,21,10,22,31
1444,-37.055250000000036,1429.0,7,12,21,19
1445,9.242000000000882,3179.5,56,11,20,67
1446,-31.060749999999466,1429.0,19,2,36,21
1447,29.110750000003872,3586.8823529411766,68,12,24,80
1448,-15.118999999998895,3001.3684210526317,24,8,22,32
1449,-22.706999999999645,2711.4736842105262,36,7,37,43
1450,-16.289749999999028,2640.4210526315787,28,8,20,36
1451,-29.059249999998865,2514.2105263157896,20,10,29,30
1452,-12.299249999998837,2390.222222222222,27,9,22,36
1453,-24.252499999999664,2131.8888888888887,22,15,19,37
1454,-35.51324999999961,2276.7,14,14,15,28
1455,4.613750000000677,2619.5,45,13,22,58
1456,-41.22099999999991,2636.2105263157896,18,11,13,29
1457,-2.9054999999988924,3566.8947368421054,45,19,14,64
1458,-7.086749999998555,3373.0526315789475,40,17,20,57
1459,1.89925000000149,4027.2631578947367,46,14,14,60
1460,-31.13324999999994,2627.0526315789475,31,18,30,49
1461,-7.1762499999988325,2846.7894736842104,42,12,24,54
1462,-7.849999999998036,5580.6,49,16,23,65
1463,-20.694999999998597,3251.9473684210525,23,13,32,36
1464,-6.849249999999347,3109.8947368421054,32,13,19,45
1465,6.895250000001677,4109.833333333333,54,10,22,64
1466,-25.354500000000055,2431.722222222222,32,8,27,40
1467,-14.822999999999084,2232.176470588235,27,9,27,36
1468,-19.641249999998816,2157.3125,32,17,21,49
1469,-26.544499999999033,2431.5789473684213,20,13,24,33
1470,-23.325499999999693,1457.6,23,10,24,33
1471,8.022500000002534,3295.1111111111113,60,6,14,66
1472,-9.743499999998793,2153.3125,31,16,20,47
1473,-22.282250000001007,2024.2777777777778,42,11,37,53
1474,-20.912749999999257,2688.125,40,18,11,58
1475,-9.163499999998695,2527.1176470588234,32,10,23,42
1476,-24.594999999999498,2087.3529411764707,23,13,24,36
1477,-3.08874999999938,2538.3529411764707,36,17,27,53
1478,-37.48499999999993,1917.5555555555557,12,11,22,23
1479,-20.286249999999015,3169.8333333333335,41,14,18,55
1480,-0.7529999999978667,2801.5882352941176,49,20,12,69
1481,-23.474999999999618,2039.0526315789473,12,9,22,21
1482,-40.84150000000001,1438.5333333333333,9,9,17,18
1483,-10.112999999999314,2437.4117647058824,38,10,24,48
1484,-24.76149999999908,2254.4444444444443,16,19,20,35
1485,-12.440499999999442,3455.8947368421054,38,12,18,50
1486,-1.3252499999997693,2933.5,30,17,24,47
1487,-34.07549999999897,3023.9473684210525,29,17,13,46
1488,-11.22549999999946,2389.3888888888887,40,17,19,57
1489,-22.08574999999851,2497.6315789473683,30,11,17,41
1490,-27.734999999999168,2784.9473684210525,26,12,22,38
1491,-6.804749999999092,3538.5263157894738,29,24,13,53
1492,-41.41875000000001,2792.5,12,7,30,19
1493,-49.31675000000014,1429.0,0,17,28,17
1494,-20.60349999999937,2846.277777777778,30,18,15,48
1495,-18.63874999999862,3133.4210526315787,31,12,24,43
1496,-14.943749999998989,4226.65,40,14,17,54
1497,-18.901999999998818,2211.529411764706,29,11,20,40
1498,3.6227500000011785,3005.0,44,16,9,60
1499,-8.589749999999043,3075.6315789473683,44,17,22,61
1500,-38.41999999999888,2121.684210526316,9,7,32,16
1501,-23.604249999999432,2824.315789473684,26,19,18,45
1502,-15.94099999999857,2411.1875,57,8,19,65
1503,-2.8724999999984746,3455.5555555555557,47,12,16,59
1504,-20.181999999999242,3132.5263157894738,26,2,23,28
1505,-22.314749999999247,3059.6111111111113,36,13,25,49
1506,-15.987249999999307,2345.9411764705883,29,11,16,40
1507,-18.739249999999107,3436.95,33,12,15,45
1508,-9.867249999998796,4087.05,43,16,16,59
1509,12.764500000002451,5964.85,65,12,23,77
1510,-7.397749999998585,2946.3529411764707,45,13,22,58
1511,-4.8275000000000166,2937.0555555555557,54,14,13,68
1512,-22.34699999999842,3439.1052631578946,32,11,32,43
1513,0.2035000000010311,4114.105263157895,48,13,22,61
1514,-18.122499999999697,2786.277777777778,40,3,43,43
1515,-10.580249999999392,3944.5263157894738,56,8,23,64
1516,-14.750249999998342,4420.789473684211,55,18,19,73
1517,-20.086999999998937,2730.6,24,13,18,37
1518,-21.503749999999194,3323.55,26,5,36,31
1519,11.339500000001518,5101.25,52,20,12,72
1520,-30.28499999999888,2131.235294117647,23,14,26,37
1521,-26.80224999999976,3079.9473684210525,34,13,22,47
1522,-20.082499999999502,1893.25,56,25,22,81
1523,-7.988999999998823,2390.277777777778,31,14,18,45
1524,-30.705999999998692,2724.1176470588234,38,14,20,52
1525,-9.392999999997233,1831.8125,51,12,20,63
1526,-33.89924999999945,2088.235294117647,27,4,25,31
1527,-4.124499999998388,4807.65,49,15,22,64
1528,-20.189249999998395,3419.65,34,15,17,49
1529,-32.44600000000023,1429.0,11,14,37,25
1530,-18.135249999998813,2105.9411764705883,36,9,28,45
1531,-20.746999999999087,1782.25,43,15,22,58
1532,-14.876499999999183,2813.0,43,20,15,63
1533,-19.32524999999924,3229.0,24,7,26,31
1534,-25.637999999999096,3380.6315789473683,37,17,20,54
1535,-27.33899999999978,1755.4375,19,3,25,22
1536,-12.396499999999579,2553.4210526315787,35,5,28,40
1537,6.314750000001085,2732.75,56,11,15,67
1538,-17.06074999999942,2903.5555555555557,34,9,16,43
1539,-18.567249999999554,2291.0,35,16,31,51
1540,-40.46200000000005,1756.8235294117646,9,14,20,23
1541,-33.08149999999925,1866.9411764705883,15,16,24,31
1542,-9.650500000000202,2067.6470588235293,45,13,23,58
1543,-29.19924999999971,1803.5294117647059,26,15,25,41
1544,-13.152749999999589,2267.375,38,6,23,44
1545,-19.39899999999879,3209.35,33,13,18,46
1546,-24.27024999999818,3776.7,41,6,30,47
1547,-23.404749999998902,3237.1,31,11,15,42
1548,-32.92874999999926,2459.8333333333335,25,16,23,41
1549,-2.897249999999126,2112.625,46,16,23,62
1550,-29.865249999999254,2738.5555555555557,27,10,29,37
1551,-22.47999999999997,2635.3333333333335,42,11,23,53
1552,-36.841999999997924,1539.235294117647,17,16,29,33
1553,-24.74424999999937,2698.0526315789475,17,16,16,33
1554,-9.616499999997938,4317.95,45,9,17,54
1555,-3.0432499999989586,4318.75,47,15,13,62
1556,-24.70849999999945,3936.9473684210525,44,14,23,58
1557,1.369500000002646,1974.6875,52,8,19,60
1558,9.21650000000242,3482.684210526316,47,10,26,57
1559,2.429500000001665,2517.823529411765,42,7,23,49
1560,-12.707999999999277,2287.176470588235,40,12,19,52
1561,-16.105499999999207,3633.6666666666665,38,21,27,59
1562,-23.0822499999993,2830.3333333333335,37,7,34,44
1563,-17.784749999999608,3508.4736842105262,28,15,18,43
1564,-28.957249999999256,1706.875,17,10,16,27
1565,-16.500999999999358,2454.294117647059,43,19,23,62
1566,-21.37624999999884,3652.15,36,11,28,47
1567,-14.672749999997398,3166.7894736842104,34,7,37,41
1568,-6.205249999998996,3403.157894736842,38,11,17,49
1569,8.292500000000844,3122.764705882353,59,17,15,76
1570,-19.351749999998123,5287.8,50,9,18,59
1571,-8.41424999999866,2115.5,34,9,21,43
1572,-11.55699999999835,3058.6,36,13,16,49
1573,-15.221749999997906,2965.222222222222,49,12,24,61
1574,-7.122499999999479,2807.3888888888887,45,9,26,54
1575,-24.485499999997934,4235.210526315789,51,11,31,62
1576,-34.8004999999995,1630.4375,15,14,20,29
1577,-25.7264999999985,2467.4117647058824,40,12,34,52
1578,-24.63724999999977,2055.1666666666665,24,13,23,37
1579,-18.220999999999243,2715.722222222222,27,10,23,37
1580,1.943750000003472,2413.235294117647,57,14,21,71
1581,-23.874999999998316,1668.125,29,8,31,37
1582,1.9460000000015936,2673.764705882353,37,14,18,51
1583,-34.22974999999795,1805.0625,23,11,30,34
1584,-16.63299999999986,2603.705882352941,49,9,21,58
1585,-30.99949999999876,3327.8947368421054,38,16,23,54
1586,-29.937999999998446,2638.0555555555557,34,16,18,50
1587,-21.462249999998978,2072.4117647058824,35,9,17,44
1588,-33.19774999999942,1643.764705882353,22,23,21,45
1589,-8.568749999998683,2291.125,39,11,25,50
1590,-22.954249999999032,3030.5789473684213,30,12,17,42
1591,-25.142249999999656,4171.789473684211,32,20,19,52
1592,-22.26274999999939,2528.3,27,10,12,37
1593,-31.6942499999995,2069.0526315789475,12,12,18,24
1594,-13.302999999999386,3516.0526315789475,48,5,20,53
1595,-28.595999999999037,2618.6666666666665,24,4,36,28
1596,-10.626999999999466,4350.6,38,13,17,51
1597,-21.44800000000011,2109.9473684210525,18,2,32,20
1598,-34.11949999999954,2090.6315789473683,15,19,16,34
1599,-26.30674999999956,3126.5882352941176,41,16,17,57
1600,-14.151499999999047,2722.2631578947367,31,16,17,47
1601,-32.74574999999986,2300.4736842105262,21,11,24,32
1602,-16.14999999999967,2603.65,22,9,21,31
1603,-10.307999999998437,2719.222222222222,31,10,22,41
1604,1.8905000000005319,2605.529411764706,50,22,10,72
1605,-25.36899999999955,1429.0,24,13,23,37
1606,-14.93699999999908,2989.8888888888887,33,11,19,44
1607,-25.741999999997795,2603.5555555555557,44,13,21,57
1608,-41.22499999999811,2202.5,21,14,31,35
1609,-4.443999999998887,2711.1176470588234,52,8,25,60
1610,-18.152749999999813,2321.3888888888887,27,13,22,40
1611,-13.801749999998801,4279.9,46,15,15,61
1612,-23.624249999999375,2478.3684210526317,20,11,23,31
1613,-10.375499999999072,4340.15,47,13,14,60
1614,-12.544749999999357,1898.3125,45,11,31,56
1615,-2.036749999998461,4132.578947368421,59,10,28,69
1616,3.866500000001184,5539.35,51,9,12,60
1617,-31.24724999999875,2562.222222222222,29,20,18,49
1618,-37.90050000000032,2418.157894736842,32,10,26,42
1619,-10.4999999999999,2176.9411764705883,41,16,24,57
1620,-15.060499999999497,2601.764705882353,31,10,17,41
1621,-30.694749999999466,2136.684210526316,13,11,17,24
1622,-22.02824999999811,1926.0625,32,10,23,42
1623,-27.797249999999174,3775.1,27,11,23,38
1624,-6.603999999998676,3173.5,36,17,15,53
1625,-25.074249999998624,1850.1764705882354,20,11,25,31
1626,-34.748499999999346,1589.6470588235295,4,20,21,24
1627,-17.221999999998275,2603.684210526316,30,15,25,45
1628,-13.03274999999914,2491.529411764706,38,9,19,47
1629,-18.847749999999508,1467.1333333333334,25,15,29,40
1630,-17.714749999999263,3165.0526315789475,30,18,15,48
1631,-23.34725000000002,2147.777777777778,14,12,32,26
1632,-24.625499999999597,2854.2105263157896,27,10,17,37
1633,-12.54224999999955,3274.722222222222,46,5,23,51
1634,-1.8342499999971502,2219.625,55,11,20,66
1635,-18.387499999997278,2715.6666666666665,37,9,35,46
1636,-11.108999999999611,2606.2105263157896,33,12,19,45
1637,-0.07624999999893074,4533.75,52,15,17,67
1638,-18.283999999998912,3023.842105263158,23,6,28,29
1639,-28.023249999998995,2206.823529411765,33,14,22,47
1640,-10.732249999998645,3100.842105263158,40,17,10,57
1641,-10.611749999998786,3251.1052631578946,31,11,25,42
1642,-23.254999999999008,2245.1176470588234,37,12,25,49
1643,-27.51174999999923,2386.6111111111113,31,19,18,50
1644,21.76875000000128,3239.4210526315787,41,8,18,49
1645,-12.115249999998877,1917.3529411764705,31,5,22,36
1646,-12.324249999999484,3899.4210526315787,38,6,26,44
1647,-8.176749999998401,4955.25,45,9,23,54
1648,-11.067999999998111,3693.8947368421054,45,19,28,64
1649,-21.205999999999253,3792.65,37,13,19,50
1650,-19.52049999999975,2624.8333333333335,22,11,20,33
1651,-19.760999999999264,2324.470588235294,24,6,31,30
1652,-32.31524999999963,2553.4210526315787,18,8,26,26
1653,1.2817500000023179,4772.8,58,6,25,64
1654,-14.988999999999066,2783.315789473684,26,6,19,32
1655,-37.43999999999967,2164.2631578947367,9,10,24,19
1656,-22.927499999999654,4375.05,47,6,21,53
1657,-6.343499999999345,3663.0,47,12,19,59
1658,-16.071749999999234,2910.6111111111113,32,9,25,41
1659,-22.35675000000003,1429.0,20,7,23,27
1660,-29.118499999999568,1547.6470588235295,10,12,22,22
1661,-8.457749999997285,3790.842105263158,48,15,17,63
1662,14.181250000000684,2901.777777777778,44,10,20,54
1663,-22.90649999999886,2219.6875,52,4,39,56
1664,-11.601999999998801,3554.3684210526317,29,12,28,41
1665,-3.1962499999989396,3862.8333333333335,51,10,17,61
1666,-30.038749999999276,2148.3684210526317,15,12,24,27
1667,-4.291249999997413,5320.526315789473,77,19,25,96
1668,-7.215249999999772,2453.294117647059,26,11,22,37
1669,-0.5524999999971488,3865.2105263157896,50,7,24,57
1670,1.8932500000008148,3946.5,36,16,18,52
1671,-8.340249999998639,3545.2105263157896,38,9,24,47
1672,-19.269499999997254,2820.3529411764707,43,9,30,52
1673,-20.19424999999897,2302.9411764705883,30,5,20,35
1674,-15.676999999998435,3109.8888888888887,37,11,24,48
1675,-51.39799999999964,1742.5625,7,13,25,20
1676,-13.237499999999207,3246.5555555555557,54,13,26,67
1677,-29.304499999999383,1429.0,15,9,26,24
1678,-37.76874999999963,2181.705882352941,20,14,25,34
1679,-12.935999999998668,1983.625,27,10,28,37
1680,1.5662500000017014,3768.315789473684,46,5,25,51
1681,0.2237500000008989,3857.6111111111113,52,17,25,69
1682,-12.917999999999171,2236.705882352941,30,9,19,39
1683,-18.43199999999912,2603.684210526316,23,11,22,34
1684,-16.513749999999597,3202.9,35,10,12,45
1685,-17.751499999999325,2018.4375,31,14,18,45
1686,-9.598499999998172,3591.8,39,13,25,52
1687,2.7567500000009018,1706.8125,32,5,24,37
1688,-34.15849999999868,2454.235294117647,28,21,22,49
1689,-6.851249999998108,4147.35,50,8,16,58
1690,-26.67049999999938,2900.55,17,20,19,37
1691,-15.502249999999936,1909.611111111111,19,9,34,28
1692,-28.240499999999606,3085.7368421052633,31,11,21,42
1693,-10.369999999999713,4080.6315789473683,43,12,18,55
1694,-27.523749999996983,2791.3529411764707,42,9,33,51
1695,-2.6732499999987303,3179.4444444444443,44,16,24,60
1696,-12.690499999999279,2688.9473684210525,46,14,24,60
1697,-12.538999999999742,3238.5555555555557,42,11,21,53
1698,-22.566749999999246,2894.2631578947367,27,14,29,41
1699,7.587000000001377,3613.7368421052633,47,23,15,70
1700,-13.720999999999481,3398.157894736842,38,10,21,48
1701,-12.661249999999203,2929.5882352941176,52,12,29,64
1702,-19.228250000000127,2092.9411764705883,37,18,19,55
1703,-7.00624999999778,2753.176470588235,52,8,19,60
1704,-13.69449999999895,2272.1111111111113,34,11,20,45
1705,-42.16174999999893,1644.3125,8,8,33,16
1706,-5.8234999999985115,1572.875,26,11,23,37
1707,-16.201749999997983,3045.3888888888887,49,13,19,62
1708,-3.3434999999973902,3297.8947368421054,49,5,25,54
1709,-15.111999999998684,3607.7,34,10,22,44
1710,-10.58924999999957,2893.8888888888887,31,11,23,42
1711,-39.87124999999997,1625.4375,17,20,16,37
1712,-11.78049999999782,2534.8888888888887,41,24,14,65
1713,-14.547249999999128,2974.5789473684213,27,15,18,42
1714,-7.826999999999098,3353.157894736842,42,8,26,50
1715,-14.486749999999224,1862.2941176470588,23,23,13,46
1716,-35.062999999999676,2258.8333333333335,15,20,22,35
1717,-29.656499999999262,2702.85,21,21,9,42
1718,-4.750999999997381,2842.6666666666665,48,4,26,52
1719,-8.067749999998219,4622.75,46,8,22,54
1720,-18.21024999999809,4265.65,39,12,23,51
1721,5.488250000000642,2474.764705882353,48,11,26,59
1722,-9.690999999999631,2560.4444444444443,31,14,22,45
1723,-7.028499999997933,3546.9473684210525,45,9,22,54
1724,-24.557499999999674,1904.2941176470588,40,22,22,62
1725,-35.73900000000013,2238.5,40,17,26,57
1726,-41.40324999999891,3211.3333333333335,40,7,31,47
1727,-18.75749999999886,3582.5333333333333,32,12,17,44
1728,-41.76399999999964,2190.8947368421054,11,6,32,17
1729,-13.395499999998197,3539.2631578947367,39,11,22,50
1730,-17.25075000000016,2325.9444444444443,23,9,32,32
1731,-28.17149999999998,2460.777777777778,27,5,36,32
1732,-17.539749999998314,1999.611111111111,27,17,26,44
1733,-12.218499999999954,2028.7222222222222,31,14,20,45
1734,-15.831749999999257,2825.8888888888887,54,13,20,67
1735,-6.260249999999095,2425.25,42,6,24,48
1736,-25.487999999999495,2115.9444444444443,22,2,32,24
1737,-22.495249999999476,2809.157894736842,24,10,20,34
1738,-2.800249999998552,1544.4,34,4,25,38
1739,-6.724499999998871,3571.1,34,8,19,42
1740,-18.142999999999176,3481.684210526316,31,23,11,54
1741,-13.409999999998893,3044.15,30,11,20,41
1742,-25.31249999999951,2750.1111111111113,30,14,25,44
1743,-40.28274999999944,1429.0,7,17,40,24
1744,-23.58949999999914,2693.1052631578946,25,13,15,38
1745,-16.306999999998585,2593.4117647058824,38,9,25,47
1746,-25.327249999999374,2097.5882352941176,34,16,23,50
1747,-12.525500000000685,1429.0,49,6,35,55
1748,-23.19024999999889,2253.529411764706,20,6,30,26
1749,-5.1719999999994855,4181.0526315789475,28,8,22,36
1750,-6.373749999999316,2150.4444444444443,30,11,16,41
1751,-6.79624999999933,2846.1666666666665,40,11,19,51
1752,-18.613499999998233,2239.5555555555557,32,21,15,53
1753,-23.820499999999683,2675.1,21,9,14,30
1754,-9.522999999997321,3652.1111111111113,54,8,17,62
1755,-14.43675000000016,2897.3333333333335,49,23,22,72
1756,-14.572749999999306,2540.222222222222,33,10,24,43
1757,-20.304750000000244,2825.9444444444443,40,15,22,55
1758,-9.897749999998911,2943.222222222222,45,16,27,61
1759,-18.545000000000087,1666.125,32,10,31,42
1760,-28.752999999998952,2496.9444444444443,27,15,15,42
1761,-0.3114999999992394,3185.3529411764707,59,21,15,80
1762,-30.224249999999888,2071.875,25,20,22,45
1763,-13.3819999999982,1914.125,36,6,32,42
1764,-38.177749999999506,2132.4210526315787,11,14,18,25
1765,-26.35774999999895,2116.8888888888887,22,5,28,27
1766,-9.631749999999014,2571.8823529411766,37,11,24,48
1767,-19.480249999999266,2107.5625,45,11,34,56
1768,-25.522999999999872,2121.5625,30,9,22,39
1769,-32.133999999998814,2667.15,23,21,15,44
1770,-23.020999999999287,2661.5,21,13,17,34
1771,-35.1092499999998,1974.6315789473683,20,8,25,28
1772,-24.082749999999105,1481.9333333333334,21,18,21,39
1773,-57.68849999999854,2254.3888888888887,10,14,32,24
1774,0.6200000000010066,4542.6,54,10,18,64
1775,-6.354249999998832,4567.1,46,15,18,61
1776,-9.532250000000083,4031.4210526315787,38,11,18,49
1777,-35.01449999999898,2505.2105263157896,17,5,28,22
1778,-14.952750000000028,3079.8888888888887,42,6,41,48
1779,-15.472749999999067,3414.0526315789475,34,10,26,44
1780,-14.354249999999183,2181.5882352941176,47,11,18,58
1781,-26.81749999999938,1937.9411764705883,19,11,21,30
1782,-2.921499999999857,2689.470588235294,53,15,23,68
1783,-17.188749999999352,2715.6,26,18,16,44
1784,-39.758249999998995,3780.05,41,15,15,56
1785,-12.540749999999163,2581.294117647059,44,13,20,57
1786,-19.305999999999155,4108.45,36,8,19,44
1787,-28.16799999999999,1701.875,19,18,44,37
1788,4.165750000000228,3272.842105263158,48,9,18,57
1789,-6.195749999998634,3929.85,39,12,20,51
1790,-23.067249999999184,2917.7894736842104,30,15,14,45
1791,1.409500000002445,4733.263157894737,63,13,16,76
1792,-16.482749999999225,3454.9473684210525,34,12,16,46
1793,1.884000000001857,5851.25,64,11,16,75
1794,1.9790000000009342,4037.0,28,3,28,31
1795,-18.62424999999885,2245.1176470588234,39,18,24,57
1796,-25.89474999999942,1558.1333333333334,37,8,30,45
1797,-23.026499999999807,3125.0,34,7,31,41
1798,-31.359500000000054,2089.5,22,10,22,32
1799,-30.299999999999176,4038.6,32,4,24,36
1800,-24.04624999999945,2690.95,27,9,15,36
1801,-27.774499999999886,2496.0555555555557,24,6,27,30
1802,10.16050000000163,4803.473684210527,63,13,19,76
1803,-25.64824999999983,2496.3529411764707,46,13,23,59
1804,-24.758249999998448,4065.55,35,8,19,43
1805,-13.099999999998762,3044.6111111111113,48,3,22,51
1806,-30.95974999999974,1429.0,20,20,18,40
1807,-6.026499999998944,2941.4444444444443,36,16,32,52
1808,-9.366499999998762,3265.6,34,9,18,43
1809,-14.579249999999245,3037.5,35,20,23,55
1810,-9.691499999999824,2302.9411764705883,37,11,27,48
1811,-9.939249999998998,2630.1111111111113,38,4,22,42
1812,-16.772999999998426,2303.0555555555557,37,3,29,40
1813,-6.827499999998913,3203.3333333333335,41,10,23,51
1814,-20.46099999999924,3783.9,33,7,22,40
1815,-35.68799999999878,3243.35,31,16,9,47
1816,-19.36549999999905,2987.157894736842,33,18,18,51
1817,-14.113999999999379,3365.6315789473683,35,11,18,46
1818,-19.229499999998335,4350.631578947368,47,19,23,66
1819,-21.632250000000404,2706.8888888888887,37,7,32,44
1820,-9.820249999999069,3731.55,39,12,18,51
1821,-17.3554999999989,3317.1052631578946,33,7,22,40
1822,-17.854499999999764,1981.0555555555557,29,13,40,42
1823,5.738000000001195,3951.1111111111113,59,17,9,76
1824,-22.1484999999992,2395.684210526316,18,11,26,29
1825,-20.1634999999997,2155.0,16,17,29,33
1826,-26.001999999999423,4821.85,39,6,27,45
1827,9.654750000001771,2946.4117647058824,53,9,23,62
1828,-1.1804999999986279,4462.55,51,18,16,69
1829,-19.22774999999954,2496.235294117647,29,11,24,40
1830,-7.58074999999847,2534.529411764706,48,3,25,51
1831,-24.95824999999898,2625.4210526315787,25,2,28,27
1832,-28.82799999999809,3258.4,30,14,20,44
1833,-21.71899999999934,2319.705882352941,26,8,28,34
1834,-6.274499999998871,2901.777777777778,39,6,28,45
1835,-24.097999999999733,2244.235294117647,24,17,21,41
1836,-13.128499999998429,4695.0,66,13,12,79
1837,-17.17399999999916,2692.722222222222,35,13,17,48
1838,-5.303749999998521,2816.529411764706,54,10,19,64
1839,4.176000000001171,3107.625,54,12,16,66
1840,-22.507249999999136,2056.9444444444443,20,11,21,31
1841,-17.98974999999811,3368.222222222222,42,6,20,48
1842,-28.745499999999005,2181.222222222222,21,11,24,32
1843,-8.790249999999725,3628.7368421052633,33,9,28,42
1844,-30.429499999999724,2360.0,11,8,24,19
1845,-31.159249999999577,2247.25,16,6,21,22
1846,-33.31324999999992,2234.3684210526317,7,13,17,20
1847,-17.063499999999447,1505.4375,15,13,21,28
1848,-26.582749999999276,2492.470588235294,34,2,34,36
1849,-24.192249999999067,2683.8947368421054,32,13,17,45
1850,-16.617250000000293,2738.6111111111113,62,12,23,74
1851,-12.48324999999837,2514.1176470588234,34,7,31,41
1852,-7.941249999997038,2215.8125,46,16,26,62
1853,-18.694999999999094,1684.0,30,10,23,40
1854,-17.861249999999316,3988.55,44,8,20,52
1855,-13.333999999999474,3373.0526315789475,43,8,13,51
1856,3.007500000001925,3577.222222222222,59,11,16,70
1857,-25.798999999999545,4429.85,21,12,26,33
1858,2.556500000000741,3937.0,55,17,15,72
1859,-20.095499999999358,2637.157894736842,25,4,24,29
1860,-46.49524999999911,2365.6315789473683,24,12,28,36
1861,-26.686999999999244,3206.8947368421054,34,14,29,48
1862,-36.07625,2403.2631578947367,17,8,33,25
1863,-1.7449999999992616,3466.35,29,13,19,42
1864,-3.3079999999986733,3723.5,47,8,15,55
1865,9.689250000002197,4179.1578947368425,63,16,19,79
1866,-20.480249999999707,4205.3,39,16,18,55
1867,-10.195249999998964,1987.625,44,9,19,53
1868,-19.404249999998225,3265.2631578947367,32,8,26,40
1869,-29.963999999999526,1719.75,29,17,21,46
1870,-21.709500000000187,2524.3888888888887,21,10,29,31
1871,-43.20299999999979,1429.0,14,11,29,25
1872,-6.83974999999946,4159.105263157895,45,7,18,52
1873,-35.67999999999937,3168.0,23,10,26,33
1874,5.823000000001395,3322.3888888888887,56,16,21,72
1875,3.5765000000012774,3625.2,41,8,22,49
1876,-20.26524999999967,2000.5,33,12,25,45
1877,0.2037500000004034,3145.0,47,7,20,54
1878,-6.413249999998749,2902.6111111111113,40,9,22,49
1879,-8.34449999999877,2984.6111111111113,43,8,28,51
1880,-26.809000000000008,1909.7222222222222,30,8,29,38
1881,-16.770249999999248,2477.4736842105262,25,5,21,30
1882,15.70200000000193,3719.222222222222,55,8,20,63
1883,-32.19199999999928,2864.4210526315787,25,11,19,36
1884,3.9470000000016485,2985.6111111111113,45,20,20,65
1885,-5.615249999997383,3153.9444444444443,50,9,24,59
1886,-47.85149999999844,2072.8333333333335,8,10,36,18
1887,-27.7392499999982,2414.1052631578946,23,3,37,26
1888,-23.526249999999713,3431.6,29,12,18,41
1889,-12.227499999998653,2211.6470588235293,35,9,17,44
1890,-40.80750000000039,2087.4210526315787,5,9,37,14
1891,-11.190999999998429,2549.470588235294,50,12,20,62
1892,-32.03924999999956,2395.4117647058824,26,9,32,35
1893,2.544000000001076,3369.55,33,14,20,47
1894,-20.6769999999983,3510.0526315789475,38,11,32,49
1895,2.0292500000027522,4908.55,61,6,17,67
1896,2.640250000000684,4815.7,43,10,17,53
1897,-31.030999999999455,3410.85,24,7,20,31
1898,-11.739999999999174,2536.35,27,14,13,41
1899,-2.310749999998268,2478.6875,47,7,22,54
1900,7.444000000001114,5496.6,66,9,19,75
1901,-31.23399999999906,3291.8,38,10,20,48
1902,-12.728999999999177,2536.0625,58,22,17,80
1903,-15.425249999999375,3651.25,26,12,25,38
1904,-10.389249999999,3647.9473684210525,51,13,23,64
1905,-12.560249999999776,3448.3684210526317,34,11,28,45
1906,-12.455250000000223,2510.1111111111113,26,3,24,29
1907,-25.729999999998956,2441.3888888888887,34,11,23,45
1908,5.421750000000991,3474.1111111111113,52,17,16,69
1909,-26.902999999998865,3455.95,29,8,22,37
1910,8.692750000001475,2679.25,53,8,23,61
1911,-8.037499999999039,4420.4,52,8,16,60
1912,-22.000750000000274,1429.0,35,15,22,50
1913,-33.155999999999594,1614.8823529411766,11,16,19,27
1914,-15.536999999998958,1481.9333333333334,45,2,34,47
1915,0.787000000000144,2891.842105263158,39,6,29,45
1916,-7.130749999998886,2153.4375,29,3,22,32
1917,-31.220249999999318,3463.95,30,8,28,38
1918,-26.392249999997926,3975.95,46,13,20,59
1919,-2.267749999997487,2823.222222222222,51,8,21,59
1920,-11.197749999998912,3997.157894736842,49,5,28,54
1921,-6.104749999999376,3283.7894736842104,44,20,22,64
1922,-15.32074999999804,2488.823529411765,39,7,24,46
1923,-20.32374999999975,1564.4117647058824,10,10,26,20
1924,-31.209999999999212,1803.4705882352941,18,5,29,23
1925,-29.538749999999283,1715.75,15,14,21,29
1926,-7.177499999998983,4144.0,40,14,22,54
1927,-26.789499999999197,2054.277777777778,16,13,30,29
1928,1.4475000000004454,4080.6,44,5,17,49
1929,-20.68124999999936,1539.235294117647,19,13,19,32
1930,-23.682749999999565,1727.8235294117646,21,6,26,27
1931,-22.781499999999802,2302.8888888888887,15,10,31,25
1932,-28.238749999999158,2952.0,32,9,19,41
1933,-18.139249999999844,2611.5555555555557,45,18,20,63
1934,-24.14300000000013,2017.235294117647,20,2,28,22
1935,-11.904749999999362,3583.6315789473683,42,6,24,48
1936,-31.188499999998847,2949.277777777778,27,11,28,38
1937,-25.735249999998917,2769.9473684210525,23,5,27,28
1938,2.2692500000006075,3543.6666666666665,45,11,22,56
1939,-13.91099999999897,3099.1052631578946,37,9,18,46
1940,-5.892249999997808,3203.277777777778,52,14,22,66
1941,-36.401999999999305,3297.3,33,12,15,45
1942,-5.03849999999901,3881.4444444444443,62,18,22,80
1943,-8.395249999998734,5844.1,42,19,28,61
1944,-4.720999999998729,2623.294117647059,41,12,21,53
1945,-23.911499999999794,3135.4444444444443,46,10,36,56
1946,-7.247749999999696,3312.1052631578946,40,9,27,49
1947,-8.81874999999987,2866.0526315789475,46,12,20,58
1948,-4.09424999999863,2652.3529411764707,47,13,17,60
1949,12.255000000000212,3821.684210526316,53,22,24,75
1950,-29.424499999999462,2160.0555555555557,16,14,19,30
1951,-28.429499999999575,1429.0,11,3,26,14
1952,-5.455499999998841,4562.45,46,8,23,54
1953,-10.633499999999396,3287.842105263158,42,16,19,58
1954,-2.9004999999979284,2456.684210526316,39,8,25,47
1955,4.654500000001744,2460.823529411765,37,15,20,52
1956,-10.93299999999932,3083.157894736842,37,15,19,52
1957,-4.950999999997881,4572.7,47,8,16,55
1958,-11.632499999998867,2183.125,35,14,10,49
1959,-14.924999999998501,2162.9411764705883,36,17,12,53
1960,-18.918249999998885,3120.5,25,5,29,30
1961,-23.579499999998795,3632.9473684210525,40,10,26,50
1962,-15.210499999999858,2195.4444444444443,38,20,18,58
1963,-31.8702499999998,2905.2631578947367,21,7,39,28
1964,-23.566499999998975,2619.5789473684213,24,10,23,34
1965,-14.194750000000278,1946.9375,51,14,23,65
1966,-4.424749999998378,3798.85,38,12,18,50
1967,12.354750000001811,5348.1,59,3,19,62
1968,0.3340000000031941,4172.631578947368,70,9,26,79
1969,-18.40549999999946,1964.875,31,10,28,41
1970,-30.995249999998812,2725.9,19,14,26,33
1971,-9.253249999998536,2391.0555555555557,36,12,25,48
1972,-14.899499999998728,2716.6470588235293,39,14,15,53
1973,-22.86424999999873,3525.9,32,14,23,46
1974,0.6685000000004578,2030.3529411764705,38,8,29,46
1975,-10.783499999998432,3008.4,36,4,25,40
1976,-28.62524999999958,1969.6875,23,9,27,32
1977,-1.0932499999986955,4109.2,48,12,19,60
1978,-20.458249999999687,2876.842105263158,32,11,28,43
1979,15.775500000001543,3882.684210526316,54,11,15,65
1980,-37.28349999999991,1585.75,11,13,24,24
1981,-18.366749999999136,2757.7,23,14,17,37
1982,-13.411750000000008,2353.4117647058824,46,12,22,58
1983,-10.464249999998374,2047.235294117647,45,8,28,53
1984,-27.49849999999954,2612.0,24,13,17,37
1985,-10.62474999999905,3087.777777777778,44,9,25,53
1986,2.3652500000020638,2446.777777777778,38,8,28,46
1987,-11.75924999999899,3547.684210526316,45,19,22,64
1988,-11.518499999998712,4094.05,44,10,21,54
1989,-24.181249999998318,4585.45,43,13,18,56
1990,-26.29499999999937,3263.684210526316,40,13,18,53
1991,-32.39524999999979,2897.222222222222,30,15,26,45
1992,-16.661749999999895,2034.1176470588234,36,19,21,55
1993,-23.78249999999889,2112.5555555555557,22,6,29,28
1994,-5.0634999999990296,4691.0,54,11,18,65
1995,-20.97924999999851,2457.3333333333335,33,5,23,38
1996,-26.07074999999842,4037.1,41,9,22,50
1997,-9.482999999998379,3533.9444444444443,40,10,33,50
1998,-10.16999999999957,3648.7894736842104,55,9,24,64
1999,-8.693749999999673,2814.2105263157896,47,16,19,63
2000,-20.424749999998834,2018.3125,32,11,21,43
2001,-5.655249999998874,2176.0588235294117,37,14,14,51
2002,-7.0592499999988885,3380.65,37,13,15,50
2003,-20.049249999999184,2518.3125,47,11,20,58
2004,-8.684749999998314,4036.25,39,9,21,48
2005,-3.6172499999984167,3815.65,45,8,17,53
2006,-17.195249999998982,3211.277777777778,37,11,18,48
2007,-6.881499999997876,1814.0,43,11,17,54
2008,-7.4854999999987255,2729.8823529411766,54,9,24,63
2009,-10.899499999999238,2491.6875,50,11,21,61
2010,-2.8454999999999195,3778.222222222222,63,11,22,74
2011,-34.57899999999934,2194.25,16,3,24,19
2012,-17.39849999999864,2655.8823529411766,43,8,19,51
2013,-13.646749999997951,4838.55,51,6,24,57
2014,-2.592499999998868,3838.277777777778,49,6,20,55
2015,-20.444249999999734,2122.823529411765,24,16,27,40
2016,-18.9964999999989,2143.235294117647,27,16,20,43
2017,6.753500000002106,3647.777777777778,64,10,20,74
2018,-21.55924999999893,3412.4,35,9,14,44
2019,-6.707999999999089,4398.2,51,7,26,58
2020,-18.02299999999838,3659.684210526316,45,12,20,57
2021,-21.50999999999904,2621.2631578947367,23,9,26,32
2022,-4.37949999999787,1481.9333333333334,31,10,29,41
2023,-21.684249999998734,2248.9411764705883,26,10,36,36
2024,-33.58224999999957,1589.6470588235295,9,8,23,17
2025,-4.601749999999289,2768.823529411765,46,16,19,62
2026,-7.676499999999592,2294.1666666666665,28,15,25,43
2027,-28.93449999999922,2256.8947368421054,14,8,32,22
2028,-4.85824999999908,3420.3333333333335,42,16,14,58
2029,1.3505000000024086,2841.8823529411766,54,13,16,67
2030,-9.13799999999837,3666.35,42,11,20,53
2031,-12.807749999998233,3469.2631578947367,39,12,24,51
2032,-29.990249999999236,2687.05,19,7,28,26
2033,-6.4314999999981435,3778.3,43,8,24,51
2034,-30.888499999999446,1564.0,13,8,22,21
2035,-20.350249999999395,2561.0,21,6,27,27
2036,-16.65649999999878,2505.5882352941176,39,3,21,42
2037,-10.820499999999104,2114.470588235294,33,16,13,49
2038,-24.348249999998778,2200.157894736842,19,24,14,43
2039,-12.68249999999854,1582.4666666666667,31,11,18,42
2040,-13.97249999999956,3208.5789473684213,40,16,18,56
2041,-31.52299999999955,2536.0,23,15,32,38
2042,-23.65499999999929,4308.4,29,3,33,32
2043,-12.810749999997066,2110.823529411765,45,13,26,58
2044,-36.31674999999949,2084.0526315789475,15,4,26,19
2045,-19.129999999999065,2687.05,23,7,20,30
2046,-4.684249999999084,3143.3529411764707,56,15,37,71
2047,-29.448749999999155,3829.9,33,9,20,42
2048,-8.303749999999834,2174.222222222222,26,17,23,43
2049,0.21325000000151179,4439.35,47,16,15,63
2050,-1.3907499999978867,4787.75,61,6,16,67
2051,-20.24549999999887,2679.1,27,10,23,37
2052,-3.6119999999980443,3100.277777777778,53,10,15,63
2053,-32.76074999999971,1567.9375,32,11,28,43
2054,-28.430999999999546,2254.5263157894738,21,7,26,28
2055,-21.875249999998886,3297.777777777778,33,10,26,43
2056,-24.50599999999931,3488.55,36,13,16,49
2057,1.782500000000765,3998.7894736842104,37,15,20,52
2058,9.929000000001198,3717.3684210526317,49,7,24,56
2059,-12.330000000000192,2556.0555555555557,39,2,35,41
2060,-25.739749999998885,2311.529411764706,23,11,24,34
2061,15.288000000001295,2206.8125,53,6,13,59
2062,-25.119749999999136,2816.35,27,14,21,41
2063,-27.56824999999942,2121.6875,21,16,25,37
2064,-25.511249999999713,1652.1764705882354,20,14,26,34
2065,-15.175499999998618,2198.470588235294,30,14,23,44
2066,-22.66050000000006,1429.0,21,19,20,40
2067,-17.869999999999116,2703.6,22,9,22,31
2068,-17.884249999999952,2094.8947368421054,32,13,26,45
2069,1.3135000000025479,2564.9444444444443,45,7,24,52
2070,-36.64574999999964,1828.7058823529412,15,10,24,25
2071,-18.065999999998986,2757.4210526315787,27,12,26,39
2072,-10.310749999998185,2677.4117647058824,48,6,22,54
2073,-19.473499999999525,2629.222222222222,21,17,15,38
2074,-21.750499999997768,4921.05,51,20,16,71
2075,-19.78774999999928,2314.3888888888887,26,17,28,43
2076,-24.319999999999176,4578.3,32,11,26,43
2077,-3.231999999999298,3556.0555555555557,50,14,20,64
2078,-30.0849999999992,2072.8333333333335,9,15,24,24
2079,-0.280249999998774,2173.3529411764707,24,10,32,34
2080,-39.97224999999933,1429.0,8,9,30,17
2081,-26.61749999999885,1528.25,20,1,32,21
2082,-3.888999999997668,3658.5,44,14,22,58
2083,-6.697749999999219,1897.25,27,12,23,39
2084,-32.30649999999966,3046.4210526315787,19,13,41,32
2085,-13.81274999999874,1951.0,31,6,23,37
2086,-24.739249999998304,1814.0,30,9,23,39
2087,-18.50649999999901,2593.45,28,10,14,38
2088,-15.903249999997877,2228.4117647058824,35,12,22,47
2089,-19.501249999999164,2591.157894736842,23,16,22,39
2090,2.3007500000001055,3160.0,46,13,23,59
2091,14.869000000002092,3679.4444444444443,64,5,31,69
2092,-4.220249999999128,3312.35,34,7,23,41
2093,-27.40749999999943,1429.0,15,10,36,25
2094,-23.237249999999992,3272.7894736842104,35,23,17,58
2095,-34.32324999999936,3069.8947368421054,28,14,38,42
2096,-16.79149999999881,2760.7368421052633,33,9,25,42
2097,-18.602249999999536,2227.4117647058824,35,23,24,58
2098,5.606750000002875,2394.375,55,2,30,57
2099,-18.870999999998695,2735.9444444444443,33,10,16,43
2100,-4.348249999998883,3529.05,34,12,23,46
2101,-20.28224999999961,2373.5,27,24,15,51
2102,-12.691249999999247,3472.222222222222,54,14,21,68
2103,-26.51824999999888,2730.7368421052633,23,10,20,33
2104,-21.28099999999899,2538.235294117647,52,14,34,66
2105,0.1345000000021214,3078.1111111111113,42,17,18,59
2106,-21.128499999999285,2072.777777777778,22,15,12,37
2107,-11.073749999999176,3267.8947368421054,43,5,27,48
2108,11.608000000002184,4922.0,67,9,20,76
2109,-14.520499999998407,2641.0,37,18,19,55
2110,-7.430249999999082,2353.625,48,6,29,54
2111,-4.986749999998826,2704.1111111111113,36,6,30,42
2112,-12.602249999999495,3133.2631578947367,42,18,19,60
2113,-14.351249999999684,2148.0588235294117,28,7,23,35
2114,-21.625749999999375,2543.4736842105262,23,16,16,39
2115,-22.931999999999384,3448.15,23,9,27,32
2116,-8.562499999999313,2798.5,51,18,17,69
2117,5.597750000000341,2735.8888888888887,52,10,22,62
2118,-0.24474999999993088,2005.4375,53,9,17,62
2119,-23.46049999999851,3030.7,23,20,22,43
2120,-3.810749999998418,2205.8125,38,7,30,45
2121,-13.522999999999513,2944.5789473684213,38,9,24,47
2122,-25.285999999997664,1542.125,31,6,31,37
2123,-8.935499999998964,4225.9,43,13,18,56
2124,-31.95099999999885,2332.823529411765,23,7,31,30
2125,-2.8249999999982434,2604.5555555555557,37,6,29,43
2126,-12.961499999999054,3309.2,34,10,24,44
2127,-28.478499999998792,3818.75,27,7,29,34
2128,-28.757999999998752,2873.4444444444443,27,5,29,32
2129,6.791750000001882,3537.5,57,2,18,59
2130,6.321000000003343,2203.1176470588234,50,3,37,53
2131,-14.3759999999999,2719.0,39,5,23,44
2132,4.131250000001503,2294.6470588235293,48,13,17,61
2133,-36.17599999999898,2461.722222222222,21,16,19,37
2134,-2.0034999999992054,3282.6666666666665,51,4,20,55
2135,-33.735499999999156,2651.3,17,5,24,22
2136,-4.672749999998271,2895.9411764705883,59,7,27,66
2137,-38.40549999999904,2592.1666666666665,28,9,24,37
2138,4.544500000001067,4119.210526315789,48,14,22,62
2139,-20.552749999998838,3594.4736842105262,41,8,33,49
2140,-17.705499999999052,2644.2,21,10,23,31
2141,-5.059249999997004,4018.1052631578946,60,7,26,67
2142,-32.33174999999935,2671.15,20,16,15,36
2143,-26.195999999999856,2106.0,26,23,16,49
2144,-32.28099999999946,2545.3888888888887,24,19,20,43
2145,-10.226499999999,2403.823529411765,40,10,19,50
2146,-20.82499999999894,2582.235294117647,36,12,17,48
2147,-23.18149999999941,2790.1,22,12,19,34
2148,-2.9364999999995613,3298.6111111111113,48,17,23,65
2149,-21.013249999999342,1660.5882352941176,21,6,24,27
2150,0.9842500000018661,4764.9473684210525,73,22,10,95
2151,-16.95449999999962,2965.222222222222,32,9,28,41
2152,-10.130749999999473,3028.6666666666665,44,12,33,56
2153,-15.354749999998372,3666.4,39,10,19,49
2154,-2.4367499999988462,3500.5,55,8,22,63
2155,-37.50374999999967,2187.5,11,7,26,18
2156,-33.73374999999969,2093.35,14,12,15,26
2157,-4.648749999999353,3258.6315789473683,40,11,30,51
2158,-32.29174999999882,1976.235294117647,23,10,20,33
2159,-6.21424999999831,2493.625,44,18,18,62
2160,-20.035999999999127,3102.4210526315787,50,7,20,57
2161,4.6197500000012734,3555.0555555555557,53,8,18,61
2162,-14.979999999999247,2936.9444444444443,31,12,21,43
2163,-22.95799999999857,2134.0588235294117,32,12,16,44
2164,-16.473249999999233,3724.7894736842104,42,17,25,59
2165,-26.280999999999644,1966.8235294117646,29,20,13,49
2166,-16.692499999999338,2412.235294117647,29,22,15,51
2167,-35.2682499999987,2326.722222222222,21,8,28,29
2168,-15.472999999999228,3282.842105263158,34,14,21,48
2169,-7.510749999999549,4673.4,47,13,14,60
2170,-10.164749999998588,3407.2631578947367,32,7,25,39
2171,-26.22450000000011,1429.0,32,10,17,42
2172,-24.831749999998763,3162.684210526316,36,20,29,56
2173,-22.111499999999594,2273.8333333333335,23,14,18,37
2174,-16.04074999999908,2155.722222222222,24,11,23,35
2175,-6.835499999999456,2211.75,45,9,15,54
2176,-16.613249999998782,3038.5,35,15,22,50
2177,-10.190249999997846,2932.842105263158,44,8,19,52
2178,-3.6652499999986574,2549.1111111111113,58,10,24,68
2179,-3.730749999999081,3918.5555555555557,44,8,19,52
2180,-15.348000000000104,1687.9375,24,27,15,51
2181,-4.580249999998765,3930.7,45,10,15,55
2182,-24.40924999999924,2687.4444444444443,35,8,19,43
2183,-26.018999999999625,2452.4210526315787,19,16,18,35
2184,-32.237249999998696,2271.3888888888887,22,7,30,29
2185,1.60175000000095,1496.5,37,11,24,48
2186,-4.033499999998328,2846.1111111111113,43,12,32,55
2187,-20.039499999999748,1429.0,23,18,30,41
2188,-22.22874999999984,2192.684210526316,20,13,23,33
2189,-25.48949999999883,2280.0,24,11,22,35
2190,-22.823249999999284,1670.0625,33,17,33,50
2191,-31.82574999999887,1639.3125,18,19,17,37
2192,-22.017249999998914,1728.625,31,13,27,44
2193,-11.831999999998867,1916.125,44,19,14,63
2194,-13.631999999999021,3555.2105263157896,43,16,15,59
2195,-0.5712499999996343,2865.6111111111113,48,12,20,60
2196,-14.071749999998985,2009.3125,60,13,20,73
2197,-21.273499999999185,3350.4736842105262,37,12,35,49
2198,-31.11375000000018,1429.0,25,9,29,34
2199,12.80750000000081,3505.2105263157896,48,10,14,58
2200,-31.534999999999123,2900.0555555555557,29,13,23,42
2201,-13.349500000000068,2076.0588235294117,27,11,26,38
2202,-0.707999999999394,3052.5,61,14,18,75
2203,-31.561749999997353,2119.5555555555557,40,14,20,54
2204,-25.18374999999865,1925.125,36,8,22,44
2205,-6.235999999998976,2795.0,27,19,15,46
2206,-6.421249999998819,2784.3888888888887,34,7,24,41
2207,-13.06224999999877,3273.6315789473683,36,7,19,43
2208,-40.66675000000005,1870.0,10,9,47,19
2209,-6.848249999997319,3329.9411764705883,67,5,23,72
2210,-3.092499999998701,2398.3125,54,8,21,62
2211,-8.062999999999372,2271.3333333333335,29,14,16,43
2212,1.0532500000011427,2937.8823529411766,50,13,22,63
2213,-16.315999999999242,2518.5789473684213,29,16,11,45
2214,-15.357749999999054,3079.95,32,7,18,39
2215,-20.645999999999425,2293.7894736842104,26,7,21,33
2216,-5.819499999999386,3527.684210526316,54,10,24,64
2217,-30.95824999999931,2681.315789473684,34,10,28,44
2218,-13.287249999998718,2660.6470588235293,37,15,22,52
2219,22.129000000002264,4643.736842105263,71,10,19,81
2220,-3.1879999999983055,3908.45,43,7,18,50
2221,-12.644249999998154,2514.8823529411766,43,5,32,48
2222,-25.159749999998567,2181.705882352941,22,12,31,34
2223,2.6565000000016012,2501.0,54,11,18,65
2224,-5.770499999999168,3290.4736842105262,42,9,25,51
2225,6.685250000000747,4531.45,53,9,22,62
2226,-25.005999999999425,2922.75,15,11,23,26
2227,-10.935999999997625,2422.0,42,8,20,50
2228,-18.363249999999546,2366.6470588235293,35,13,18,48
2229,-20.934999999999732,1933.235294117647,24,16,23,40
2230,-30.51249999999889,1429.0,10,7,32,17
2231,-29.591249999999377,2059.125,24,10,21,34
2232,6.181000000001766,3078.8823529411766,55,19,18,74
2233,-6.888749999999651,3320.5263157894738,46,15,24,61
2234,-6.582499999998413,2790.842105263158,36,11,17,47
2235,-21.30449999999948,2639.35,15,18,19,33
2236,-5.98874999999895,4676.315789473684,46,13,25,59
2237,-25.450749999999648,2584.277777777778,17,5,32,22
2238,-42.46674999999898,2735.7894736842104,18,7,30,25
2239,-15.195249999999822,2172.3529411764707,24,15,13,39
2240,-20.67075000000015,2211.277777777778,25,10,24,35
2241,-20.631999999999657,1429.0,21,6,26,27
2242,-15.283499999999176,2522.684210526316,31,10,11,41
2243,-8.109999999999877,1978.1176470588234,40,17,21,57
2244,-0.9787499999987656,3114.157894736842,35,5,25,40
2245,-17.613749999998543,3252.8,38,7,23,45
2246,-23.31150000000013,2037.5,39,12,39,51
2247,-10.296249999999928,2171.5555555555557,31,15,16,46
2248,-8.634499999999248,3414.842105263158,38,5,22,43
2249,-12.54374999999898,2941.4444444444443,53,8,19,61
2250,-6.625999999999536,3719.0,49,13,22,62
2251,-8.529749999998515,2304.0,33,11,25,44
2252,-7.98224999999813,3060.5,42,19,23,61
2253,-0.5479999999987429,2986.5,37,12,20,49
2254,-13.635249999998962,3547.25,33,10,21,43
2255,-17.00699999999878,4552.05,53,6,29,59
2256,-13.64199999999875,3195.05,45,4,20,49
2257,11.676000000000336,3927.3888888888887,67,7,21,74
2258,-16.010749999999312,2160.1176470588234,32,14,17,46
2259,-13.831749999999275,2775.85,30,2,23,32
2260,-17.88099999999944,3087.4210526315787,30,17,31,47
2261,-3.962999999998157,2236.705882352941,39,10,21,49
2262,-0.23149999999806567,3983.7894736842104,52,19,20,71
2263,-33.784499999998545,2565.315789473684,16,13,27,29
2264,1.32325000000173,4309.684210526316,55,15,19,70
2265,-8.634249999998051,2712.1666666666665,41,4,24,45
2266,-8.409499999997704,4625.9,51,20,26,71
2267,-44.781999999999144,2072.8888888888887,11,8,32,19
2268,15.522250000001865,2657.3125,94,16,16,110
2269,-48.51175000000016,2084.277777777778,10,15,37,25
2270,0.49900000000101485,4298.05,41,9,13,50
2271,-3.5684999999986013,3945.315789473684,52,4,29,56
2272,-9.735999999998786,3792.6,48,8,20,56
2273,-28.13149999999947,2849.6111111111113,33,8,32,41
2274,1.6922500000030194,2121.5625,69,8,29,77
2275,-27.733749999999638,2500.5,30,18,16,48
2276,5.409000000001443,2005.4375,56,12,19,68
2277,-14.69624999999991,2193.705882352941,34,24,22,58
2278,-5.078749999998161,3926.4444444444443,56,10,18,66
2279,-26.693749999998545,4241.8,42,15,18,57
2280,-31.10549999999933,3338.0,38,9,22,47
2281,-19.150749999999338,2112.5,22,5,23,27
2282,-9.17124999999811,3986.2631578947367,51,6,20,57
2283,-36.00799999999889,1429.0,13,8,29,21
2284,-18.60124999999964,2330.277777777778,45,12,28,57
2285,-4.86199999999923,3135.4444444444443,35,12,22,47
2286,-18.016499999999336,2193.764705882353,40,16,19,56
2287,-24.3702499999982,2072.8333333333335,29,16,17,45
2288,-6.744249999999434,2807.235294117647,39,16,20,55
2289,-13.59449999999909,3051.6315789473683,33,9,28,42
2290,-8.219249999999482,3826.0,51,22,21,73
2291,22.932000000001718,2679.25,64,20,17,84
2292,-19.03199999999893,2275.9411764705883,30,5,33,35
2293,16.92825000000199,3647.8333333333335,54,8,19,62
2294,-30.097749999999763,1481.9333333333334,30,9,20,39
2295,-49.82699999999993,2496.294117647059,41,14,30,55
2296,12.245750000002676,4219.166666666667,74,9,23,83
2297,-33.816999999999425,1964.75,21,8,22,29
2298,-22.620249999999352,3456.05,35,14,14,49
2299,-18.110999999999564,3701.35,25,13,21,38
2300,-28.563499999999106,3502.05,30,15,23,45
2301,-30.46299999999947,2684.6,8,19,22,27
2302,-8.017999999997121,3001.470588235294,51,5,30,56
2303,-20.088499999999822,1871.5,24,10,25,34
2304,10.410000000001645,3005.0,58,7,27,65
2305,-22.444499999998772,2988.8947368421054,33,5,24,38
2306,-5.81324999999728,2982.0,63,15,16,78
2307,0.6175000000004257,3445.0,60,9,22,69
2308,-15.957999999998586,3850.1052631578946,49,5,29,54
2309,-5.841749999997775,2394.4117647058824,44,8,22,52
2310,-1.5647499999985843,2817.5789473684213,37,4,24,41
2311,-18.368999999999275,2898.05,22,17,14,39
2312,-25.121749999999942,2143.4375,26,14,34,40
2313,-36.92099999999893,1429.0,15,20,16,35
2314,-16.716749999998793,3779.2105263157896,44,17,24,61
2315,-0.4387500000000342,2832.4117647058824,50,11,22,61
2316,-8.745249999998368,2924.8823529411766,45,6,25,51
2317,6.619000000001618,3385.8333333333335,65,9,16,74
2318,-19.243749999999054,2485.8947368421054,29,14,11,43
2319,-24.047499999999214,2097.5,22,3,24,25
2320,-21.15249999999788,2497.235294117647,42,4,23,46
2321,3.0970000000019104,2959.8888888888887,49,16,12,65
2322,16.918750000000834,3989.7368421052633,58,7,15,65
2323,-17.78549999999874,3488.5,37,13,21,50
2324,1.569750000001664,1929.6,59,12,24,71
2325,-7.36649999999851,5239.35,45,5,23,50
2326,9.673750000000823,2720.1111111111113,40,10,15,50
2327,-13.3989999999981,2808.277777777778,30,15,27,45
2328,3.0615000000018795,4640.15,61,6,14,67
2329,1.0422500000006945,2886.5882352941176,46,8,25,54
2330,-1.197249999998173,3366.3684210526317,43,4,20,47
2331,-23.639499999999217,2696.5,25,15,16,40
2332,-2.8659999999991053,3325.9444444444443,55,24,12,79
2333,4.052500000001074,3927.842105263158,49,6,17,55
2334,-5.383999999999046,2504.8888888888887,34,7,28,41
2335,-43.06824999999922,2642.9473684210525,28,14,24,42
2336,12.27900000000099,3386.0555555555557,53,2,23,55
2337,-12.267249999998592,3637.0526315789475,42,9,19,51
2338,-17.187250000000304,2556.9444444444443,28,12,28,40
2339,-35.60349999999916,2420.222222222222,32,13,25,45
2340,-20.631499999999104,3135.4,35,6,27,41
2341,-12.321249999997583,3241.9473684210525,34,12,28,46
2342,-12.097499999999414,2749.1052631578946,40,14,16,54
2343,-11.279249999998727,3242.65,39,8,19,47
2344,-9.8282499999988,2153.5882352941176,36,14,16,50
2345,-27.1377499999995,1429.0,20,8,22,28
2346,-0.7842499999987564,2900.529411764706,47,11,16,58
2347,-29.468249999999006,3017.15,21,20,20,41
2348,-2.149749999998749,2258.0,33,17,20,50
2349,-9.430249999998496,5210.85,64,6,16,70
2350,10.994750000002039,3706.777777777778,53,10,14,63
2351,-20.836249999998078,2223.6111111111113,35,8,20,43
2352,-8.262499999999239,2556.1666666666665,35,18,18,53
2353,-7.068999999999801,2387.0,56,15,16,71
2354,-4.895249999999803,1429.0,25,8,26,33
2355,6.775000000000306,2000.5625,58,15,15,73
2356,-16.391249999998273,2106.0588235294117,23,11,33,34
2357,-27.150499999998793,1559.0,24,11,23,35
2358,-31.458999999999424,3138.65,19,7,26,26
2359,7.357250000001477,4252.05,52,11,9,63
2360,4.544500000000291,3144.1666666666665,41,9,27,50
2361,4.210250000000503,3677.157894736842,47,8,26,55
2362,-48.27524999999925,1429.0,0,14,25,14
2363,-12.422249999998844,3560.1,30,6,28,36
2364,-13.709999999999392,1853.6875,29,17,18,46
2365,-24.563499999999074,2232.0588235294117,25,17,24,42
2366,-8.004749999997502,4404.45,49,9,27,58
2367,-34.91199999999961,2654.6315789473683,17,11,24,28
2368,8.510500000000892,2152.25,59,12,23,71
2369,-4.22899999999874,3722.2105263157896,58,17,17,75
2370,-20.4102499999996,2219.1111111111113,20,7,22,27
2371,-1.30174999999906,2263.277777777778,36,3,17,39
2372,-5.752499999998576,3164.823529411765,54,5,23,59
2373,-22.229249999999567,2906.05,30,11,17,41
2374,-13.355499999999083,2257.235294117647,41,9,31,50
2375,-20.483249999999803,2170.1052631578946,22,19,20,41
2376,-8.667999999999463,2719.0,30,7,18,37
2377,-18.460999999998428,3370.0,34,17,26,51
2378,-25.935499999998807,1791.2941176470588,18,5,32,23
2379,-22.265499999998504,2703.8947368421054,32,8,24,40
2380,-6.773999999999053,4138.65,35,14,28,49
2381,-32.36674999999907,2295.4210526315787,22,17,10,39
2382,-15.559999999999741,2193.823529411765,29,16,18,45
2383,-5.79999999999923,3613.7368421052633,51,12,23,63
2384,-21.413999999999255,2651.315789473684,39,7,21,46
2385,-33.53674999999974,1429.0,12,14,17,26
2386,-10.728999999998623,3643.7894736842104,50,12,25,62
2387,-16.924249999998523,1481.9333333333334,31,8,23,39
2388,-4.691999999999186,2489.0,47,12,33,59
2389,-9.135999999999143,3358.1052631578946,36,20,25,56
2390,-7.200249999999319,3806.8,27,21,16,48
2391,3.4247500000013615,3993.35,50,11,18,61
2392,-19.731749999999913,2159.3333333333335,42,7,28,49
2393,-6.87699999999906,4365.5,48,2,22,50
2394,-2.375999999998966,3152.1666666666665,51,10,20,61
2395,-13.921499999997888,2866.5,42,4,32,46
2396,-22.031499999998406,2658.7894736842104,32,11,22,43
2397,-20.28824999999926,2181.6470588235293,20,5,23,25
2398,-27.451999999999988,2000.4117647058824,18,9,29,27
2399,-36.37224999999952,1581.235294117647,6,7,30,13
2400,-27.291249999999945,2754.4444444444443,22,10,30,32
2401,17.37650000000249,3685.722222222222,61,15,21,76
2402,-28.905749999998186,2038.764705882353,44,12,17,56
2403,-10.320749999998315,1617.5625,36,14,16,50
2404,-21.42674999999945,3023.1052631578946,26,12,18,38
2405,-16.023999999999077,2546.0,33,13,22,46
2406,-11.812749999998896,3882.7368421052633,54,6,31,60
2407,-15.747000000000691,1429.0,32,21,29,53
2408,-16.362499999999176,3048.1,31,12,13,43
2409,-18.476750000000706,1429.0,22,24,22,46
2410,-17.36299999999951,2606.1052631578946,22,12,26,34
2411,-9.309499999999392,2194.705882352941,46,16,16,62
2412,-12.77649999999867,1675.0625,29,12,25,41
2413,-24.890499999999435,2819.3684210526317,24,10,18,34
2414,-8.61074999999878,3249.4736842105262,41,8,22,49
2415,-8.688249999997797,1903.25,41,4,33,45
2416,-2.7812499999984666,3696.4736842105262,53,6,26,59
2417,-22.03574999999985,1949.3333333333333,24,14,20,38
2418,-8.566249999998384,4052.3684210526317,38,14,22,52
2419,-19.416749999998622,2014.375,37,17,22,54
2420,3.320250000000852,2836.1176470588234,51,6,27,57
2421,12.648000000000906,4410.631578947368,59,14,15,73
2422,-1.6467499999985815,2268.3125,44,13,24,57
2423,-20.7569999999988,3383.05,33,12,26,45
2424,-25.993999999999073,2149.2105263157896,22,6,27,28
2425,-36.39449999999944,2394.6666666666665,13,12,28,25
2426,-19.125750000000174,2105.7894736842104,26,19,15,45
2427,-10.881749999998075,2576.5882352941176,42,10,30,52
2428,-30.84899999999942,2199.9444444444443,23,9,15,32
2429,-22.371499999999806,2749.0526315789475,24,6,33,30
2430,15.806250000000443,3481.7368421052633,52,6,22,58
2431,-13.326499999999522,2271.235294117647,26,10,21,36
2432,-21.648499999998947,2113.5882352941176,27,7,27,34
2433,-27.92399999999959,2295.0555555555557,30,14,34,44
2434,-21.85324999999829,5201.3,50,15,26,65
2435,-26.23225000000018,1429.0,17,12,23,29
2436,-16.220499999999458,2772.0555555555557,38,6,37,44
2437,-13.46324999999861,3805.25,48,7,14,55
2438,2.124750000001412,2669.0,44,10,33,54
2439,-31.44024999999889,2919.65,25,10,20,35
2440,-15.900249999999295,2876.842105263158,32,13,14,45
2441,-24.150499999998228,2727.0555555555557,41,9,19,50
2442,-17.789749999998904,2703.3333333333335,43,19,15,62
2443,-0.5379999999978315,4594.25,55,7,22,62
2444,-25.646499999999083,3124.3,25,1,32,26
2445,-0.46699999999793745,2885.0,37,21,22,58
2446,-21.663749999999535,2736.95,23,4,23,27
2447,-22.427749999999442,2798.5555555555557,39,7,22,46
2448,-2.0129999999980166,1796.125,45,3,23,48
2449,-2.1339999999979424,4970.4,55,6,24,61
2450,-23.624250000000043,3426.5789473684213,22,9,22,31
2451,-20.913499999998628,3133.85,34,13,13,47
2452,-25.909499999999987,2297.0,12,11,27,23
2453,-4.247999999998226,5151.3,62,13,17,75
2454,2.5997500000009444,2343.8125,53,13,15,66
2455,-14.87149999999949,3298.05,30,11,19,41
2456,-20.071249999999537,2219.1666666666665,32,15,21,47
2457,-16.67549999999887,2376.1666666666665,25,13,21,38
2458,-2.0407499999989467,4143.4,54,15,17,69
2459,-3.8009999999985262,5792.55,55,10,23,65
2460,-30.65899999999964,1429.0,19,16,17,35
2461,-28.072999999999666,2825.8888888888887,43,18,21,61
2462,-12.080999999999566,2063.9411764705883,46,11,36,57
2463,-40.89100000000033,1982.6875,28,30,19,58
2464,-7.648749999998398,3281.315789473684,46,8,16,54
2465,-23.84774999999967,4592.6,42,13,22,55
2466,-22.74524999999868,2027.1875,37,10,18,47
2467,-16.18399999999901,2452.0,31,8,22,39
2468,-9.170999999998994,2974.5789473684213,30,9,28,39
2469,-27.025999999999364,2341.4117647058824,29,13,14,42
2470,2.5410000000000124,2224.529411764706,35,12,20,47
2471,-10.406749999998718,3580.2631578947367,46,10,25,56
2472,8.834250000000758,3725.5789473684213,69,9,21,78
2473,-14.94099999999936,3592.1052631578946,36,16,19,52
2474,-1.2182499999985374,4500.5,53,8,21,61
2475,29.642500000001906,3946.3529411764707,75,7,22,82
2476,-11.129249999999889,2412.3333333333335,36,14,19,50
2477,-6.021999999998954,2650.4444444444443,39,7,14,46
2478,-14.54849999999883,3403.2105263157896,34,18,16,52
2479,-19.749749999999494,2608.5,21,13,14,34
2480,-5.432249999998993,4061.5263157894738,54,23,17,77
2481,-33.43949999999931,1782.25,18,12,26,30
2482,-0.5767499999984576,2937.8823529411766,55,12,23,67
2483,-19.731999999999328,2735.0555555555557,28,17,18,45
2484,-34.66874999999977,2095.6666666666665,19,19,18,38
2485,-8.213999999999068,1666.1875,33,12,24,45
2486,-29.040499999999362,2060.3888888888887,28,7,22,35
2487,-23.020749999999012,1911.1875,26,24,17,50
2488,1.058250000001708,4697.263157894737,69,15,22,84
2489,-10.744749999998639,3314.5789473684213,34,8,16,42
2490,-16.29324999999917,2594.8888888888887,43,16,19,59
2491,-15.718249999997502,2110.6470588235293,43,8,23,51
2492,-11.646749999999944,1631.375,26,3,28,29
2493,-0.7154999999992393,2579.777777777778,39,14,15,53
2494,-24.951499999999253,2116.9444444444443,17,15,17,32
2495,-22.395249999997937,2002.3529411764705,37,5,25,42
2496,-24.91324999999897,2707.157894736842,23,14,23,37
2497,17.620750000002918,3926.157894736842,62,8,23,70
2498,-14.280249999999137,3334.65,32,23,14,55
2499,-24.664999999998567,2255.4444444444443,27,10,23,37
2500,-11.760249999997999,1994.8823529411766,39,12,18,51
2501,-22.017499999998165,3966.2105263157896,50,15,15,65
2502,-14.384749999999613,2227.1666666666665,24,12,17,36
2503,-14.57474999999894,2930.777777777778,33,6,26,39
2504,-9.789999999998537,3215.722222222222,33,14,17,47
2505,-27.713999999998258,1969.75,40,9,31,49
2506,0.6837500000001178,3583.6315789473683,36,7,23,43
2507,-20.02649999999893,2584.222222222222,37,9,20,46
2508,-2.3969999999985045,3794.157894736842,45,4,23,49
2509,-2.1489999999992158,3343.0526315789475,39,10,18,49
2510,-17.438499999999713,2401.6666666666665,35,4,25,39
2511,-18.271499999999925,3282.2,25,11,21,36
2512,-34.56824999999899,2131.235294117647,33,20,22,53
2513,-34.171999999998725,2143.4210526315787,20,16,22,36
2514,-20.1002499999995,2846.1666666666665,34,10,19,44
2515,-30.98899999999922,2666.4210526315787,22,8,24,30
2516,-13.324749999999531,2922.0526315789475,38,7,32,45
2517,15.357500000002668,4174.263157894737,57,8,19,65
2518,-20.02249999999959,2079.8888888888887,29,11,21,40
2519,-14.07474999999879,3352.15,34,18,16,52
2520,0.30600000000185157,3589.5263157894738,48,7,22,55
2521,-38.826249999998836,1986.2631578947369,10,7,33,17
2522,3.430250000000755,2518.3125,62,7,22,69
2523,7.727750000002894,2882.277777777778,51,5,26,56
2524,-4.42699999999933,2560.5555555555557,36,11,22,47
2525,-27.720999999999584,1524.25,17,11,23,28
2526,7.5127500000024225,2455.176470588235,45,6,25,51
2527,-24.272749999998968,1555.0625,19,2,28,21
2528,-22.602749999998665,2691.0,29,15,22,44
2529,-18.091249999999278,2279.1666666666665,25,14,14,39
2530,-9.988999999998587,1862.5625,40,12,23,52
2531,-9.698999999998007,4337.05,50,16,26,66
2532,-13.973749999998745,2790.8947368421054,26,14,24,40
2533,4.352500000002034,2732.6470588235293,49,6,21,55
2534,-19.739249999998712,4368.8421052631575,41,14,27,55
2535,-25.792249999998905,2304.0,25,6,27,31
2536,-20.65349999999948,2672.9,24,10,14,34
2537,-9.570999999998945,3414.0526315789475,32,8,23,40
2538,28.40500000000108,6251.2,71,15,20,86
2539,-0.8174999999976746,2840.823529411765,54,18,11,72
2540,-9.515499999999182,3321.4444444444443,44,19,16,63
2541,3.9467500000016607,4798.85,53,19,15,72
2542,-2.603249999997809,5114.85,63,9,15,72
2543,-20.310499999999074,3321.95,32,9,21,41
2544,-21.867999999999483,3573.5,32,5,34,37
2545,-7.325249999998907,1576.875,45,11,24,56
2546,-29.041999999998342,2529.9411764705883,34,11,22,45
2547,-6.545749999998755,2460.764705882353,41,9,21,50
2548,-18.27424999999831,3425.684210526316,41,7,26,48
2549,-44.82174999999989,2192.5789473684213,12,8,35,20
2550,6.578250000000805,2064.1176470588234,41,2,26,43
2551,-9.04100000000015,2403.8823529411766,47,15,25,62
2552,-36.705499999999944,1429.0,13,6,23,19
2553,17.03200000000073,1987.5625,59,8,16,67
2554,-17.700249999999752,3474.9473684210525,41,14,21,55
2555,-2.675499999996782,2382.277777777778,52,9,25,61
2556,-9.08524999999926,2664.294117647059,51,20,17,71
2557,-15.763499999999164,3084.842105263158,38,17,21,55
2558,-13.804499999999546,2671.4210526315787,31,23,9,54
2559,18.327750000002403,4556.0,61,4,20,65
2560,10.064750000001975,4711.526315789473,60,11,18,71
2561,-20.518249999998854,2737.722222222222,30,3,36,33
2562,-37.92474999999954,2190.1,12,10,20,22
2563,-9.786499999998409,3347.157894736842,33,13,16,46
2564,-32.77474999999931,1528.25,16,9,19,25
2565,3.429000000001526,4101.35,48,3,26,51
2566,1.0255000000011303,3744.9,46,12,13,58
2567,2.8217500000015363,4217.95,44,4,26,48
2568,4.176000000002086,2437.9375,56,18,20,74
2569,-18.023499999999082,2756.1666666666665,30,11,28,41
2570,-12.987249999998657,3784.6,42,15,14,57
2571,-12.90174999999895,2201.9375,38,16,8,54
2572,-0.32224999999767245,2396.5,43,15,15,58
2573,4.3055000000022225,4204.45,56,8,21,64
2574,-18.392249999998384,2176.0555555555557,16,17,29,33
2575,-23.72750000000033,2828.3684210526317,39,8,26,47
2576,-39.02625000000078,1429.0,21,9,40,30
2577,-12.466499999999163,2120.4444444444443,24,12,18,36
2578,-12.61899999999856,2987.2105263157896,39,10,21,49
2579,-5.287249999999489,2925.5,52,5,21,57
2580,-24.681499999998326,3727.45,41,15,17,56
2581,-2.8944999999994385,4067.3684210526317,68,4,21,72
2582,1.659000000000703,4420.736842105263,58,14,18,72
2583,-0.4249999999977193,2441.0,58,8,15,66
2584,-14.833749999999188,3003.1111111111113,42,11,19,53
2585,-29.522499999999173,1680.0625,19,3,29,22
2586,-13.258999999999336,2706.777777777778,45,6,28,51
2587,-3.0072499999995728,3038.8947368421054,36,10,25,46
2588,-6.498999999998676,3953.7894736842104,54,5,27,59
2589,-20.797499999998184,2358.5555555555557,26,14,22,40
2590,-4.803249999999636,2509.5882352941176,55,9,24,64
2591,-15.813750000000272,2619.5555555555557,37,16,25,53
2592,3.457750000001762,4188.421052631579,53,15,15,68
2593,-16.07149999999958,2444.9444444444443,34,18,19,52
2594,-11.074999999998933,3428.2105263157896,35,5,30,40
2595,-22.895499999999238,4026.6,30,9,22,39
2596,-32.38974999999909,2469.157894736842,23,26,12,49
2597,-18.483499999998703,2676.3684210526317,28,12,24,40
2598,-30.351249999998977,3315.55,33,12,19,45
2599,-2.8809999999987097,4028.15,48,9,17,57
2600,-15.6769999999991,2350.5,27,4,21,31
2601,21.730500000000685,4852.05,61,5,20,66
2602,9.520250000001916,4934.65,61,8,14,69
2603,-6.345249999999631,3245.2105263157896,44,8,25,52
2604,-7.288499999999834,2623.9444444444443,37,11,18,48
2605,-21.77074999999909,2460.0,28,11,17,39
2606,16.45425000000123,3992.5555555555557,56,23,13,79
2607,-7.281749999998676,3553.5789473684213,54,11,24,65
2608,-13.191749999999065,2504.705882352941,46,27,14,73
2609,-8.64900000000003,2667.1111111111113,44,10,15,54
2610,-20.804750000000517,2059.294117647059,41,24,20,65
2611,-8.833249999998724,2147.8333333333335,45,21,17,66
2612,-13.86449999999908,3042.2631578947367,41,4,23,45
2613,-14.504249999997928,3744.1052631578946,44,9,29,53
2614,-11.302499999999636,2683.0555555555557,33,13,26,46
2615,-10.915499999998225,2587.7368421052633,32,14,24,46
2616,1.3947500000010902,2348.6875,48,22,17,70
2617,-17.276249999999173,1904.2941176470588,22,9,26,31
2618,2.4430000000029426,2463.6470588235293,53,16,25,69
2619,-2.435999999999282,2696.9375,57,9,29,66
2620,-8.914249999998201,3005.5789473684213,37,15,19,52
2621,-0.3099999999979442,2618.5882352941176,53,17,14,70
2622,-34.9012500000006,2269.4117647058824,48,16,23,64
2623,2.6970000000000476,2395.470588235294,72,14,19,86
2624,-10.448749999998421,2354.3529411764707,21,18,28,39
2625,-16.211749999999135,3110.7368421052633,48,14,25,62
2626,-8.66224999999844,3079.9,31,14,20,45
2627,-28.456499999999487,3135.5,33,10,26,43
2628,-17.8349999999988,3702.9,34,18,22,52
2629,-9.5199999999991,2824.157894736842,35,8,15,43
2630,-13.22999999999916,2452.8333333333335,31,13,17,44
2631,10.402750000000927,2032.25,58,7,30,65
2632,-6.90524999999847,3810.75,52,11,13,63
2633,-13.089999999999923,2664.3529411764707,67,7,27,74
2634,0.6810000000001157,1559.0,39,8,23,47
2635,-41.57774999999917,1429.0,13,13,22,26
2636,-34.439749999999464,2969.5263157894738,33,13,20,46
2637,21.142500000003235,2967.9411764705883,64,4,27,68
2638,-22.46049999999874,1429.0,20,12,25,32
2639,-20.428999999998503,2362.8823529411766,36,19,12,55
2640,14.020500000000467,3059.294117647059,50,14,24,64
2641,-14.868249999999534,2546.0,27,8,23,35
2642,-3.0142499999988095,4019.684210526316,46,12,20,58
2643,-7.380000000000388,2025.8235294117646,39,5,28,44
2644,-11.489250000000007,2266.777777777778,38,8,18,46
2645,-30.76924999999887,2926.65,22,15,25,37
2646,-12.587749999999183,2933.4444444444443,46,8,24,54
2647,-25.044249999999437,2437.529411764706,23,10,25,33
2648,-24.540999999999066,3174.3,27,12,24,39
2649,-32.84174999999938,1429.0,11,6,27,17
2650,-22.1354999999985,3314.0,35,8,28,43
2651,1.42225000000007,3333.777777777778,61,14,18,75
2652,-33.82774999999991,1933.5555555555557,12,9,20,21
2653,-21.547249999999416,1429.0,36,5,31,41
2654,-19.85749999999899,2838.3333333333335,28,6,29,34
2655,-2.952499999999078,2727.1111111111113,44,7,25,51
2656,-5.748249999997983,4053.7,46,8,24,54
2657,-5.821249999997534,2144.294117647059,50,6,22,56
2658,-10.786999999999706,1429.0,39,10,24,49
2659,-11.734749999998204,3729.1,47,18,14,65
2660,-13.582999999998474,2103.625,37,5,31,42
2661,6.926250000001526,2669.0,47,13,18,60
2662,-30.742749999999575,2116.1111111111113,18,13,24,31
2663,-21.05149999999972,2297.8947368421054,37,13,24,50
2664,-15.096999999998928,3039.277777777778,47,9,23,56
2665,2.978250000001638,2996.823529411765,65,7,24,72
2666,-30.173999999998934,2073.6666666666665,23,6,28,29
2667,-4.942499999997943,1541.125,51,13,23,64
2668,-4.847749999998961,2324.470588235294,43,18,20,61
2669,-14.590249999998582,2454.176470588235,38,5,31,43
2670,-0.7349999999982344,4259.35,59,8,17,67
2671,4.772250000002404,2471.4444444444443,51,16,9,67
2672,-20.0457499999983,2354.3529411764707,23,5,38,28
2673,-31.539499999999993,1603.625,27,12,21,39
2674,-15.389750000000925,1438.5333333333333,48,25,30,73
2675,-10.536499999999743,2278.222222222222,38,13,21,51
2676,-14.451999999999137,2524.277777777778,28,7,27,35
2677,-29.14474999999924,3165.7,22,11,22,33
2678,-9.475499999999228,1996.8823529411766,41,8,24,49
2679,-20.35124999999929,2130.1666666666665,22,8,20,30
2680,1.6862500000007905,3508.4210526315787,54,7,28,61
2681,22.51775000000194,2858.6470588235293,53,10,17,63
2682,-3.762499999999528,2647.777777777778,35,14,19,49
2683,-20.60824999999984,2087.8333333333335,34,15,22,49
2684,-12.930250000000182,3012.8333333333335,54,11,20,65
2685,-1.8569999999992302,2594.0,38,10,27,48
2686,-17.785499999999736,2649.3529411764707,43,10,18,53
2687,10.096750000002109,5201.4,60,10,19,70
2688,-9.389249999998206,2545.823529411765,52,17,16,69
2689,2.5442499999999177,2824.0,62,19,14,81
2690,4.909250000001572,2887.470588235294,69,12,21,81
2691,-26.089249999999897,1639.3125,24,4,24,28
2692,-6.945249999999604,2265.6470588235293,35,5,30,40
2693,-1.0359999999985994,2560.4444444444443,32,12,29,44
2694,-17.947749999999708,2098.4444444444443,17,13,20,30
2695,-6.150499999998716,3193.6111111111113,47,10,23,57
2696,7.479000000001291,1835.875,41,19,22,60
2697,21.70275000000208,6147.35,72,11,22,83
2698,-19.711499999999237,2886.6666666666665,35,23,14,58
2699,-13.507250000000472,2101.3529411764707,25,9,37,34
2700,-16.591999999999306,2857.5882352941176,52,16,18,68
2701,-36.38074999999994,2405.222222222222,16,15,48,31
2702,-21.72049999999817,3611.2105263157896,35,17,25,52
2703,-23.254749999999135,2647.777777777778,42,15,20,57
2704,-13.982249999998396,2868.823529411765,35,26,16,61
2705,-0.2477499999997878,2770.277777777778,42,6,31,48
2706,-19.90349999999975,2921.9473684210525,24,14,26,38
2707,-31.144999999999573,2572.823529411765,31,10,21,41
2708,-20.932749999999242,2663.95,26,8,15,34
2709,-26.5899999999996,2101.3529411764707,35,12,36,47
2710,-17.810749999998155,2922.7894736842104,40,6,20,46
2711,-26.546749999999086,3087.0,25,11,17,36
2712,-13.376249999999036,4127.45,38,12,19,50
2713,-24.689999999999355,2448.315789473684,20,10,21,30
2714,-6.953749999999014,4109.105263157895,51,16,20,67
2715,-2.721499999997993,2396.4117647058824,44,17,14,61
2716,-13.959999999998795,3148.2631578947367,35,20,16,55
2717,-44.224499999999004,1628.388888888889,9,13,25,22
2718,-18.241999999998846,1572.8235294117646,18,16,22,34
2719,6.3870000000009854,4440.2,51,9,15,60
2720,-8.510999999998283,3175.9473684210525,47,4,27,51
2721,19.225750000002904,2197.9375,55,13,21,68
2722,-31.237499999998818,2122.1666666666665,19,6,30,25
2723,-27.501249999999725,2457.3333333333335,27,20,23,47
2724,-3.627499999998647,1817.9375,41,13,27,54
2725,-14.240749999998476,2610.176470588235,48,12,20,60
2726,-24.237499999999258,2125.6666666666665,23,7,21,30
2727,-10.416499999998894,4654.45,43,7,21,50
2728,21.49400000000233,4454.55,57,15,19,72
2729,-5.283499999998966,2484.1176470588234,67,8,20,75
2730,-27.68099999999825,2981.1666666666665,34,17,40,51
2731,-22.34124999999687,3399.7894736842104,45,8,29,53
2732,-16.222999999999214,2487.6315789473683,23,18,14,41
2733,-3.7384999999976416,4695.0,49,15,21,64
2734,-3.3087499999998093,3810.8888888888887,57,8,17,65
2735,-12.95199999999737,2803.0,38,13,24,51
2736,-17.564749999999716,2467.3529411764707,42,17,24,59
2737,-2.148749999998851,3622.7,38,6,18,44
2738,-21.389749999999143,3358.7894736842104,40,17,23,57
2739,1.4672500000009094,3824.277777777778,56,13,15,69
2740,-8.787749999998747,3189.2631578947367,37,11,23,48
2741,-4.8799999999995745,2681.3684210526317,43,11,18,54
2742,-35.592749999999214,2659.6315789473683,18,15,17,33
2743,-10.22224999999861,3982.157894736842,60,6,22,66
2744,-10.644499999999216,3719.0,50,18,17,68
2745,-2.0809999999991438,3093.4,31,9,21,40
2746,-17.524749999999198,3111.55,33,10,15,43
2747,-46.00900000000016,1429.0,12,4,22,16
2748,2.780750000001862,2924.722222222222,47,12,13,59
2749,-16.672749999997947,3814.0,51,7,17,58
2750,-28.96324999999853,2462.5555555555557,20,17,22,37
2751,1.6377500000015128,4833.8,61,12,13,73
2752,-9.763499999998217,3944.95,47,10,22,57
2753,-6.7149999999982395,4019.55,47,10,25,57
2754,-12.343249999998852,2925.5555555555557,45,9,25,54
2755,-12.411749999998335,2782.722222222222,47,16,29,63
2756,-6.762499999999283,4637.75,42,6,27,48
2757,-7.5617499999986135,2102.3529411764707,34,16,16,50
2758,-20.74874999999925,3651.35,27,8,29,35
2759,2.105000000001092,5148.95,50,9,13,59
2760,-12.379249999998738,1692.9375,33,14,28,47
2761,-41.38649999999892,2508.5,10,12,28,22
2762,-18.245999999999018,2925.5555555555557,28,8,26,36
2763,-21.69549999999897,2597.3888888888887,31,11,18,42
2764,-10.566499999999024,3111.55,29,8,25,37
2765,-9.434999999999716,1576.875,24,17,18,41
2766,-10.447749999997077,3820.6666666666665,56,17,21,73
2767,18.770000000001893,3954.6666666666665,71,13,20,84
2768,-15.093249999998553,2095.764705882353,33,11,23,44
2769,-18.21049999999874,2421.5882352941176,28,3,33,31
2770,-9.666499999999829,2791.5,37,7,26,44
2771,-26.457749999999447,2369.222222222222,23,10,16,33
2772,-13.816499999997774,1742.5625,33,8,25,41
2773,-14.319499999998877,2331.8125,43,2,20,45
2774,-8.448749999998741,2055.6470588235293,42,8,18,50
2775,-18.794249999998968,3693.842105263158,39,12,30,51
2776,-4.6167499999990715,4806.75,48,12,15,60
2777,-27.256249999999103,2962.842105263158,30,6,21,36
2778,-33.07974999999843,1528.25,15,12,30,27
2779,-29.275749999999277,2396.4444444444443,28,11,23,39
2780,-13.818749999998966,2689.705882352941,55,5,31,60
2781,-27.226499999998698,2023.8235294117646,30,12,18,42
2782,-0.26749999999826846,2463.5882352941176,41,15,18,56
2783,-20.76775000000004,1429.0,39,12,23,51
2784,1.7062500000010274,5832.3,61,25,12,86
2785,-22.549749999999218,1429.0,16,16,26,32
2786,-16.95749999999968,2312.9473684210525,23,20,13,43
2787,-14.811999999997942,3080.8333333333335,45,6,19,51
2788,-18.314249999998815,2184.0,28,14,19,42
2789,-19.30174999999879,2663.4117647058824,43,16,24,59
2790,-25.09974999999961,2064.0,29,7,22,36
2791,8.712500000001814,4615.368421052632,60,5,23,65
2792,-14.837749999999293,2623.0555555555557,42,13,19,55
2793,-28.01649999999828,2686.6111111111113,31,23,20,54
2794,-2.9232499999991006,2846.222222222222,54,17,15,71
2795,-22.44649999999955,1429.0,25,12,28,37
2796,-17.887249999999412,3008.5,31,13,8,44
2797,15.138000000002345,4035.5263157894738,67,7,17,74
2798,-19.76174999999958,2666.2631578947367,20,2,31,22
2799,-19.435749999998894,2103.75,44,13,20,57
2800,9.443500000002176,4616.4,58,8,20,66
2801,-6.460999999999368,2103.75,51,13,21,64
2802,-26.509749999999144,2110.705882352941,19,14,17,33
2803,-26.713749999997884,2246.5,39,24,18,63
2804,-1.6652499999987538,5033.05,57,8,17,65
2805,3.8707500000011876,5717.15,66,12,25,78
2806,-12.26124999999899,2747.5,45,11,16,56
2807,-25.46199999999923,3216.0,25,6,29,31
2808,-16.035499999998272,4691.0,45,10,24,55
2809,-6.933249999999683,1701.875,42,13,17,55
2810,-24.776249999999916,2382.3888888888887,35,14,20,49
2811,-2.674499999998827,2932.6111111111113,54,13,12,67
2812,0.2260000000018719,2010.4375,37,13,27,50
2813,-1.1497499999996705,3785.7894736842104,50,10,14,60
2814,-10.358249999998916,4064.8947368421054,43,5,25,48
2815,-37.74774999999961,2196.842105263158,10,6,34,16
2816,-4.584249999998692,2893.9444444444443,47,11,25,58
2817,-23.32999999999854,1635.375,20,6,34,26
2818,10.040750000001024,4306.75,60,10,20,70
2819,3.2475000000030265,2959.470588235294,59,9,19,68
2820,-28.799249999999113,2265.0555555555557,20,8,20,28
2821,-24.877499999999802,3004.684210526316,34,10,17,44
2822,2.536500000001111,2500.5,48,18,22,66
2823,-30.34699999999931,2766.4,23,10,20,33
2824,-11.501999999998016,4095.8,42,15,16,57
2825,-17.13799999999892,3457.4736842105262,31,10,22,41
2826,-4.2834999999976455,4760.85,59,12,14,71
2827,-37.1094999999999,1707.2941176470588,7,21,13,28
2828,-16.755749999998677,3234.4210526315787,29,7,27,36
2829,-19.00449999999893,2523.6315789473683,29,5,30,34
2830,-10.998749999999193,2168.0555555555557,20,17,20,37
2831,-23.62949999999982,2240.4117647058824,44,16,18,60
2832,-1.752749999998287,3155.722222222222,41,16,20,57
2833,-15.504499999999805,2162.722222222222,35,6,21,41
2834,-31.826999999999607,2177.4736842105262,11,6,26,17
2835,6.59425000000294,1805.0625,56,13,18,69
2836,-8.546249999999663,2371.6666666666665,36,18,13,54
2837,-2.565499999999417,1481.9333333333334,43,9,24,52
2838,-12.412999999998554,3151.3333333333335,53,8,13,61
2839,-5.504249999998232,3536.0,49,11,18,60
2840,-20.463249999998936,2798.6666666666665,30,14,20,44
2841,-3.826249999998139,3557.7894736842104,44,2,24,46
2842,-29.685500000000456,1429.0,8,21,40,29
2843,-12.096249999999896,2485.9473684210525,33,3,27,36
2844,-12.027999999998146,3414.842105263158,39,11,24,50
2845,-11.068249999997999,4543.35,47,13,24,60
2846,-28.685249999998682,2295.470588235294,36,2,24,38
2847,-0.6797499999982095,2362.625,57,17,14,74
2848,-23.5794999999989,2544.6111111111113,35,15,24,50
2849,-16.5087499999993,2131.235294117647,30,5,33,35
2850,-6.885249999998696,2853.4210526315787,34,10,18,44
2851,-11.524749999998871,3042.5882352941176,47,15,12,62
2852,-19.958749999998908,2282.3125,51,7,23,58
2853,7.843250000001971,3647.157894736842,52,12,17,64
2854,-36.739249999999195,1429.0,5,13,26,18
2855,-33.0767499999993,2054.125,37,14,27,51
2856,1.0217500000009978,2726.0,53,13,16,66
2857,-5.355749999999385,2807.176470588235,49,20,18,69
2858,-11.57849999999907,4107.55,40,6,27,46
2859,-23.325249999998974,2338.277777777778,43,14,23,57
2860,-0.7064999999979992,2598.0588235294117,40,12,26,52
2861,-13.087999999998669,3038.823529411765,56,6,26,62
2862,-9.698499999998184,2982.0555555555557,48,11,14,59
2863,-7.257749999998458,2182.9375,39,14,18,53
2864,-9.475499999998409,2814.5555555555557,44,10,24,54
2865,-31.330999999999136,2371.176470588235,26,17,19,43
2866,-21.198000000000224,2714.8333333333335,31,21,19,52
2867,-25.19124999999902,3493.35,32,19,21,51
2868,6.0722500000015085,5545.75,59,9,23,68
2869,-31.271999999999178,2247.3888888888887,12,13,26,25
2870,1.0940000000006862,2638.294117647059,57,15,14,72
2871,-21.70249999999904,2891.7894736842104,26,14,23,40
2872,-9.83099999999882,3084.1052631578946,46,14,21,60
2873,-29.573749999999485,2880.65,17,8,23,25
2874,-16.516249999998486,2837.176470588235,45,10,22,55
2875,8.093000000001021,2527.25,65,13,15,78
2876,-13.232999999999134,3398.1666666666665,53,4,21,57
2877,-19.50174999999889,3162.5263157894738,38,16,15,54
2878,-8.479249999997545,1715.75,49,4,24,53
2879,-23.71074999999898,3382.2,33,7,16,40
2880,-11.694250000000203,2179.4444444444443,49,13,20,62
2881,-1.5734999999994899,3459.1052631578946,55,14,17,69
2882,-5.134499999998891,4762.45,55,6,22,61
2883,-7.469999999998689,4327.9473684210525,48,13,12,61
2884,-44.01949999999877,3016.3684210526317,24,12,23,36
2885,-18.655749999999667,3207.684210526316,35,19,16,54
2886,-1.7874999999987669,3531.0,52,12,16,64
2887,-0.39024999999814336,4008.4,49,7,22,56
2888,-15.703999999998853,1553.9333333333334,25,4,20,29
2889,-23.38350000000017,2008.4444444444443,36,18,19,54
2890,4.150000000001431,4374.35,59,13,15,72
2891,-22.822249999998853,3123.55,31,9,17,40
2892,-9.86299999999775,2266.5882352941176,49,11,19,60
2893,-21.2887499999988,3257.6,30,10,25,40
2894,-42.49599999999964,1429.0,18,6,44,24
2895,12.118500000000918,3155.6666666666665,54,9,17,63
2896,-8.560749999999256,3440.5,45,16,18,61
2897,-38.9825,1429.0,5,9,27,14
2898,-24.41199999999854,2130.4375,40,10,22,50
2899,-32.72274999999975,2004.888888888889,13,7,35,20
2900,10.273500000000453,4510.222222222223,62,14,18,76
2901,-3.459499999997275,4508.5,51,13,17,64
2902,-16.121999999999588,2174.2631578947367,20,15,14,35
2903,-32.07299999999924,2309.222222222222,19,15,18,34
2904,-7.323749999999157,2156.4117647058824,38,8,21,46
2905,-14.917749999998895,2300.1875,39,3,23,42
2906,-11.816249999999949,2335.5263157894738,33,14,22,47
2907,3.024500000002033,4564.8,56,7,18,63
2908,10.620250000001871,4636.421052631579,69,9,21,78
2909,-11.078249999999153,3104.5555555555557,30,16,22,46
2910,-37.205499999999546,2665.5,17,9,21,26
2911,-15.711749999999224,2839.315789473684,33,9,31,42
2912,-13.081749999999385,2187.9375,45,9,25,54
2913,-13.665749999998974,2528.4,30,15,10,45
2914,-6.9099999999995605,2528.722222222222,47,8,27,55
2915,-33.00774999999867,2366.5882352941176,35,5,18,40
2916,-8.531999999997986,2533.9444444444443,41,12,20,53
2917,-0.20650000000016783,2540.222222222222,52,11,22,63
2918,-24.43899999999943,2771.6315789473683,29,11,23,40
2919,-35.96599999999933,2902.85,21,20,17,41
2920,-41.25575000000001,1496.5,12,10,33,22
2921,-3.7972499999990035,4333.0,64,11,15,75
2922,-40.51774999999893,2184.315789473684,17,13,21,30
2923,5.670750000001118,5316.4,64,13,15,77
2924,-19.26450000000021,1677.4117647058824,28,11,20,39
2925,8.211000000002198,3889.4210526315787,62,3,24,65
2926,-30.7734999999982,4221.15,52,12,22,64
2927,-20.45774999999929,2500.9473684210525,25,9,27,34
2928,-16.924249999997464,2246.5,44,19,19,63
2929,-18.12424999999901,2425.5,23,10,36,33
2930,-2.773499999998743,2055.5882352941176,40,17,25,57
2931,-8.136499999998142,3263.277777777778,40,7,21,47
2932,-12.13949999999852,1909.0,28,18,17,46
2933,-20.80499999999812,1572.8235294117646,26,14,25,40
2934,-18.323999999999533,1817.9375,35,9,28,44
2935,-13.937249999998334,2336.5882352941176,48,14,20,62
2936,0.34450000000073067,2818.8333333333335,33,6,24,39
2937,7.1760000000015705,4177.777777777777,70,19,12,89
2938,-33.68024999999911,2799.75,20,17,18,37
2939,6.445250000001411,2585.75,53,10,20,63
2940,-0.2927500000001487,2330.875,48,25,21,73
2941,-1.9862499999989214,3303.0,51,23,12,74
2942,-3.4589999999979653,3018.0555555555557,50,11,22,61
2943,-44.282749999999524,1429.0,18,6,34,24
2944,-0.31874999999945786,2603.764705882353,53,14,15,67
2945,-23.350249999999573,3225.2105263157896,34,14,22,48
2946,-7.367249999998904,2529.8823529411766,47,21,19,68
2947,-20.57174999999934,2488.823529411765,31,16,17,47
2948,-25.604999999999272,2890.1,20,12,21,32
2949,-2.458249999999424,3008.3888888888887,41,12,17,53
2950,-47.74349999999932,2187.15,7,21,15,28
2951,-20.840499999998006,1592.0,42,8,19,50
2952,-5.938499999999246,3202.294117647059,55,6,30,61
2953,-23.952749999999206,2155.722222222222,18,19,29,37
2954,-32.957499999999364,2072.3529411764707,26,13,24,39
2955,-29.835999999999302,3222.684210526316,37,6,31,43
2956,-17.219249999998787,3788.6,39,19,16,58
2957,0.4522500000015528,2862.0555555555557,39,18,16,57
2958,-16.82599999999973,2638.0555555555557,29,3,28,32
2959,-31.17475000000008,1648.25,22,17,21,39
2960,0.5887500000008311,4271.1578947368425,62,5,17,67
2961,-30.826750000000068,1950.1176470588234,14,10,30,24
2962,-19.164249999999925,1684.0,32,16,19,48
2963,-14.917749999999057,2729.05,37,6,15,43
2964,-14.488999999999185,2637.0,27,15,12,42
2965,-39.55024999999962,2163.6666666666665,25,10,39,35
2966,-36.92650000000043,2012.157894736842,30,3,29,33
2967,3.4157500000002785,4294.222222222223,85,15,21,100
2968,22.374500000003195,5762.4,78,8,15,86
2969,-9.498249999998444,1973.625,38,8,28,46
2970,-25.534999999998572,2465.222222222222,28,26,18,54
2971,-28.512999999999852,2311.2105263157896,25,9,25,34
2972,-24.865749999998794,3207.6,25,12,19,37
2973,-5.5199999999983484,3167.5263157894738,34,3,31,37
2974,-22.259999999998644,3798.15,40,10,14,50
2975,-34.691249999999435,2821.0,20,7,29,27
2976,-2.3532499999985044,4301.25,54,11,14,65
2977,-4.1424999999984,2437.4117647058824,42,13,22,55
2978,-35.05224999999944,2779.8947368421054,23,7,27,30
2979,-10.06374999999773,2462.8125,62,17,14,79
2980,-3.1492499999986787,2409.470588235294,42,10,16,52
2981,-23.45849999999833,1680.0625,29,6,30,35
2982,-18.145249999999404,2981.0555555555557,43,8,20,51
2983,3.3935000000030535,2421.5882352941176,59,14,11,73
2984,-43.011499999998705,2306.2631578947367,16,13,27,29
2985,-32.729749999999186,2555.2105263157896,25,7,32,32
2986,-18.7184999999997,2084.222222222222,30,5,27,35
2987,-4.390499999998353,4120.894736842105,47,11,28,58
2988,7.459000000001983,3528.722222222222,68,10,22,78
2989,3.0590000000011095,2296.1875,37,14,8,51
2990,-5.492249999998894,4713.2,53,12,18,65
2991,-5.7782499999984385,5319.5,69,10,18,79
2992,-8.301499999998615,2341.294117647059,46,11,26,57
2993,-36.79324999999889,2777.5,18,12,29,30
2994,-13.518249999999592,3710.3333333333335,39,6,17,45
2995,-16.4597499999988,2731.6111111111113,28,7,23,35
2996,-11.922999999998883,2602.1052631578946,31,10,21,41
2997,-5.389749999998102,3717.25,42,12,27,54
2998,-25.88399999999921,2299.4117647058824,27,16,15,43
2999,-7.119499999999405,2190.0,70,13,17,83
3000,-8.405749999999639,3120.7368421052633,37,8,16,45
3001,-34.338249999999626,2688.8947368421054,21,8,23,29
3002,7.458750000000956,1835.8125,44,13,16,57
3003,-20.67249999999923,3101.5789473684213,25,15,16,40
3004,4.365750000001312,4487.0,48,11,15,59
3005,-12.44849999999869,4079.05,45,9,17,54
3006,-0.5177499999998499,3016.3333333333335,49,10,21,59
3007,-11.40249999999878,4271.9,47,8,18,55
3008,-4.39849999999834,4604.555555555556,52,15,18,67
3009,-3.429999999998363,4917.9,53,12,20,65
3010,-17.869999999997354,3069.8947368421054,29,6,43,35
3011,-27.37349999999853,3236.35,29,12,18,41
3012,-18.020499999997597,2273.25,33,8,38,41
3013,2.9547500000003453,3564.0,55,12,23,67
3014,-31.608999999999888,2117.5263157894738,11,20,29,31
3015,-6.172499999998695,3586.842105263158,44,16,10,60
3016,0.9660000000013522,2569.3333333333335,38,13,14,51
3017,-2.570999999998347,3681.315789473684,48,4,22,52
3018,-22.12974999999896,1922.0555555555557,24,10,14,34
3019,2.54000000000167,3044.6111111111113,55,11,18,66
3020,-8.136999999998281,2408.529411764706,45,9,22,54
3021,-5.5397499999992155,3546.0,39,19,18,58
3022,-6.157749999998827,3052.05,40,14,11,54
3023,7.27375000000075,1925.1875,50,11,20,61
3024,-18.859749999998975,1988.3529411764705,29,16,19,45
3025,-16.341249999999363,3028.4,28,10,18,38
3026,-11.922250000000108,1567.9375,30,17,14,47
3027,-18.96149999999916,2210.3888888888887,23,12,14,35
3028,-9.723499999999074,3779.05,39,6,23,45
3029,-28.117499999999033,3828.2,33,11,20,44
3030,-25.438999999998753,2383.3529411764707,46,14,31,60
3031,12.562000000001573,4102.421052631579,61,7,22,68
3032,3.9440000000018083,5302.1,69,13,19,82
3033,5.124500000002196,3588.722222222222,54,8,17,62
3034,-18.0697499999984,3826.8,49,13,14,62
3035,-4.09299999999949,2484.6666666666665,47,14,22,61
3036,8.019250000003677,2483.625,67,14,14,81
3037,-20.026499999999675,2548.0,37,12,20,49
3038,-5.758749999999452,2849.777777777778,41,10,27,51
3039,-31.652749999998804,3212.35,30,19,15,49
3040,-16.12675000000014,2054.0,53,23,14,76
3041,9.446500000000952,3367.4117647058824,78,14,16,92
3042,4.961250000003375,2083.8125,64,18,13,82
3043,-12.346999999999785,2126.4375,28,13,24,41
3044,-16.95699999999874,2516.823529411765,41,12,22,53
3045,11.162500000000064,4135.789473684211,66,10,20,76
3046,17.3965000000014,2941.6470588235293,66,9,15,75
3047,-22.91324999999849,1528.25,23,14,17,37
3048,-6.772499999999684,3019.0555555555557,49,2,25,51
3049,-21.434749999999312,2160.0555555555557,24,12,16,36
3050,-21.62324999999929,2114.4117647058824,22,14,19,36
3051,-28.10174999999926,2730.5555555555557,18,13,32,31
3052,14.345500000000436,4080.7368421052633,59,6,23,65
3053,-25.883249999999748,2997.3,23,11,21,34
3054,1.0350000000017077,2744.6470588235293,56,13,21,69
3055,-18.243749999998784,3018.9473684210525,35,10,26,45
3056,-1.3872499999978563,2533.1111111111113,41,9,25,50
3057,-41.6037499999989,2006.421052631579,13,22,18,35
3058,-29.069499999999664,2076.3333333333335,24,16,17,40
3059,-21.503749999999243,2905.3333333333335,37,21,22,58
3060,6.006250000001468,2949.3888888888887,59,14,20,73
3061,9.215000000003043,1760.375,67,12,16,79
3062,-19.158249999999125,2341.294117647059,34,9,32,43
3063,-7.216749999999045,3347.2631578947367,33,6,19,39
3064,-7.9909999999998345,2387.0588235294117,41,9,30,50
3065,-23.555000000000184,2036.7222222222222,31,21,12,52
3066,-13.467499999999731,4419.55,40,19,14,59
3067,-4.025749999999343,3311.55,31,13,21,44
3068,0.7450000000038293,2942.5882352941176,63,15,20,78
3069,-29.678749999999006,1429.0,14,13,22,27
3070,-5.636499999997457,2581.875,56,4,24,60
3071,-10.560749999999675,2666.2105263157896,25,14,18,39
3072,-33.87674999999819,3971.2631578947367,36,8,27,44
3073,-19.719749999997127,2353.6875,54,7,31,61
3074,-25.368999999999765,2072.315789473684,12,8,35,20
3075,-11.566999999998881,3195.8,36,23,7,59
3076,-10.534249999999025,2515.5555555555557,31,13,27,44
3077,-18.439249999998978,2344.9411764705883,27,8,20,35
3078,-17.156999999999705,2096.705882352941,24,6,25,30
3079,-25.462249999998576,1429.0,8,11,33,19
3080,-9.7257499999997,2484.176470588235,50,9,19,59
3081,-14.933249999998898,2156.3529411764707,35,16,17,51
3082,-18.899249999998446,1737.5625,31,10,30,41
3083,-34.18824999999951,2184.3684210526317,16,9,20,25
3084,-7.958499999999278,3508.3888888888887,55,8,35,63
3085,0.08400000000145891,2129.5625,39,26,8,65
3086,-8.112499999998384,3434.8947368421054,46,5,20,51
3087,-12.652499999999554,4048.1666666666665,60,10,26,70
3088,-17.7327499999986,3561.6,32,10,27,42
3089,-11.382499999999053,2618.764705882353,43,5,38,48
3090,-8.6284999999979,2358.1176470588234,44,6,24,50
3091,-10.831749999999495,4094.95,35,12,16,47
3092,-14.358749999999592,1429.0,49,16,17,65
3093,-20.001999999999203,3427.5,32,8,17,40
3094,-6.298249999999968,3056.0555555555557,48,14,24,62
3095,-6.506749999998985,4278.25,50,13,12,63
3096,-10.618499999998942,2703.3333333333335,38,9,22,47
3097,-32.097499999999904,1429.0,11,13,33,24
3098,-31.241749999999104,2725.85,24,10,17,34
3099,-16.243249999997943,2851.5555555555557,35,10,21,45
3100,-19.22924999999929,2515.8947368421054,26,11,19,37
3101,-3.8447499999986787,2723.8125,59,31,17,90
3102,7.934250000001876,1520.0666666666666,54,12,23,66
3103,-36.69225,1429.0,4,16,25,20
3104,0.5167500000014517,2466.4117647058824,49,6,21,55
3105,-21.42224999999843,4419.6,52,10,28,62
3106,-29.411000000000193,2263.277777777778,30,10,23,40
3107,-26.90174999999914,2687.0,21,4,26,25
3108,-21.53374999999948,2628.7894736842104,17,15,23,32
3109,-11.515999999998282,2575.3888888888887,33,13,27,46
3110,-22.110749999998937,2861.6,24,13,22,37
3111,-32.22875000000006,1523.25,13,8,29,21
3112,-6.9549999999989085,3127.3888888888887,56,12,28,68
3113,-27.199999999999044,2581.9473684210525,26,16,16,42
3114,-15.557999999999344,3010.05,27,8,22,35
3115,-11.908249999998711,2196.470588235294,34,15,18,49
3116,1.6362500000006388,4679.631578947368,63,16,16,79
3117,-31.760249999999655,2286.1666666666665,22,5,25,27
3118,-10.146999999997835,2719.75,70,14,27,84
3119,-22.342749999999103,3173.4210526315787,32,8,26,40
3120,-13.670249999999783,2621.2105263157896,28,5,40,33
3121,-8.202499999997805,2965.277777777778,55,15,19,70
3122,-28.684249999998933,2453.777777777778,22,6,31,28
3123,-9.500749999998416,2197.875,34,13,19,47
3124,-19.66924999999917,3328.684210526316,33,14,21,47
3125,7.084500000001599,2778.235294117647,55,10,16,65
3126,-11.999499999998704,3652.1,39,4,23,43
3127,-9.447499999999703,2489.0555555555557,43,10,28,53
3128,-35.08149999999965,1660.5882352941176,23,15,24,38
3129,-21.03874999999956,2578.4117647058824,31,12,15,43
3130,5.749500000002755,4559.263157894737,71,9,20,80
3131,-23.34674999999796,3672.315789473684,43,4,34,47
3132,-18.76999999999762,1631.6470588235295,36,12,23,48
3133,-29.75949999999947,2772.3684210526317,33,17,17,50
3134,-29.621999999999353,3463.2,28,8,17,36
3135,-17.497749999999353,3164.05,29,11,17,40
3136,-9.127749999998816,2568.3888888888887,33,6,24,39
3137,-18.049999999999184,3174.3,29,2,22,31
3138,-11.800499999998173,3495.0526315789475,43,16,18,59
3139,-15.764999999998974,2727.1666666666665,42,5,21,47
3140,-5.437749999998968,2674.1666666666665,36,9,17,45
3141,-3.875749999999107,3163.6666666666665,50,14,18,64
3142,-8.229749999999484,3269.529411764706,55,13,27,68
3143,1.2780000000027971,1967.8235294117646,50,8,20,58
3144,-11.869499999999249,1938.0,25,8,24,33
3145,-45.93174999999987,1429.0,0,6,28,6
3146,-15.784499999999074,3091.5789473684213,28,9,24,37
3147,7.666250000001154,3038.764705882353,52,15,22,67
3148,-27.411499999999528,2696.4736842105262,28,3,26,31
3149,2.1355000000002655,3056.0,45,14,18,59
3150,9.707750000002674,3918.684210526316,53,7,21,60
3151,-3.1467499999993387,3151.222222222222,59,18,25,77
3152,-7.000999999999529,1978.6875,35,15,24,50
3153,0.055250000000551136,1692.9375,39,11,22,50
3154,-36.75299999999893,2304.0,27,13,15,40
3155,-16.70099999999956,2109.8333333333335,28,14,27,42
3156,-18.938749999999636,2938.684210526316,26,8,23,34
3157,-8.405999999998828,3131.5789473684213,39,1,35,40
3158,3.5922500000005435,3440.7368421052633,50,16,23,66
3159,-30.942249999999383,3806.6315789473683,41,7,38,48
3160,-26.22999999999888,1429.0,27,10,26,37
3161,-13.285749999998899,4275.263157894737,57,6,26,63
3162,-16.160250000000275,1429.0,27,10,21,37
3163,-3.7944999999993585,2921.176470588235,40,17,18,57
3164,-18.871249999998117,2517.3333333333335,35,4,26,39
3165,-18.025249999999637,2425.5,24,8,18,32
3166,-19.236499999998916,3056.1,30,15,15,45
3167,14.77850000000139,3261.0,60,15,17,75
3168,-21.494749999998508,2072.8333333333335,26,14,20,40
3169,-8.906249999999634,2722.722222222222,42,9,27,51
3170,-21.88974999999916,3396.5,26,4,23,30
3171,-15.463749999998859,3001.3684210526317,37,9,16,46
3172,-11.924249999998699,3358.5555555555557,44,9,17,53
3173,-9.387249999997811,4573.4,54,15,20,69
3174,-27.669999999999494,1528.25,9,6,28,15
3175,5.811250000001442,4750.5,52,10,25,62
3176,3.9652500000016184,3625.5263157894738,43,9,26,52
3177,-17.663249999999103,2956.0,29,5,24,34
3178,-30.42949999999845,2604.6666666666665,27,2,34,29
3179,6.379250000001575,4149.8,55,5,23,60
3180,-7.6339999999994035,3388.1052631578946,49,5,24,54
3181,-19.370499999999605,2484.5555555555557,44,16,18,60
3182,-8.996249999998762,2873.5263157894738,32,3,26,35
3183,-7.635499999999636,2741.4736842105262,41,12,17,53
3184,19.683500000002105,5215.6,60,9,15,69
3185,-31.402249999999288,2386.4736842105262,14,10,28,24
3186,-30.170249999999204,2633.0,20,10,20,30
3187,6.90225000000215,2153.3125,51,8,17,59
3188,-24.78449999999949,2119.5,22,13,15,35
3189,-13.80299999999904,1429.0,41,7,24,48
3190,-23.419999999999757,1593.3529411764705,11,12,17,23
3191,-12.489749999998839,2175.0625,38,14,23,52
3192,-36.87974999999935,1733.5625,20,16,15,36
3193,12.361250000001863,5290.85,62,8,18,70
3194,-22.09449999999999,2342.6666666666665,39,13,15,52
3195,1.2857500000017055,5058.45,49,6,25,55
3196,-14.881499999999344,2896.0526315789475,35,6,22,41
3197,-12.051749999999723,2305.8823529411766,49,11,20,60
3198,-27.82074999999806,2801.6470588235293,35,15,32,50
3199,-7.390499999998811,3674.4,35,11,18,46
3200,-8.734999999999596,3682.2105263157896,45,18,16,63
3201,-12.405499999998897,2640.0,50,8,19,58
3202,-12.044499999999179,3647.35,40,20,10,60
3203,-11.231749999998343,3765.65,39,6,22,45
3204,-13.484749999998263,3106.5789473684213,34,11,16,45
3205,-30.185249999999904,2070.684210526316,41,11,29,52
3206,-0.15074999999973127,3954.5263157894738,64,11,18,75
3207,-0.3127499999981513,3235.9444444444443,48,20,21,68
3208,-1.5607499999992591,2914.5263157894738,36,7,23,43
3209,-24.940749999999273,2576.8947368421054,18,21,25,39
3210,-19.425000000000175,2294.1666666666665,29,3,24,32
3211,-22.979499999999373,1675.0625,19,22,20,41
3212,-3.183249999998592,3823.45,48,7,14,55
3213,-26.717249999999826,2050.6666666666665,30,12,22,42
3214,-24.81799999999931,2644.2,19,7,22,26
3215,0.5197500000013793,3413.2105263157896,41,10,18,51
3216,-20.66774999999904,2692.5,28,7,19,35
3217,-13.179249999998902,3400.35,36,5,22,41
3218,-33.31849999999887,3187.6315789473683,39,14,21,53
3219,-3.8589999999998126,3126.5882352941176,51,19,15,70
3220,-22.280749999999895,2891.0526315789475,28,20,17,48
3221,-7.294749999998864,1572.875,33,6,25,39
3222,-22.60024999999894,3067.95,29,7,22,36
3223,-3.6894999999991547,2862.4117647058824,51,9,20,60
3224,-15.354249999998242,2187.9375,43,4,19,47
3225,-5.638249999999091,3751.5263157894738,53,7,31,60
3226,7.145250000002515,2509.294117647059,52,13,23,65
3227,-43.664499999998704,1985.5,11,2,39,13
3228,-11.383249999998931,3733.8,39,11,13,50
3229,1.4632500000007873,5521.1,42,7,29,49
3230,9.948750000001471,2963.176470588235,50,6,20,56
3231,-0.21999999999785497,3693.0526315789475,46,6,24,52
3232,6.789500000001018,3016.294117647059,56,14,16,70
3233,-17.196250000000123,1567.9375,32,7,24,39
3234,-34.63599999999939,1429.0,12,16,24,28
3235,-15.773999999999077,2789.6666666666665,31,9,17,40
3236,-17.435499999999504,2342.75,48,9,24,57
3237,1.5930000000013325,2801.125,48,9,17,57
3238,-13.270249999999725,2853.823529411765,40,10,23,50
3239,-2.532499999999348,2774.722222222222,39,8,35,47
3240,-4.009499999998089,5375.15,68,9,16,77
3241,12.630750000002983,4467.526315789473,58,12,19,70
3242,-13.958499999997931,2152.6470588235293,40,17,16,57
3243,-19.310499999999422,2560.05,19,5,25,24
3244,-18.893249999999366,2620.315789473684,48,10,22,58
3245,-6.177499999998963,3783.0,32,13,20,45
3246,-5.2037499999994665,3454.8947368421054,54,7,24,61
3247,-16.719499999999762,2617.722222222222,31,6,37,37
3248,15.613500000000425,2647.705882352941,61,5,31,66
3249,-6.205999999996488,4612.45,60,14,24,74
3250,7.8727500000023936,2367.6875,49,5,23,54
3251,-6.653749999997666,2271.375,51,19,19,70
3252,-30.551999999999214,2044.611111111111,19,9,25,28
3253,-35.28749999999957,2163.15,12,12,21,24
3254,-28.14149999999999,2478.315789473684,23,7,33,30
3255,-26.230499999998976,2192.722222222222,19,14,26,33
3256,-26.859499999999695,1429.0,37,11,28,48
3257,-21.721999999999074,2918.6315789473683,34,9,18,43
3258,-17.70574999999985,2587.8333333333335,39,9,22,48
3259,-24.359749999999362,2234.3684210526317,17,8,25,25
3260,-11.339749999999494,3655.3,24,21,16,45
3261,-3.3247499999987036,2094.8888888888887,39,15,19,54
3262,-40.51324999999957,2411.4444444444443,18,13,38,31
3263,-23.838749999998427,5390.25,55,18,29,73
3264,-19.30099999999812,3670.4736842105262,55,14,19,69
3265,-26.333749999998226,3029.842105263158,27,13,27,40
3266,-6.367749999997792,3839.55,48,10,19,58
3267,-4.526249999998624,2886.0526315789475,42,6,20,48
3268,-25.197249999998327,2556.842105263158,24,8,31,32
3269,3.3902500000009015,3322.3333333333335,63,2,23,65
3270,-28.293749999999307,1599.6875,16,14,24,30
3271,-18.99824999999847,3609.25,46,12,11,58
3272,-13.409249999998346,3633.0,48,11,17,59
3273,-28.43174999999921,2133.85,18,14,16,32
3274,-12.24524999999867,3772.0,41,12,21,53
3275,-25.94749999999932,2639.45,20,13,20,33
3276,-18.887999999999565,2578.684210526316,37,12,15,49
3277,-33.001249999999395,3202.05,27,11,22,38
3278,-22.943499999998483,1822.875,28,10,21,38
3279,-24.690250000000127,2225.3888888888887,35,15,21,50
3280,-3.374999999999537,3256.0526315789475,48,9,18,57
3281,-18.837499999998705,2127.529411764706,20,13,25,33
3282,-15.406999999999272,2822.3888888888887,27,7,19,34
3283,-6.81349999999957,2806.4444444444443,42,16,23,58
3284,-17.851249999998732,2685.823529411765,42,10,21,52
3285,-3.8637499999988556,2907.0,37,8,26,45
3286,-28.900999999998767,2129.1052631578946,13,10,30,23
3287,-37.00399999999943,2721.8333333333335,22,12,31,34
3288,6.5832500000007075,3838.222222222222,59,8,18,67
3289,-19.43599999999936,2937.0,27,11,19,38
3290,-8.740999999999506,2176.9411764705883,47,19,20,66
3291,-23.659499999997692,3798.315789473684,47,9,23,56
3292,-5.559749999998398,2255.4375,42,7,21,49
3293,-33.14299999999936,2362.0555555555557,31,15,19,46
3294,-27.415749999999235,2703.8947368421054,17,12,19,29
3295,5.628250000000459,2103.6875,64,7,23,71
3296,-22.14999999999917,2208.4,16,17,16,33
3297,-10.808249999998207,2143.4117647058824,45,11,10,56
3298,-25.549000000000195,1933.3529411764705,24,17,31,41
3299,-6.671749999999494,3785.55,36,11,18,47
3300,-7.022999999998559,3322.9473684210525,47,3,25,50
3301,-23.904499999998844,2497.5789473684213,22,3,33,25
3302,-42.339499999999916,1838.2222222222222,10,13,13,23
3303,2.2385000000014963,3673.8947368421054,48,7,24,55
3304,-13.091499999998732,2550.125,42,12,23,54
3305,-2.3572499999992913,1657.1875,39,13,15,52
3306,-33.025999999999335,2731.5,21,10,21,31
3307,-24.37349999999876,2601.3,24,9,24,33
3308,-16.265999999999714,2790.95,23,9,23,32
3309,-34.592499999998815,2103.6875,27,5,31,32
3310,-0.1444999999988184,2932.6111111111113,50,19,14,69
3311,-19.410249999999486,3003.9473684210525,41,11,21,52
3312,-22.592999999997822,4418.65,52,7,19,59
3313,-25.757500000000118,2821.5,34,9,16,43
3314,-6.736749999999196,4002.8,40,13,13,53
3315,-9.494999999998921,2420.5882352941176,27,15,23,42
3316,-1.895999999997916,3158.315789473684,49,9,19,58
3317,-6.79824999999982,3408.1052631578946,56,15,19,71
3318,-33.284499999999674,1940.764705882353,10,15,23,25
3319,-2.0099999999970897,2505.6470588235293,56,8,21,64
3320,-22.153249999999126,2847.9444444444443,29,12,23,41
3321,-16.20099999999958,1982.625,41,15,13,56
3322,-7.063499999998801,3343.842105263158,46,9,23,55
3323,-12.584749999999566,2702.705882352941,47,14,18,61
3324,1.0672500000023988,3810.0526315789475,55,6,18,61
3325,-27.0872499999995,2879.3684210526317,26,10,30,36
3326,2.0930000000002797,3000.470588235294,54,12,23,66
3327,3.422750000001385,3967.9473684210525,72,10,12,82
3328,-21.913499999998454,4316.35,42,5,27,47
3329,-32.860749999998546,2990.5263157894738,28,20,20,48
3330,-13.744749999999183,2443.0588235294117,35,8,21,43
3331,-14.919749999998562,2414.0555555555557,35,5,26,40
3332,-17.84824999999961,2021.8823529411766,26,5,31,31
3333,-21.83274999999894,2513.0588235294117,33,6,37,39
3334,23.943750000000925,2768.3125,90,15,19,105
3335,-21.17699999999906,1541.125,25,12,20,37
3336,-7.120749999999163,2265.6470588235293,33,7,24,40
3337,-17.942249999998307,2553.277777777778,37,9,18,46
3338,-20.541750000000093,2172.6315789473683,23,14,17,37
3339,-17.21199999999958,2544.5555555555557,33,7,22,40
3340,-20.550999999998705,2714.722222222222,25,19,22,44
3341,-43.06149999999959,2115.55,11,7,22,18
3342,-25.987499999999358,2118.1176470588234,28,13,24,41
3343,0.4262500000007508,2870.0555555555557,44,10,25,54
3344,11.28375000000145,2122.764705882353,54,12,29,66
3345,-10.423499999998112,2977.6111111111113,42,1,27,43
3346,-13.26049999999899,3813.3684210526317,74,10,20,84
3347,-20.102249999999014,3310.1,29,13,17,42
3348,-24.941249999999247,2720.7368421052633,30,10,25,40
3349,-5.479999999999977,2508.4736842105262,33,15,12,48
3350,-1.2609999999980228,3719.0,51,12,24,63
3351,-18.55324999999732,2091.5789473684213,25,5,45,30
3352,-21.36374999999968,1660.6470588235295,18,14,18,32
3353,-4.44849999999896,4600.421052631579,70,12,14,82
3354,-19.137749999999233,1692.875,32,10,30,42
3355,2.7002500000003855,2748.4117647058824,59,15,23,74
3356,1.4815000000016307,2273.3125,47,8,31,55
3357,-4.87249999999879,1737.625,41,13,23,54
3358,2.8077500000017865,2902.470588235294,59,13,12,72
3359,12.820750000002395,3862.294117647059,61,4,30,65
3360,-30.534749999999587,3016.35,20,8,23,28
3361,-15.7444999999995,2694.4444444444443,31,15,12,46
3362,-20.046499999999313,2678.1052631578946,24,2,27,26
3363,-14.999749999999441,1523.3125,31,8,23,39
3364,4.184500000001489,4106.0,45,12,14,57
3365,-12.73374999999972,3585.2631578947367,46,19,15,65
3366,-10.71449999999952,2331.0,41,11,22,52
3367,-13.75124999999928,3147.5789473684213,42,6,22,48
3368,-22.082749999998647,4175.1,42,5,26,47
3369,-5.301499999999403,5214.7,47,13,19,60
3370,-26.25124999999901,2400.235294117647,33,7,22,40
3371,-37.63924999999994,1925.5555555555557,19,3,27,22
3372,-16.15974999999907,2496.9444444444443,46,2,31,48
3373,-25.235749999999257,2395.7368421052633,14,21,18,35
3374,-1.7809999999981625,4008.45,40,10,22,50
3375,-10.00824999999986,3206.8888888888887,44,14,17,58
3376,-7.174499999999066,2211.529411764706,30,10,20,40
3377,13.380750000000159,3427.176470588235,67,8,16,75
3378,11.428000000001422,3655.6666666666665,63,6,25,69
3379,-8.112749999999725,2984.722222222222,51,15,23,66
3380,-20.02124999999891,3504.45,33,7,18,40
3381,-21.413749999998586,3336.2631578947367,34,9,24,43
3382,4.522250000000464,2549.0555555555557,27,9,29,36
3383,-5.984749999998674,5214.0,54,8,23,62
3384,-13.191999999999485,2673.8947368421054,38,9,25,47
3385,-0.915249999997912,2018.3529411764705,44,5,24,49
3386,-19.699499999999013,2663.3,29,14,17,43
3387,-39.01525000000016,2049.7368421052633,13,11,35,24
3388,-30.24224999999987,1438.5333333333333,13,8,19,21
3389,-5.606499999998647,3711.55,43,7,22,50
3390,-38.51674999999875,2026.6470588235295,19,8,30,27
3391,9.756750000001796,1956.875,52,9,22,61
3392,-33.39499999999917,3058.45,23,5,25,28
3393,-2.742749999998606,2048.0625,50,17,24,67
3394,-28.21049999999922,3006.85,23,8,24,31
3395,-12.902249999999245,2560.2,29,8,16,37
3396,-27.740249999999566,1706.8125,12,12,20,24
3397,-8.42824999999922,2484.722222222222,25,8,20,33
3398,-5.901999999998202,3088.722222222222,42,16,18,58
3399,-19.07899999999819,2103.625,39,3,33,42
3400,-20.319749999998095,2094.9444444444443,36,9,21,45
3401,-10.834999999999084,1429.0,36,12,20,48
3402,-12.342249999999634,2383.235294117647,36,8,19,44
3403,-24.092249999999225,3008.8947368421054,27,9,27,36
3404,-31.98074999999965,2437.9444444444443,16,9,20,25
3405,10.317500000002344,3060.5,53,5,27,58
3406,-4.45999999999852,3832.2,44,9,21,53
3407,-40.57649999999981,2302.85,7,12,22,19
3408,-16.642249999998803,2220.0,30,3,26,33
3409,-7.594999999999622,2089.235294117647,43,9,22,52
3410,-10.813749999998397,3706.8,41,8,19,49
3411,-5.973999999998249,2550.470588235294,54,3,24,57
3412,4.5847500000022645,3565.0,54,15,17,69
3413,-0.014249999997835161,2519.5882352941176,44,12,18,56
3414,-14.568499999998542,4172.7,37,5,21,42
3415,-1.9412499999993404,2703.277777777778,59,6,22,65
3416,-0.1787499999989862,2309.125,43,8,21,51
3417,-9.587000000000208,2172.4117647058824,32,6,31,38
3418,2.6810000000019913,3669.684210526316,40,13,20,53
3419,-3.5944999999987486,3311.315789473684,42,14,14,56
3420,-22.390749999997904,3335.5263157894738,36,8,27,44
3421,-6.384499999998086,3248.8823529411766,65,3,24,68
3422,-5.992999999998732,3832.6315789473683,38,8,23,46
3423,-8.030999999998016,4838.6,57,1,31,58
3424,-5.6799999999995645,3421.1111111111113,50,11,29,61
3425,-41.345249999999126,2333.0526315789475,13,13,29,26
3426,-14.722249999998713,4296.6,50,12,13,62
3427,1.3542500000008375,2820.294117647059,64,15,16,79
3428,-6.624749999998317,2576.5882352941176,52,13,18,65
3429,3.0695000000011445,3084.529411764706,58,17,19,75
3430,-16.902999999999146,2940.315789473684,28,8,19,36
3431,27.668500000002542,4415.631578947368,73,7,24,80
3432,-23.106999999999566,2083.5882352941176,29,9,30,38
3433,-22.029249999999017,2592.277777777778,28,3,34,31
3434,-25.29274999999903,2617.8947368421054,28,8,20,36
3435,-8.153249999999227,2988.3529411764707,48,14,24,62
3436,-28.257249999999424,2760.0,21,16,23,37
3437,4.884500000002086,3226.8947368421054,44,11,23,55
3438,0.06950000000024517,3094.8947368421054,33,5,29,38
3439,-4.121499999998658,4253.75,47,5,26,52
3440,-6.4242499999992955,2438.470588235294,30,9,24,39
3441,-28.92099999999993,1710.75,10,9,24,19
3442,-15.660499999998748,3549.6,34,17,24,51
3443,-32.558499999999334,2551.3,19,7,20,26
3444,-36.273749999999566,3305.3684210526317,31,11,34,42
3445,-14.771499999998644,4524.95,49,8,20,57
3446,-11.546999999999047,2538.294117647059,39,12,28,51
3447,-19.132499999998906,2793.2631578947367,30,6,24,36
3448,-21.42149999999823,1993.5,19,12,45,31
3449,-4.947249999999277,2366.5625,46,5,16,51
3450,-16.053749999999532,2711.4210526315787,25,14,10,39
3451,-25.68524999999849,3379.05,35,9,25,44
3452,-16.58349999999872,2042.4117647058824,52,15,37,67
3453,-11.068749999999266,3152.4210526315787,39,4,19,43
3454,-8.308249999999223,1467.1333333333334,55,6,23,61
3455,-23.108999999999682,1944.8333333333333,27,21,25,48
3456,-0.6832499999986507,3783.5555555555557,64,5,27,69
3457,3.4465000000014934,4788.65,47,14,17,61
3458,-29.472249999999725,1429.0,33,11,31,44
3459,3.845250000001775,2478.625,53,5,28,58
3460,-31.35099999999925,3590.15,28,7,21,35
3461,-3.896999999999244,3524.3333333333335,48,17,16,65
3462,-28.72424999999971,2018.842105263158,13,16,19,29
3463,-26.97974999999919,2098.470588235294,31,14,18,45
3464,-19.717499999999426,2289.6666666666665,31,7,28,38
3465,-17.797999999999558,2344.9411764705883,28,9,18,37
3466,-8.582499999999305,3509.95,36,7,24,43
3467,5.728250000001298,4891.05,62,7,18,69
3468,-21.8869999999987,3272.7894736842104,29,8,23,37
3469,-6.598249999997866,2176.8888888888887,24,8,43,32
3470,-30.151500000000276,1429.0,25,8,31,33
3471,-13.407749999997602,4356.9,53,7,25,60
3472,-0.09074999999809093,2499.1176470588234,50,7,18,57
3473,-8.801249999999467,2089.176470588235,30,11,27,41
3474,-11.747249999998482,2174.277777777778,29,9,28,38
3475,19.897000000001576,3893.9444444444443,61,9,23,70
3476,-26.24824999999827,2429.0555555555557,23,10,31,33
3477,-16.735499999999774,3225.95,20,13,18,33
3478,12.786750000001442,5275.9,68,10,19,78
3479,-4.692999999998606,2916.3529411764707,50,12,26,62
3480,-23.17974999999984,2890.1,23,12,19,35
3481,-18.668749999999566,3143.3333333333335,47,16,21,63
3482,-15.00649999999888,3508.55,31,1,26,32
3483,12.306500000000948,2778.3529411764707,61,7,19,68
3484,8.50975000000247,3588.722222222222,75,7,21,82
3485,-29.72099999999992,2410.684210526316,27,9,32,36
3486,-14.969749999998811,3468.75,39,14,19,53
3487,-16.84574999999844,2706.777777777778,56,11,26,67
3488,-11.068749999999085,4358.45,46,12,22,58
3489,-10.679749999999732,2429.0,61,3,23,64
3490,-21.250499999999263,3064.7894736842104,29,1,37,30
3491,-21.25424999999954,2176.9411764705883,29,12,22,41
3492,-28.716249999999643,2390.222222222222,29,8,23,37
3493,-34.70424999999922,2080.722222222222,20,15,22,35
3494,-16.506499999999747,3008.3333333333335,38,12,18,50
3495,-26.373249999999068,3163.4736842105262,29,14,21,43
3496,-7.365999999998914,4289.35,52,6,15,58
3497,-23.67074999999901,3156.9,31,4,20,35
3498,-19.41599999999913,2451.875,40,9,22,49
3499,-11.883499999998927,4672.7,41,5,25,46
3500,-24.70949999999898,2530.9473684210525,21,10,23,31
3501,-1.0184999999987558,2164.823529411765,51,6,25,57
3502,-18.060249999998256,3619.55,33,13,19,46
3503,-26.45674999999927,2798.85,24,10,16,34
3504,-5.759750000000136,2307.6470588235293,49,6,24,55
3505,6.0602500000019175,3358.4444444444443,48,11,25,59
3506,-13.291000000000182,1982.625,63,15,30,78
3507,-5.4877499999992745,1973.625,47,20,12,67
3508,16.44700000000364,3862.0555555555557,76,10,23,86
3509,12.047250000001199,5321.85,55,11,23,66
3510,-3.296499999997856,3678.8947368421054,51,8,16,59
3511,-19.115999999998653,2469.8125,43,13,24,56
3512,-13.907249999999959,2340.8888888888887,38,9,16,47
3513,-9.611499999997633,4143.35,54,11,20,65
3514,-4.544499999998694,4575.2,47,18,19,65
3515,-18.735749999997758,2339.4117647058824,33,10,26,43
3516,-19.213749999999635,1429.0,25,16,25,41
3517,1.831500000002081,1733.625,42,9,19,51
3518,-4.50174999999895,4029.0,47,4,24,51
3519,-3.1422499999975018,3169.777777777778,46,10,28,56
3520,7.186250000001654,5102.9,62,7,15,69
3521,-39.062499999999275,2768.2105263157896,21,10,25,31
3522,4.054000000002602,5374.3,67,8,21,75
3523,-1.4079999999989297,3686.3684210526317,49,16,18,65
3524,-17.583999999999474,2168.529411764706,38,8,22,46
3525,-13.944999999999599,3667.0555555555557,59,13,24,72
3526,-20.77899999999905,1585.75,30,4,27,34
3527,-29.01474999999873,1621.5,22,16,25,38
3528,-3.253500000000328,3969.5263157894738,62,7,31,69
3529,-51.626000000000076,2143.315789473684,12,5,41,17
3530,-26.906749999999267,2252.6470588235293,31,12,16,43
3531,-9.510499999998988,3595.315789473684,36,7,18,43
3532,-40.877499999999486,2173.3684210526317,10,8,29,18
3533,-32.85799999999871,1817.9375,30,8,33,38
3534,-20.435249999999094,1710.75,36,11,34,47
3535,-19.49999999999863,3435.5,35,10,22,45
3536,-7.7084999999988355,2695.3333333333335,35,7,22,42
3537,-6.852249999999093,3224.3,25,9,21,34
3538,-24.76474999999958,1929.0,19,16,20,35
3539,1.4045000000003205,2957.3333333333335,35,9,19,44
3540,2.2987500000026335,2547.705882352941,45,14,23,59
3541,-22.827999999998816,2501.3333333333335,33,21,19,54
3542,-10.27124999999831,4391.7,42,12,21,54
3543,-23.769749999999906,2143.375,38,13,23,51
3544,10.719000000001275,4171.666666666667,58,8,23,66
3545,15.678000000002083,3473.1111111111113,74,9,19,83
3546,-26.4069999999991,1539.0666666666666,32,6,24,38
3547,-26.9644999999998,3043.0526315789475,30,12,20,42
3548,-10.784249999999584,3072.315789473684,32,10,18,42
3549,6.474750000001194,4034.7894736842104,56,11,26,67
3550,-17.608999999998467,2406.277777777778,37,9,16,46
3551,-45.351749999999804,1429.0,14,11,47,25
3552,-14.891749999998334,3436.6315789473683,41,12,21,53
3553,-22.156749999999825,1585.75,13,8,25,21
3554,-19.717249999998923,3291.05,31,1,23,32
3555,-9.349999999997868,3556.9444444444443,53,10,30,63
3556,-30.70224999999919,2560.1,23,13,15,36
3557,-10.900499999998924,4044.95,40,13,18,53
3558,-36.257499999999,2354.7368421052633,19,10,25,29
3559,-6.280999999999053,3573.4210526315787,54,9,25,63
3560,-13.804999999999103,2488.9444444444443,32,16,14,48
3561,-2.8534999999984536,3550.1052631578946,58,17,20,75
3562,-9.401749999998495,3645.4736842105262,41,6,24,47
3563,-13.618749999999375,2471.0588235294117,36,17,21,53
3564,-3.8444999999988725,1728.625,44,11,25,55
3565,11.472500000002553,3207.722222222222,60,4,19,64
3566,2.7640000000008613,3561.157894736842,43,9,22,52
3567,-38.68699999999821,2612.5,16,13,40,29
3568,-43.11249999999892,2020.0,12,10,33,22
3569,-18.15524999999956,2500.6111111111113,42,18,22,60
3570,2.8275000000024444,2691.0625,54,10,20,64
3571,-17.07474999999868,2409.4117647058824,36,13,24,49
3572,11.772500000001688,3929.95,51,11,13,62
3573,-9.950249999998544,3191.8888888888887,38,8,23,46
3574,-16.952499999999276,3363.777777777778,52,11,25,63
3575,-11.260749999998913,2097.5882352941176,45,6,22,51
3576,-16.86549999999945,3346.1111111111113,45,5,24,50
3577,-6.5047499999992535,3884.3684210526317,52,10,15,62
3578,-5.169999999998548,3517.6315789473683,42,8,19,50
3579,-19.909249999998313,3000.4210526315787,38,10,22,48
3580,-30.016999999999307,1822.3333333333333,17,12,20,29
3581,6.528500000001571,2576.8125,57,2,20,59
3582,-11.333499999999379,3674.7368421052633,49,10,15,59
3583,-11.778999999999488,4344.684210526316,48,5,26,53
3584,-2.9367499999986135,3468.3684210526317,45,16,13,61
3585,7.891750000000269,3571.9444444444443,69,8,30,77
3586,5.768500000001093,4353.7,59,12,18,71
3587,7.031250000001982,4760.85,52,10,23,62
3588,-5.533249999997621,2608.1111111111113,35,14,26,49
3589,-29.464749999999253,2582.9473684210525,23,11,23,34
3590,-37.28649999999825,1555.0625,16,13,33,29
3591,-13.009999999999959,2160.1176470588234,56,12,30,68
3592,7.699250000001191,3203.4444444444443,52,12,23,64
3593,-10.563249999998323,3143.4444444444443,44,11,20,55
3594,-4.253749999997983,2199.8333333333335,34,12,25,46
3595,-27.87399999999887,1510.5333333333333,27,9,29,36
3596,-25.605000000000132,1429.0,31,17,23,48
3597,-21.199249999999005,2922.7894736842104,29,5,26,34
3598,-23.37674999999943,2530.5,31,14,18,45
3599,-9.621249999997689,3571.8947368421054,52,9,25,61
3600,18.67800000000256,5658.45,60,6,22,66
3601,-7.036249999997229,2005.4375,69,4,27,73
3602,-19.17825000000024,1899.5882352941176,36,10,30,46
3603,-0.06324999999763445,3385.8888888888887,50,15,19,65
3604,-4.634249999997107,2136.375,48,13,24,61
3605,-34.50299999999956,2610.0,18,12,20,30
3606,-17.64174999999884,4024.3,44,3,16,47
3607,-30.616499999998744,1514.375,19,12,25,31
3608,-24.556249999998727,3036.3684210526317,32,5,26,37
3609,0.46075000000138766,3602.05,39,6,27,45
3610,13.167000000002371,3850.9473684210525,57,2,25,59
3611,-20.73549999999883,3069.7894736842104,23,9,32,32
3612,-36.535749999997385,2110.764705882353,26,5,51,31
3613,-41.05399999999989,2222.7368421052633,11,15,34,26
3614,-26.581999999999358,2464.157894736842,20,12,16,32
3615,-4.037999999998289,3675.15,44,11,21,55
3616,-3.0697499999991686,2740.0,59,13,28,72
3617,-12.627249999997973,3637.157894736842,48,20,21,68
3618,-25.511499999999167,2865.6,21,5,28,26
3619,11.526750000002817,2728.625,69,9,30,78
3620,18.05725000000091,5278.35,54,13,17,67
3621,-14.661249999998901,3981.45,44,9,23,53
3622,-12.839249999999831,3533.5263157894738,39,4,21,43
3623,-14.798499999998825,2587.842105263158,30,9,17,39
3624,-13.223749999998223,3579.95,37,4,28,41
3625,8.959000000001069,2076.875,54,4,26,58
3626,-17.429249999996987,2744.6470588235293,57,8,30,65
3627,7.592000000001605,3810.0526315789475,56,11,18,67
3628,-49.91849999999981,1576.875,8,13,26,21
3629,-26.19299999999969,3233.5789473684213,26,5,27,31
3630,-7.008499999999134,4205.2,33,8,36,41
3631,-18.296249999998512,2703.1052631578946,32,11,21,43
3632,-25.71899999999955,3365.5789473684213,45,11,30,56
3633,-18.734249999999186,2168.1666666666665,22,7,22,29
3634,-35.2149999999992,1990.7777777777778,18,9,24,27
3635,-10.717749999998848,3155.6666666666665,47,0,25,47
3636,6.863500000000772,3258.8888888888887,64,3,25,67
3637,4.437249999999884,2303.0,52,18,16,70
3638,-16.037249999998053,2997.157894736842,47,3,21,50
3639,-8.203249999999125,1954.7058823529412,55,8,29,63
3640,-19.473249999999368,2054.1875,22,3,38,25
3641,-3.279249999999068,2155.6111111111113,30,11,17,41
3642,-22.493999999999083,4024.3,36,12,29,48
3643,-28.270999999999596,1429.0,11,8,26,19
3644,-15.839999999998753,3195.3888888888887,40,15,25,55
3645,-2.92824999999925,3683.8888888888887,46,8,17,54
3646,2.9950000000023005,4251.722222222223,64,13,17,77
3647,-15.001749999998518,4194.1,41,15,26,56
3648,-23.03149999999939,1991.6875,28,17,28,45
3649,-20.882749999999003,2702.315789473684,23,12,24,35
3650,-35.65399999999922,2576.5882352941176,32,6,31,38
3651,-30.059499999999467,2523.4736842105262,20,5,30,25
3652,-25.81074999999824,2662.9473684210525,28,8,35,36
3653,-10.472999999999269,2973.222222222222,38,8,17,46
3654,-12.590249999999106,2583.176470588235,40,11,20,51
3655,-37.63874999999946,1429.0,24,20,21,44
3656,-10.482249999998926,3549.3684210526317,47,10,29,57
3657,-13.587000000000035,2849.6666666666665,42,22,31,64
3658,-9.912000000000535,1839.75,36,5,33,41
3659,-34.7724999999994,2798.1,20,7,23,27
3660,15.277750000001319,2672.5555555555557,46,8,22,54
3661,-3.2777499999981514,2610.235294117647,56,17,14,73
3662,-6.046249999998724,3091.75,44,10,14,54
3663,0.7307500000008993,2905.294117647059,37,12,20,49
3664,-28.848499999999394,2216.0,13,3,34,16
3665,-25.637749999998743,2339.1666666666665,22,9,25,31
3666,-16.527749999998335,3782.2,41,8,24,49
3667,-22.171249999999496,2103.75,27,3,41,30
3668,-11.220749999998272,2961.6666666666665,40,8,18,48
3669,-10.572999999999112,2949.5263157894738,32,4,20,36
3670,-3.000249999997604,3246.0588235294117,62,12,14,74
3671,-13.882999999999601,3283.6315789473683,41,12,30,53
3672,-8.410499999998352,4183.0,48,7,27,55
3673,-22.29999999999884,2938.777777777778,23,13,30,36
3674,-31.042249999999694,2248.684210526316,11,12,26,23
3675,-13.241249999998129,3400.55,38,5,28,43
3676,-25.466749999999028,2723.5,26,13,14,39
3677,-17.949749999999824,1568.1176470588234,27,4,29,31
3678,-23.619249999999237,3443.35,34,7,18,41
3679,-0.2692499999971451,2197.9375,55,7,22,62
3680,-31.174249999998388,2862.0,30,13,21,43
3681,-6.872499999999208,3703.8947368421054,39,6,26,45
3682,-9.248249999999782,2148.0,38,5,23,43
3683,5.694500000001495,3552.5555555555557,61,4,21,65
3684,-30.17524999999897,1820.235294117647,13,12,24,25
3685,-5.42975000000019,1429.0,36,14,20,50
3686,5.789250000001242,5031.4,52,9,24,61
3687,-23.95824999999804,2509.470588235294,40,13,30,53
3688,-22.255999999998725,3372.6111111111113,46,19,29,65
3689,-14.760749999999124,2565.722222222222,57,8,21,65
3690,-0.8834999999983136,2310.0,54,13,20,67
3691,0.8140000000008063,1937.9411764705883,44,10,23,54
3692,5.84000000000258,2610.235294117647,67,3,28,70
3693,7.442000000001857,2398.277777777778,45,11,17,56
3694,-14.962249999999145,2592.222222222222,31,7,31,38
3695,-9.94974999999867,4861.5,57,10,24,67
3696,-18.43599999999904,3822.7,33,4,25,37
3697,-15.375749999999403,2122.823529411765,24,5,24,29
3698,-15.679999999999671,1996.764705882353,35,18,18,53
3699,-16.07949999999827,3797.25,42,4,26,46
3700,-3.3867499999992576,2857.6111111111113,56,15,13,71
3701,-5.545249999999532,3854.315789473684,36,10,22,46
3702,-21.452749999998638,3809.157894736842,47,7,27,54
3703,7.88900000000068,3779.157894736842,63,7,21,70
3704,-11.548499999999194,2933.235294117647,40,12,21,52
3705,4.1707500000008055,4006.4210526315787,56,17,16,73
3706,10.748500000001176,3118.294117647059,47,12,14,59
3707,-33.89500000000053,2397.222222222222,38,11,33,49
3708,-11.834499999999277,2361.8823529411766,46,19,22,65
3709,-20.523749999998294,3776.5789473684213,46,4,27,50
3710,3.2202500000017364,2388.0,41,8,21,49
3711,-18.40049999999901,2751.777777777778,43,11,26,54
3712,-12.688499999998047,3571.85,38,4,27,42
3713,-0.6627499999987361,3022.0,46,4,23,50
3714,-28.168999999999762,2116.1666666666665,27,13,21,40
3715,-41.09524999999999,1429.0,14,11,25,25
3716,4.146250000000998,3613.6315789473683,53,7,22,60
3717,-11.565249999997974,2171.1875,51,7,17,58
3718,-14.642249999999603,3058.157894736842,36,3,27,39
3719,-20.51449999999885,3216.0526315789475,31,10,21,41
3720,-19.393999999999327,2210.5882352941176,28,13,27,41
3721,10.904500000001088,4958.4,49,7,28,56
3722,-27.291749999999286,2407.25,35,6,32,41
3723,-6.71699999999885,4759.1,51,13,15,64
3724,-24.8612499999996,3092.315789473684,36,11,26,47
3725,-38.00349999999962,2120.4444444444443,16,8,32,24
3726,-36.57249999999948,1684.0,20,12,22,32
3727,-34.292000000000115,1429.0,15,9,24,24
3728,-16.799749999998905,4190.95,45,2,23,47
3729,6.2880000000019,2706.9375,38,1,37,39
3730,-12.460499999999222,2263.277777777778,27,10,26,37
3731,4.443749999999684,2185.3529411764707,59,12,18,71
3732,-24.346749999998636,3345.5789473684213,36,14,27,50
3733,-6.335499999999716,2455.875,58,18,23,76
3734,-27.104999999998775,1429.0,19,7,26,26
3735,-7.469249999999015,3269.5263157894738,34,10,18,44
3736,-26.435999999998945,2814.2105263157896,28,8,25,36
3737,-8.211499999999186,3151.6470588235293,57,12,17,69
3738,-18.117749999999734,3713.1052631578946,40,5,30,45
3739,-7.902749999998605,2782.9411764705883,40,8,24,48
3740,-12.082249999999043,1710.75,34,8,25,42
3741,-6.68674999999899,3076.3888888888887,45,5,23,50
3742,-5.045749999997367,3553.5263157894738,55,10,21,65
3743,2.5670000000018156,2526.235294117647,62,10,22,72
3744,-2.7194999999994494,3269.5263157894738,34,2,22,36
3745,-19.96099999999837,2693.1052631578946,21,11,29,32
3746,-17.595749999998837,1892.1764705882354,25,16,18,41
3747,-11.496249999999314,2635.529411764706,53,10,21,63
3748,-34.507499999998785,1429.0,7,9,35,16
3749,-0.5707499999979854,4719.5,51,9,29,60
3750,-26.67024999999868,2535.2631578947367,22,11,22,33
3751,-11.122749999999261,3108.45,25,9,19,34
3752,-1.9542499999982552,2264.4375,48,15,19,63
3753,-36.01549999999945,2017.2941176470588,21,5,43,26
3754,-3.4222499999997202,3270.4210526315787,59,14,23,73
3755,-13.217749999998002,3318.75,34,13,23,47
3756,-16.64899999999907,2729.8333333333335,33,9,20,42
3757,-10.612749999999306,3076.277777777778,40,17,14,57
3758,-31.899500000000206,2270.3333333333335,15,18,16,33
3759,-31.513500000000057,2277.8823529411766,24,2,26,26
3760,-25.74099999999894,2842.5789473684213,22,12,24,34
3761,-6.013999999999308,5070.35,60,13,22,73
3762,-17.539749999999835,3018.65,18,10,22,28
3763,-2.539249999998547,4664.1,46,12,23,58
3764,5.33325000000243,3385.8888888888887,66,9,23,75
3765,6.402500000002627,2505.4375,66,16,10,82
3766,-12.990999999999698,4091.0,50,15,23,65
3767,-37.29174999999938,1740.9411764705883,7,14,22,21
3768,1.0180000000010814,3078.1111111111113,38,9,18,47
3769,-3.6912500000003257,2143.294117647059,51,27,24,78
3770,-18.15274999999927,3073.157894736842,30,25,13,55
3771,-5.841999999998507,2426.0625,42,16,19,58
3772,16.64550000000111,4592.8421052631575,66,8,27,74
3773,-5.352999999999954,2223.625,45,21,22,66
3774,-5.4764999999988895,4222.736842105263,39,8,28,47
3775,-29.39799999999998,2468.6666666666665,48,21,31,69
3776,-9.770749999998646,3044.5555555555557,49,11,22,60
3777,-20.99474999999936,1978.75,26,4,30,30
3778,-21.58324999999806,2802.9444444444443,38,8,25,46
3779,-21.846749999999247,1528.25,15,11,24,26
3780,-40.27224999999949,3678.0,15,7,28,22
3781,2.6987500000000404,3189.315789473684,38,4,22,42
3782,-13.6099999999999,3840.0526315789475,47,7,30,54
3783,-22.321499999999066,3281.45,33,10,23,43
3784,-25.00299999999989,1429.0,22,11,21,33
3785,-12.645500000000013,2861.7894736842104,30,13,21,43
3786,-13.316999999999464,2084.1666666666665,26,9,20,35
3787,-3.8099999999984986,1824.8666666666666,48,12,16,60
3788,-17.565499999999254,1768.3125,40,10,21,50
3789,-6.400499999999427,2346.823529411765,39,8,24,47
3790,-29.810749999998688,1929.4705882352941,25,7,27,32
3791,-17.11724999999872,3810.0,38,8,33,46
3792,3.0970000000010924,2743.0,47,9,21,56
3793,-5.111999999998659,3891.0,48,11,21,59
3794,-24.905749999999422,2028.6666666666667,20,8,25,28
3795,-8.673999999998596,2381.4375,42,9,12,51
3796,-18.70024999999983,1562.9375,27,22,19,49
3797,-5.355999999999267,3328.0526315789475,44,6,23,50
3798,1.9105000000011594,3825.8888888888887,75,9,26,84
3799,9.040250000000436,2941.823529411765,57,14,24,71
3800,11.632750000001947,4846.789473684211,77,12,16,89
3801,-21.14024999999937,1870.764705882353,45,13,22,58
3802,4.7267500000029825,5200.5,68,14,14,82
3803,1.2680000000000646,2579.4210526315787,44,13,18,57
3804,-9.895249999999166,2014.4375,30,11,24,41
3805,-14.287749999999406,2706.5789473684213,35,15,35,50
3806,-5.710499999999059,2196.875,55,22,18,77
3807,-21.60249999999982,2777.294117647059,39,12,14,51
3808,-19.95174999999954,3056.0,24,9,20,33
3809,4.72975000000188,2768.0,85,10,17,95
3810,6.108500000001444,2336.6470588235293,42,10,20,52
3811,0.7252500000002163,2746.5,59,5,28,64
3812,2.9932500000011144,5238.6,49,15,14,64
3813,-14.556999999999736,2306.5,25,4,27,29
3814,-5.582499999998975,2600.0555555555557,49,12,26,61
3815,-14.816999999999544,3576.1052631578946,37,8,19,45
3816,-3.0844999999978953,3350.6666666666665,59,7,15,66
3817,-27.121499999999365,2933.5,35,7,27,42
3818,-21.97974999999899,3010.714285714286,30,13,14,43
3819,15.867750000000644,4715.684210526316,71,4,14,75
3820,-21.132999999999054,3014.684210526316,37,5,23,42
3821,-13.709249999999065,2679.7368421052633,29,11,17,40
3822,-5.253749999998515,4087.4210526315787,46,12,26,58
3823,-9.526749999999023,2628.3333333333335,35,8,19,43
3824,-24.298999999999445,2608.0555555555557,22,18,26,40
3825,-1.2144999999992752,2830.3888888888887,63,10,26,73
3826,20.865500000001706,3290.8823529411766,76,12,15,88
3827,-28.927999999999173,2478.4210526315787,21,15,18,36
3828,-16.91974999999872,1979.8823529411766,32,4,28,36
3829,-24.98249999999967,2500.0526315789475,28,10,20,38
3830,-17.12574999999885,3114.75,32,9,16,41
3831,-23.095249999998934,2112.5,24,4,30,28
3832,-3.0814999999972743,2726.277777777778,50,12,21,62
3833,-17.60124999999953,3060.05,25,9,18,34
3834,-14.694999999999862,2009.5,36,16,29,52
3835,-18.728499999998753,1778.3125,23,23,12,46
3836,-15.809749999999415,2457.0588235294117,24,14,32,38
3837,9.669000000000764,5271.105263157895,63,8,24,71
3838,-13.178249999999931,3724.7894736842104,52,20,20,72
3839,-24.369999999999546,2513.6666666666665,26,15,21,41
3840,17.55725000000087,2038.6,56,14,18,70
3841,-11.045499999998437,4201.25,45,6,22,51
3842,-28.10224999999962,3371.3684210526317,29,14,24,43
3843,-13.503249999999138,2370.176470588235,37,26,15,63
3844,-11.163999999998605,2649.6111111111113,34,23,11,57
3845,-1.5699999999998588,2617.8333333333335,46,6,21,52
3846,2.87550000000213,1960.75,43,18,17,61
3847,-33.3687499999996,2627.1052631578946,28,12,21,40
3848,3.5930000000018323,4792.5,60,6,18,66
3849,0.5455000000014538,4741.526315789473,53,5,26,58
3850,-24.677249999999276,3118.7,32,11,22,43
3851,-15.120249999997409,2228.3529411764707,43,12,20,55
3852,-4.216249999998579,3482.9444444444443,61,6,25,67
3853,12.195250000000515,3185.3529411764707,57,15,20,72
3854,-14.500749999997947,2891.222222222222,45,7,24,52
3855,-22.67374999999962,2089.75,33,9,23,42
3856,6.136000000001118,4508.473684210527,66,9,18,75
3857,-18.77449999999961,2983.722222222222,47,7,23,54
3858,-29.4077499999995,2087.4117647058824,20,9,23,29
3859,-22.90224999999917,3337.75,34,11,23,45
3860,-7.583249999998782,2700.5263157894738,31,7,25,38
3861,-18.240249999998216,4814.75,54,14,15,68
3862,-8.042749999998708,3825.95,44,12,15,56
3863,-18.389999999999187,3338.7894736842104,44,8,27,52
3864,2.1072500000003145,3171.842105263158,48,10,18,58
3865,-7.620499999998826,2417.0,48,7,29,55
3866,-23.976749999999534,2619.5789473684213,25,8,17,33
3867,-9.977999999998227,3012.2631578947367,43,10,29,53
3868,-8.45624999999897,2042.4705882352941,30,10,19,40
3869,-41.0330000000001,1429.0,11,14,38,25
3870,-25.574749999999607,2274.0,27,11,25,38
3871,-1.2042499999984115,2451.470588235294,40,12,16,52
3872,-3.0162500000000163,2437.529411764706,53,17,25,70
3873,-0.09099999999764155,4058.1052631578946,66,11,20,77
3874,-24.691499999999614,1917.4117647058824,17,15,14,32
3875,-1.8947499999985502,2580.3529411764707,46,13,23,59
3876,1.11225000000013,4120.684210526316,61,4,20,65
3877,-9.412999999999338,4237.736842105263,46,12,26,58
3878,2.2482500000004184,3587.8333333333335,54,9,22,63
3879,-27.772999999999513,2285.235294117647,41,14,22,55
3880,-10.91724999999869,4010.4736842105262,50,11,28,61
3881,-37.562250000000034,1429.0,13,21,27,34
3882,-24.144499999999113,2882.705882352941,35,4,21,39
3883,-9.53399999999957,1539.0666666666666,39,15,22,54
3884,-19.43874999999777,1438.5333333333333,39,6,30,45
3885,-18.202249999998976,3249.4736842105262,30,16,19,46
3886,-29.415999999998256,1573.0,25,4,34,29
3887,-27.316499999999202,2155.722222222222,27,9,20,36
3888,-28.14974999999918,1550.0625,21,8,29,29
3889,-24.450999999999354,2796.684210526316,28,4,28,32
3890,-33.882000000000026,2462.5263157894738,22,9,39,31
3891,-21.15699999999899,2733.157894736842,26,22,15,48
3892,-14.72949999999847,1534.8666666666666,36,14,12,50
3893,-42.78974999999926,2795.7,17,5,28,22
3894,-5.690749999998845,2900.8333333333335,38,19,18,57
3895,-0.41875000000015206,2160.176470588235,51,14,16,65
3896,-12.571750000000124,2040.2222222222222,29,17,18,46
3897,-0.2607499999983952,2677.3529411764707,43,9,18,52
3898,-38.581749999999616,1429.0,17,6,22,23
3899,-17.13849999999759,2072.777777777778,37,5,29,42
3900,-25.87449999999863,2183.8888888888887,24,9,31,33
3901,3.3032500000014684,5064.8,54,15,18,69
3902,-26.08799999999905,2261.9411764705883,26,8,20,34
3903,-26.08574999999945,2696.55,22,12,19,34
3904,-12.771000000000106,1835.8125,36,15,10,51
3905,-27.441249999999208,1835.8125,26,18,18,44
3906,-30.29524999999964,2108.9444444444443,18,9,22,27
3907,-20.73949999999938,3057.777777777778,30,16,18,46
3908,-27.156499999999635,2033.1764705882354,35,5,32,40
3909,1.7050000000017878,3903.5555555555557,68,10,21,78
3910,-12.112999999999388,2623.55,24,5,22,29
3911,-6.174249999998375,2349.705882352941,53,5,28,58
3912,-2.282249999998002,3922.0526315789475,56,7,23,63
3913,8.520500000000725,2731.5882352941176,48,11,18,59
3914,-19.52324999999934,2878.0714285714284,35,10,19,45
3915,-3.885249999999078,3584.277777777778,45,15,20,60
3916,-19.715749999998867,3494.1,38,7,19,45
3917,-13.16749999999916,2248.823529411765,29,6,33,35
3918,-5.8437499999992335,2361.823529411765,28,6,26,34
3919,-16.642249999999827,2627.0526315789475,31,10,23,41
3920,-16.089749999998666,3930.4210526315787,54,10,22,64
3921,-27.346499999998976,2461.8333333333335,20,9,26,29
3922,-17.647249999999335,2627.3888888888887,42,11,27,53
3923,3.3137500000012174,4297.894736842105,65,12,17,77
3924,11.265500000001524,2533.1111111111113,48,9,16,57
3925,-25.519999999999772,2463.315789473684,24,12,19,36
3926,-13.372499999999253,3169.6,31,8,15,39
3927,-14.552500000000117,1750.5,43,16,28,59
3928,-20.69199999999861,4894.15,53,18,27,71
3929,-5.631499999999104,3577.7894736842104,48,8,22,56
3930,-5.613249999999147,2420.125,35,10,18,45
3931,-16.932999999998444,3595.722222222222,50,10,16,60
3932,-6.143749999999359,2219.3333333333335,48,12,19,60
3933,-26.45724999999885,2607.625,44,4,31,48
3934,-20.417999999998756,2544.5555555555557,44,11,25,55
3935,-10.324249999999154,2964.5789473684213,30,5,22,35
3936,-19.87774999999915,3388.1052631578946,42,12,14,54
3937,-7.11724999999912,3833.4210526315787,43,9,24,52
3938,-0.42824999999960556,2425.3529411764707,47,8,24,55
3939,-44.902249999999306,2089.0,12,11,27,23
3940,-33.145249999998796,1740.9411764705883,26,12,20,38
3941,-11.443999999999054,2598.0588235294117,37,9,34,46
3942,15.618000000001683,2685.8823529411766,57,15,18,72
3943,-31.94675000000018,1429.0,16,12,24,28
3944,-17.272249999998436,2085.75,39,7,21,46
3945,-31.271000000000704,1429.0,22,4,34,26
3946,6.9652500000022215,2504.0,48,16,17,64
3947,-11.802999999999452,3224.3,28,7,23,35
3948,-11.536999999998793,3808.45,41,11,20,52
3949,-23.469750000000133,2290.4210526315787,18,16,20,34
3950,-18.342749999998865,2678.0526315789475,27,8,20,35
3951,-24.349249999999557,2989.5789473684213,38,4,27,42
3952,-23.88149999999882,3119.55,32,7,23,39
3953,3.7962500000014336,2228.6875,44,10,16,54
3954,-37.93874999999902,3194.1,26,10,21,36
3955,-12.455999999998806,3004.6315789473683,33,18,22,51
3956,-23.184999999998535,2805.8947368421054,28,12,24,40
3957,-4.449749999998291,2947.235294117647,55,16,18,71
3958,-32.534749999998745,3289.35,27,10,27,37
3959,-11.266749999997238,3064.8888888888887,48,12,26,60
3960,-35.87899999999877,2219.1666666666665,19,4,36,23
3961,1.4110000000019327,3952.8,45,12,24,57
3962,-22.203249999999162,3459.95,25,11,24,36
3963,4.959500000001858,4431.5,46,10,16,56
3964,0.36600000000250554,2625.1176470588234,49,7,27,56
3965,-18.189249999999003,2154.8888888888887,23,11,23,34
3966,-28.17249999999969,2244.176470588235,22,10,30,32
3967,-25.280999999999022,3140.842105263158,36,8,25,44
3968,-11.727999999998096,2353.222222222222,36,8,22,44
3969,-12.822499999997927,4405.3,40,11,24,51
3970,-18.314749999998547,1839.75,33,5,27,38
3971,-15.97999999999872,2501.3333333333335,36,8,20,44
3972,-18.076499999999637,1523.25,30,6,23,36
3973,-23.382999999999576,2052.5,15,8,29,23
3974,-37.155999999999416,2215.157894736842,20,17,21,37
3975,-23.826249999999064,2705.25,23,10,23,33
3976,-1.4862499999986882,2599.0,48,8,30,56
3977,-9.15999999999749,3403.5555555555557,57,6,24,63
3978,0.33500000000108204,3041.0555555555557,45,12,22,57
3979,-22.93474999999975,2018.3125,49,7,29,56
3980,7.814750000001517,3613.7894736842104,53,6,28,59
3981,25.022,4810.0,63,6,18,69
3982,-26.288000000000114,1976.7222222222222,23,12,26,35
3983,-10.623749999999042,1898.3125,41,3,24,44
3984,-23.867999999999306,4487.85,41,14,22,55
3985,-6.129249999998592,4458.5,51,7,26,58
3986,-41.66124999999949,2046.2777777777778,19,15,16,34
3987,-33.87599999999979,2258.8333333333335,18,4,40,22
3988,-8.515999999998634,4150.0526315789475,47,15,23,62
3989,-13.755249999999066,4107.7,39,3,22,42
3990,-29.454749999998633,3979.9,48,5,21,53
3991,-5.762999999998279,3631.777777777778,51,8,26,59
3992,-31.583249999999378,2752.0,22,3,25,25
3993,2.4700000000016558,2926.705882352941,62,9,24,71
3994,-1.335999999999439,3532.7368421052633,57,5,17,62
3995,-8.63725000000017,1996.9444444444443,37,15,18,52
3996,-6.6559999999985235,3463.5555555555557,45,8,20,53
3997,-43.48149999999873,2608.8888888888887,16,19,31,35
3998,-11.27274999999853,3273.0,46,9,23,55
3999,-3.056999999997763,4431.684210526316,58,8,26,66
4000,-15.961999999998763,3251.3,27,4,27,31
4001,-34.09574999999886,2630.75,23,8,28,31
4002,-26.48999999999731,1701.875,51,13,33,64
4003,-19.263749999998684,4217.95,42,11,22,53
4004,-12.025499999999255,2529.8823529411766,41,10,20,51
4005,-40.257999999999406,1429.0,9,10,26,19
4006,-5.0854999999991515,2103.625,42,10,20,52
4007,-8.178999999998478,2949.3333333333335,42,11,27,53
4008,-22.36724999999921,2565.2105263157896,20,13,22,33
4009,0.02925000000084026,2938.722222222222,42,7,22,49
4010,-12.970499999997902,4421.95,43,4,31,47
4011,-23.716499999999478,1964.75,24,7,34,31
4012,-0.9082499999992522,3703.9473684210525,58,6,25,64
4013,-36.96649999999869,2898.222222222222,23,12,31,35
4014,0.7727500000012354,2433.764705882353,60,13,19,73
4015,-8.502999999999444,2473.222222222222,47,20,16,67
4016,-19.807499999999926,1857.625,28,20,30,48
4017,-17.719249999998215,3361.4210526315787,36,10,32,46
4018,-25.89425000000004,2412.3684210526317,18,6,28,24
4019,-5.357249999999025,2484.235294117647,48,16,13,64
4020,-2.831749999997612,2641.6666666666665,41,6,30,47
4021,-11.328249999998985,3190.0526315789475,40,8,24,48
4022,-21.44474999999987,3194.9,24,8,21,32
4023,15.974000000000604,3186.7894736842104,64,14,19,78
4024,-27.5159999999993,3427.5,23,9,27,32
4025,-4.74399999999911,4358.5,51,7,14,58
4026,10.510250000001905,4140.0,59,11,19,70
4027,-0.9622499999978537,1880.0,39,17,24,56
4028,-29.147249999998394,2165.823529411765,22,7,36,29
4029,4.849000000000762,3704.0526315789475,63,6,27,69
4030,6.925500000001788,5622.85,48,2,22,50
4031,-5.954749999999553,3302.1111111111113,46,13,25,59
4032,-27.92574999999933,2848.1,27,16,22,43
4033,-10.415749999999095,2487.75,47,6,30,53
4034,-21.15249999999899,2568.3888888888887,36,9,19,45
4035,-27.86749999999831,3983.7368421052633,47,8,28,55
4036,-22.696249999998482,3087.1,31,7,25,38
4037,5.198000000001164,2568.5555555555557,41,12,29,53
4038,-14.137499999998834,2160.1666666666665,23,4,26,27
4039,-29.46449999999977,1438.5333333333333,17,8,28,25
4040,18.591750000002236,2689.0,54,4,25,58
4041,-22.94524999999868,2237.0,19,10,25,29
4042,-38.80374999999994,1429.0,8,5,36,13
4043,-3.3169999999993935,3868.5263157894738,73,7,20,80
4044,-22.25349999999876,2279.1666666666665,24,16,19,40
4045,-2.612749999997823,4008.0526315789475,55,10,21,65
4046,-4.55299999999889,3151.842105263158,31,6,26,37
4047,-4.518499999999355,3291.2631578947367,48,21,12,69
4048,5.87250000000323,2744.5625,71,11,14,82
4049,-15.305749999998941,3163.3684210526317,34,17,19,51
4050,-15.513749999999508,3179.8,35,8,17,43
4051,-9.527499999998783,2900.1666666666665,37,18,22,55
4052,-2.3357499999986944,2920.3333333333335,44,8,20,52
4053,-4.1652499999995,3204.2631578947367,50,9,26,59
4054,-19.69324999999895,3631.9444444444443,49,6,27,55
4055,-21.485249999998324,3163.6666666666665,38,23,19,61
4056,2.3140000000004752,3351.315789473684,47,10,19,57
4057,13.14650000000035,2622.3529411764707,53,12,19,65
4058,-15.279999999999024,2219.75,48,8,25,56
4059,-20.114749999998,2153.25,33,13,33,46
4060,12.940750000001055,5654.45,66,11,22,77
4061,0.7770000000015671,1537.1875,34,18,14,52
4062,-5.6579999999990305,2641.6111111111113,43,10,18,53
4063,-29.959249999999372,3260.7,19,6,25,25
4064,-29.22024999999896,1820.235294117647,18,11,26,29
4065,-12.993749999999702,1496.5,33,17,18,50
4066,-6.277499999998012,3906.8,34,8,31,42
4067,-6.170499999998974,2828.764705882353,49,22,13,71
4068,-38.23774999999936,2315.6,10,5,29,15
4069,-21.236499999998614,1534.8666666666666,30,16,13,46
4070,-17.703249999998867,2352.277777777778,34,11,18,45
4071,-14.707999999999128,3595.8,40,8,16,48
4072,-45.52624999999838,2685.5789473684213,16,4,43,20
4073,-17.129749999998996,4002.0,41,5,28,46
4074,-4.477499999998598,3620.3,35,12,23,47
4075,-32.95474999999967,2264.0,12,12,19,24
4076,-21.404249999999912,2762.3888888888887,21,16,23,37
4077,-22.573999999998406,1534.8666666666666,24,14,22,38
4078,-33.24249999999857,1534.8666666666666,17,4,38,21
4079,-10.795749999999526,3064.7894736842104,41,5,19,46
4080,-34.16924999999949,1803.4705882352941,10,12,22,22
4081,2.9625000000010777,3311.777777777778,39,3,32,42
4082,-20.360499999998545,3936.15,42,16,19,58
4083,-46.69099999999925,2112.5,7,6,35,13
4084,12.74325000000172,4825.15,61,6,15,67
4085,1.0692500000018563,3299.5789473684213,42,13,20,55
4086,13.410250000000712,3524.3888888888887,79,23,18,102
4087,-16.63249999999886,2188.3333333333335,27,5,29,32
4088,-13.987499999998349,3449.1052631578946,36,4,32,40
4089,6.5357500000011965,4073.55,50,11,19,61
4090,16.585000000002644,3574.6470588235293,74,20,18,94
4091,-28.57424999999909,3875.8,31,15,19,46
4092,0.36075000000051355,3714.8,37,6,26,43
4093,-32.163999999999064,3182.9,31,7,19,38
4094,-6.3259999999977135,2768.3684210526317,45,8,15,53
4095,-43.66124999999961,1429.0,6,9,25,15
4096,-21.281499999999312,2702.15,28,9,14,37
4097,-0.9919999999983933,2190.1111111111113,37,13,22,50
4098,-21.01024999999941,2624.5263157894738,25,16,12,41
4099,-40.33349999999955,2162.722222222222,16,16,17,32
4100,20.87350000000131,4797.3,55,5,21,60
4101,-12.4824999999981,2541.1666666666665,31,8,35,39
4102,0.396250000001621,2027.25,43,17,11,60
4103,-15.773749999998207,3619.5789473684213,42,5,23,47
4104,-11.05674999999916,2224.75,33,6,27,39
4105,-4.597749999999161,2518.6470588235293,34,11,19,45
4106,-0.019499999998864936,4284.6,55,9,18,64
4107,-13.234749999999249,2324.5882352941176,35,10,24,45
4108,-19.96574999999871,3276.75,35,13,25,48
4109,-9.880749999998905,3561.0526315789475,57,10,32,67
4110,-9.661999999998292,2103.6875,37,8,17,45
4111,-7.951999999999461,2832.529411764706,33,12,27,45
4112,-15.730999999999536,4171.736842105263,47,6,26,53
4113,-8.898999999999537,2534.529411764706,35,11,19,46
4114,-12.263500000000018,2817.8888888888887,46,14,38,60
4115,-30.28274999999939,2051.5263157894738,18,14,21,32
4116,-8.74074999999812,4218.0,49,8,27,57
4117,3.367500000002311,3936.2105263157896,52,14,25,66
4118,-13.368000000000304,1768.25,39,10,26,49
4119,-11.889499999998677,2862.4117647058824,36,15,19,51
4120,2.6855000000009746,4786.736842105263,66,2,25,68
4121,-39.39099999999972,1532.1875,14,10,23,24
4122,-1.1242499999978706,5286.05,61,15,18,76
4123,-29.97099999999956,2322.3888888888887,22,15,26,37
4124,4.821250000000468,2571.875,55,20,15,75
4125,-16.444999999998835,2677.157894736842,26,15,23,41
4126,-5.339249999999053,2643.5555555555557,42,21,17,63
4127,-13.15700000000019,2328.176470588235,42,12,19,54
4128,-11.448249999999145,2897.3888888888887,53,21,28,74
4129,-30.011999999998967,2247.3888888888887,24,4,27,28
4130,-5.538749999998815,3740.2,39,5,16,44
4131,-10.732999999999148,3975.4736842105262,39,27,15,66
4132,-12.277499999998474,3006.6666666666665,36,2,27,38
4133,-2.803749999998602,4673.5,53,11,17,64
4134,13.499750000001768,2071.875,75,18,17,93
4135,4.99850000000138,2430.9375,53,8,30,61
4136,-13.749749999999452,3195.9473684210525,43,17,21,60
4137,-19.36774999999968,1874.4705882352941,26,24,25,50
4138,-6.5769999999983835,3989.6315789473683,54,11,24,65
4139,-22.598499999998666,2090.8125,33,11,19,44
4140,-33.43874999999938,2205.2,15,9,19,24
4141,-17.642499999999497,2639.1176470588234,37,13,23,50
4142,-13.651249999998859,2352.470588235294,43,20,15,63
4143,-0.3577499999988401,2371.5625,52,5,22,57
4144,-29.00774999999866,2843.4736842105262,27,12,28,39
4145,-21.10799999999947,2950.315789473684,31,9,26,40
4146,-38.56899999999984,2780.7894736842104,19,5,41,24
4147,-12.971749999999545,2345.1176470588234,35,11,24,46
4148,-30.268499999999154,3112.4,20,9,28,29
4149,-39.24499999999951,2252.8947368421054,19,10,20,29
4150,-4.008999999998616,3101.3,31,9,24,40
4151,-26.545249999999406,2353.4117647058824,29,14,28,43
4152,-19.10649999999938,3310.0,46,12,28,58
4153,-10.687499999999343,4898.85,52,8,18,60
4154,-27.407499999999168,3552.9,25,6,26,31
4155,2.07350000000296,2251.5,61,9,16,70
4156,-6.930999999997738,2963.7894736842104,43,19,13,62
4157,-21.003249999999664,3275.3684210526317,38,1,25,39
4158,-17.47524999999804,4281.45,56,5,13,61
4159,-20.365999999999357,2935.315789473684,35,12,24,47
4160,-19.87474999999956,2060.5,20,16,20,36
4161,14.210000000001347,2496.5,51,9,17,60
4162,-21.384999999998414,2987.277777777778,39,11,39,50
4163,-10.70900000000004,2370.235294117647,40,8,24,48
4164,-27.38999999999782,1969.75,41,12,24,53
4165,-11.38224999999861,2343.842105263158,23,9,27,32
4166,-24.910499999998944,2120.3888888888887,21,12,21,33
4167,-16.083999999999342,3095.7894736842104,35,11,22,46
4168,4.107250000003957,4353.0526315789475,55,7,40,62
4169,-18.652249999998652,2525.1666666666665,29,14,17,43
4170,1.449000000001718,2138.764705882353,43,13,12,56
4171,-12.025999999999634,2778.277777777778,37,17,18,54
4172,-31.298249999999474,1848.625,20,19,23,39
4173,-8.306999999998814,3579.85,37,7,22,44
4174,7.231750000001521,3634.5555555555557,54,9,28,63
4175,-20.5899999999993,3719.1052631578946,53,2,32,55
4176,-0.6982499999996591,3698.9444444444443,64,12,26,76
4177,-13.186249999999367,3703.65,30,9,19,39
4178,-19.450499999999053,1675.0625,19,15,17,34
4179,-9.172249999998744,3314.4444444444443,38,18,24,56
4180,-32.19799999999967,2343.25,12,14,16,26
4181,9.871250000001833,4500.0526315789475,58,10,21,68
4182,-14.826749999999171,4082.25,36,17,15,53
4183,-22.85799999999806,4329.9,47,5,26,52
4184,6.758000000002511,2171.1875,53,5,20,58
4185,-25.39799999999844,1534.8666666666666,30,11,19,41
4186,-8.830999999998578,3682.2105263157896,50,3,21,53
4187,-20.273499999999622,1467.1333333333334,29,24,14,53
4188,-0.2832499999970571,5949.85,75,6,25,81
4189,-9.846749999998767,3932.1052631578946,61,17,17,78
4190,10.330500000002385,2903.3529411764707,56,9,25,65
4191,-15.745249999998881,2072.3529411764707,28,17,14,45
4192,-5.908999999998711,2108.823529411765,35,12,18,47
4193,-13.257000000000232,2627.5,45,19,9,64
4194,-22.723499999998715,3002.1052631578946,23,10,28,33
4195,10.85275000000102,2166.1875,40,13,21,53
4196,-33.148499999998904,3912.4,26,10,30,36
4197,-9.737249999999245,2927.3333333333335,41,9,18,50
4198,-43.53899999999977,1429.0,4,14,29,18
4199,-29.56124999999941,2079.8947368421054,14,8,26,22
4200,-5.179749999999267,2917.6666666666665,42,9,19,51
4201,-21.327249999999257,1929.4705882352941,26,9,35,35
4202,-8.485499999999632,1880.4375,36,17,19,53
4203,7.805000000003028,2937.8823529411766,60,7,32,67
4204,-37.060500000000026,1857.611111111111,16,12,13,28
4205,-22.74299999999907,2632.0526315789475,26,11,18,37
4206,-9.106749999998872,1582.4666666666667,30,3,31,33
4207,-7.288749999999001,2989.6315789473683,34,14,22,48
4208,-27.594749999999074,3519.5,28,13,24,41
4209,-0.5612499999985608,2400.1176470588234,43,14,17,57
4210,-23.69250000000023,1481.9333333333334,16,12,45,28
4211,-17.025999999998323,2161.8888888888887,31,11,17,42
4212,6.68900000000193,2887.470588235294,58,15,19,73
4213,-10.971749999998394,2922.0555555555557,43,8,19,51
4214,-19.106999999997882,2890.3333333333335,41,6,28,47
4215,-35.75174999999949,2192.684210526316,21,9,23,30
4216,-1.7357499999989183,3921.9473684210525,50,13,23,63
4217,-34.26099999999972,2639.8333333333335,24,11,31,35
4218,-9.70974999999989,3133.6111111111113,42,12,20,54
4219,-27.86124999999945,2098.9,13,18,16,31
4220,-1.6607499999980608,4469.5,45,6,26,51
4221,-41.77749999999942,2537.1,11,6,31,17
4222,10.891500000001745,4508.421052631579,57,7,24,64
4223,-10.564999999998737,2273.3125,53,8,32,61
4224,-0.02499999999879865,4651.263157894737,70,14,24,84
4225,9.138000000001004,4429.8,54,17,16,71
4226,-23.285749999999062,2837.0,13,18,24,31
4227,-10.574999999998983,2904.294117647059,60,25,19,85
4228,-15.394999999998078,1539.0666666666666,60,15,19,75
4229,-9.866749999999017,2921.277777777778,43,12,17,55
4230,-18.647999999999094,3481.4,26,12,21,38
4231,-1.8059999999993248,2993.4444444444443,43,12,8,55
4232,5.188500000000774,3213.8888888888887,59,16,18,75
4233,-25.95649999999818,2697.2631578947367,36,13,17,49
4234,-2.9674999999981218,2287.1666666666665,39,9,17,48
4235,-27.99599999999881,2774.6666666666665,34,10,28,44
4236,-12.897999999998778,2178.6666666666665,39,13,11,52
4237,-14.684999999999878,3185.1052631578946,46,10,20,56
4238,-5.914249999999332,3682.95,39,10,16,49
4239,-10.563499999999689,1429.0,25,13,16,38
4240,-11.440249999999438,2310.529411764706,38,11,24,49
4241,-13.963249999998038,2416.9411764705883,38,19,16,57
4242,-14.55124999999905,3373.1052631578946,41,13,20,54
4243,-9.95949999999821,2146.8333333333335,37,4,25,41
4244,0.23975000000033148,2832.3529411764707,66,13,14,79
4245,14.97750000000166,3076.176470588235,65,14,22,79
4246,-20.625249999999465,2677.722222222222,25,16,20,41
4247,-14.897249999998579,3092.2631578947367,38,17,16,55
4248,-14.546749999998742,2605.5882352941176,43,16,18,59
4249,-23.605249999998506,2148.0,36,19,17,55
4250,-9.213249999998286,3583.9,45,8,21,53
4251,-4.208499999997713,2985.5555555555557,47,3,29,50
4252,2.838500000002574,1711.75,50,11,20,61
4253,-23.451999999999618,2783.2631578947367,14,12,23,26
4254,-33.09274999999915,2094.15,10,13,24,23
4255,-29.12224999999962,2003.2941176470588,25,12,30,37
4256,1.0502500000020027,2892.176470588235,55,4,25,59
4257,-14.989999999999352,2417.6111111111113,41,15,16,56
4258,-0.31625000000007153,2226.529411764706,46,12,17,58
4259,-16.31424999999922,2338.1666666666665,30,13,17,43
4260,-14.346249999999694,2937.0,57,15,21,72
4261,-9.67649999999913,1960.75,37,17,22,54
4262,-18.48449999999861,2801.1111111111113,41,10,18,51
4263,-27.278499999999475,1514.375,20,15,15,35
4264,-5.457499999999105,2157.25,43,15,13,58
4265,-15.897749999999991,1585.75,31,10,27,41
4266,-8.027999999999327,3208.45,35,14,13,49
4267,-24.40699999999962,2501.0,31,6,19,37
4268,-8.844249999997647,2223.6111111111113,19,12,47,31
4269,1.6160000000023298,3223.764705882353,59,8,21,67
4270,-15.945249999998452,1951.875,57,9,24,66
4271,-22.179749999999675,2080.764705882353,21,15,24,36
4272,2.123250000000192,3635.4444444444443,63,12,12,75
4273,5.304000000001816,2845.529411764706,63,15,14,78
4274,-4.407999999999222,3546.1052631578946,46,8,17,54
4275,-17.52450000000044,2211.222222222222,40,10,29,50
4276,-13.413749999998283,2001.388888888889,28,15,18,43
4277,-24.36949999999878,2106.6315789473683,29,13,17,42
4278,16.476750000000433,5083.15,59,6,22,65
4279,-10.574499999999315,2814.5,52,13,13,65
4280,-14.647749999999286,3203.65,38,13,11,51
4281,-8.967249999999108,2181.6470588235293,48,12,28,60
4282,-23.13849999999957,2349.6666666666665,32,15,25,47
4283,-22.962999999999433,2219.8823529411766,23,5,23,28
4284,-21.94250000000003,2799.9473684210525,34,14,26,48
4285,-5.09650000000003,2054.0,58,11,17,69
4286,9.305000000001296,5852.1,65,15,13,80
4287,4.796249999999981,2905.222222222222,47,16,28,63
4288,-14.427249999999038,3045.5,42,16,14,58
4289,-28.986499999999374,2080.7368421052633,16,13,17,29
4290,-13.689499999999729,1710.75,53,15,22,68
4291,-26.2732499999991,2679.9,20,13,18,33
4292,-15.05274999999869,2369.1666666666665,34,13,16,47
4293,-11.717999999998737,2982.9473684210525,32,9,22,41
4294,-24.666999999999362,2599.9411764705883,28,17,23,45
4295,-23.806999999999483,2552.5789473684213,22,16,15,38
4296,4.3505000000008,2202.1176470588234,45,19,22,64
4297,3.840500000001886,2389.375,58,10,16,68
4298,-17.074249999999942,1429.0,27,3,29,30
4299,-28.815499999999197,1969.75,26,15,26,41
4300,3.429000000000444,4643.789473684211,55,11,29,66
4301,-14.616249999998406,4028.2,43,14,20,57
4302,-22.020749999999087,2263.375,53,12,27,65
4303,-6.1359999999990125,2248.823529411765,49,11,23,60
4304,-8.36749999999741,2162.25,46,5,24,51
4305,-10.569499999998897,2829.5882352941176,40,11,20,51
4306,-18.2937499999995,2107.5625,36,6,26,42
4307,-25.99599999999878,2648.470588235294,43,14,20,57
4308,-30.97225000000061,2087.777777777778,29,18,32,47
4309,-5.507249999998836,3865.1052631578946,46,15,14,61
4310,5.711750000002608,3310.9444444444443,55,5,25,60
4311,-16.120249999998975,2727.222222222222,48,5,33,53
4312,-4.210249999998982,3355.8333333333335,46,20,12,66
4313,-19.01624999999951,2941.4444444444443,32,13,16,45
4314,-1.5279999999995437,3317.8888888888887,53,12,30,65
4315,-19.022499999998566,2196.6470588235293,34,12,14,46
4316,-3.3882499999990907,3200.157894736842,53,12,21,65
4317,-13.886499999999222,2591.470588235294,57,15,23,72
4318,-4.480999999998419,1528.25,36,12,20,48
4319,5.103500000001363,5589.45,52,8,24,60
4320,-27.99325000000001,3070.684210526316,31,16,22,47
4321,-0.2239999999982439,2781.0,37,8,28,45
4322,-18.524249999998638,3051.4736842105262,33,11,17,44
4323,-24.840499999998883,3834.65,39,13,20,52
4324,-8.82924999999831,2652.176470588235,58,8,22,66
4325,-33.590499999999906,2751.5263157894738,32,17,20,49
4326,-19.39049999999916,2833.777777777778,39,12,26,51
4327,-6.362999999999187,2128.5625,38,9,14,47
4328,-17.620749999998427,1528.25,31,11,19,42
4329,2.329250000001097,2643.823529411765,36,12,17,48
4330,-5.772999999999251,2404.3888888888887,37,10,26,47
4331,-11.564499999998969,3278.6315789473683,38,10,24,48
4332,-15.147249999999039,2198.3529411764707,29,13,19,42
4333,-5.33199999999958,2597.1176470588234,44,9,25,53
4334,-21.416749999998295,1528.25,23,12,25,35
4335,-36.25299999999964,2008.5,12,13,12,25
4336,-13.587499999998371,3016.4210526315787,42,4,20,46
4337,5.536500000001771,2522.5882352941176,48,6,21,54
4338,-40.122999999999976,2034.7368421052631,14,14,14,28
4339,1.2650000000024497,3676.0,51,11,24,62
4340,-34.43174999999946,2683.8,17,22,12,39
4341,-21.81374999999889,3125.0526315789475,42,17,17,59
4342,-4.6719999999984685,2754.0588235294117,45,16,14,61
4343,0.9702500000015661,1671.125,30,17,22,47
4344,-26.224750000000164,2185.4117647058824,37,23,12,60
4345,8.634999999999987,3659.222222222222,55,11,19,66
4346,-7.789499999998401,5012.4,50,10,17,60
4347,-3.8867499999981527,2550.3529411764707,62,17,16,79
4348,-30.215249999999166,2550.2105263157896,17,7,27,24
4349,-33.22949999999869,2121.823529411765,26,10,22,36
4350,-30.156249999999222,2377.2631578947367,22,9,16,31
4351,-11.64024999999982,2218.9411764705883,43,20,15,63
4352,3.6192500000025722,5214.8,62,16,18,78
4353,-5.760999999999043,3662.1052631578946,59,16,24,75
4354,4.309250000000812,2991.5,56,16,16,72
4355,-20.38575000000055,1429.0,16,22,47,38
4356,-6.039999999997572,2843.6470588235293,54,11,20,65
4357,-39.31974999999978,2306.2631578947367,21,13,33,34
4358,3.6672500000019355,5172.75,57,12,18,69
4359,-1.1817499999986416,2402.25,50,15,19,65
4360,-7.967499999998616,3218.8,31,18,18,49
4361,1.1135000000013153,3025.705882352941,67,19,15,86
4362,-16.77774999999951,2789.9473684210525,30,23,20,53
4363,-18.571499999999162,2522.3529411764707,35,6,26,41
4364,5.881250000002089,3655.722222222222,51,10,29,61
4365,-20.199499999999688,3018.0,34,11,24,45
4366,-7.202249999999322,3465.5,35,14,15,49
4367,-10.14024999999938,1996.8235294117646,33,19,10,52
4368,-17.86674999999874,3114.0526315789475,34,5,20,39
4369,-16.78499999999824,3929.05,41,13,19,54
4370,-26.814999999999976,1429.0,29,7,27,36
4371,-10.718499999999448,4279.85,37,11,19,48
4372,-18.52274999999963,2018.4375,32,20,21,52
4373,-15.474499999999196,2425.5555555555557,41,15,18,56
4374,-18.67024999999994,3095.722222222222,44,13,20,57
4375,-25.01574999999874,3460.05,30,9,18,39
4376,-23.769749999998787,2299.294117647059,36,17,22,53
4377,-9.131499999999772,3333.777777777778,44,16,21,60
4378,-14.067499999998859,2551.4117647058824,29,15,26,44
4379,-32.65574999999966,2038.8947368421052,8,6,26,14
4380,-12.587499999998201,2316.875,43,9,22,52
4381,-5.289499999999813,3173.315789473684,35,13,13,48
4382,-36.21849999999874,3092.222222222222,27,4,37,31
4383,-14.212999999999493,3367.2631578947367,35,21,30,56
4384,-5.503749999999395,2887.6315789473683,33,13,20,46
4385,-2.4354999999999416,4348.2,43,1,24,44
4386,-15.498249999998649,2286.1875,48,19,19,67
4387,-22.294249999999174,3795.7894736842104,42,11,23,53
4388,-11.398249999998521,2307.6470588235293,37,15,20,52
4389,-7.478499999998864,3448.3684210526317,55,8,32,63
4390,-26.082999999998645,2787.85,26,10,24,36
4391,-1.6804999999990073,3124.0,52,8,23,60
4392,-16.431249999998833,3710.05,39,7,20,46
4393,-21.982499999999654,2681.315789473684,47,8,29,55
4394,-24.882749999999163,2713.2,19,18,16,37
4395,5.961750000001478,2290.823529411765,58,10,24,68
4396,-26.504499999999986,2064.0,33,13,18,46
4397,-20.314249999998772,2738.1052631578946,28,12,22,40
4398,15.442500000001711,3062.1666666666665,56,8,15,64
4399,-19.998749999999124,3335.5263157894738,32,13,17,45
4400,-20.97724999999949,2900.5,18,13,25,31
4401,-17.853749999999142,2112.5,24,4,22,28
4402,-17.851249999998775,2941.157894736842,34,11,23,45
4403,3.17075000000103,2450.470588235294,50,13,18,63
4404,-23.63900000000007,1429.0,32,8,28,40
4405,-26.194499999999607,2496.9444444444443,23,3,25,26
4406,-9.33949999999869,3449.9473684210525,46,13,21,59
4407,-13.368749999998695,2374.8823529411766,41,13,20,54
4408,-24.023249999999123,2350.5789473684213,27,5,32,32
4409,-23.959500000000038,2655.9411764705883,28,13,28,41
4410,-7.297999999998899,4888.65,44,19,15,63
4411,-13.998999999998219,3879.85,38,16,19,54
4412,-10.181249999998432,3196.8947368421054,30,7,32,37
4413,4.837500000000477,2963.1176470588234,43,13,21,56
4414,-29.335249999999483,2608.684210526316,22,5,21,27
4415,-9.235249999999237,4015.4736842105262,40,14,28,54
4416,-1.3037499999983093,2103.6875,50,10,16,60
4417,5.531750000000676,3202.294117647059,61,14,16,75
4418,6.891250000000753,4831.736842105263,66,9,19,75
4419,-16.120749999999504,2485.842105263158,34,9,26,43
4420,-20.307749999998887,3084.5882352941176,56,11,16,67
4421,-6.233999999998718,3242.0526315789475,39,1,22,40
4422,-27.124499999999152,2055.529411764706,26,9,24,35
4423,-2.298249999999017,2558.9375,43,12,18,55
4424,-24.004499999998817,2475.8333333333335,22,12,20,34
4425,-13.381749999998664,3240.2105263157896,43,15,16,58
4426,-2.143249999998597,4892.5,52,17,13,69
4427,-4.43724999999966,2517.764705882353,43,15,18,58
4428,-3.2624999999962,2537.1875,63,12,16,75
4429,-10.038749999998654,3243.8888888888887,43,14,16,57
4430,-8.044249999998186,2110.6470588235293,36,10,22,46
4431,-6.854499999998697,3655.722222222222,58,8,20,66
4432,-5.881749999998526,3232.5,45,6,28,51
4433,17.81675000000132,3411.5,71,7,27,78
4434,1.7205000000009718,2828.764705882353,58,8,24,66
4435,-1.764249999998599,3089.235294117647,55,8,20,63
4436,-0.16274999999824705,3814.3888888888887,55,11,16,66
4437,6.9020000000013315,4288.631578947368,78,10,21,88
4438,-3.301499999998943,1765.375,32,5,23,37
4439,-33.79599999999901,1589.6470588235295,15,9,20,24
4440,-4.240999999999042,3652.9,39,8,16,47
4441,-8.746249999997966,4653.7,66,8,15,74
4442,21.78775000000191,5087.368421052632,73,5,19,78
4443,-2.1669999999993355,3147.5263157894738,43,10,27,53
4444,-1.0132499999985014,2282.25,60,12,23,72
4445,-0.20324999999887386,3407.6,37,8,25,45
4446,-14.219749999999488,2143.3125,38,12,21,50
4447,-2.2759999999989815,4079.842105263158,58,7,22,65
4448,-29.809749999999223,2203.277777777778,24,8,23,32
4449,-7.5072499999971765,2687.705882352941,52,14,26,66
4450,-3.3354999999984605,3961.5,42,13,16,55
4451,-5.373249999998309,4446.6,52,9,20,61
4452,-9.70549999999901,3801.7894736842104,47,7,28,54
4453,-26.84299999999903,2622.75,33,11,15,44
4454,-3.4812499999988695,1831.8125,48,13,21,61
4455,-33.64674999999919,1585.8125,12,8,42,20
4456,-4.396749999999441,3458.2631578947367,43,19,28,62
4457,-25.169999999999195,2526.842105263158,20,14,18,34
4458,-5.397999999998761,3135.0588235294117,45,10,16,55
4459,-7.106749999997821,3820.8947368421054,46,9,19,55
4460,-8.122249999998747,2620.5,32,11,17,43
4461,-6.033499999999844,2863.9444444444443,51,18,11,69
4462,-9.891250000000205,2635.3333333333335,56,18,23,74
4463,-18.291499999998248,3251.1052631578946,42,7,16,49
4464,-32.00524999999921,2991.05,32,3,21,35
4465,-3.2497499999979524,4995.75,49,8,19,57
4466,-36.40299999999935,1429.0,16,15,20,31
4467,-3.352749999998475,3400.0555555555557,49,10,21,59
4468,8.201250000001329,2703.3888888888887,45,16,17,61
4469,-3.350999999998769,3950.3684210526317,57,20,20,77
4470,0.6025000000018206,3552.6111111111113,57,22,32,79
4471,-22.438749999999086,2654.5,29,10,19,39
4472,-14.945499999998011,2704.222222222222,35,8,26,43
4473,-19.0042499999989,1866.9411764705883,23,13,18,36
4474,0.5947500000011219,2295.125,46,5,30,51
4475,-23.195999999999437,2395.5263157894738,28,11,17,39
4476,-2.2707499999979226,1742.5625,39,10,20,49
4477,-11.998249999998754,3330.65,37,4,17,41
4478,9.44800000000182,2246.5,52,7,37,59
4479,-34.36574999999947,1598.0588235294117,14,14,21,28
4480,-10.60399999999883,3445.842105263158,45,15,19,60
4481,-14.78674999999861,2616.0555555555557,40,20,12,60
4482,20.124000000001605,1939.0,48,14,16,62
4483,-7.023249999999045,3297.157894736842,48,15,20,63
4484,-13.18899999999922,2758.9444444444443,35,9,17,44
4485,-18.96499999999931,2517.764705882353,35,3,22,38
4486,-10.53399999999856,3179.85,28,14,22,42
4487,-15.95324999999992,2025.764705882353,45,20,19,65
4488,15.507750000003053,2967.764705882353,66,4,21,70
4489,-8.068999999999695,2408.529411764706,28,13,34,41
4490,-13.789749999999632,3409.0,33,9,32,42
4491,-18.820999999999124,2509.3529411764707,33,9,23,42
4492,2.247500000000317,3111.6111111111113,48,16,17,64
4493,-14.999249999999401,3001.315789473684,33,11,23,44
4494,-15.217749999999274,2644.6315789473683,21,12,19,33
4495,3.6822500000018374,5501.3,56,11,22,67
4496,1.8267500000014576,2618.5882352941176,44,6,27,50
4497,-10.191999999999158,2594.5263157894738,25,14,19,39
4498,7.222500000001398,4311.368421052632,53,13,15,66
4499,-18.405499999999705,2164.5,21,7,27,28
4500,-22.605999999999106,2134.0588235294117,29,12,10,41
4501,-11.418249999999047,3858.35,36,21,15,57
4502,-29.952999999999133,3945.0,31,16,20,47
4503,6.4142500000027365,2488.764705882353,52,9,23,61
4504,-10.891999999999673,2387.1176470588234,43,10,26,53
4505,-18.163499999998372,2433.4444444444443,38,22,12,60
4506,-18.0704999999993,3766.777777777778,44,11,30,55
4507,-16.59824999999945,2314.4444444444443,28,3,27,31
4508,8.199250000001687,3730.6,53,17,16,70
4509,-12.569999999999993,3365.6111111111113,53,9,32,62
4510,-22.910250000000175,2636.2105263157896,34,14,34,48
4511,-25.798499999997972,3931.5,45,17,19,62
4512,-4.243249999998587,4244.9,39,14,24,53
4513,-28.245250000000446,2090.0,13,5,37,18
4514,-47.38149999999949,2515.9473684210525,22,7,38,29
4515,-0.16149999999826203,4617.85,60,11,18,71
4516,-13.510999999998663,3060.15,35,8,18,43
4517,-21.93749999999844,3463.4210526315787,42,4,28,46
4518,9.27000000000216,4550.105263157895,73,4,25,77
4519,-12.186749999998009,4602.894736842105,51,13,18,64
4520,-12.158999999997784,4602.1,61,15,25,76
4521,-5.637749999998857,2517.277777777778,32,15,13,47
4522,-14.423499999999638,3221.0555555555557,39,15,28,54
4523,-7.894249999998829,3266.8333333333335,41,10,33,51
4524,6.129750000001968,4672.75,50,5,22,55
4525,-20.911249999999516,2277.8823529411766,28,10,15,38
4526,-14.967999999998955,3621.2631578947367,41,5,26,46
4527,-4.161749999998838,2624.8333333333335,34,6,25,40
4528,-4.3254999999988915,2487.3333333333335,35,10,20,45
4529,-5.919249999998955,4353.6,36,12,17,48
4530,8.45475000000141,2171.3529411764707,55,12,17,67
4531,-26.951000000000214,1496.5,20,5,23,25
4532,-6.582999999998769,3252.95,31,5,25,36
4533,-11.907999999999618,3040.1666666666665,34,14,35,48
4534,-31.037749999999193,1581.8125,17,7,24,24
4535,-11.693999999998507,3402.85,37,21,22,58
4536,-18.079249999997774,2729.705882352941,40,4,28,44
4537,-10.302999999999667,2727.764705882353,45,11,20,56
4538,-13.139999999999713,3368.842105263158,42,9,25,51
4539,18.27100000000174,5270.35,70,8,18,78
4540,5.905250000001726,5298.85,66,14,22,80
4541,-20.052249999999347,2852.1,18,23,18,41
4542,-9.278749999999558,2250.5625,49,13,19,62
4543,-21.949499999999006,2182.1111111111113,28,16,33,44
4544,-2.4047499999997464,2613.9411764705883,40,9,28,49
4545,6.883500000001165,5199.65,67,7,17,74
4546,-29.607499999999447,2815.6,21,11,17,32
4547,-16.69749999999909,2982.0555555555557,48,15,21,63
4548,8.696250000002815,2493.5,46,17,24,63
4549,-17.00299999999904,2818.8888888888887,31,7,21,38
4550,-6.302999999999246,2054.1875,34,14,20,48
4551,-27.2579999999988,3190.9,32,5,22,37
4552,3.865000000001339,3870.2105263157896,50,12,25,62
4553,-8.397749999998513,2750.0526315789475,28,6,33,34
4554,-9.664499999998554,3136.277777777778,43,15,17,58
4555,-18.35049999999878,2711.3684210526317,24,9,28,33
4556,-24.559749999999248,2147.722222222222,25,3,35,28
4557,-21.691749999999054,2897.7368421052633,29,14,18,43
4558,-13.986999999998712,2891.9473684210525,32,6,20,38
4559,0.3330000000005963,2535.0,37,12,16,49
4560,18.840750000000604,2723.625,65,17,20,82
4561,-25.60224999999976,1675.125,21,9,31,30
4562,-10.203749999998895,2585.8823529411766,41,3,26,44
4563,4.830750000001277,4183.473684210527,61,14,22,75
4564,-20.301749999998925,3195.157894736842,28,16,18,44
4565,-2.854250000000046,2698.1052631578946,51,5,19,56
4566,-2.7859999999983716,4671.25,52,9,22,61
4567,-25.50149999999984,2695.75,20,11,16,31
4568,-25.908749999999305,2232.5625,26,6,31,32
4569,2.1197500000011003,4291.263157894737,58,11,18,69
4570,-32.21524999999947,2004.6315789473683,13,8,24,21
4571,-19.317999999999685,3306.5,44,12,24,56
4572,-29.34449999999963,1828.6470588235295,27,5,31,32
4573,2.447750000000429,3422.4736842105262,44,7,23,51
4574,-4.236249999999285,3660.8,34,9,29,43
4575,-30.294999999999995,1429.0,13,10,29,23
4576,-19.10174999999904,2241.9473684210525,17,13,22,30
4577,-13.992999999998597,1534.8666666666666,26,10,29,36
4578,-18.162499999999635,2150.3333333333335,25,12,17,37
4579,-5.8154999999990435,3532.222222222222,60,12,20,72
4580,-2.3594999999979924,4079.9,56,10,17,66
4581,-25.3504999999992,2719.222222222222,34,5,28,39
4582,-1.7382499999990753,3643.9473684210525,42,8,21,50
4583,-2.2682499999991608,3137.75,40,10,12,50
4584,-9.522499999998868,2698.9411764705883,45,6,20,51
4585,-20.849249999998193,2529.8823529411766,35,10,31,45
4586,-16.28999999999975,3438.2105263157896,34,17,27,51
4587,-9.224500000000877,1429.0,59,13,18,72
4588,-16.764249999999112,2125.4375,35,3,29,38
4589,-8.519749999999487,3236.0526315789475,36,18,18,54
4590,-17.191999999998906,2848.4210526315787,27,15,19,42
4591,-27.58599999999978,2854.45,21,15,18,36
4592,1.5280000000013076,3425.5,63,9,21,72
4593,-2.3869999999984985,3865.2105263157896,51,8,24,59
4594,4.2535000000020995,5123.55,70,9,22,79
4595,-18.387249999998453,3543.5789473684213,35,12,22,47
4596,-8.223249999998945,3107.6666666666665,44,12,20,56
4597,-14.587749999998234,2092.0,29,9,32,38
4598,-11.830499999998986,2862.0,61,7,26,68
4599,-11.169500000000216,1924.8235294117646,46,13,23,59
4600,-9.521999999998135,3401.5263157894738,49,9,20,58
4601,-5.5947499999972905,2081.8125,56,16,11,72
4602,-17.85199999999889,3125.0,27,9,24,36
4603,-16.00199999999844,2644.823529411765,49,14,26,63
4604,-34.33199999999955,2079.0526315789475,8,12,24,20
4605,-24.709999999998825,3085.7368421052633,26,18,21,44
4606,-25.79624999999952,2941.0,20,9,29,29
4607,9.3200000000021,3472.277777777778,56,6,25,62
4608,-25.78974999999942,2028.7777777777778,18,9,26,27
4609,-15.81724999999813,3504.5,40,14,19,54
4610,-19.904499999999153,2554.176470588235,32,18,29,50
4611,-16.331249999999034,2493.5,28,11,23,39
4612,-15.44899999999868,4592.55,47,11,23,58
4613,-21.991999999999322,2673.842105263158,26,6,26,32
4614,-30.375749999999368,2715.55,21,14,19,35
4615,-19.315499999999457,2616.2105263157896,24,13,19,37
4616,6.509250000002384,3663.9473684210525,53,15,16,68
4617,-9.627999999998798,2837.0588235294117,38,6,21,44
4618,-10.853249999998155,4147.3,50,8,24,58
4619,16.89325000000097,2679.3125,71,12,17,83
4620,-5.5767499999986505,2134.1176470588234,38,11,17,49
4621,-9.56649999999875,4493.368421052632,65,12,21,77
4622,-26.686999999999625,2138.8333333333335,24,15,16,39
4623,-2.770749999999102,3552.6666666666665,51,11,14,62
4624,8.094000000002453,4796.5,59,10,23,69
4625,-19.638499999999567,2055.529411764706,19,11,18,30
4626,-18.059749999998555,2479.529411764706,39,10,27,49
4627,-6.887249999999459,2335.875,39,2,17,41
4628,-1.1962499999988032,3625.4210526315787,46,10,17,56
4629,-20.947249999999094,2575.5,29,9,23,38
4630,2.7380000000026863,5237.05,53,4,29,57
4631,-19.074749999998808,3378.9473684210525,40,10,18,50
4632,-14.122499999999054,2108.1111111111113,29,10,17,39
4633,-12.499499999998443,3181.7894736842104,43,18,13,61
4634,-39.58799999999943,2121.684210526316,13,13,24,26
4635,-20.83624999999962,2530.5,39,13,25,52
4636,-17.005499999999394,3215.9473684210525,43,20,20,63
4637,-17.462500000000063,2416.9411764705883,39,12,28,51
4638,-5.383749999998299,4008.4,40,14,14,54
4639,-27.846750000000174,1429.0,10,3,33,13
4640,-20.64624999999962,2973.222222222222,41,13,29,54
4641,-5.386749999997944,4216.4,50,12,18,62
4642,-9.382999999999054,2843.5,27,13,23,40
4643,-22.818999999998,3114.9473684210525,37,3,26,40
4644,-24.231749999999955,2034.7368421052631,37,7,24,44
4645,-13.695749999999355,2837.05,26,8,21,34
4646,-5.64974999999937,3628.7894736842104,52,7,19,59
4647,7.854250000002604,3965.3684210526317,70,12,12,82
4648,-3.9649999999989176,3775.95,42,6,19,48
4649,-28.29049999999874,2521.842105263158,28,19,12,47
4650,-11.368249999998422,2030.4117647058824,35,18,24,53
4651,-18.75674999999953,2714.8823529411766,47,20,23,67
4652,-22.650249999999303,3583.5789473684213,36,12,16,48
4653,8.400750000001732,2558.9411764705883,49,11,15,60
4654,-34.179499999999564,2419.842105263158,21,20,16,41
4655,-20.64600000000032,2588.6470588235293,49,4,27,53
4656,-29.41174999999954,2202.8,13,22,10,35
4657,-24.08149999999985,3007.65,25,5,16,30
4658,9.29125000000203,2474.75,55,10,15,65
4659,-2.190249999998809,3220.0,49,14,21,63
4660,-10.094249999998706,3538.4736842105262,42,13,15,55
4661,-16.07999999999968,2467.3529411764707,43,13,20,56
4662,-31.358249999999224,1589.6470588235295,12,1,33,13
4663,12.921500000001307,2694.5,54,7,20,61
4664,-13.714749999998679,3019.1666666666665,45,17,21,62
4665,-0.5337499999987713,2807.235294117647,43,5,25,48
4666,-13.731999999998774,2064.0,31,11,18,42
4667,9.235000000002923,4509.315789473684,66,8,23,74
4668,10.725500000001409,4225.85,50,9,21,59
4669,-29.822749999998848,3387.722222222222,44,13,22,57
4670,-19.486749999999365,2346.1666666666665,29,15,12,44
4671,-26.379499999999133,2802.4736842105262,24,8,21,32
4672,-26.3947499999994,3286.222222222222,42,20,21,62
4673,-3.5667500000003542,5417.1,42,12,20,54
4674,-7.603999999998569,2946.3529411764707,55,15,16,70
4675,-1.5614999999987664,4221.05,36,11,22,47
4676,-14.303249999999746,2219.75,38,9,27,47
4677,-16.405249999999505,2636.315789473684,26,12,15,38
4678,9.550000000000797,3391.1111111111113,57,14,18,71
4679,20.266750000001494,4858.55,62,5,16,67
4680,-45.55899999999973,1604.5555555555557,0,14,22,14
4681,-13.893999999999092,2555.1176470588234,44,12,25,56
4682,1.9052500000010018,1532.1875,38,8,23,46
4683,-23.5122499999992,3191.75,29,10,17,39
4684,2.6270000000022264,2980.0,64,15,21,79
4685,-3.8749999999981126,3751.6315789473683,45,16,24,61
4686,20.58550000000274,2824.0,69,5,24,74
4687,-21.941749999999214,3344.6315789473683,31,10,18,41
4688,-3.335749999999569,3762.315789473684,48,9,19,57
4689,0.8925000000023282,4197.3,51,10,26,61
4690,-17.612249999998223,3776.684210526316,53,10,28,63
4691,4.462250000000841,3198.8888888888887,53,10,25,63
4692,14.964750000001406,2986.315789473684,43,11,20,54
4693,-42.11750000000009,1973.111111111111,20,20,22,40
4694,-25.255499999999927,2621.9473684210525,19,14,34,33
4695,-21.524999999998677,3052.05,34,10,22,44
4696,-21.043000000000085,1728.625,37,4,30,41
4697,-20.63024999999864,2664.5,29,19,20,48
4698,-0.5315000000002075,2103.625,58,7,19,65
4699,-19.687999999999885,2937.0,32,10,15,42
4700,-9.736999999997328,2967.0,46,18,21,64
4701,-4.828249999998653,2433.764705882353,45,15,18,60
4702,-18.50549999999855,2466.8888888888887,33,10,21,43
4703,-14.875999999999076,3134.7,30,10,14,40
4704,-11.102499999999276,2447.0,43,14,21,57
4705,-39.96024999999984,2028.8333333333333,16,9,23,25
4706,-1.2049999999967778,2694.875,64,17,14,81
4707,0.6755000000021607,2484.176470588235,46,9,26,55
4708,-5.487249999998324,2409.25,45,7,19,52
4709,0.28475000000123635,2922.0555555555557,45,8,19,53
4710,-12.138750000000142,2874.315789473684,35,8,20,43
4711,-12.40299999999884,1627.4375,24,12,20,36
4712,-26.266249999999882,1429.0,17,19,18,36
4713,-9.9947499999987,4352.9,43,7,18,50
4714,0.4772500000013672,2549.529411764706,41,6,22,47
4715,-22.983999999999877,2648.0526315789475,25,18,25,43
4716,-13.092749999998556,2100.4117647058824,36,14,21,50
4717,-5.494999999998788,2568.5,45,8,12,53
4718,6.961000000001445,2811.8823529411766,53,3,26,56
4719,-1.289499999998175,3952.85,47,12,19,59
4720,-21.92149999999768,2902.684210526316,36,10,25,46
4721,-11.387749999998661,2303.9411764705883,44,17,27,61
4722,-18.052249999999184,2730.6666666666665,45,10,18,55
4723,-29.573750000000082,2054.0,29,11,23,40
4724,-19.735749999999314,2505.5,51,4,29,55
4725,-22.325249999998043,2207.75,42,11,23,53
4726,-8.754749999998005,1528.25,34,7,29,41
4727,-7.392499999999041,3790.95,39,8,18,47
4728,-27.569749999998947,3364.0,25,15,20,40
4729,-13.95199999999966,2847.5263157894738,37,6,19,43
4730,-18.608749999999382,2741.5263157894738,33,8,28,41
4731,-6.3652499999981265,2171.125,36,17,14,53
4732,-20.06549999999771,2644.277777777778,41,7,22,48
4733,-15.006749999997798,2866.5,42,4,28,46
4734,-2.9404999999996955,2540.1111111111113,38,13,16,51
4735,-20.687499999999336,2219.823529411765,35,12,14,47
4736,-13.814249999998628,2837.6315789473683,29,12,26,41
4737,1.431500000001791,2599.6875,64,7,21,71
4738,-1.6399999999983508,2689.705882352941,66,14,25,80
4739,-14.143999999999679,2751.0,52,8,37,60
4740,-38.0584999999996,1984.6666666666667,13,21,25,34
4741,31.69550000000112,4703.9473684210525,71,12,13,83
4742,-28.263749999999078,2080.722222222222,17,13,24,30
4743,-9.963249999999356,2938.722222222222,37,5,31,42
4744,5.506000000002544,5143.3,57,7,22,64
4745,-15.511999999997267,2390.277777777778,33,4,42,37
4746,-12.079749999998825,2391.1111111111113,39,4,22,43
4747,-14.936499999998698,5019.55,55,11,14,66
4748,3.57675000000109,3768.2631578947367,61,8,12,69
4749,-39.86649999999974,2066.6111111111113,20,18,21,38
4750,4.321250000001507,3733.9473684210525,56,11,27,67
4751,10.492250000001146,3147.777777777778,60,8,15,68
4752,-14.640249999999103,2425.684210526316,24,11,20,35
4753,-7.531499999998525,2852.3333333333335,37,12,20,49
4754,-25.802999999999457,2064.0526315789475,15,21,18,36
4755,-15.259749999998585,3102.4736842105262,43,5,29,48
4756,-17.765499999999566,2493.3684210526317,29,8,23,37
4757,-13.184499999999264,3271.222222222222,44,14,39,58
4758,-14.311999999998946,2712.1666666666665,34,13,18,47
4759,-12.41474999999886,2655.6666666666665,36,11,22,47
4760,-21.824500000000263,3016.3888888888887,61,12,16,73
4761,4.308250000001779,2332.8823529411766,63,14,33,77
4762,-3.3734999999986783,3545.9473684210525,49,15,19,64
4763,-13.080749999998593,3450.277777777778,49,12,19,61
4764,-9.724499999999557,2353.6875,42,16,22,58
4765,-24.076749999999954,2219.222222222222,32,16,23,48
4766,6.2875000000006125,3040.222222222222,50,13,20,63
4767,-23.64474999999947,2457.3888888888887,36,12,24,48
4768,-23.951499999999662,3133.6666666666665,60,1,31,61
4769,-2.5107499999978153,3362.1111111111113,48,15,30,63
4770,-30.384749999999872,2175.0555555555557,27,15,25,42
4771,-19.644999999998912,1708.8125,27,9,26,36
4772,-23.237249999999207,3581.55,25,9,21,34
4773,-29.113749999999573,2637.05,17,8,19,25
4774,10.359500000001173,3967.1111111111113,62,12,20,74
4775,-22.97774999999809,2665.4117647058824,37,13,22,50
4776,-10.06749999999744,3610.3684210526317,53,7,20,60
4777,-13.60649999999919,3878.3,42,8,20,50
4778,-6.3612499999981855,3239.4210526315787,49,3,20,52
4779,3.78575000000127,4935.35,47,14,18,61
4780,14.296750000000605,2478.6875,60,11,21,71
4781,2.5750000000012294,3134.9411764705883,55,7,23,62
4782,3.9090000000023792,3755.3888888888887,55,5,20,60
4783,-5.768999999998013,4144.2,44,9,22,53
4784,0.3415000000002257,3188.4736842105262,49,5,20,54
4785,-13.419999999999016,2534.6470588235293,45,14,24,59
4786,-23.106249999998496,2600.222222222222,38,14,18,52
4787,0.9140000000008802,2814.4444444444443,67,12,14,79
4788,-3.6504999999986176,2588.6111111111113,38,2,22,40
4789,-16.468499999999327,2820.0526315789475,25,9,20,34
4790,-24.15149999999947,3213.95,30,19,15,49
4791,-12.347999999999313,2635.3333333333335,63,10,26,73
4792,-16.731249999999065,3248.95,31,13,19,44
4793,-1.819499999999601,2854.1111111111113,39,10,20,49
4794,-17.900499999999806,2546.0526315789475,38,9,32,47
4795,-9.338749999999555,3798.315789473684,48,13,18,61
4796,-23.83824999999898,3206.9,31,9,19,40
4797,-8.717249999998712,4374.45,47,6,16,53
4798,-21.808999999998502,2120.4444444444443,30,5,29,35
4799,-24.35149999999838,1528.25,19,18,21,37
4800,-2.2302499999990513,2727.1666666666665,57,15,19,72
4801,-11.487499999999732,2353.4117647058824,60,11,28,71
4802,-3.383499999998931,4762.315789473684,49,18,19,67
4803,-26.548750000000133,2810.0555555555557,36,17,17,53
4804,-7.360500000000019,1755.4375,37,8,22,45
4805,-37.23724999999892,2472.4210526315787,18,6,36,24
4806,-21.417999999998578,3142.5,33,4,23,37
4807,-24.731749999998883,2701.35,20,12,23,32
4808,1.3317500000015707,4980.7,55,9,19,64
4809,-6.201999999998808,4525.05,43,8,19,51
4810,-21.469749999999728,2214.722222222222,33,6,30,39
4811,-26.456749999999793,1652.1764705882354,15,10,20,25
4812,-15.384249999999133,3836.95,36,9,18,45
4813,-19.848249999999922,1958.4117647058824,41,6,27,47
4814,8.923000000001123,2402.1875,57,14,21,71
4815,-7.746999999999384,3228.15,36,8,13,44
4816,-6.740749999999676,2417.6666666666665,37,14,14,51
4817,-28.598249999999002,1599.6875,18,8,26,26
4818,-23.08449999999922,2598.684210526316,29,5,27,34
4819,-55.12325000000014,2189.2631578947367,10,21,36,31
4820,-15.35674999999955,2619.5,48,18,18,66
4821,-13.280499999998458,2438.9375,47,13,26,60
4822,-27.31999999999938,2556.9444444444443,24,10,16,34
4823,-6.6689999999987535,2124.705882352941,32,11,20,43
4824,-5.4392499999992365,3267.6666666666665,64,18,27,82
4825,-23.363249999999617,1853.8823529411766,20,8,25,28
4826,-26.585249999999167,2815.65,22,13,22,35
4827,-18.35299999999976,3463.2631578947367,44,2,28,46
4828,5.21550000000164,3911.4444444444443,68,17,18,85
4829,-38.75299999999932,2191.8333333333335,16,11,23,27
4830,-13.134499999999463,2737.1176470588234,40,12,19,52
4831,-8.88999999999884,4018.8,39,7,27,46
4832,-29.678749999998445,2619.5789473684213,20,8,39,28
4833,-24.715249999999564,2403.823529411765,35,20,18,55
4834,-27.724999999999483,2222.75,10,15,22,25
4835,-0.052249999997575715,4976.8,55,9,29,64
4836,12.108499999999847,2866.0588235294117,62,15,13,77
4837,8.359000000002151,2898.277777777778,53,6,20,59
4838,10.443750000001224,2917.5555555555557,46,9,17,55
4839,-15.302999999998189,2606.470588235294,37,28,21,65
4840,-27.264249999999357,1737.5625,40,16,21,56
4841,-11.368749999998757,2832.4117647058824,38,17,20,55
4842,10.509750000001338,4104.105263157895,56,11,17,67
4843,12.743250000001021,2786.375,53,18,16,71
4844,5.394499999999918,2062.9375,68,6,19,74
4845,-7.909249999998993,2760.470588235294,42,17,16,59
4846,7.681250000001282,3431.722222222222,52,6,17,58
4847,-20.6217499999996,3124.8947368421054,24,6,33,30
4848,-10.853749999998723,3054.1052631578946,30,9,22,39
4849,13.895500000001926,3998.0526315789475,50,6,26,56
4850,-22.594249999998063,2354.3529411764707,40,2,21,42
4851,-19.630249999998952,1929.4705882352941,30,7,25,37
4852,-9.168499999998465,2461.705882352941,44,11,20,55
4853,-5.593499999998363,3861.842105263158,57,5,19,62
4854,-36.602499999999495,2839.315789473684,38,6,31,44
4855,-39.05399999999988,1952.1052631578948,14,11,38,25
4856,-8.774499999999579,3508.4444444444443,60,13,15,73
4857,10.947500000000602,2354.470588235294,47,15,19,62
4858,-1.0367499999991836,3227.294117647059,59,22,18,81
4859,-10.563249999998245,2340.75,46,10,29,56
4860,-30.525249999998643,2173.235294117647,31,9,29,40
4861,-19.481999999999566,1429.0,30,0,30,30
4862,-32.93224999999916,3380.7,30,4,28,34
4863,-0.497999999999365,2201.875,43,17,16,60
4864,-47.28849999999922,3607.0526315789475,32,12,24,44
4865,-44.08475000000025,1514.375,11,10,20,21
4866,-7.102749999999089,2742.9444444444443,38,20,22,58
4867,-3.457499999999296,3460.7894736842104,46,7,27,53
4868,-27.606999999999726,2021.9411764705883,15,11,36,26
4869,-14.09774999999911,3588.5789473684213,43,8,24,51
4870,-19.42424999999951,1969.75,38,5,27,43
4871,-14.381499999998889,1889.375,24,13,24,37
4872,-6.831749999999511,2322.3333333333335,51,14,22,65
4873,-1.573499999999584,2669.0,37,14,26,51
4874,-18.254749999998165,3503.3684210526317,45,12,20,57
4875,-20.576749999998718,3165.65,31,9,23,40
4876,-7.2787499999992535,3784.1052631578946,45,10,18,55
4877,1.6365000000008478,3019.7368421052633,49,7,19,56
4878,-37.075999999999894,1429.0,16,10,25,26
4879,-6.781999999998834,2559.764705882353,53,11,20,64
4880,7.7009999999998415,2802.1111111111113,65,11,23,76
4881,-14.002499999998168,1534.8666666666666,28,12,27,40
4882,-5.532999999998219,4524.35,51,16,18,67
4883,-26.60974999999943,2063.9411764705883,27,7,33,34
4884,-21.31850000000026,1429.0,31,12,26,43
4885,-2.5977499999983302,4215.263157894737,57,18,22,75
4886,-7.320249999999251,4631.45,36,9,23,45
4887,-2.1569999999968417,2606.470588235294,48,7,34,55
4888,-15.178749999998763,2785.684210526316,32,13,21,45
4889,-0.5062500000002628,3101.3529411764707,71,11,16,82
4890,-2.9032499999982715,3541.9444444444443,54,5,21,59
4891,1.079000000002109,2610.777777777778,45,4,24,49
4892,-10.712249999999228,2787.1111111111113,31,6,25,37
4893,-13.068249999998793,2942.5882352941176,45,5,24,50
4894,-6.4327499999976,2390.3333333333335,43,4,23,47
4895,11.622000000001067,3136.823529411765,62,15,13,77
4896,1.4900000000008191,2922.9444444444443,43,7,14,50
4897,-24.70850000000009,1917.611111111111,26,16,26,42
4898,1.7352500000015887,4992.55,54,5,27,59
4899,-7.402999999998838,3250.9444444444443,45,14,17,59
4900,3.2897500000005415,2808.1176470588234,48,7,18,55
4901,-23.60424999999991,1429.0,13,8,27,21
4902,-11.283999999999676,2064.0,29,8,22,37
4903,-41.017499999998925,1953.7777777777778,20,13,19,33
4904,8.916000000001286,2805.3529411764707,53,8,25,61
4905,2.081250000000967,4503.368421052632,58,10,22,68
4906,-15.6894999999985,1850.1176470588234,26,10,24,36
4907,-22.37999999999917,3391.75,33,7,20,40
4908,-2.740749999998189,3844.25,45,10,24,55
4909,11.776500000001452,3385.9444444444443,81,12,18,93
4910,-15.302999999998368,3641.315789473684,36,8,27,44
4911,-8.527249999998997,2059.0,54,14,27,68
4912,-9.041999999996932,5422.8,52,8,28,60
4913,-16.30574999999961,2268.375,43,5,24,48
4914,-17.557999999998803,2252.529411764706,44,12,24,56
4915,-11.20524999999952,1567.9375,36,20,26,56
4916,-20.098999999999357,3299.75,30,4,21,34
4917,-27.70699999999905,2164.5,25,14,20,39
4918,-37.65224999999882,2593.9444444444443,24,10,28,34
4919,-19.029249999998946,2830.277777777778,33,7,16,40
4920,10.287000000001782,3481.1666666666665,69,12,19,81
4921,28.088000000002022,4146.888888888889,73,7,20,80
4922,-19.59249999999917,2072.8888888888887,21,11,21,32
4923,-24.257749999999135,4910.0,42,11,20,53
4924,-6.570999999998622,3064.0555555555557,48,15,24,63
4925,2.150250000001049,4683.85,52,19,14,71
4926,1.5982500000013482,3954.6315789473683,50,8,18,58
4927,-18.795499999998917,3403.2631578947367,32,14,29,46
4928,-15.567749999998663,2097.5882352941176,34,14,21,48
4929,3.7330000000011574,2997.0,49,16,18,65
4930,-5.849999999998356,4088.5,39,11,22,50
4931,-27.335999999999746,2116.1666666666665,18,5,31,23
4932,-21.821749999999362,2624.8333333333335,46,14,23,60
4933,-17.482749999999623,2192.823529411765,40,9,17,49
4934,12.751250000001486,2103.625,67,15,18,82
4935,6.117750000000849,4620.421052631579,60,8,29,68
4936,-28.71699999999849,2786.3333333333335,35,17,21,52
4937,-8.597999999999228,2194.764705882353,33,4,26,37
4938,-12.210249999999593,2881.4444444444443,51,20,16,71
4939,-49.75449999999861,2371.777777777778,22,7,33,29
4940,-34.368499999999756,1643.8235294117646,7,11,26,18
4941,-6.698749999998917,5052.05,46,10,22,56
4942,-25.24249999999841,2114.1052631578946,14,4,41,18
4943,-11.501999999999741,1937.875,43,17,22,60
4944,-6.230249999998916,2940.705882352941,43,16,22,59
4945,-32.74899999999899,3523.5,32,5,25,37
4946,-13.635499999999457,3089.842105263158,43,23,21,66
4947,-20.399499999999307,2009.375,35,4,30,39
4948,-31.266249999999552,2302.85,12,20,13,32
4949,12.980500000001985,2076.9375,67,9,18,76
4950,-2.4814999999996084,3225.2105263157896,43,14,18,57
4951,7.587000000000143,2395.4117647058824,43,18,22,61
4952,-13.019249999998227,3730.65,45,10,21,55
4953,-18.45474999999979,3182.5789473684213,26,7,25,33
4954,-42.716000000000115,1429.0,3,15,21,18
4955,4.165250000001767,4318.65,54,8,21,62
4956,0.05550000000194437,2478.6875,61,9,23,70
4957,17.81700000000175,2496.6875,60,7,20,67
4958,-14.29099999999983,2473.8823529411766,26,17,19,43
4959,-19.470249999998845,3036.6111111111113,39,12,28,51
4960,-21.56174999999855,3358.0526315789475,34,7,29,41
4961,-26.582499999999357,2030.3529411764705,25,10,24,35
4962,7.895250000001101,3929.4736842105262,52,17,26,69
4963,-9.292499999997197,2127.6470588235293,42,5,36,47
4964,9.338750000001381,2614.277777777778,45,5,21,50
4965,-28.798499999999432,1936.8947368421052,14,15,17,29
4966,-20.29599999999936,2722.6666666666665,42,10,23,52
4967,-25.098749999998805,3159.222222222222,34,16,28,50
4968,12.799250000003171,5701.35,64,9,21,73
4969,-14.016249999999577,4173.55,32,3,28,35
4970,-5.542249999999197,4316.3,41,9,25,50
4971,8.12525000000041,2840.823529411765,60,12,18,72
4972,-14.002749999998699,4421.95,45,10,21,55
4973,-18.725249999998333,2525.176470588235,41,14,15,55
4974,-7.109999999998827,3491.0,38,5,21,43
4975,-25.856499999998626,4102.05,41,5,21,46
4976,-27.940499999999695,2298.7368421052633,14,11,25,25
4977,-8.287999999998783,2757.1111111111113,33,8,28,41
4978,-15.045999999998745,5246.5,60,3,29,63
4979,-35.07749999999947,2131.3529411764707,14,7,26,21
4980,-25.008749999998834,4210.1578947368425,52,12,25,64
4981,-7.309249999999659,2196.875,58,21,25,79
4982,-40.66499999999934,2207.7368421052633,13,8,25,21
4983,-20.474249999999042,3289.4,31,5,22,36
4984,-5.606999999999328,3588.5789473684213,40,2,28,42
4985,-24.24049999999958,1988.9444444444443,18,8,21,26
4986,5.364250000002224,3293.684210526316,51,2,21,53
4987,-3.311999999998527,1429.0,54,23,24,77
4988,-18.87274999999846,3247.35,32,6,27,38
4989,1.993250000000982,3261.2105263157896,49,21,13,70
4990,-4.401749999999926,1777.25,41,16,29,57
4991,-14.120999999999373,3546.8947368421054,27,6,27,33
4992,-9.210749999999756,3290.6666666666665,52,5,31,57
4993,-27.61624999999903,2604.5263157894738,20,8,32,28
4994,-22.28174999999981,2481.0555555555557,28,6,23,34
4995,-14.142749999999257,2685.823529411765,40,14,24,54
4996,-31.42249999999904,2302.1176470588234,21,13,32,34
4997,-11.302249999999159,2756.684210526316,35,11,18,46
4998,-6.2467499999985225,4380.578947368421,63,9,25,72
4999,-6.777249999999745,4499.210526315789,60,18,17,78
5000,-12.024999999997956,4109.894736842105,51,5,29,56
