Episode,Average Reward,Average Lifespan,True Location Count,False Location Count,Explore Actions,Target Actions
1,-24.431249999999025,2550.777777777778,22,25,6,47
2,-32.248999999999754,2381.3333333333335,18,29,3,47
3,-46.535249999999465,2572.8888888888887,26,36,7,62
4,-27.567000000000444,2481.1111111111113,25,24,9,49
5,-41.41124999999946,2015.4444444444443,9,26,9,35
6,-34.09424999999943,3281.2631578947367,25,27,9,52
7,-27.014999999998317,3115.222222222222,27,29,8,56
8,-27.636999999999187,2759.2105263157896,22,29,10,51
9,-41.36674999999867,3160.8,18,33,5,51
10,-19.34874999999734,3199.8333333333335,33,28,11,61
11,-42.573749999999634,1707.7222222222222,5,26,6,31
12,-38.15049999999943,3164.6111111111113,16,29,4,45
13,-34.20974999999932,3328.0,35,29,6,64
14,-41.02224999999976,2243.1666666666665,14,25,7,39
15,-37.90549999999893,2409.0,20,17,6,37
16,-43.98849999999952,3121.684210526316,20,26,8,46
17,-37.4199999999998,1800.842105263158,5,25,10,30
18,-36.5732499999993,2470.7368421052633,14,21,9,35
19,-36.07449999999979,2766.5789473684213,16,32,5,48
20,-27.228249999999655,2084.277777777778,13,28,5,41
21,-37.33574999999859,3118.157894736842,19,37,7,56
22,-44.7457499999994,1827.8125,11,20,11,31
23,-32.03149999999872,2585.9375,28,32,7,60
24,-32.65799999999799,3294.25,28,18,13,46
25,-37.03249999999899,2959.5789473684213,20,28,5,48
26,-33.872249999999084,2795.842105263158,15,34,5,49
27,-44.6222499999991,2323.9375,23,25,6,48
28,-32.4114999999997,2614.8,13,26,4,39
29,-32.34749999999898,4308.5,24,26,10,50
30,-36.2737499999997,2554.3888888888887,15,30,12,45
31,-34.674749999999456,2723.1052631578946,21,31,2,52
32,-35.07474999999967,1701.875,11,33,5,44
33,-25.528749999999825,2394.470588235294,20,25,4,45
34,-47.04800000000023,1429.0,2,21,7,23
35,-35.01649999999771,2224.6875,30,25,12,55
36,-37.747999999999784,2804.777777777778,21,34,4,55
37,-39.93724999999873,1912.7058823529412,22,28,18,50
38,-47.88799999999935,3439.4,18,26,8,44
39,-34.26574999999923,2916.315789473684,23,30,9,53
40,-36.587249999999024,2682.25,14,26,8,40
41,-37.70025000000011,1973.7894736842106,9,24,5,33
42,-43.126499999999275,2708.1052631578946,11,26,7,37
43,-25.52199999999963,2013.6470588235295,20,26,3,46
44,-25.714749999999082,4318.7,25,43,5,68
45,-39.12449999999915,2391.764705882353,21,27,9,48
46,-43.04299999999948,3117.4210526315787,17,27,10,44
47,-47.47924999999964,2825.8888888888887,20,30,6,50
48,-30.006499999998027,4358.4,35,33,7,68
49,-30.180000000000405,1870.7058823529412,31,23,15,54
50,-38.80249999999925,2754.45,13,27,8,40
51,-25.480249999999035,2712.9444444444443,22,27,5,49
52,-24.209499999999416,3189.2631578947367,28,30,7,58
53,-25.23324999999945,3210.315789473684,19,27,7,46
54,-42.594749999999785,2290.4210526315787,8,21,9,29
55,-37.74999999999919,3666.4210526315787,17,29,10,46
56,-31.771499999999612,2122.85,14,23,4,37
57,-24.530999999999285,2433.764705882353,31,20,11,51
58,-33.425499999999644,2016.45,8,26,4,34
59,-45.79649999999964,2176.75,8,24,8,32
60,-43.384749999999514,2463.315789473684,8,24,13,32
61,-38.0959999999991,2279.1666666666665,18,22,8,40
62,-33.540499999999646,2640.4736842105262,14,28,6,42
63,-24.86049999999956,2663.722222222222,25,24,10,49
64,-32.66824999999947,2156.4117647058824,20,27,7,47
65,-47.55824999999955,2343.0,12,24,8,36
66,-56.40850000000012,2395.4117647058824,15,25,12,40
67,-31.58774999999966,2956.85,17,27,8,44
68,-37.33624999999908,2571.9444444444443,16,31,9,47
69,-25.82800000000005,2537.6315789473683,21,30,9,51
70,-32.42299999999953,2473.1666666666665,17,26,9,43
71,-43.36999999999874,2467.4117647058824,22,36,5,58
72,-34.01424999999951,2706.294117647059,23,28,10,51
73,-40.64799999999896,3636.25,20,27,8,47
74,-36.77774999999987,2854.315789473684,32,30,12,62
75,-29.207499999999662,2673.0526315789475,16,23,8,39
76,-33.42924999999987,2255.3529411764707,16,22,6,38
77,-29.747000000000167,1870.764705882353,20,27,5,47
78,-38.37249999999937,2041.0555555555557,10,31,2,41
79,-49.60649999999997,1429.0,8,23,10,31
80,-30.423249999999427,3218.7,18,22,8,40
81,-32.92500000000008,2092.222222222222,25,28,11,53
82,-29.304499999999184,2366.6470588235293,23,24,7,47
83,-42.864749999999525,2568.5789473684213,14,24,8,38
84,-38.14274999999997,2262.7368421052633,15,27,7,42
85,-49.99599999999961,3052.85,19,22,7,41
86,-29.2194999999998,2855.1052631578946,14,24,6,38
87,-29.375499999999636,3162.684210526316,20,26,12,46
88,-24.88849999999885,3044.7894736842104,20,26,10,46
89,-50.70324999999947,2709.7894736842104,15,30,4,45
90,-28.48674999999968,2583.5789473684213,16,25,7,41
91,-22.58150000000023,1996.8235294117646,30,28,10,58
92,-40.293499999999156,2941.2631578947367,18,23,11,41
93,-35.3117499999987,2255.3888888888887,14,30,7,44
94,-33.52099999999935,2675.1111111111113,26,16,6,42
95,-38.01474999999845,2906.842105263158,22,32,5,54
96,-39.13274999999988,1429.0,0,25,9,25
97,-39.82874999999904,2956.1,21,29,4,50
98,-41.103749999999124,2467.4117647058824,25,27,13,52
99,-23.706499999998915,3773.0555555555557,29,32,6,61
100,-41.85149999999965,2552.842105263158,17,30,3,47
101,-34.24524999999866,3313.842105263158,27,27,6,54
102,-37.47549999999942,2479.277777777778,19,24,11,43
103,-32.38574999999973,2156.684210526316,14,24,8,38
104,-36.526499999999785,2151.7894736842104,16,23,8,39
105,-40.54724999999972,3292.8947368421054,22,31,6,53
106,-25.117499999999364,2501.3888888888887,19,19,8,38
107,-33.62649999999967,1972.8947368421052,10,26,7,36
108,-36.64699999999955,2087.0,10,24,6,34
109,-31.86149999999946,2341.470588235294,16,20,8,36
110,-30.509999999999298,3199.315789473684,20,30,5,50
111,-42.66599999999828,3829.2631578947367,26,26,10,52
112,-41.504499999999574,1948.6842105263158,9,25,6,34
113,-40.28649999999961,2464.3333333333335,15,25,3,40
114,-30.290499999999515,3350.5263157894738,24,22,8,46
115,-35.330249999999225,2904.4,25,22,4,47
116,-38.82024999999929,2376.222222222222,19,22,8,41
117,-39.79699999999932,2480.7,13,21,9,34
118,-47.81924999999896,2892.1111111111113,21,37,10,58
119,-19.869749999999513,2989.1111111111113,23,27,2,50
120,-27.693499999999307,2950.45,20,26,7,46
121,-55.060249999998994,3149.315789473684,16,30,4,46
122,-37.28649999999938,2016.45,8,23,9,31
123,-46.15149999999956,2402.3684210526317,12,27,6,39
124,-29.516249999999452,2752.722222222222,22,29,6,51
125,-26.098249999999855,2592.222222222222,27,25,9,52
126,-32.63524999999958,2542.3125,23,30,2,53
127,-41.02174999999934,2308.7894736842104,13,24,6,37
128,-33.05174999999974,2306.6111111111113,15,29,10,44
129,-30.510499999999222,2584.6,16,22,4,38
130,-27.662249999999528,2109.9473684210525,16,29,5,45
131,-33.82474999999947,3176.1052631578946,29,27,5,56
132,-47.96499999999905,2823.315789473684,13,33,5,46
133,-37.47475000000004,2708.1052631578946,11,28,8,39
134,-20.745499999999204,3232.176470588235,40,30,3,70
135,-37.42249999999966,2744.8947368421054,16,24,7,40
136,-45.34874999999866,2417.4210526315787,17,23,10,40
137,-35.88049999999924,3027.2631578947367,18,27,9,45
138,-45.976999999999315,2982.1052631578946,18,25,10,43
139,-31.788749999999105,2512.55,19,16,11,35
140,-31.588999999999466,3198.5789473684213,24,30,3,54
141,-42.285500000000084,1429.0,3,29,8,32
142,-29.118749999998823,1862.5625,23,26,12,49
143,-49.577500000000185,1482.5625,8,30,6,38
144,-30.087999999999454,3698.8333333333335,37,44,7,81
145,-34.53174999999998,3085.7894736842104,17,22,7,39
146,-28.192999999999206,2981.0555555555557,20,30,5,50
147,-28.200999999999322,2703.529411764706,22,27,7,49
148,-39.927499999999895,2508.5,18,31,7,49
149,-44.265249999999924,2063.9444444444443,14,25,4,39
150,-29.137749999998835,2942.1052631578946,25,24,8,49
151,-35.932249999999314,2362.315789473684,11,28,3,39
152,-35.43899999999951,2240.529411764706,17,26,7,43
153,-29.865500000000264,2275.315789473684,25,26,10,51
154,-37.180249999999106,5566.5,24,31,13,55
155,-45.555999999998704,3558.5,18,31,4,49
156,-27.00174999999957,2609.294117647059,28,26,7,54
157,-41.7299999999994,2821.684210526316,15,26,7,41
158,-27.238249999998846,2932.0,17,29,8,46
159,-38.725249999998795,2843.5,26,22,9,48
160,-46.15149999999964,2315.4736842105262,12,28,6,40
161,-38.61749999999959,2192.5789473684213,16,25,7,41
162,-30.190499999999144,3271.2,25,26,5,51
163,-37.0179999999993,2417.4210526315787,15,25,6,40
164,-33.08824999999948,2546.705882352941,17,30,11,47
165,-38.16800000000049,2020.375,26,28,11,54
166,-32.68774999999915,2026.6470588235295,17,21,7,38
167,-42.8402499999993,2087.0,8,23,8,31
168,-23.988749999999513,2788.529411764706,31,23,10,54
169,-32.42949999999904,2996.9444444444443,28,31,10,59
170,-32.953249999998924,2487.625,27,27,5,54
171,-37.45224999999984,2033.111111111111,9,22,15,31
172,-32.46124999999974,2492.5555555555557,23,30,8,53
173,-42.903249999999154,1800.0625,11,30,2,41
174,-35.81174999999972,1911.125,16,25,6,41
175,-20.172499999999662,2829.6470588235293,31,27,2,58
176,-40.58374999999959,2121.2,9,27,4,36
177,-42.51774999999951,2195.3888888888887,17,23,6,40
178,-13.287499999998559,4100.277777777777,38,31,3,69
179,-42.677999999999074,2606.529411764706,21,34,6,55
180,-45.996499999998996,2346.4210526315787,12,29,9,41
181,-34.42299999999988,2949.5263157894738,20,22,10,42
182,-33.2509999999997,2060.1,11,23,5,34
183,-47.71199999999952,2744.0526315789475,23,38,3,61
184,-35.581500000000155,3524.2631578947367,26,43,5,69
185,-46.131999999999636,2060.5555555555557,8,22,6,30
186,-40.265249999999966,2035.9411764705883,29,26,15,55
187,-28.87649999999948,2494.2105263157896,13,32,6,45
188,-41.32024999999891,3170.722222222222,30,36,3,66
189,-44.02724999999992,3203.8,15,27,6,42
190,-35.00350000000033,2634.5263157894738,13,34,7,47
191,-39.440749999998495,2949.4444444444443,22,33,9,55
192,-36.675000000000175,1975.3529411764705,11,34,7,45
193,-28.797749999999503,3109.5882352941176,36,27,7,63
194,-31.89049999999972,2297.6111111111113,16,30,9,46
195,-37.51200000000016,2235.2631578947367,9,27,6,36
196,-48.30074999999942,2208.5263157894738,11,20,5,31
197,-39.637500000000195,1429.0,9,22,14,31
198,-40.41574999999985,3426.5789473684213,13,38,6,51
199,-34.81400000000041,2189.0588235294117,15,29,8,44
200,-33.079000000000455,2311.4117647058824,23,33,12,56
201,-43.938499999999756,2253.5,10,26,6,36
202,-36.12449999999971,2847.684210526316,28,27,5,55
203,-25.35774999999923,2572.7894736842104,16,29,7,45
204,-42.50724999999951,2420.6470588235293,18,28,4,46
205,-27.293999999998675,3580.7,25,34,5,59
206,-28.346499999999402,2752.4210526315787,25,17,11,42
207,-33.55524999999957,2568.8,10,32,3,42
208,-23.333499999999727,3243.0,34,34,12,68
209,-30.269749999998957,3650.55,23,33,10,56
210,-32.47024999999947,2035.0588235294117,11,21,10,32
211,-42.286999999999715,2741.3333333333335,20,30,6,50
212,-26.552249999999567,2245.0,10,26,8,36
213,-29.780249999998897,2108.9444444444443,20,28,5,48
214,-38.50899999999905,2507.5555555555557,15,29,7,44
215,-45.08650000000004,1776.5,5,25,10,30
216,-20.203249999999613,3124.0526315789475,29,28,7,57
217,-38.62724999999941,1845.5294117647059,20,32,10,52
218,-42.39999999999948,2187.5,16,23,5,39
219,-41.009749999999585,2262.8823529411766,16,23,15,39
220,-31.75674999999928,2751.5263157894738,15,34,4,49
221,-35.06224999999994,3060.5,26,31,8,57
222,-44.530499999999776,2514.5,31,26,4,57
223,-31.482749999999292,2808.5,15,26,8,41
224,-33.374999999998884,2691.4210526315787,16,28,8,44
225,-39.19924999999979,2262.7894736842104,13,28,9,41
226,-43.40649999999983,2398.235294117647,14,22,7,36
227,-39.13799999999873,3171.1,20,27,3,47
228,-32.073499999999484,2488.1666666666665,24,24,7,48
229,-40.94774999999952,2405.684210526316,14,28,8,42
230,-50.380499999999735,2160.0555555555557,13,29,9,42
231,-24.94124999999871,2573.823529411765,25,22,12,47
232,-12.213749999999509,2898.6315789473683,23,26,4,49
233,-38.5587499999994,2504.9444444444443,15,23,7,38
234,-30.673499999999773,2277.375,19,21,10,40
235,-36.94999999999941,2559.5263157894738,14,29,6,43
236,-37.971749999999645,2195.4444444444443,16,25,7,41
237,-35.3937499999994,2615.4210526315787,21,27,11,48
238,-38.72025000000009,2696.4210526315787,25,18,11,43
239,-38.16224999999967,2084.277777777778,18,30,8,48
240,-21.293749999999584,2164.823529411765,20,22,8,42
241,-30.652749999999422,2131.9444444444443,16,32,10,48
242,-39.42824999999925,3191.75,17,26,5,43
243,-48.522249999999545,2870.1111111111113,16,26,7,42
244,-40.735750000000095,2671.5555555555557,33,33,8,66
245,-46.14874999999952,3059.0526315789475,27,32,6,59
246,-36.73774999999916,2223.722222222222,14,24,7,38
247,-26.8114999999992,2699.842105263158,22,36,6,58
248,-33.948249999999966,2751.777777777778,21,27,6,48
249,-34.141999999999776,2970.4210526315787,32,25,5,57
250,-45.70550000000049,1960.7777777777778,16,33,12,49
251,-21.223499999999472,2940.3684210526317,29,22,9,51
252,-44.517000000000635,1429.0,18,25,14,43
253,-30.966499999999478,3258.45,22,32,3,54
254,-24.41049999999933,2602.9,18,28,3,46
255,-28.44074999999986,2591.3333333333335,15,26,6,41
256,-43.591749999999976,1491.5625,3,26,6,29
257,-34.54924999999956,4025.9,22,28,10,50
258,-35.30399999999956,2381.470588235294,17,27,5,44
259,-27.220999999998526,2602.842105263158,23,20,7,43
260,-30.933499999999743,2089.235294117647,33,20,7,53
261,-31.939999999999582,2580.470588235294,26,21,5,47
262,-42.65649999999975,2984.6,12,30,7,42
263,-26.343999999999347,3265.315789473684,24,25,12,49
264,-30.707999999998925,3990.25,23,29,11,52
265,-28.15899999999926,2815.8947368421054,18,27,9,45
266,-37.55624999999968,3801.684210526316,31,37,5,68
267,-29.890249999999376,3403.7,22,22,4,44
268,-33.15249999999919,3064.8,17,26,9,43
269,-27.397999999999495,2734.222222222222,21,25,5,46
270,-42.04549999999928,2032.25,11,27,6,38
271,-31.96199999999833,2373.176470588235,27,28,10,55
272,-28.687749999999717,2451.529411764706,22,21,9,43
273,-43.530750000000154,2017.2941176470588,17,34,12,51
274,-37.46150000000031,2162.8333333333335,25,31,11,56
275,-38.57574999999975,2209.6111111111113,14,23,10,37
276,-48.190749999999625,3417.6666666666665,14,29,7,43
277,-49.41899999999934,2598.684210526316,16,34,3,50
278,-40.661999999999686,2147.6315789473683,17,25,11,42
279,-34.5184999999996,2188.277777777778,15,29,4,44
280,-17.34200000000005,2051.823529411765,29,30,8,59
281,-32.58099999999992,2010.5263157894738,7,27,7,34
282,-24.41449999999988,2267.25,14,25,5,39
283,-37.56074999999928,2369.9444444444443,22,18,10,40
284,-40.41775000000047,2020.7777777777778,14,26,10,40
285,-34.18124999999983,2143.277777777778,15,37,4,52
286,-31.644749999998634,2630.222222222222,21,36,5,57
287,-25.912000000000187,2881.4444444444443,26,31,4,57
288,-43.27774999999973,2425.4117647058824,16,30,9,46
289,-33.97999999999942,2863.2,17,30,2,47
290,-33.15374999999925,3130.65,19,23,10,42
291,-33.516999999999406,3686.3684210526317,26,26,4,52
292,-35.617249999999935,2217.3888888888887,13,23,6,36
293,-60.86874999999948,3135.4444444444443,19,40,6,59
294,-31.54524999999946,3504.5,22,23,4,45
295,-17.526999999998925,3547.7894736842104,29,27,3,56
296,-44.04024999999989,2485.0526315789475,15,26,4,41
297,-34.733999999999455,2364.6470588235293,20,28,1,48
298,-29.90100000000003,2193.764705882353,18,26,6,44
299,-50.416000000000295,2000.4705882352941,15,33,3,48
300,-22.71224999999936,2753.9473684210525,16,30,4,46
301,-32.6074999999997,3808.5,21,33,7,54
302,-25.210499999999943,2429.8947368421054,17,31,3,48
303,-39.83574999999986,2079.85,10,20,8,30
304,-37.343249999999436,2743.0,27,29,4,56
305,-38.598500000000485,1429.0,16,28,13,44
306,-31.765249999999632,3083.0,17,23,3,40
307,-24.383499999999515,3575.05,25,31,4,56
308,-31.65374999999861,3616.3,23,32,4,55
309,-34.28124999999905,2321.5,14,31,5,45
310,-29.386999999999386,3155.3,19,28,4,47
311,-31.38149999999944,2664.75,11,30,5,41
312,-41.66374999999995,2111.6315789473683,13,25,7,38
313,-40.99199999999927,2726.5263157894738,19,31,6,50
314,-19.017999999999414,2080.823529411765,11,33,8,44
315,-51.20449999999969,1779.1666666666667,3,33,4,36
316,-31.244499999999174,2748.15,15,28,4,43
317,-39.4552499999992,2433.764705882353,18,28,6,46
318,-45.1459999999994,2358.8947368421054,14,21,8,35
319,-23.853999999999825,2857.6111111111113,24,40,7,64
320,-33.08749999999951,2008.4,12,21,8,33
321,-27.14574999999952,2438.2631578947367,16,28,5,44
322,-51.6969999999998,1925.5555555555557,7,28,5,35
323,-34.5729999999989,2875.315789473684,25,21,6,46
324,-43.07450000000016,2689.5882352941176,26,32,9,58
325,-28.169499999999363,2287.157894736842,9,31,5,40
326,-29.09524999999915,3084.0526315789475,22,27,5,49
327,-50.580999999999705,1429.0,6,21,9,27
328,-24.57824999999926,2467.6315789473683,20,21,7,41
329,-30.438749999999704,2675.1,19,24,3,43
330,-31.496499999999457,2451.684210526316,22,21,4,43
331,-35.049499999999014,4090.2,32,22,3,54
332,-34.54374999999949,2438.315789473684,17,24,5,41
333,-34.9707499999995,1653.25,12,20,7,32
334,-26.059749999999916,2429.9444444444443,24,30,6,54
335,-22.610499999999558,2236.764705882353,18,23,7,41
336,-35.4164999999992,2661.315789473684,23,29,3,52
337,-27.283749999999706,2756.823529411765,27,36,5,63
338,-38.133749999998635,2303.9411764705883,26,25,6,51
339,-51.103249999999726,2651.2631578947367,14,30,7,44
340,-22.860999999999116,3642.7,25,25,7,50
341,-35.97599999999984,2160.222222222222,11,21,7,32
342,-38.73174999999921,2864.3684210526317,19,28,4,47
343,-33.06924999999982,2089.875,24,33,7,57
344,-33.56824999999891,3166.7894736842104,16,27,6,43
345,-38.43924999999904,4035.4,28,34,3,62
346,-39.934000000000054,3466.7368421052633,28,29,7,57
347,-34.804749999999345,3385.35,19,35,4,54
348,-40.97624999999892,2183.529411764706,22,23,5,45
349,-38.820249999999014,3277.0526315789475,21,39,1,60
350,-41.70324999999981,2116.0555555555557,14,22,8,36
351,-35.16474999999918,3064.8947368421054,18,22,12,40
352,-23.06299999999918,3293.6315789473683,29,27,4,56
353,-33.643249999999725,1991.6666666666667,13,23,6,36
354,-44.18849999999979,1429.0,14,27,10,41
355,-29.15074999999944,2651.315789473684,20,30,3,50
356,-26.092750000000144,2167.1666666666665,20,33,8,53
357,-47.98949999999955,2053.764705882353,19,22,6,41
358,-23.042499999998213,4568.736842105263,37,35,3,72
359,-33.62874999999956,2861.7,15,27,4,42
360,-35.11349999999927,2416.25,25,25,8,50
361,-25.533999999999697,2401.777777777778,34,23,8,57
362,-36.17224999999946,3393.35,19,23,5,42
363,-38.52074999999779,4308.789473684211,38,32,9,70
364,-29.030749999998694,2358.1176470588234,27,27,5,54
365,-27.56025000000008,1429.0,14,24,12,38
366,-24.214499999999795,2001.388888888889,15,23,6,38
367,-30.461499999999557,2594.4210526315787,13,27,10,40
368,-35.52349999999886,3215.55,25,19,5,44
369,-31.088499999999517,2008.45,10,26,1,36
370,-38.35074999999923,2217.1176470588234,17,25,4,42
371,-40.57525000000008,1429.0,11,24,13,35
372,-24.480749999998874,3100.0,28,25,2,53
373,-42.77399999999953,1973.1666666666667,13,28,2,41
374,-31.87724999999957,2023.3125,26,30,7,56
375,-30.05974999999966,2459.0588235294117,18,26,4,44
376,-15.386000000000475,3251.2105263157896,39,32,8,71
377,-11.724000000000212,3019.7368421052633,39,21,10,60
378,-30.956749999999897,2838.277777777778,33,28,8,61
379,-25.190000000000342,2247.4444444444443,32,35,10,67
380,-37.55399999999917,2239.5882352941176,22,24,3,46
381,-35.04274999999876,3055.7894736842104,27,23,5,50
382,-32.26824999999948,2312.157894736842,12,28,5,40
383,-32.29324999999919,2484.6666666666665,16,26,6,42
384,-37.33799999999968,1429.0,4,29,5,33
385,-28.117249999999153,3327.9473684210525,25,23,7,48
386,-32.112499999999805,2087.4210526315787,18,25,6,43
387,-28.99324999999946,3029.7368421052633,29,28,9,57
388,-25.926999999999595,3076.0588235294117,31,27,2,58
389,-32.7379999999993,3041.0555555555557,24,26,8,50
390,-31.827249999999374,2340.8333333333335,23,23,5,46
391,-34.68124999999902,2962.4117647058824,29,25,6,54
392,-32.6107499999995,3327.4,15,37,5,52
393,-47.211749999999725,1652.1764705882354,9,30,5,39
394,-27.563249999998828,3521.95,23,32,6,55
395,-34.66649999999932,2286.15,14,21,11,35
396,-21.877499999998992,2943.4,24,26,8,50
397,-28.891249999998735,3988.55,31,29,2,60
398,-36.35024999999927,2228.1111111111113,16,23,7,39
399,-16.550749999999468,2215.294117647059,34,29,3,63
400,-27.045999999999196,2950.55,22,26,5,48
401,-32.408249999999185,2959.2,22,32,2,54
402,-32.60074999999936,3015.55,15,29,7,44
403,-47.54999999999939,3864.0,24,32,5,56
404,-31.782999999999465,2527.375,30,28,2,58
405,-36.20524999999972,2925.9,23,27,3,50
406,-36.08999999999909,2152.764705882353,20,30,2,50
407,-24.927249999999482,3561.0526315789475,25,36,2,61
408,-32.45599999999934,2087.0,14,23,4,37
409,-26.136999999999365,2726.4736842105262,23,27,4,50
410,-32.51974999999959,2004.9444444444443,14,26,6,40
411,-33.369249999999155,1755.4375,14,29,5,43
412,-43.58724999999934,2932.0,20,25,6,45
413,-14.094749999999397,3499.777777777778,30,27,5,57
414,-33.90174999999993,2359.1176470588234,19,30,6,49
415,-22.9312499999998,2675.1666666666665,18,28,4,46
416,-19.796249999999667,2760.75,18,27,2,45
417,-32.98099999999865,2991.722222222222,23,29,6,52
418,-32.120999999999654,2719.7894736842104,26,23,7,49
419,-41.81200000000011,2984.722222222222,26,38,3,64
420,-36.45074999999898,2077.0588235294117,15,31,4,46
421,-39.516249999999665,2130.1052631578946,9,29,6,38
422,-27.815249999999885,2619.5,19,26,3,45
423,-34.76574999999949,2005.235294117647,19,22,9,41
424,-33.957999999999586,2068.4444444444443,18,27,2,45
425,-30.955999999999868,2044.2,18,19,4,37
426,-28.629499999999304,2240.529411764706,23,31,5,54
427,-33.77924999999928,2294.5789473684213,20,27,3,47
428,-34.79674999999959,2652.9473684210525,24,29,4,53
429,-25.492249999998467,3157.6666666666665,29,26,3,55
430,-31.515749999999457,2079.0555555555557,14,22,6,36
431,-28.574749999999852,2147.5263157894738,21,32,9,53
432,-42.80149999999952,2378.777777777778,18,22,3,40
433,-9.02624999999941,3876.8947368421054,37,30,5,67
434,-27.31599999999883,4322.85,28,35,2,63
435,-7.190249999998892,2822.0,41,24,7,65
436,-18.236499999998912,3219.5263157894738,26,21,8,47
437,-21.27049999999945,2467.9444444444443,30,17,5,47
438,-30.236999999999107,2185.6666666666665,23,27,3,50
439,-43.69599999999948,3296.2631578947367,28,30,3,58
440,-26.025999999999982,2997.1052631578946,28,26,1,54
441,-48.8544999999999,2092.9411764705883,23,39,1,62
442,-32.93949999999894,2501.5,19,29,4,48
443,-28.236499999999715,2319.6666666666665,32,26,5,58
444,-37.51824999999966,3964.684210526316,27,43,5,70
445,-46.01150000000059,2167.1111111111113,24,34,5,58
446,-49.093750000000135,1429.0,2,24,1,26
447,-24.617249999998975,2796.8888888888887,28,35,1,63
448,-33.91074999999972,2088.722222222222,14,29,2,43
449,-31.919999999999362,2248.823529411765,25,34,2,59
450,-47.455999999998866,2711.3333333333335,27,34,6,61
451,-30.43224999999933,2499.6666666666665,20,28,5,48
452,-28.55549999999972,2320.6666666666665,19,28,0,47
453,-31.49074999999892,2896.5555555555557,27,32,6,59
454,-35.699249999999196,2548.15,19,22,4,41
455,-23.58774999999919,2713.714285714286,26,22,5,48
456,-25.22149999999903,2528.35,24,21,2,45
457,-42.92674999999899,2786.6315789473683,19,32,5,51
458,-29.41624999999984,2727.1111111111113,40,32,15,72
459,-26.153249999998838,4256.1,28,25,9,53
460,-12.27474999999934,2430.214285714286,26,27,5,53
461,-35.216249999999,2609.5789473684213,19,29,3,48
462,-30.84324999999932,2735.6315789473683,23,23,4,46
463,-35.720749999999,1749.3529411764705,7,36,4,43
464,-31.95174999999899,2280.6470588235293,23,26,3,49
465,-47.38725000000002,1866.0588235294117,10,40,1,50
466,-15.357249999998995,2566.4117647058824,25,29,2,54
467,-20.20999999999845,3741.6315789473683,31,38,9,69
468,-34.57750000000031,2614.0588235294117,33,38,2,71
469,-31.64974999999937,2096.6111111111113,19,21,7,40
470,-31.930500000000173,2087.4210526315787,11,29,7,40
471,-26.635999999998937,2660.1666666666665,23,23,3,46
472,-23.881249999999252,3395.8,25,25,6,50
473,-36.40824999999943,2030.4117647058824,15,29,2,44
474,-40.83299999999951,2196.1052631578946,11,26,4,37
475,-25.3392499999997,1903.25,37,27,10,64
476,-38.39974999999988,2052.1,11,22,4,33
477,-17.471999999999404,3449.0,23,30,5,53
478,-31.469499999999766,2165.8947368421054,23,20,2,43
479,-30.269499999999407,2451.684210526316,19,28,1,47
480,-20.06099999999935,2729.8125,37,23,5,60
481,-27.629249999999644,2122.764705882353,23,28,6,51
482,-21.665999999999098,2880.6111111111113,35,26,3,61
483,-31.98224999999881,3766.45,30,26,3,56
484,-28.143999999999238,2211.842105263158,22,25,2,47
485,-32.283999999999615,3093.4,12,32,1,44
486,-27.154499999999295,2365.6,21,24,2,45
487,-40.781999999998625,3829.85,26,40,5,66
488,-42.2722500000001,1941.388888888889,11,33,4,44
489,-29.531499999999255,2080.8333333333335,18,29,1,47
490,-21.93074999999927,3200.5,25,28,1,53
491,-36.5892499999993,2559.9411764705883,26,24,4,50
492,-11.935999999999618,4059.3,28,30,2,58
493,-26.415999999999563,2699.8,22,25,2,47
494,-38.555999999999344,2099.6,24,15,3,39
495,-14.953749999998669,2993.842105263158,27,27,3,54
496,-33.309249999999146,3035.684210526316,26,22,8,48
497,-41.22674999999934,1989.0555555555557,6,31,4,37
498,-23.12474999999963,2136.6315789473683,12,25,6,37
499,-34.34749999999909,3177.6315789473683,24,32,4,56
500,-34.33449999999908,2743.8888888888887,30,25,2,55
501,-10.225499999997714,2413.176470588235,38,25,10,63
502,-26.87424999999892,2932.0526315789475,26,35,6,61
503,-30.08374999999942,2051.8823529411766,22,28,4,50
504,-38.04799999999843,3098.3888888888887,35,31,4,66
505,-20.29824999999914,3461.7368421052633,25,30,6,55
506,-26.562249999999732,2353.4117647058824,25,24,5,49
507,-26.263499999998523,3621.315789473684,42,33,3,75
508,-45.143249999999604,2135.3888888888887,20,30,4,50
509,-32.135999999999825,2032.25,12,28,2,40
510,-32.65349999999949,2023.8947368421052,17,22,5,39
511,-47.30674999999964,2107.625,32,34,5,66
512,-27.669499999999402,2552.15,22,20,4,42
513,-38.553999999999405,3296.2105263157896,24,35,4,59
514,-25.452999999999363,2441.5,31,30,7,61
515,-35.06024999999964,1981.3684210526317,12,24,5,36
516,-6.7702499999989385,3284.5789473684213,42,21,3,63
517,-24.445499999999164,3242.55,23,28,2,51
518,-25.417499999999517,2139.705882352941,28,21,2,49
519,-35.32924999999954,1933.5,18,25,4,43
520,-23.440499999999144,2565.65,14,33,6,47
521,-16.363499999999284,2603.769230769231,30,29,2,59
522,-28.494499999999583,2086.9444444444443,23,18,3,41
523,-34.93999999999885,2005.5625,33,23,7,56
524,-24.498499999998923,2344.8125,21,30,2,51
525,-33.687500000000455,2238.6111111111113,23,33,6,56
526,-21.758499999999465,2497.0,22,22,6,44
527,-11.399249999999784,2671.5555555555557,36,28,10,64
528,-11.673500000000164,2108.0555555555557,34,21,4,55
529,-31.89199999999935,2935.45,17,30,6,47
530,-27.414249999999846,2402.5555555555557,25,28,4,53
531,-29.120249999998844,3361.7,25,31,3,56
532,-18.383499999999554,2648.923076923077,32,22,4,54
533,-24.112499999999454,2512.6315789473683,27,20,4,47
534,-35.83349999999937,2117.176470588235,26,25,0,51
535,-24.257249999999853,2319.764705882353,40,19,4,59
536,-38.040249999998956,3794.25,25,37,2,62
537,-25.30924999999935,2526.235294117647,33,41,8,74
538,-14.211999999998676,3646.6,46,25,5,71
539,-28.128999999999497,2247.8947368421054,18,23,2,41
540,-29.89674999999887,2803.315789473684,20,33,2,53
541,-13.548499999999132,2717.2631578947367,35,19,3,54
542,-36.99325000000003,1429.0,6,27,2,33
543,-31.644999999999385,2274.5263157894738,23,25,2,48
544,-34.54874999999891,3340.2,21,35,3,56
545,-17.490249999998913,4021.1,35,28,3,63
546,-28.417999999999807,2218.4736842105262,19,19,8,38
547,-24.18249999999899,4417.95,43,24,4,67
548,-25.35874999999877,4478.368421052632,41,31,3,72
549,-21.719749999999145,2586.157894736842,24,22,4,46
550,-14.232999999999445,3152.5789473684213,36,27,1,63
551,-33.185499999999585,2086.0,27,17,5,44
552,-34.34349999999941,2001.4444444444443,15,25,6,40
553,-24.141249999999896,2297.9473684210525,18,24,7,42
554,-6.307249999999105,2917.1875,36,30,3,66
555,-18.196749999999305,3948.15,33,33,3,66
556,-36.310999999999105,2650.4736842105262,22,26,6,48
557,-36.13525000000013,2084.529411764706,28,31,2,59
558,-15.840499999999029,2433.5,32,23,1,55
559,-24.976499999998904,2472.3333333333335,24,30,1,54
560,-26.974999999999834,2442.4736842105262,20,33,4,53
561,-22.89874999999942,3788.65,29,34,0,63
562,-31.000249999998793,3492.5789473684213,35,36,2,71
563,-27.983999999998996,3733.9,26,26,7,52
564,-19.089249999998923,3074.722222222222,30,32,1,62
565,-35.346499999999494,2169.6,19,27,0,46
566,-23.053499999999836,2074.235294117647,31,17,8,48
567,-22.184249999999505,2028.3,26,14,5,40
568,-21.229249999999443,2246.5625,32,24,5,56
569,-23.25449999999985,2310.470588235294,21,27,1,48
570,-27.43574999999965,2631.5833333333335,26,26,0,52
571,-26.511249999998917,3324.25,31,28,2,59
572,-29.105499999999058,2520.777777777778,38,30,6,68
573,-39.270749999999154,2531.0526315789475,20,29,3,49
574,-21.595499999999415,2666.315789473684,43,19,3,62
575,-30.095249999999464,2185.3529411764707,17,43,5,60
576,-26.02499999999963,2032.25,17,20,6,37
577,-24.224999999999298,2005.5,34,22,4,56
578,-19.063499999999053,3673.8947368421054,34,30,5,64
579,-24.50699999999977,2058.55,16,19,3,35
580,-14.543249999999713,2328.294117647059,31,31,3,62
581,7.126250000000482,3221.8888888888887,38,25,2,63
582,-15.172499999999351,3053.7,26,32,1,58
583,-36.86799999999981,2532.277777777778,14,38,6,52
584,-32.62174999999931,2711.3333333333335,24,29,4,53
585,-26.48399999999959,2197.684210526316,20,24,3,44
586,-31.719749999999475,2586.95,19,25,3,44
587,-19.0039999999997,3423.2105263157896,29,37,3,66
588,-11.497499999999231,3966.35,43,30,3,73
589,-11.67424999999861,2403.4375,38,27,4,65
590,-30.652249999999405,2126.7,19,23,4,42
591,-26.20699999999788,2625.1176470588234,46,18,5,64
592,-20.082749999999113,2747.3333333333335,34,24,6,58
593,-26.456749999999158,2691.4117647058824,33,39,3,72
594,-14.81499999999943,2556.0,37,32,2,69
595,-14.777749999998951,1925.125,38,26,4,64
596,-28.323999999999536,2602.5384615384614,24,21,4,45
597,-40.15574999999981,2116.684210526316,16,28,2,44
598,-19.929749999999625,2209.5555555555557,44,40,7,84
599,-20.872499999998578,3588.684210526316,42,26,2,68
600,-24.844749999999472,2092.277777777778,28,20,6,48
601,-18.613999999999237,1782.9411764705883,11,32,7,43
602,-27.607249999999112,2064.8823529411766,31,16,2,47
603,-45.74024999999967,2745.7,11,33,4,44
604,-26.44374999999938,2257.5333333333333,24,22,7,46
605,-22.954749999999372,2457.1176470588234,42,28,2,70
606,-13.10124999999922,2551.4117647058824,40,16,4,56
607,-17.329749999999642,2548.0555555555557,23,32,4,55
608,-17.56949999999906,2401.8333333333335,29,32,5,61
609,-36.24649999999973,1967.1052631578948,21,23,5,44
610,-41.75549999999925,3921.1052631578946,21,37,2,58
611,-31.788249999999984,2063.0625,32,28,3,60
612,-11.764999999999988,2076.277777777778,45,15,6,60
613,-35.22100000000069,1429.0,15,43,4,58
614,-21.70899999999952,2846.6,33,22,0,55
615,-33.18099999999982,2420.222222222222,18,37,3,55
616,-6.728499999997505,2776.529411764706,44,31,7,75
617,-26.536499999999137,3379.15,30,29,2,59
618,-26.548750000000364,1429.0,6,33,14,39
619,-23.840499999998922,1845.6875,21,34,5,55
620,-19.777999999999288,2014.3125,31,30,6,61
621,-21.51149999999949,2257.0,15,37,3,52
622,-18.1187499999994,4262.8421052631575,45,31,2,76
623,-7.063499999999481,3425.7368421052633,41,25,5,66
624,-15.043249999999777,2567.0,40,20,6,60
625,-18.67399999999963,1964.0,27,20,2,47
626,-30.24899999999884,2855.5714285714284,28,29,4,57
627,-25.825999999999304,2219.0,27,23,5,50
628,-20.188999999998718,2543.0,32,31,5,63
629,-22.70974999999859,2178.0,29,26,9,55
630,2.916250000000364,4410.666666666667,48,30,2,78
631,-18.821749999999547,1950.0,33,23,4,56
632,-23.50599999999974,2672.823529411765,27,33,5,60
633,-21.103499999998068,5085.5,42,43,4,85
634,-11.755749999999892,2550.125,35,31,10,66
635,-34.83949999999935,2058.55,17,28,2,45
636,-17.468999999999518,2359.4444444444443,30,17,3,47
637,1.1865000000010317,4148.15,54,23,1,77
638,-26.33924999999971,2550.5,12,32,2,44
639,-36.5784999999994,2307.3888888888887,21,37,4,58
640,-11.635749999998175,3787.5263157894738,55,18,6,73
641,-39.37450000000012,2124.9473684210525,12,27,5,39
642,-6.45974999999946,2423.5882352941176,40,17,2,57
643,-16.956249999999272,2849.75,24,28,2,52
644,-15.463499999999703,2170.0625,31,18,1,49
645,-27.49474999999951,2235.4,20,18,7,38
646,0.01625000000028507,3080.7368421052633,54,19,8,73
647,1.2115000000009755,2085.875,43,28,6,71
648,-13.059749999999397,2593.470588235294,32,25,4,57
649,-7.816499999999638,2161.25,37,25,9,62
650,-1.460999999999594,3628.0,34,25,6,59
651,-17.876499999999012,3068.2105263157896,45,22,1,67
652,-13.79849999999833,2093.9411764705883,41,24,1,65
653,-25.391999999999474,2084.529411764706,37,22,5,59
654,19.744750000001197,3837.05,57,17,2,74
655,-19.780749999997983,4550.55,47,34,6,81
656,-24.645249999999628,2291.823529411765,38,20,6,58
657,-31.457000000000107,2102.4210526315787,25,18,15,43
658,-18.26049999999918,2628.3333333333335,26,23,7,49
659,-10.924249999999557,2507.0833333333335,31,13,5,44
660,-15.576749999999526,3828.25,31,32,3,63
661,-32.99500000000001,1429.0,14,42,3,56
662,-32.12649999999937,1959.4736842105262,27,15,5,42
663,-22.663499999998564,3370.0,37,31,9,68
664,-19.565999999999416,2122.764705882353,29,16,3,45
665,-10.36349999999854,3482.3529411764707,51,15,5,66
666,-23.00124999999963,2044.15,25,21,4,46
667,-22.09499999999934,2552.1,26,21,4,47
668,-14.78149999999917,2605.5,39,22,1,61
669,1.715250000001177,4075.1,55,24,1,79
670,-29.651749999999208,1741.5625,18,41,5,59
671,-25.586249999999588,2500.1052631578946,35,16,5,51
672,-12.33724999999967,2419.8947368421054,30,21,9,51
673,-5.859249999998743,3139.8888888888887,54,15,8,69
674,-14.218499999998851,2174.3333333333335,37,21,5,58
675,-28.376249999998766,3026.9444444444443,30,34,6,64
676,4.89325000000194,3252.4117647058824,59,22,6,81
677,-10.414499999998748,2947.6666666666665,46,19,3,65
678,-15.590499999998887,3750.9444444444443,48,25,9,73
679,4.004250000001649,4773.55,65,25,3,90
680,-18.301749999999025,1876.5,34,16,6,50
681,-27.491749999999975,1913.2222222222222,11,32,3,43
682,6.5650000000007065,2908.235294117647,49,27,1,76
683,-9.60999999999925,4062.35,35,29,4,64
684,7.119750000001605,3809.2631578947367,53,27,2,80
685,-16.638249999999623,2210.529411764706,27,22,3,49
686,-21.827999999999143,2143.375,31,22,5,53
687,-9.413249999999554,2587.842105263158,39,25,2,64
688,-5.807999999999078,3576.75,35,31,1,66
689,-43.463499999998376,2104.9473684210525,23,26,10,49
690,-13.044749999999434,2439.722222222222,36,18,7,54
691,-29.041999999998744,3639.35,31,38,3,69
692,6.558500000001006,3254.5555555555557,40,28,6,68
693,-19.589249999999435,2038.9473684210527,25,13,7,38
694,8.735750000000296,3409.0,46,28,3,74
695,-21.61874999999824,2666.1875,41,34,9,75
696,-21.888999999999417,2465.8947368421054,27,23,3,50
697,6.092250000000791,3109.8888888888887,54,21,7,75
698,-4.287999999999211,3161.7368421052633,44,21,3,65
699,-7.202499999999186,2841.75,31,20,5,51
700,-19.487999999999495,2627.0,31,22,2,53
701,-23.189499999999136,2009.764705882353,34,17,2,51
702,-7.116749999999763,2307.5882352941176,35,22,13,57
703,-25.897749999999,2649.5,29,31,4,60
704,4.912250000001427,3089.176470588235,49,21,4,70
705,-33.83674999999934,2924.823529411765,39,56,10,95
706,-31.767249999999922,1711.2777777777778,9,36,9,45
707,-18.053749999999248,3147.5263157894738,22,33,7,55
708,-25.553249999999338,2284.5263157894738,27,19,1,46
709,-16.31849999999952,1890.2222222222222,19,30,3,49
710,-17.85949999999948,1953.7222222222222,27,18,2,45
711,-26.76849999999887,4103.6,32,37,3,69
712,-4.928749999998986,3757.7,39,26,2,65
713,-29.923499999999613,2062.2631578947367,26,17,4,43
714,-18.237999999999595,2125.85,28,17,2,45
715,-24.199499999998928,2024.8,34,24,8,58
716,-10.33949999999931,2425.6111111111113,36,28,11,64
717,-6.820749999998803,3970.5263157894738,43,26,3,69
718,-15.35324999999896,2607.1666666666665,35,25,1,60
719,-6.426249999997931,1867.0,34,25,8,59
720,-22.13200000000021,2548.1111111111113,34,20,16,54
721,-3.826749999998291,4515.9473684210525,51,35,4,86
722,-15.329500000000166,1963.1764705882354,36,22,13,58
723,-11.856749999999579,3060.7368421052633,25,29,4,54
724,-8.799499999998993,3651.2631578947367,32,33,6,65
725,-33.6067499999997,2017.2777777777778,20,24,6,44
726,-17.38124999999929,2451.076923076923,30,17,2,47
727,-19.994499999999526,3117.5263157894738,34,33,11,67
728,-9.400999999998486,2550.1875,52,30,3,82
729,-34.522499999998914,1660.5882352941176,20,37,11,57
730,-2.445999999999324,3167.6315789473683,49,18,4,67
731,-16.702499999999493,2008.4,24,20,2,44
732,-13.501249999999061,2804.4,28,29,0,57
733,1.543000000000695,2206.764705882353,35,24,3,59
734,-16.00599999999871,2794.0588235294117,37,31,4,68
735,-13.568999999998514,3719.842105263158,42,28,9,70
736,-34.87349999999946,2955.15,19,35,5,54
737,-7.313499999998463,4538.6,39,46,5,85
738,-5.697249999999203,3179.2631578947367,45,22,6,67
739,-33.26799999999958,2314.230769230769,31,27,11,58
740,-6.370749999998442,3483.1,36,26,3,62
741,-26.47124999999972,2101.470588235294,14,40,2,54
742,-5.542999999999443,2513.1176470588234,32,18,2,50
743,-16.115749999999274,2487.277777777778,30,24,4,54
744,-28.633499999999923,1959.578947368421,25,22,12,47
745,4.328500000001888,4609.25,67,18,2,85
746,-31.078499999999472,1786.6470588235295,18,29,8,47
747,-27.725749999999163,2343.5,38,17,9,55
748,-9.843999999999195,3087.0,35,19,5,54
749,-13.85649999999932,2719.7894736842104,38,20,5,58
750,-23.749249999999414,2393.5882352941176,34,17,7,51
751,-15.884499999999658,2213.9444444444443,27,22,3,49
752,-20.45549999999966,2515.9473684210525,36,17,12,53
753,-11.065249999999327,2707.2631578947367,28,29,4,57
754,-7.853999999998786,3032.222222222222,37,32,1,69
755,-26.593249999999493,2024.3,27,12,5,39
756,-26.66924999999989,2166.5882352941176,25,24,6,49
757,-17.05274999999977,2133.6111111111113,25,19,4,44
758,-17.65799999999983,2245.2631578947367,28,18,5,46
759,-24.804249999999392,2238.6666666666665,27,27,7,54
760,-27.42574999999954,2022.9473684210527,23,19,3,42
761,-11.905499999999414,3072.3684210526317,40,26,7,66
762,-9.140999999999774,2370.235294117647,35,21,3,56
763,-13.640750000000281,2317.9411764705883,45,28,8,73
764,-1.5034999999992067,3462.5263157894738,45,34,4,79
765,0.3492500000015456,2184.470588235294,32,27,7,59
766,-25.24874999999927,2030.6,20,26,1,46
767,-32.15974999999948,2008.55,14,30,1,44
768,21.01325000000135,4393.777777777777,69,30,8,99
769,-22.96124999999929,2167.15,28,16,3,44
770,-16.3407499999995,1848.625,33,20,2,53
771,-19.51824999999958,2679.4444444444443,32,16,6,48
772,-28.32349999999886,2714.6666666666665,31,22,9,53
773,-20.69999999999978,2240.3888888888887,23,23,5,46
774,-21.207999999999288,3381.4,39,15,6,54
775,-7.048999999999379,2571.0588235294117,34,17,2,51
776,-5.997999999998406,3127.6,37,30,4,67
777,-7.807999999999109,3794.0526315789475,51,25,9,76
778,-7.764999999999489,3152.3333333333335,47,14,4,61
779,-18.396499999999712,2455.9375,30,31,6,61
780,-15.656749999999372,1982.625,36,32,5,68
781,-19.428999999999895,1921.1764705882354,27,28,8,55
782,-11.754249999999015,2530.2105263157896,34,19,2,53
783,-7.115999999999235,1951.8125,42,15,5,57
784,-24.203999999999724,1795.1875,34,36,5,70
785,-6.621499999999154,1925.125,52,32,12,84
786,-19.15149999999975,2143.4117647058824,28,20,5,48
787,-13.367999999999435,2689.4,38,13,1,51
788,-25.568749999999575,1429.0,12,33,9,45
789,-18.06199999999889,2342.75,30,24,6,54
790,-24.57424999999877,2183.8888888888887,32,16,8,48
791,6.811500000001234,4048.2,37,34,4,71
792,3.048000000000945,2999.7,48,18,3,66
793,-12.95899999999881,2395.5555555555557,34,24,2,58
794,-8.447999999998753,2231.6111111111113,38,20,6,58
795,-23.234499999999663,2059.8947368421054,23,21,8,44
796,-3.030249999999234,3338.3888888888887,50,24,6,74
797,-17.279999999999543,2115.75,16,28,4,44
798,-19.07724999999907,2518.705882352941,27,30,2,57
799,-11.068499999999355,3130.0,39,35,7,74
800,-21.671499999999885,1909.7222222222222,28,26,13,54
801,7.280750000001417,4031.4736842105262,57,18,3,75
802,-6.14974999999917,2568.05,30,29,3,59
803,1.6065000000009202,2659.277777777778,35,30,5,65
804,-15.20024999999921,1960.75,48,19,5,67
805,-11.660999999999166,3137.15,33,18,3,51
806,-43.26199999999903,2370.235294117647,23,38,4,61
807,-19.461249999999662,1912.7058823529412,37,19,6,56
808,-23.23474999999957,2374.4444444444443,24,32,6,56
809,-17.180249999999155,2958.6315789473683,41,25,3,66
810,-10.950249999999238,3802.15,36,30,5,66
811,-20.608499999999367,3563.25,25,29,4,54
812,-2.4102499999994746,2146.1176470588234,41,29,10,70
813,-18.51149999999917,2817.6470588235293,31,23,4,54
814,4.0910000000012765,3910.1,40,33,2,73
815,-11.89624999999944,2041.0,20,25,8,45
816,-23.104999999999386,1963.1176470588234,26,20,5,46
817,-9.188999999999307,2322.4444444444443,29,17,4,46
818,-11.770749999999518,3253.6111111111113,41,33,8,74
819,3.5510000000015722,2854.0,41,31,5,72
820,-5.633499999999316,2963.176470588235,40,26,4,66
821,-12.335749999999873,2168.0,39,20,13,59
822,1.7137500000006987,3835.45,47,17,2,64
823,5.216750000000953,2419.6,45,28,3,73
824,-19.30174999999983,1959.5263157894738,24,21,5,45
825,-0.2032499999988607,3823.5,49,19,5,68
826,-23.16749999999873,2198.0,27,25,9,52
827,-14.013249999999084,2462.823529411765,36,28,3,64
828,-6.219499999999019,3018.4375,39,47,2,86
829,-33.02074999999975,1976.2105263157894,21,22,4,43
830,-19.976999999998515,2522.470588235294,43,21,7,64
831,-10.207249999998972,2397.3333333333335,35,23,6,58
832,-14.913999999999074,3119.157894736842,31,31,4,62
833,-24.349249999999664,2054.0625,30,24,7,54
834,-35.762499999999996,1952.0526315789473,20,26,17,46
835,0.6985000000007608,2694.3529411764707,41,23,3,64
836,-21.551499999999372,2364.777777777778,27,26,1,53
837,-4.22699999999943,3512.5789473684213,55,19,3,74
838,5.703500000001393,2479.470588235294,32,38,8,70
839,1.22925000000035,4624.578947368421,51,28,3,79
840,0.26750000000105256,3542.777777777778,47,29,2,76
841,-9.795999999999065,3028.722222222222,53,17,5,70
842,-2.6972499999989674,3125.0,44,16,2,60
843,-25.72649999999869,2389.0,28,29,4,57
844,-4.953499999999217,3237.684210526316,34,29,3,63
845,-24.11799999999987,1913.1666666666667,18,33,2,51
846,-33.93074999999982,1960.7222222222222,19,38,1,57
847,-12.451499999998905,3102.5263157894738,36,24,4,60
848,-15.008749999999377,2329.5555555555557,32,18,2,50
849,-13.98574999999957,2643.35,24,25,2,49
850,-26.86524999999948,2274.0588235294117,29,18,2,47
851,-33.38349999999994,1913.111111111111,23,27,6,50
852,-26.880749999999892,2246.0,14,32,7,46
853,-24.744749999999637,2055.529411764706,28,23,4,51
854,-34.73724999999968,2007.157894736842,21,11,7,32
855,4.878000000000435,3703.4444444444443,46,32,6,78
856,-23.866749999999747,2094.75,28,21,10,49
857,-24.027249999999746,2275.85,19,24,2,43
858,-13.853999999998768,3631.45,49,24,5,73
859,-4.46174999999935,4533.1,49,31,1,80
860,7.982500000001394,4099.65,42,37,3,79
861,-18.496499999999486,2349.684210526316,25,28,5,53
862,-17.290249999998828,2536.722222222222,36,18,6,54
863,-10.191249999999119,2708.4,32,19,6,51
864,-23.924499999999533,2024.35,25,16,2,41
865,-8.415999999999972,1907.0588235294117,31,44,3,75
866,9.339000000001038,3538.235294117647,52,23,8,75
867,11.025000000002057,2731.6470588235293,60,16,9,76
868,17.72550000000148,3974.684210526316,66,17,3,83
869,0.1390000000025065,5086.2,69,23,5,92
870,-12.002499999999223,2053.9375,35,19,5,54
871,-5.9374999999994404,2357.625,31,30,3,61
872,-24.72199999999973,1929.421052631579,17,27,5,44
873,0.45525000000126836,4001.35,49,31,1,80
874,3.14550000000074,4729.15,48,31,1,79
875,1.6002500000010855,3228.1111111111113,45,20,3,65
876,-12.624499999999188,2749.470588235294,23,26,5,49
877,11.033500000001066,3300.4444444444443,48,24,1,72
878,3.3647500000014796,4630.7,61,26,3,87
879,-7.841999999999496,2775.3333333333335,29,24,1,53
880,-29.909500000000207,1429.0,8,32,7,40
881,-18.802500000000087,2130.7894736842104,34,21,18,55
882,7.5077500000016055,3274.6666666666665,52,28,4,80
883,-20.98274999999989,2169.5,19,24,0,43
884,-5.322249999999036,4063.2105263157896,43,37,7,80
885,-9.528499999998804,2816.277777777778,43,17,5,60
886,-27.011000000000006,1567.9375,20,27,18,47
887,5.5117500000010216,4157.7,38,34,5,72
888,-9.872249999998457,2589.6875,48,21,5,69
889,-21.59524999999898,2320.3846153846152,25,25,4,50
890,-11.08649999999897,2634.4736842105262,43,19,2,62
891,-16.156249999999243,2957.65,37,17,4,54
892,-0.7624999999989005,2909.8333333333335,51,17,5,68
893,1.9902500000007222,3125.0526315789475,38,24,4,62
894,-13.843999999998562,5091.75,54,35,4,89
895,-20.177999999998978,2444.923076923077,30,22,4,52
896,0.9192500000012261,2458.9375,41,24,5,65
897,-21.08274999999917,2396.375,35,27,2,62
898,-0.8739999999984234,3713.0526315789475,50,20,6,70
899,8.225000000001438,2732.6875,54,24,5,78
900,1.3520000000013312,3842.6315789473683,49,26,3,75
901,4.641750000001063,3512.684210526316,53,21,1,74
902,-8.663249999999234,2173.294117647059,29,25,6,54
903,7.775750000002178,2731.6666666666665,46,27,5,73
904,-10.657249999999125,2038.6,42,26,6,68
905,-10.618999999999179,3184.3684210526317,47,22,4,69
906,-9.247999999998948,3712.5,45,24,2,69
907,-8.823249999999621,1951.0588235294117,23,27,11,50
908,-9.63849999999909,2839.0,50,22,3,72
909,-6.877749999999319,2410.0666666666666,45,20,3,65
910,-9.998749999999294,2421.25,33,31,3,64
911,-25.62574999999948,2024.3,25,13,5,38
912,-5.769749999999183,3549.0555555555557,44,29,1,73
913,-29.555499999999842,2158.4,15,22,4,37
914,-35.86499999999877,2186.235294117647,26,25,5,51
915,-18.23624999999962,2317.157894736842,20,32,4,52
916,-30.951999999999323,2223.6875,34,20,5,54
917,-29.8747499999997,2104.4,23,15,5,38
918,-21.434249999999306,2223.705882352941,30,26,8,56
919,0.047500000001177066,3653.0,40,24,2,64
920,-20.645499999998936,2817.9444444444443,44,24,1,68
921,-33.78075000000002,1429.0,10,27,6,37
922,-9.210499999999161,3510.75,40,21,1,61
923,15.529000000001535,4219.368421052632,46,37,7,83
924,-9.681499999999442,2526.294117647059,34,22,8,56
925,-3.6357499999989917,3179.315789473684,38,38,5,76
926,3.4272500000007695,3182.222222222222,52,24,2,76
927,-28.20624999999954,1429.0,9,34,8,43
928,0.3787500000014684,3110.9,50,21,5,71
929,-30.512499999999545,1921.1176470588234,33,18,3,51
930,-0.4959999999988695,2670.25,45,34,3,79
931,-20.832999999997618,2514.0588235294117,42,24,10,66
932,-17.48024999999949,2879.85,13,42,3,55
933,-10.937249999998853,3221.95,36,26,5,62
934,-17.862749999999313,2063.0,35,37,10,72
935,-3.167499999998987,3147.684210526316,53,13,2,66
936,-11.244499999999437,2012.8333333333333,38,19,8,57
937,-11.09199999999967,2743.705882352941,32,26,4,58
938,-12.019999999998998,3008.5,39,29,9,68
939,-9.56449999999939,3483.2,37,23,5,60
940,9.886750000001951,4542.5,59,19,5,78
941,0.6585000000006396,3636.25,41,29,2,70
942,-16.91149999999901,2002.9473684210527,31,19,5,50
943,-24.305999999999546,2068.3333333333335,26,20,5,46
944,-38.80374999999956,2028.2,22,15,6,37
945,-17.062249999999537,2370.0555555555557,31,29,7,60
946,-7.1794999999991465,2423.1875,38,24,4,62
947,-1.490999999999149,2554.3333333333335,38,18,2,56
948,-10.527749999998766,2923.6,45,15,5,60
949,-4.423499999999062,3759.9473684210525,48,42,11,90
950,0.8697500000011491,3162.684210526316,52,16,6,68
951,3.758500000001709,2356.294117647059,50,20,2,70
952,-6.511749999999852,2134.3125,39,26,11,65
953,-21.06724999999898,1564.4117647058824,18,29,5,47
954,-13.90674999999926,2164.823529411765,29,29,7,58
955,-8.382749999998783,2490.6470588235293,48,20,5,68
956,18.698000000002217,2733.5625,71,13,5,84
957,-20.419499999999285,2659.222222222222,33,29,4,62
958,-4.80449999999864,3002.3333333333335,42,30,4,72
959,-16.28699999999832,2263.0,38,41,3,79
960,-21.604499999999046,2837.176470588235,33,39,3,72
961,-9.960499999998952,3083.85,36,19,5,55
962,4.390250000001368,3522.6315789473683,48,21,5,69
963,-10.925499999999541,2612.8571428571427,41,22,9,63
964,-8.902999999999267,3481.4,40,31,2,71
965,-20.71524999999834,3182.6315789473683,27,42,8,69
966,-13.068999999999459,3044.2,29,30,7,59
967,-20.209999999999706,1727.8235294117646,21,32,6,53
968,2.618500000001029,3770.35,45,29,4,74
969,-29.894499999999333,2099.277777777778,24,17,5,41
970,9.74300000000216,2545.1875,61,16,5,77
971,-9.963999999999341,1853.6875,27,30,6,57
972,-17.89499999999955,2647.5882352941176,42,33,5,75
973,10.697000000001387,3590.315789473684,55,22,2,77
974,-2.8914999999996343,3957.9473684210525,48,20,5,68
975,-9.06024999999876,3316.176470588235,51,27,6,78
976,-2.8672499999985073,3729.0526315789475,49,17,8,66
977,-19.544999999999142,2444.0588235294117,35,30,7,65
978,-20.24549999999931,2674.3333333333335,25,31,4,56
979,2.942000000001232,2923.722222222222,47,24,5,71
980,-17.644999999998596,3038.65,42,20,3,62
981,-27.720249999998533,2454.8125,35,36,7,71
982,-1.9217499999988448,3638.8947368421054,44,23,5,67
983,-31.305749999999442,2028.25,27,9,7,36
984,-6.32974999999813,2237.6875,45,29,4,74
985,0.5500000000008398,3583.3888888888887,38,34,6,72
986,-5.6187499999990385,2634.470588235294,44,21,4,65
987,-10.493249999999268,2571.9,31,22,5,53
988,-9.917249999998418,4910.1,46,40,3,86
989,-3.7892499999984075,3273.0555555555557,44,29,3,73
990,-4.116999999998887,3009.684210526316,44,20,1,64
991,0.9105000000014577,5342.7,45,31,11,76
992,12.180750000001481,3516.9411764705883,59,26,6,85
993,-8.531749999999644,3143.315789473684,37,27,7,64
994,-0.3917499999987329,3042.0,50,22,1,72
995,-19.47649999999927,2800.7894736842104,24,32,4,56
996,2.675750000000878,3440.1,41,22,4,63
997,-17.2177499999991,2336.6470588235293,37,30,2,67
998,1.4110000000004348,2546.6470588235293,35,24,4,59
999,-21.006249999999614,2125.5882352941176,35,33,7,68
1000,7.980000000001181,3582.1052631578946,58,23,4,81
1001,-18.620249999999483,2672.4444444444443,33,33,6,66
1002,28.451000000001663,5104.55,65,27,6,92
1003,-0.9782499999987714,4907.0,40,26,9,66
1004,-14.323249999999373,1937.9411764705883,30,19,9,49
1005,-16.507749999999092,3404.45,32,30,4,62
1006,-14.935999999999671,2296.8333333333335,40,22,8,62
1007,7.5900000000010035,3895.7,41,30,3,71
1008,-13.717749999998578,3102.777777777778,40,27,6,67
1009,12.01150000000111,5015.6,56,17,5,73
1010,-24.26024999999957,2154.5,28,16,3,44
1011,-5.745999999999527,2485.625,34,26,6,60
1012,-15.644749999999169,2253.7,32,24,1,56
1013,-15.742749999999333,2568.0,41,17,0,58
1014,-20.608999999999575,2063.9,27,14,3,41
1015,-7.152499999999004,2755.0588235294117,33,19,4,52
1016,-9.52649999999907,2430.0,38,14,6,52
1017,9.958500000001486,3788.315789473684,58,20,3,78
1018,-5.190499999997604,2800.3888888888887,53,17,12,70
1019,-9.3829999999996,2112.625,51,17,14,68
1020,-16.221249999999184,2660.0,38,21,11,59
1021,-3.4849999999995425,2366.5882352941176,34,26,7,60
1022,17.105500000001605,3448.5555555555557,58,21,7,79
1023,-4.79699999999871,3072.0,37,29,4,66
1024,-0.8397499999989803,3211.0,34,27,4,61
1025,-1.5847499999983448,3953.7894736842104,46,31,6,77
1026,3.136750000001213,3943.4,47,16,10,63
1027,-16.935999999999677,2024.25,29,19,2,48
1028,11.861250000000283,2517.764705882353,45,18,8,63
1029,-4.741999999999214,2640.2,34,27,1,61
1030,-15.288749999998846,3467.25,37,38,2,75
1031,-1.1229999999988802,4210.210526315789,45,37,7,82
1032,-9.402499999999586,2659.764705882353,28,25,5,53
1033,1.322500000001072,2420.6470588235293,38,26,3,64
1034,-14.236749999999224,3228.4,40,21,3,61
1035,-14.082999999998952,2629.0,38,16,4,54
1036,-10.1557499999992,2678.3,29,22,4,51
1037,-2.6294999999995166,4364.7,30,44,4,74
1038,13.30650000000134,3860.0,41,34,5,75
1039,-18.456750000000017,2011.0555555555557,31,16,12,47
1040,9.187000000002575,4480.65,67,21,4,88
1041,-4.2144999999987185,3833.85,46,34,4,80
1042,-3.445749999999154,3820.35,48,23,7,71
1043,-13.58599999999916,2423.2631578947367,29,26,4,55
1044,-13.271249999999261,2883.9,26,35,2,61
1045,-15.656999999999474,2266.8333333333335,15,30,11,45
1046,-23.6844999999995,2604.4736842105262,23,35,7,58
1047,-4.74199999999883,2523.3529411764707,38,28,5,66
1048,-22.238749999999563,2028.7222222222222,27,21,2,48
1049,-15.715499999999068,2731.4736842105262,37,19,2,56
1050,-6.043749999998466,3009.277777777778,41,27,15,68
1051,-2.595999999999461,4515.1578947368425,56,25,6,81
1052,-22.89374999999912,2097.529411764706,17,29,11,46
1053,-12.474999999998854,3065.684210526316,38,29,6,67
1054,-8.176499999998516,4233.1,36,41,7,77
1055,-9.507000000000028,2114.4117647058824,50,20,22,70
1056,-26.829999999999075,3129.9,23,37,5,60
1057,-14.012249999999188,2337.8125,37,17,5,54
1058,20.675500000002,4314.789473684211,64,28,13,92
1059,-13.034499999999401,2773.9285714285716,38,19,14,57
1060,-23.685249999998863,2871.4285714285716,33,24,8,57
1061,-14.051999999999415,3861.842105263158,35,41,6,76
1062,15.44700000000164,4288.6,62,19,5,81
1063,2.192000000002287,2651.25,52,24,14,76
1064,-15.66549999999916,2399.1052631578946,24,27,6,51
1065,2.5607500000007697,3282.9473684210525,45,26,4,71
1066,-20.159749999998958,2652.375,37,38,7,75
1067,-4.186499999999128,2416.8823529411766,39,34,17,73
1068,-10.950999999999238,2785.3333333333335,34,24,7,58
1069,5.795500000001515,2398.4375,52,23,7,75
1070,-9.309499999999371,2223.6470588235293,28,18,11,46
1071,-18.27124999999962,2695.6315789473683,24,29,4,53
1072,-6.78374999999983,1933.5,34,16,8,50
1073,-0.4872499999994598,2512.9444444444443,42,15,11,57
1074,-20.136999999999816,2252.6470588235293,41,21,13,62
1075,-24.277999999999384,2121.7894736842104,15,26,11,41
1076,3.4992500000009743,3407.3684210526317,47,26,1,73
1077,3.650750000001254,3851.0526315789475,49,18,6,67
1078,-6.59649999999953,2749.470588235294,34,16,4,50
1079,-17.322249999999343,2235.0555555555557,35,20,6,55
1080,0.5355000000019148,3508.45,59,16,8,75
1081,-1.0307499999994842,2139.0666666666666,44,28,18,72
1082,5.141750000000797,2419.125,49,23,6,72
1083,-14.809749999998226,3542.7894736842104,60,33,7,93
1084,-28.13449999999987,2134.9411764705883,25,26,11,51
1085,-12.023249999999024,2810.214285714286,37,21,7,58
1086,-23.75674999999916,1514.375,17,33,12,50
1087,-31.69899999999965,2002.9473684210527,18,19,3,37
1088,3.895500000000966,2674.0714285714284,43,23,3,66
1089,-25.14274999999909,2121.5625,35,26,12,61
1090,-15.187499999999503,3064.0555555555557,36,38,4,74
1091,-3.686749999998728,3148.9411764705883,48,28,14,76
1092,8.912750000000427,3475.0526315789475,46,26,8,72
1093,-0.4822499999996472,2550.1875,45,21,18,66
1094,-9.181749999999564,1925.1875,29,27,4,56
1095,-14.730749999999466,2455.5,32,16,10,48
1096,-3.672249999998916,3553.5789473684213,44,14,12,58
1097,-13.840999999999628,2042.7777777777778,32,26,6,58
1098,14.62375000000146,3475.95,51,18,9,69
1099,-21.57775000000006,1866.0,18,38,6,56
1100,-10.393749999998809,2517.6315789473683,34,20,10,54
1101,10.180000000001382,4189.263157894737,61,25,7,86
1102,-14.111749999998699,4324.35,45,32,8,77
1103,-14.307249999999646,2061.4210526315787,25,16,15,41
1104,-14.595499999999593,1830.8125,36,22,7,58
1105,-26.937999999998738,2129.3529411764707,27,18,18,45
1106,-25.04174999999963,2058.0,31,13,12,44
1107,-8.484999999999122,3307.0526315789475,50,20,9,70
1108,-10.214249999999288,2508.5,42,8,7,50
1109,-32.196749999999895,1429.0,18,32,7,50
1110,-16.75849999999956,2195.75,28,21,3,49
1111,5.213000000001593,3834.65,64,20,3,84
1112,2.4835000000019276,4023.842105263158,53,30,7,83
1113,-4.032249999999087,2139.4375,50,18,4,68
1114,-9.267999999999478,3929.1,32,43,8,75
1115,-4.54699999999932,3977.45,53,24,6,77
1116,16.416000000001638,2963.7368421052633,60,9,7,69
1117,-7.253249999999189,2942.0,25,38,6,63
1118,-18.2372500000001,1731.5294117647059,14,32,4,46
1119,-5.226499999998781,3068.3888888888887,59,16,7,75
1120,-19.640999999999828,1967.0526315789473,26,18,12,44
1121,-7.722499999999286,2567.8,33,24,2,57
1122,-5.557249999999618,2607.75,32,21,7,53
1123,-23.050999999999426,2173.3684210526317,27,20,4,47
1124,-6.60499999999881,3561.1052631578946,43,31,5,74
1125,-0.17599999999900717,3090.6111111111113,41,28,5,69
1126,-11.674749999999383,2146.0,28,16,4,44
1127,6.845500000001397,3540.3,45,27,2,72
1128,-6.532999999998147,1925.764705882353,35,24,14,59
1129,11.16875000000042,2652.294117647059,51,20,10,71
1130,-7.807249999999025,3053.1052631578946,34,24,9,58
1131,-33.45250000000019,1429.0,20,38,15,58
1132,-3.6647499999988624,3298.0,46,22,11,68
1133,-10.407749999998853,3024.842105263158,42,18,3,60
1134,0.14050000000097507,3038.764705882353,46,28,8,74
1135,-18.556749999999838,1830.875,22,25,5,47
1136,-23.78099999999948,2145.75,19,22,2,41
1137,-4.792249999999317,1973.6875,40,25,8,65
1138,-6.0474999999994825,3055.5882352941176,41,36,12,77
1139,-21.05249999999876,3125.6666666666665,42,26,8,68
1140,-21.129500000000068,2019.7894736842106,19,19,17,38
1141,-4.531249999999039,3455.842105263158,43,31,3,74
1142,4.3780000000007835,2707.6153846153848,41,24,5,65
1143,-4.773499999999318,2407.3125,42,18,9,60
1144,-1.4912499999991264,3154.3684210526317,37,20,8,57
1145,11.629500000001354,3410.8,47,21,3,68
1146,-6.97474999999924,2668.7,40,15,5,55
1147,17.16900000000171,4028.35,59,15,5,74
1148,-1.4404999999983452,2501.9166666666665,44,13,13,57
1149,-17.9862499999994,2861.222222222222,29,27,12,56
1150,-15.086250000000271,1874.4705882352941,32,27,17,59
1151,-40.23225000000042,1429.0,5,36,16,41
1152,-4.473249999998975,2425.4117647058824,35,26,11,61
1153,-0.47824999999932666,3940.2,41,31,4,72
1154,-9.506249999998637,2788.8333333333335,42,13,15,55
1155,-19.338749999999827,2094.777777777778,18,22,4,40
1156,-12.512749999999489,2158.45,30,13,3,43
1157,-18.787249999999595,2110.764705882353,23,28,2,51
1158,-13.562999999999093,2460.8125,34,12,12,46
1159,-14.1112499999997,2101.3529411764707,28,36,11,64
1160,-20.236249999999355,2202.684210526316,19,27,6,46
1161,11.425750000000678,2210.8125,41,28,15,69
1162,-17.719249999999416,3098.1,26,33,1,59
1163,5.0385000000006706,3140.842105263158,27,26,7,53
1164,-13.049749999999184,2812.6923076923076,31,20,10,51
1165,15.643000000001242,4037.9,56,25,4,81
1166,-21.381250000000353,1429.0,8,33,13,41
1167,-12.573249999999224,3315.65,36,25,3,61
1168,-1.5587499999986965,3244.235294117647,57,24,6,81
1169,4.792500000001985,3575.4210526315787,67,21,8,88
1170,-8.559749999999061,2146.176470588235,37,17,5,54
1171,11.5495000000013,4028.9473684210525,66,15,7,81
1172,-15.613749999999516,2012.157894736842,32,14,9,46
1173,-23.37525000000019,2214.777777777778,13,36,6,49
1174,-8.589749999997547,3160.1176470588234,66,33,6,99
1175,-11.42174999999919,2536.25,45,35,11,80
1176,-17.7399999999996,1980.1666666666667,22,20,4,42
1177,2.0137500000006234,2496.235294117647,43,14,5,57
1178,-15.580249999999364,2202.875,30,14,12,44
1179,0.0895000000010823,2364.6470588235293,36,29,9,65
1180,5.82675000000086,2638.294117647059,39,19,8,58
1181,-32.39124999999896,2059.842105263158,24,14,13,38
1182,-0.15224999999900576,4171.2,43,35,3,78
1183,-7.922749999998848,2595.777777777778,42,28,3,70
1184,-6.31099999999884,3056.4736842105262,33,23,14,56
1185,17.663250000002712,3238.6923076923076,72,16,6,88
1186,1.497750000001017,3052.0,31,32,6,63
1187,-24.913499999999377,2961.6,22,29,8,51
1188,-9.55999999999862,5283.85,63,31,5,94
1189,-6.336749999999439,2251.0,32,25,10,57
1190,-23.17374999999975,2028.25,17,21,5,38
1191,13.50100000000116,4603.578947368421,49,36,1,85
1192,-18.771499999999612,2198.0555555555557,27,17,7,44
1193,16.136250000001702,3673.3888888888887,62,23,2,85
1194,5.561750000001373,3063.1666666666665,54,15,9,69
1195,-24.433749999999673,2008.45,21,22,1,43
1196,2.537500000000711,2861.529411764706,52,24,9,76
1197,-8.043999999999143,2669.684210526316,37,23,7,60
1198,-24.73374999999977,2327.6666666666665,23,31,9,54
1199,-15.320249999999191,2798.85,33,22,7,55
1200,19.747750000000817,3397.277777777778,50,15,5,65
1201,17.2125000000012,4443.45,56,16,5,72
1202,-8.398749999999893,2064.0,36,12,15,48
1203,-13.926249999998698,2714.9375,28,19,18,47
1204,-14.043249999999398,3056.4736842105262,25,39,7,64
1205,-26.204249999999735,2266.157894736842,18,24,4,42
1206,-21.602249999999156,2528.25,28,17,9,45
1207,6.23625000000162,2964.75,75,17,7,92
1208,-5.555999999999536,2496.294117647059,30,20,4,50
1209,-2.1064999999992375,3846.7894736842104,48,29,9,77
1210,-4.51399999999863,2982.764705882353,42,32,6,74
1211,-19.45024999999955,2040.1,24,20,2,44
1212,-19.110999999998498,2515.4444444444443,37,28,12,65
1213,5.47700000000097,4160.0526315789475,45,30,3,75
1214,-21.83624999999949,2852.1,17,33,6,50
1215,-10.71299999999938,2146.8888888888887,26,20,9,46
1216,-4.221249999998993,3076.5789473684213,48,19,4,67
1217,-9.619500000000057,2485.7894736842104,18,41,7,59
1218,-44.82024999999943,2204.55,13,26,9,39
1219,-8.559999999999441,2420.6470588235293,34,21,3,55
1220,-22.992999999999718,1967.0526315789473,18,31,5,49
1221,-18.599999999999323,2175.8947368421054,26,18,5,44
1222,-17.98525000000013,1877.9444444444443,26,24,28,50
1223,-25.47149999999956,2145.85,19,24,2,43
1224,-15.497499999999343,2305.722222222222,28,22,7,50
1225,1.3997499999997935,2813.4210526315787,36,30,13,66
1226,-20.65324999999938,1917.5555555555557,29,22,8,51
1227,-7.5737499999993805,2619.6111111111113,35,25,6,60
1228,-47.57075000000005,1929.0555555555557,27,53,5,80
1229,-7.579749999998349,3482.5263157894738,46,38,5,84
1230,-14.784999999998757,2419.1875,37,23,3,60
1231,-7.777499999998618,3840.15,36,35,5,71
1232,-20.511999999999503,2032.3,22,22,3,44
1233,2.633250000001028,3383.1,39,27,7,66
1234,-8.698999999999105,2333.75,33,24,5,57
1235,-7.636749999999462,2603.6,43,19,1,62
1236,20.842000000000986,2383.4375,50,12,10,62
1237,-20.732749999999466,2081.6111111111113,21,32,1,53
1238,-26.853000000000492,1429.0,25,44,13,69
1239,9.262500000000799,3971.85,49,28,4,77
1240,-14.936499999999612,2098.15,27,18,4,45
1241,0.9160000000005784,2453.4117647058824,40,19,3,59
1242,1.8545000000012668,4558.35,57,30,5,87
1243,-1.976749999999654,3019.842105263158,42,18,26,60
1244,-15.556999999999539,1988.842105263158,22,27,2,49
1245,-7.185249999999026,2560.05,31,21,6,52
1246,-4.446249999999698,2286.222222222222,37,20,3,57
1247,-10.238499999999856,2624.5,36,15,16,51
1248,-8.683499999999132,2255.4375,31,27,8,58
1249,-30.743499999999738,2044.2,20,17,7,37
1250,-1.0809999999994282,2908.777777777778,46,21,3,67
1251,0.24150000000180424,2778.3888888888887,55,24,6,79
1252,0.11400000000124928,4175.111111111111,61,34,5,95
1253,0.7775000000007607,2613.9411764705883,39,43,2,82
1254,-4.32199999999961,3590.25,38,24,5,62
1255,15.640500000001477,5029.95,63,29,7,92
1256,-1.632499999999603,2616.0,41,22,1,63
1257,-14.357749999999044,2670.722222222222,41,27,9,68
1258,-0.38099999999785383,3266.6470588235293,63,9,10,72
1259,-9.222249999999299,2557.285714285714,40,23,9,63
1260,-21.716749999999728,2066.5555555555557,26,26,4,52
1261,-17.7217499999993,3013.95,28,34,2,62
1262,-14.189749999999597,2159.235294117647,33,19,5,52
1263,5.03075000000166,3198.3529411764707,47,30,7,77
1264,-1.8892499999987358,3081.5789473684213,48,19,6,67
1265,-12.074999999999074,2590.4444444444443,32,28,4,60
1266,-18.81974999999913,3219.1666666666665,49,22,17,71
1267,-11.213249999999231,2339.8125,32,34,5,66
1268,-2.036749999998759,2406.25,42,25,9,67
1269,-17.717749999999874,2048.1111111111113,27,19,4,46
1270,11.440750000001685,3868.8,52,32,5,84
1271,-1.111499999998849,2846.3333333333335,43,26,7,69
1272,-26.7925,3320.5263157894738,34,29,32,63
1273,8.106500000002676,2247.0,52,21,10,73
1274,-8.722249999999033,2781.294117647059,35,21,3,56
1275,-11.610749999999058,2510.8947368421054,33,24,3,57
1276,-13.365999999999534,2449.4444444444443,50,16,10,66
1277,-17.786999999999207,2760.85,44,13,2,57
1278,-5.93924999999858,3063.2105263157896,41,29,1,70
1279,-14.677249999999187,2580.9375,38,15,8,53
1280,0.8097500000010109,4092.4736842105262,49,23,6,72
1281,-9.97074999999895,3527.6315789473683,42,31,5,73
1282,-9.07049999999844,3024.4,43,20,6,63
1283,-10.656749999999413,3258.5,31,28,2,59
1284,-18.195249999999575,2838.0833333333335,32,33,6,65
1285,-17.980749999999908,3140.842105263158,26,30,2,56
1286,2.0602500000005923,3186.842105263158,48,20,7,68
1287,-13.702749999999856,2518.4736842105262,31,31,16,62
1288,-12.411999999998695,2440.9166666666665,39,17,9,56
1289,-8.321249999998988,2717.529411764706,36,24,5,60
1290,10.984250000000955,3068.0,52,14,4,66
1291,9.09950000000093,2899.705882352941,45,29,2,74
1292,-5.383499999999282,3343.7368421052633,52,14,4,66
1293,6.796000000001193,3093.0,58,18,5,76
1294,-15.549249999999883,3357.6666666666665,41,37,9,78
1295,-33.368749999999764,1912.7058823529412,30,22,9,52
1296,-17.47024999999942,2495.1666666666665,29,21,8,50
1297,9.744250000001845,4595.75,50,23,10,73
1298,-41.95750000000008,1429.0,11,36,4,47
1299,-5.171749999998491,2894.4736842105262,36,24,9,60
1300,-7.686249999998438,2054.705882352941,35,25,9,60
1301,-12.525999999999506,2262.4,27,22,3,49
1302,-2.4842499999993697,1898.3125,47,15,6,62
1303,-15.166749999999658,2330.3333333333335,27,25,11,52
1304,21.974500000001104,3055.6470588235293,51,21,3,72
1305,6.2367500000017815,2595.2,45,19,8,64
1306,26.396250000002,4594.95,73,13,5,86
1307,-26.719499999999634,2008.45,18,24,4,42
1308,4.216000000001104,3087.8,44,22,0,66
1309,-22.88599999999897,2881.0,24,29,7,53
1310,-4.161749999998987,4087.85,42,23,1,65
1311,5.406250000001159,4042.6,48,32,3,80
1312,-6.456999999999096,3375.684210526316,43,29,5,72
1313,-1.4077499999975018,2711.0588235294117,43,33,13,76
1314,-30.590499999999707,2125.0,19,21,7,40
1315,8.01825000000174,4514.05,59,22,3,81
1316,-3.5392499999989093,3101.3529411764707,45,35,5,80
1317,-32.929999999999566,1429.0,4,32,4,36
1318,11.478250000001252,3924.5789473684213,56,26,4,82
1319,20.463000000001024,3904.45,51,15,7,66
1320,-4.46024999999717,2924.823529411765,55,25,10,80
1321,-26.909749999999292,2048.1,16,35,4,51
1322,-13.546499999999757,2135.0,23,16,7,39
1323,-1.4754999999985803,2657.5,50,18,4,68
1324,-23.828499999999256,2052.4444444444443,29,16,6,45
1325,-21.564249999999543,2125.7894736842104,24,26,2,50
1326,-14.533749999998701,1862.625,41,29,14,70
1327,-10.429499999999283,2595.3529411764707,35,21,3,56
1328,-0.41849999999925025,2625.4375,41,34,2,75
1329,-1.9229999999997838,2470.8947368421054,33,28,17,61
1330,-14.967749999999622,3403.2105263157896,22,37,9,59
1331,8.977000000001393,4343.894736842105,62,33,4,95
1332,-13.00049999999882,2059.0,39,15,7,54
1333,-11.369499999999324,2161.1875,36,36,3,72
1334,-7.901749999999225,2771.0,36,24,5,60
1335,3.6555000000006665,2634.6,39,25,5,64
1336,-27.47824999999974,1429.0,4,38,6,42
1337,-7.804749999998793,2639.176470588235,43,23,3,66
1338,30.78575000000172,4454.1578947368425,67,26,3,93
1339,-5.429749999998366,2128.375,41,24,6,65
1340,8.272000000001054,4056.8,58,24,3,82
1341,-1.359999999998555,2956.823529411765,64,20,4,84
1342,-10.589249999999518,2465.1666666666665,23,31,5,54
1343,0.751250000001169,2533.0555555555557,34,19,10,53
1344,-1.3584999999992946,2467.470588235294,38,27,9,65
1345,-11.414999999998724,3166.222222222222,43,27,6,70
1346,-22.113749999999747,2153.9444444444443,28,27,4,55
1347,-4.694499999999406,2425.6111111111113,28,27,6,55
1348,20.27975000000143,4342.1578947368425,76,12,3,88
1349,-1.0604999999992948,2643.8823529411766,50,17,7,67
1350,-3.8712499999980436,3138.9444444444443,43,29,11,72
1351,-18.59224999999963,2099.75,20,22,5,42
1352,-29.892999999999972,1429.0,18,27,3,45
1353,1.5917500000007416,2486.9411764705883,42,16,6,58
1354,-17.40424999999966,2028.8947368421052,25,20,4,45
1355,9.073000000001585,3433.2631578947367,58,21,1,79
1356,3.847000000001459,2898.764705882353,51,28,2,79
1357,-28.53024999999975,1528.25,4,33,8,37
1358,-5.043249999997687,4764.0,58,31,6,89
1359,-13.093999999999152,3668.0,43,27,4,70
1360,-2.5074999999988723,3631.5,44,29,5,73
1361,11.746500000001877,4751.25,51,36,3,87
1362,-38.71249999999963,2095.777777777778,8,46,5,54
1363,7.957500000000981,2549.285714285714,48,19,8,67
1364,-19.54774999999945,2261.0,36,24,9,60
1365,7.696000000001012,3892.65,50,19,7,69
1366,-12.197999999999373,2548.15,35,16,3,51
1367,-20.76574999999992,2211.0,24,26,14,50
1368,4.915500000000556,3307.6,38,17,6,55
1369,-15.492499999998525,3668.0,47,32,5,79
1370,-7.628249999999184,3203.5263157894738,47,19,6,66
1371,-32.615499999999855,2059.842105263158,18,19,5,37
1372,13.360250000000557,3805.8947368421054,49,29,4,78
1373,-12.753749999999716,3310.05,37,27,2,64
1374,-20.390499999999825,1966.8823529411766,37,21,1,58
1375,-2.2622499999992405,2625.235294117647,29,22,7,51
1376,-19.73674999999956,2370.0,25,18,9,43
1377,-14.137999999998865,2725.4,27,25,8,52
1378,1.8780000000013088,3841.9,51,27,2,78
1379,-29.48524999999909,2010.2222222222222,25,22,10,47
1380,-20.151749999999623,2303.7894736842104,23,30,4,53
1381,-6.497999999998288,3038.823529411765,45,22,9,67
1382,1.309250000000746,3230.2631578947367,51,27,3,78
1383,-30.193000000000257,1429.0,6,33,12,39
1384,28.08400000000259,3288.0588235294117,85,15,4,100
1385,-9.045249999999111,2462.6470588235293,35,25,10,60
1386,-2.577249999998913,3206.8333333333335,56,19,3,75
1387,-39.26699999999967,1429.0,15,36,10,51
1388,-23.34999999999948,2143.375,28,43,3,71
1389,9.318250000001331,4716.4,64,30,4,94
1390,-12.048499999999688,2286.235294117647,37,39,2,76
1391,-16.05449999999926,2558.2,42,15,9,57
1392,-49.04725000000024,1429.0,10,37,14,47
1393,10.442750000000995,3970.3684210526317,60,26,4,86
1394,-8.514249999999004,3200.157894736842,42,27,3,69
1395,-27.256999999999174,2546.6470588235293,31,45,7,76
1396,5.387250000000895,4313.25,58,21,8,79
1397,5.417500000001833,2405.222222222222,38,27,9,65
1398,20.03075000000182,3937.0,65,15,4,80
1399,-9.760749999999522,2705.5789473684213,36,16,9,52
1400,0.942250000000793,2448.705882352941,45,25,9,70
1401,8.595500000001403,3795.842105263158,57,16,11,73
1402,-23.387249999999337,2078.2,25,22,1,47
1403,2.7367500000016456,3490.842105263158,51,19,6,70
1404,-22.443499999999517,2106.7368421052633,18,27,4,45
1405,-20.973249999999048,2064.7368421052633,29,20,4,49
1406,-9.158499999998895,3900.315789473684,41,37,3,78
1407,13.974000000001572,4215.263157894737,42,33,7,75
1408,18.109499999999905,3269.5789473684213,47,27,7,74
1409,-23.75699999999947,2151.7894736842104,19,27,6,46
1410,-0.4497499999983267,4037.0,55,34,3,89
1411,-18.074749999999096,2231.5555555555557,21,32,9,53
1412,-1.0939999999988737,2368.5,45,25,2,70
1413,-18.197999999998952,2286.1176470588234,30,20,7,50
1414,27.70950000000293,5129.9,81,14,7,95
1415,-19.56949999999996,3236.8947368421054,22,34,10,56
1416,4.121250000001661,3227.470588235294,55,29,3,84
1417,7.276500000001894,3473.3333333333335,58,33,6,91
1418,-10.3942499999993,2425.4117647058824,33,25,6,58
1419,-30.35549999999973,1983.764705882353,23,30,5,53
1420,16.459250000001884,4987.05,76,9,2,85
1421,-12.471249999999467,2298.125,38,29,7,67
1422,-4.31649999999928,3163.95,42,21,4,63
1423,-17.59249999999929,2462.3684210526317,26,30,5,56
1424,9.422250000000748,4026.75,44,31,3,75
1425,12.120500000001334,3441.3333333333335,54,28,7,82
1426,-13.1297499999994,2516.842105263158,27,25,11,52
1427,0.3147500000013201,4050.6,52,36,3,88
1428,-25.138749999999185,2008.35,25,19,3,44
1429,-0.18974999999851364,4057.7,46,25,5,71
1430,-11.393749999999786,1853.625,44,18,7,62
1431,6.43875000000146,3455.0,50,18,5,68
1432,-2.836249999999188,2727.6,39,20,9,59
1433,-9.884999999997676,2508.470588235294,49,29,6,78
1434,-2.47549999999902,2508.3684210526317,35,22,3,57
1435,-2.5984999999994973,2549.529411764706,30,24,4,54
1436,11.565750000001858,4328.894736842105,57,31,3,88
1437,-12.506749999999823,2005.375,46,20,9,66
1438,-6.580999999999068,2595.0,40,22,2,62
1439,7.2667500000000755,2491.5,47,39,10,86
1440,9.663750000001226,3125.777777777778,45,20,5,65
1441,0.44000000000151485,3681.176470588235,56,26,5,82
1442,-19.056249999998986,2540.05,48,8,2,56
1443,-23.917499999999727,2019.0,29,26,13,55
1444,-8.27524999999918,2255.4375,40,23,5,63
1445,-18.942999999999536,2661.8333333333335,28,26,4,54
1446,-16.92099999999905,2675.1666666666665,25,41,6,66
1447,-15.494749999999447,3032.3333333333335,35,22,4,57
1448,-4.922749999999093,2632.4,43,22,3,65
1449,-25.921749999999445,2046.4736842105262,20,21,7,41
1450,-27.86674999999989,1429.0,14,32,1,46
1451,1.6732500000011146,3679.15,46,22,2,68
1452,-23.661499999999553,2020.35,24,24,4,48
1453,-0.8859999999993423,2450.3333333333335,41,18,6,59
1454,-2.702499999999067,2763.3529411764707,44,20,5,64
1455,18.58175000000225,4456.95,71,21,3,92
1456,9.56500000000041,2857.722222222222,44,23,3,67
1457,-5.308749999999157,3352.2631578947367,34,32,3,66
1458,21.797250000001362,4008.55,63,20,1,83
1459,-20.29374999999958,2008.55,13,30,2,43
1460,-0.7267499999993249,3444.0,45,31,7,76
1461,9.016500000000727,3168.3684210526317,51,23,4,74
1462,6.185000000001031,2696.1176470588234,48,23,6,71
1463,11.605250000001487,4295.7,52,30,6,82
1464,-27.829499999999832,2049.7368421052633,16,30,13,46
1465,-22.754749999999785,1974.578947368421,27,17,14,44
1466,26.2475000000017,3611.722222222222,67,13,5,80
1467,8.4020000000009,2275.3125,50,33,7,83
1468,16.548750000000698,4631.263157894737,57,33,3,90
1469,-5.870499999999645,2623.7894736842104,35,24,4,59
1470,-11.70575000000011,1941.5882352941176,40,29,6,69
1471,13.548500000001344,5699.75,60,37,1,97
1472,-20.359749999999103,4172.75,44,32,5,76
1473,21.289000000002225,4771.95,65,25,5,90
1474,-21.563249999999783,2663.785714285714,38,32,11,70
1475,-13.110499999998833,1965.9411764705883,30,24,9,54
1476,20.061250000000957,4158.45,56,21,4,77
1477,-22.796499999999394,2928.684210526316,42,30,11,72
1478,1.3137500000011997,3064.05,48,17,1,65
1479,12.159750000001527,3484.6666666666665,58,19,2,77
1480,-5.133999999999474,2386.235294117647,39,20,3,59
1481,12.685750000000773,2110.6,59,26,11,85
1482,-13.251999999999594,2188.0,27,22,3,49
1483,-15.19424999999939,2611.9473684210525,31,24,3,55
1484,-11.855999999999542,2576.277777777778,45,24,9,69
1485,24.44925000000177,4577.55,69,18,2,87
1486,-17.122249999999433,2036.25,27,22,2,49
1487,-6.008999999999284,2387.0,55,26,6,81
1488,-23.93550000000007,2518.9444444444443,26,25,12,51
1489,-0.6542499999992899,2508.4210526315787,33,22,2,55
1490,-7.913749999999103,2214.5263157894738,25,21,7,46
1491,-21.480249999999863,1963.1176470588234,28,31,18,59
1492,12.942000000001125,3539.153846153846,57,34,4,91
1493,-2.1977499999993726,2545.125,54,28,4,82
1494,3.3517500000009854,3439.6666666666665,55,28,7,83
1495,-7.5022499999994015,3160.157894736842,37,26,5,63
1496,-7.281249999998243,2585.0588235294117,42,22,9,64
1497,-20.700749999999935,2332.9473684210525,14,34,1,48
1498,-21.911749999999422,2103.2631578947367,24,26,3,50
1499,11.772000000000874,4222.777777777777,47,40,0,87
1500,-22.84524999999889,1862.3529411764705,24,37,8,61
1501,-21.458499999998992,2390.684210526316,27,26,9,53
1502,-7.533249999999083,2631.4210526315787,30,25,3,55
1503,8.7437500000016,2490.5625,50,17,10,67
1504,-8.478749999999206,2605.35,36,17,4,53
1505,9.11575000000218,4444.95,62,30,5,92
1506,-31.80174999999976,2040.2,22,16,7,38
1507,11.65850000000103,2447.0,39,24,4,63
1508,20.34975000000147,4008.45,66,11,2,77
1509,-10.491249999998654,3081.6111111111113,39,24,8,63
1510,11.703500000001354,3767.777777777778,63,24,6,87
1511,-6.069999999999174,2553.294117647059,38,26,5,64
1512,-34.5194999999999,1429.0,0,35,3,35
1513,2.5530000000013446,3165.3333333333335,59,13,5,72
1514,4.3395000000004735,3045.470588235294,40,28,3,68
1515,17.39800000000132,4274.35,60,30,1,90
1516,-2.927499999998777,3635.3888888888887,53,41,6,94
1517,32.56575000000109,4567.894736842105,63,32,4,95
1518,-29.507249999999367,1999.5555555555557,31,20,8,51
1519,-9.592749999999482,2080.764705882353,43,23,9,66
1520,3.8282500000004633,3611.777777777778,45,36,4,81
1521,-7.240499999999474,2478.4736842105262,32,17,6,49
1522,-18.99599999999969,1937.9411764705883,28,22,9,50
1523,-13.125749999999357,2196.875,35,24,3,59
1524,6.263250000000742,3998.15,64,14,1,78
1525,-4.214249999998833,3385.3125,48,25,1,73
1526,-12.653249999999005,2514.4210526315787,36,14,5,50
1527,-17.76699999999944,1897.8235294117646,28,20,7,48
1528,4.540000000000537,2466.0,40,20,14,60
1529,-18.561499999999246,2329.6315789473683,23,25,10,48
1530,-20.76049999999964,2500.5,29,31,3,60
1531,-4.99574999999999,2108.1111111111113,30,20,12,50
1532,-11.895499999998771,3108.1111111111113,44,28,20,72
1533,-31.060499999999706,2541.1052631578946,21,25,6,46
1534,-30.202999999999825,2075.85,12,32,3,44
1535,22.082250000002812,3547.705882352941,81,15,7,96
1536,-21.293249999999595,1983.6842105263158,21,23,5,44
1537,14.142500000001188,3052.5555555555557,59,19,4,78
1538,-5.105249999998964,2521.470588235294,51,30,1,81
1539,-5.360499999999012,2370.235294117647,46,27,4,73
1540,-21.752999999999396,2246.6,24,25,2,49
1541,-6.035999999998715,2268.5882352941176,38,24,6,62
1542,-5.270749999999053,2337.8125,36,24,9,60
1543,2.4867500000005753,3191.0,52,23,17,75
1544,-17.62399999999922,2158.176470588235,30,25,8,55
1545,-21.512249999999607,2022.0,31,20,4,51
1546,-1.4999999999988567,3907.0,50,25,8,75
1547,17.259500000001413,4997.25,60,21,3,81
1548,-9.242249999999267,3548.4736842105262,42,23,9,65
1549,-5.621499999998628,3613.25,53,14,5,67
1550,-5.754249999999344,3075.1,31,30,3,61
1551,-24.000999999999927,2026.421052631579,23,19,6,42
1552,-21.62699999999912,2047.1666666666667,23,35,14,58
1553,-8.381999999999476,2500.9411764705883,38,21,7,59
1554,-9.96749999999935,2505.1052631578946,33,25,0,58
1555,-6.174499999998906,2662.1052631578946,40,13,6,53
1556,8.41500000000066,4146.8421052631575,60,31,7,91
1557,5.4312500000009445,3969.5789473684213,64,25,4,89
1558,-7.252249999999495,3120.8947368421054,38,30,3,68
1559,-12.181249999999192,3476.6,27,38,6,65
1560,11.870250000001146,3548.85,51,22,3,73
1561,-16.820749999999112,2843.35,43,19,1,62
1562,-8.6017499999996,2856.6428571428573,34,24,9,58
1563,-13.344249999998876,2779.25,32,31,4,63
1564,-19.186499999998848,2715.6315789473683,29,37,3,66
1565,-6.665999999998729,2946.2631578947367,37,23,10,60
1566,-9.307249999999389,2532.3,30,19,3,49
1567,5.924250000001601,4220.5,46,36,3,82
1568,10.212250000002062,5917.9,51,32,4,83
1569,15.736500000001076,4066.5789473684213,66,22,7,88
1570,-19.064249999999205,2865.6666666666665,40,34,3,74
1571,-9.55149999999998,2441.6315789473683,27,24,12,51
1572,23.10750000000147,4079.95,62,16,3,78
1573,-8.123249999999087,2134.0588235294117,25,22,12,47
1574,-7.25024999999941,3072.0555555555557,44,25,3,69
1575,14.473750000001,3319.8823529411766,65,27,9,92
1576,-4.783499999998506,3286.1666666666665,43,23,7,66
1577,-23.209999999999475,2127.45,25,22,4,47
1578,-2.8919999999994497,4069.65,44,28,7,72
1579,-24.5084999999994,2085.4,28,23,0,51
1580,5.158000000000961,3116.5625,72,14,5,86
1581,-16.258249999999403,2275.722222222222,29,16,6,45
1582,-16.594499999999744,3015.65,27,26,6,53
1583,13.430000000000934,4231.9473684210525,62,25,6,87
1584,-18.930249999999525,2544.95,27,19,9,46
1585,23.595250000001382,3795.0,54,20,4,74
1586,-19.831749999999186,2286.0,25,28,6,53
1587,-7.215749999998598,3277.8947368421054,43,28,8,71
1588,12.777000000000788,4426.578947368421,66,24,6,90
1589,-8.201249999998746,3107.0,42,17,3,59
1590,7.496000000001468,3936.0588235294117,40,26,5,66
1591,-16.389249999998405,2090.4444444444443,38,10,11,48
1592,-3.14574999999936,2544.15,35,7,14,42
1593,-15.055749999999744,2252.5882352941176,34,22,7,56
1594,-8.053749999998852,3140.95,38,27,2,65
1595,-4.67024999999906,2580.9375,38,19,7,57
1596,-8.198499999998972,2391.6470588235293,34,25,7,59
1597,6.972500000001984,3128.3888888888887,44,23,14,67
1598,-15.013999999999347,2302.9,29,13,10,42
1599,-3.0247499999995253,4431.578947368421,63,25,3,88
1600,1.403000000001399,2576.8125,47,17,7,64
1601,-3.5467499999986574,4069.0,50,32,5,82
1602,11.573500000000658,3401.8333333333335,78,17,12,95
1603,-13.226499999999026,2714.8333333333335,50,22,8,72
1604,-13.956999999999748,2008.45,19,22,5,41
1605,-13.038249999998797,2722.294117647059,33,23,2,56
1606,20.963250000000706,4155.0526315789475,50,37,1,87
1607,7.5890000000005715,3347.3571428571427,39,23,8,62
1608,-0.5707499999964236,2991.6666666666665,64,25,9,89
1609,5.955000000001356,4144.2,47,25,7,72
1610,-3.2787499999989413,4233.05,49,27,6,76
1611,8.480500000001232,3887.7894736842104,57,22,5,79
1612,38.63100000000237,2993.1176470588234,73,13,8,86
1613,13.788500000001008,4082.25,53,23,3,76
1614,-7.840499999999812,1904.2941176470588,32,19,7,51
1615,-11.656249999999062,2702.2631578947367,37,17,2,54
1616,-24.15749999999848,2005.421052631579,24,18,18,42
1617,-12.060749999999365,2308.0,37,21,6,58
1618,3.7500000000021103,2581.3529411764707,54,16,14,70
1619,-9.257749999998495,2399.375,36,28,9,64
1620,6.801750000001507,3796.684210526316,51,34,5,85
1621,-25.234999999999616,2019.5333333333333,41,30,7,71
1622,-28.12050000000004,1429.0,0,35,6,35
1623,-1.8167499999987882,3217.15,50,13,1,63
1624,18.361500000001946,4590.315789473684,62,32,6,94
1625,-16.772249999999197,2354.3529411764707,36,24,10,60
1626,6.463500000001441,4220.3,59,21,7,80
1627,3.8737500000003067,3452.9444444444443,47,34,4,81
1628,24.663750000002082,4538.05,71,20,5,91
1629,14.61425000000123,3022.1176470588234,50,28,9,78
1630,-10.271249999999387,2699.8888888888887,33,23,6,56
1631,7.04925000000097,2651.294117647059,43,21,8,64
1632,-15.633999999999237,1631.6470588235295,11,33,12,44
1633,3.4812500000003546,3170.157894736842,43,19,9,62
1634,-22.06824999999919,2099.3333333333335,25,35,7,60
1635,-20.715999999998562,2345.5263157894738,32,18,14,50
1636,-18.828499999999675,2211.6,24,15,9,39
1637,-0.7269999999988924,5086.25,65,23,6,88
1638,5.340500000002253,3237.7368421052633,49,30,13,79
1639,3.448500000002094,4593.35,71,20,3,91
1640,7.179750000000827,2855.8823529411766,56,18,4,74
1641,-11.516749999999465,2307.823529411765,25,34,4,59
1642,-7.647999999999378,2699.65,36,23,3,59
1643,-15.847499999999332,2214.4210526315787,19,29,9,48
1644,-14.559249999999526,2580.9375,31,18,6,49
1645,20.762000000002086,4856.15,70,26,0,96
1646,26.13250000000199,3190.9375,79,16,9,95
1647,-17.910749999999457,2023.8235294117646,27,28,8,55
1648,-10.358749999999064,2721.6666666666665,37,22,9,59
1649,-24.209249999999496,2008.4,22,16,4,38
1650,28.36550000000117,3860.2105263157896,60,21,4,81
1651,4.067500000000385,4018.8947368421054,59,22,7,81
1652,0.7857500000018053,3634.7368421052633,56,25,7,81
1653,6.749500000000817,3774.2105263157896,49,20,14,69
1654,-19.308499999999377,3693.0526315789475,29,40,13,69
1655,-24.009249999999135,3522.7,27,31,4,58
1656,23.020000000001826,4912.45,65,24,2,89
1657,1.5290000000007529,3157.5789473684213,32,27,6,59
1658,-27.974249999999863,2812.722222222222,33,28,13,61
1659,-20.699499999999563,2460.8888888888887,35,32,9,67
1660,14.250250000000738,2494.5625,51,16,3,67
1661,-15.290249999998878,2329.1176470588234,41,42,12,83
1662,-3.287749999999238,3012.8333333333335,43,23,3,66
1663,-15.925999999999638,2115.6,15,29,4,44
1664,-0.3379999999987109,2266.375,46,30,2,76
1665,-22.1594999999994,2759.0526315789475,33,14,7,47
1666,-5.1324999999985375,2122.222222222222,32,25,9,57
1667,18.540250000002036,2750.176470588235,58,18,7,76
1668,-21.671499999999753,1997.1052631578948,23,19,6,42
1669,-3.6062499999996698,2495.1052631578946,33,24,8,57
1670,0.4260000000007785,4305.2,44,27,3,71
1671,1.9002500000007239,2597.176470588235,47,35,6,82
1672,5.4860000000016695,4481.45,59,30,5,89
1673,-16.776999999999337,2103.75,31,40,7,71
1674,-5.467499999999206,3787.75,40,21,2,61
1675,14.939250000001284,4214.1,57,22,5,79
1676,7.382250000000615,4531.5,49,28,5,77
1677,23.23150000000128,4348.2,67,16,3,83
1678,-16.76200000000006,1777.25,34,26,13,60
1679,-12.20574999999919,2099.625,44,21,2,65
1680,-17.96699999999891,2409.25,47,36,12,83
1681,-7.235499999999779,2719.1666666666665,24,34,1,58
1682,-13.218249999999296,2342.6875,40,17,8,57
1683,-21.339999999999485,3094.9473684210525,23,37,4,60
1684,-26.819999999999247,2960.75,33,31,3,64
1685,-8.076499999999019,3165.7,29,30,5,59
1686,-1.6204999999991792,3276.6111111111113,44,24,6,68
1687,15.969750000001564,4451.4,56,17,2,73
1688,-12.795999999999157,2570.2105263157896,32,27,5,59
1689,-8.872249999998726,3580.0,49,24,1,73
1690,1.2700000000000184,3870.1052631578946,28,38,7,66
1691,-2.034499999998137,2483.6875,48,22,7,70
1692,-15.124749999998802,3156.05,36,27,3,63
1693,7.310500000000691,2688.3333333333335,44,24,10,68
1694,-10.213249999998688,2157.4444444444443,28,27,11,55
1695,-20.107999999999734,2409.842105263158,23,33,2,56
1696,-2.93999999999908,2417.6666666666665,37,19,6,56
1697,-7.607749999999237,4341.8,44,19,5,63
1698,-1.0802499999998276,2648.722222222222,40,30,3,70
1699,25.222500000002018,4316.315789473684,74,16,3,90
1700,-7.5477499999994295,2912.7894736842104,37,19,2,56
1701,0.3902500000010224,2638.0,48,22,8,70
1702,-29.751000000000467,1967.0,18,29,34,47
1703,-10.508749999998853,4106.0,38,34,8,72
1704,-25.101499999999486,1965.1666666666667,28,18,8,46
1705,-4.6019999999993155,2602.8888888888887,38,23,9,61
1706,-11.209249999999402,2808.222222222222,38,23,7,61
1707,7.356750000001343,2871.6470588235293,58,27,11,85
1708,7.374500000001272,3453.65,54,23,4,77
1709,6.045500000002501,2075.235294117647,52,24,12,76
1710,8.74950000000186,3821.0,64,23,4,87
1711,-23.014249999999485,2401.9411764705883,31,29,8,60
1712,-18.790499999999852,1429.0,19,29,10,48
1713,4.613250000001711,3322.764705882353,55,16,4,71
1714,-5.8169999999990205,2511.1111111111113,33,29,6,62
1715,-0.6967499999988215,2780.4666666666667,38,26,5,64
1716,-8.165749999998766,4306.0,49,35,2,84
1717,-4.248499999998682,3231.45,47,24,2,71
1718,26.911250000000784,4588.55,67,26,1,93
1719,-2.2514999999989325,2689.5882352941176,37,35,7,72
1720,-3.889499999999452,2509.470588235294,32,19,5,51
1721,-6.17399999999932,3265.9444444444443,41,29,8,70
1722,16.506750000001148,3813.4210526315787,54,23,4,77
1723,-6.41874999999952,3008.7894736842104,34,36,8,70
1724,0.44000000000090117,2799.157894736842,38,24,4,62
1725,1.6862500000015188,3671.2,59,18,1,77
1726,37.696000000002854,4223.722222222223,82,18,2,100
1727,-7.4187499999984965,2833.8333333333335,44,31,3,75
1728,-13.812249999998826,2144.3125,45,11,7,56
1729,-8.847499999998837,2491.5,54,35,7,89
1730,-22.199749999999625,2059.95,25,16,3,41
1731,1.403750000001113,3800.0526315789475,43,34,2,77
1732,1.9500000000012114,3907.1666666666665,46,26,4,72
1733,-13.099249999999646,2048.1,19,26,4,45
1734,-8.836499999999711,2181.705882352941,24,29,3,53
1735,-11.70074999999947,2558.5263157894738,37,20,10,57
1736,-23.033250000000148,2611.5555555555557,22,38,4,60
1737,3.989750000000592,2891.4117647058824,52,21,3,73
1738,-15.164499999999851,2009.375,35,28,4,63
1739,-13.850249999999722,2131.9444444444443,31,30,10,61
1740,8.030500000001167,3646.9473684210525,55,23,4,78
1741,-12.091249999999748,2514.2631578947367,27,30,7,57
1742,-11.117499999999534,2261.0,26,32,1,58
1743,11.675750000001155,3349.6666666666665,53,24,3,77
1744,-24.260249999999427,2655.722222222222,31,32,2,63
1745,-16.27249999999891,2544.6111111111113,41,22,19,63
1746,-26.468999999998537,2685.5789473684213,42,14,6,56
1747,4.195500000000452,2970.3,28,24,4,52
1748,23.661750000002172,3297.529411764706,71,20,3,91
1749,-6.361999999999574,2616.6470588235293,39,24,8,63
1750,14.308750000001027,2658.3333333333335,41,31,5,72
1751,-14.466249999999539,2293.764705882353,29,13,10,42
1752,-9.793499999999279,2555.2631578947367,33,22,4,55
1753,15.61525000000087,3258.235294117647,50,22,3,72
1754,-1.7817499999994169,3496.7894736842104,46,21,3,67
1755,-5.881249999999456,2262.375,44,17,9,61
1756,9.993000000001159,3971.4444444444443,52,37,0,89
1757,-11.385249999999633,2650.3888888888887,39,20,7,59
1758,1.8105000000010505,3956.1,49,25,1,74
1759,3.313500000000441,4071.4210526315787,67,31,6,98
1760,-14.48674999999962,2243.5,44,31,15,75
1761,-7.041499999999047,2262.764705882353,30,31,5,61
1762,-32.11774999999949,2012.1052631578948,26,18,4,44
1763,-1.3457499999978033,2727.153846153846,46,31,6,77
1764,-13.593999999999019,3017.1052631578946,45,25,4,70
1765,-33.388749999999604,2125.15,14,21,8,35
1766,-20.881249999999532,1898.1666666666667,18,27,4,45
1767,20.333750000000556,3816.684210526316,58,29,5,87
1768,-6.10774999999993,3386.3684210526317,32,37,2,69
1769,-26.263499999999432,2165.3333333333335,22,18,5,40
1770,-2.016249999999016,3556.85,50,19,4,69
1771,-7.170499999998474,3296.6,46,25,3,71
1772,2.2845000000003055,3516.5,49,25,3,74
1773,17.792750000001224,2650.3125,59,35,3,94
1774,9.344000000002222,3251.705882352941,60,21,7,81
1775,-16.07999999999939,2098.3888888888887,28,23,5,51
1776,-40.45150000000025,1429.0,11,42,9,53
1777,-32.27750000000016,1824.0,20,33,7,53
1778,2.3565000000010583,2201.8125,42,26,5,68
1779,19.304250000001225,3344.0,73,21,10,94
1780,-28.859749999999792,2083.8,13,32,2,45
1781,-23.884249999999152,2370.294117647059,38,30,4,68
1782,-7.233499999998908,2414.3125,40,27,3,67
1783,9.475500000002006,3814.4444444444443,62,20,4,82
1784,27.70500000000275,2419.25,75,17,1,92
1785,-13.163749999999993,2232.0,31,40,7,71
1786,6.123000000001707,3152.823529411765,53,27,5,80
1787,-24.38774999999908,2749.8947368421054,34,21,6,55
1788,8.193500000001807,3136.764705882353,51,31,3,82
1789,-1.4532499999997655,2005.4375,49,24,12,73
1790,-4.597999999998836,4060.5,46,27,8,73
1791,-6.866499999999208,2562.4666666666667,34,25,4,59
1792,-0.7309999999986341,2233.5625,42,21,6,63
1793,-6.899749999998951,2541.0555555555557,34,22,6,56
1794,30.84850000000094,3489.0555555555557,60,23,4,83
1795,-26.60174999999925,2280.0,20,38,7,58
1796,-16.450249999999933,2313.0625,41,40,5,81
1797,-8.120750000000362,3442.4736842105262,41,32,20,73
1798,2.431000000001393,3993.0,49,30,3,79
1799,-0.591999999998948,3501.3,44,26,2,70
1800,-11.261499999998772,2549.8333333333335,32,29,7,61
1801,13.082000000000994,4509.35,52,26,6,78
1802,-0.2289999999990348,2659.3888888888887,39,27,4,66
1803,-25.176999999999214,1978.842105263158,24,21,3,45
1804,-6.407499999998597,1872.4,39,27,3,66
1805,-14.868999999999616,2259.230769230769,26,27,16,53
1806,-11.335999999999732,2491.842105263158,29,24,4,53
1807,-2.311749999998892,3024.35,43,16,4,59
1808,-6.965999999999207,2566.0,38,20,2,58
1809,-15.86074999999887,3057.65,38,24,4,62
1810,10.68500000000122,2358.625,41,18,3,59
1811,12.237250000000255,3358.842105263158,54,13,11,67
1812,-2.497999999999572,2623.529411764706,43,11,5,54
1813,-10.84149999999899,3457.55,31,42,2,73
1814,-24.33350000000015,1429.0,12,28,10,40
1815,-2.35799999999934,2611.5555555555557,40,24,4,64
1816,-4.112249999999671,2959.8333333333335,44,38,5,82
1817,-30.35524999999967,2193.6111111111113,21,39,11,60
1818,12.871500000002126,4715.6,71,32,0,103
1819,-7.329249999998703,2900.8888888888887,43,35,2,78
1820,5.0890000000017475,1534.8666666666666,49,28,4,77
1821,-6.997999999999211,2244.777777777778,32,19,7,51
1822,-4.172249999999016,2380.529411764706,43,36,12,79
1823,-32.10649999999954,1438.5333333333333,19,36,7,55
1824,-22.738749999999225,2241.5625,28,36,10,64
1825,0.1352500000013901,3306.5555555555557,57,24,5,81
1826,-9.151749999999712,2883.1111111111113,37,38,5,75
1827,-8.269499999999391,1991.5,42,19,2,61
1828,-13.132999999999043,2918.75,33,26,3,59
1829,-13.72849999999973,1879.1176470588234,21,23,5,44
1830,-1.5302499999986516,3564.4736842105262,52,24,1,76
1831,-32.17524999999939,2121.1,22,26,5,48
1832,4.372000000001579,3821.3,57,14,5,71
1833,-25.03924999999979,1992.0526315789473,23,20,2,43
1834,4.3462500000010795,3984.55,57,26,0,83
1835,-21.77974999999961,2512.8333333333335,22,31,4,53
1836,7.478250000001003,2969.823529411765,55,23,4,78
1837,-28.272749999999625,1988.9444444444443,24,25,10,49
1838,-28.662499999999245,3674.4,31,40,3,71
1839,15.688250000001219,3715.6,67,12,1,79
1840,18.464500000000985,2451.875,58,20,3,78
1841,6.690250000001145,3227.1666666666665,53,16,1,69
1842,-0.669249999998484,4745.0,50,33,3,83
1843,-11.760999999999447,3338.842105263158,37,29,1,66
1844,-1.0624999999985791,3803.4210526315787,50,34,5,84
1845,12.212000000000995,3527.9444444444443,57,22,6,79
1846,8.662250000001144,3999.0526315789475,59,27,0,86
1847,-8.820499999999502,2528.35,25,27,3,52
1848,-4.588249999999478,2782.4210526315787,44,21,2,65
1849,1.8050000000005313,2527.6428571428573,41,14,5,55
1850,-11.428499999999065,2444.8888888888887,32,25,1,57
1851,3.75450000000166,4515.6,62,25,1,87
1852,-14.06499999999914,2220.1111111111113,25,21,13,46
1853,9.387500000000863,3036.35,51,13,2,64
1854,-1.5957499999983966,3021.2631578947367,49,18,7,67
1855,17.668000000000607,3871.0526315789475,55,19,8,74
1856,-16.29999999999908,3556.05,35,40,4,75
1857,-15.25999999999948,2650.65,25,30,4,55
1858,-5.207499999998645,2177.125,39,31,9,70
1859,-1.1492499999993595,3195.2631578947367,45,33,5,78
1860,-5.77649999999883,3353.4117647058824,56,34,2,90
1861,17.658750000000914,3093.9375,58,22,4,80
1862,-1.034499999998988,3151.7368421052633,52,24,5,76
1863,-2.933999999999076,3305.25,43,28,1,71
1864,-5.783249999999169,4514.0,39,44,1,83
1865,-26.277749999999564,2224.8571428571427,24,27,2,51
1866,6.991500000001085,3310.3529411764707,49,31,7,80
1867,2.3682500000013986,4751.5,53,31,2,84
1868,18.223500000002197,2722.8125,64,26,1,90
1869,-12.031999999998916,2628.277777777778,30,23,6,53
1870,8.205500000001233,3920.3684210526317,45,30,10,75
1871,-20.276749999999975,2022.157894736842,16,28,7,44
1872,1.5690000000006175,4906.05,42,38,5,80
1873,-19.459499999999,2555.95,39,19,1,58
1874,4.785250000001576,2365.6,56,23,8,79
1875,-26.161250000000063,2214.722222222222,20,39,11,59
1876,29.82050000000214,5564.9,71,34,1,105
1877,8.127750000001168,3322.5,53,17,4,70
1878,2.8490000000011415,2333.9333333333334,44,28,4,72
1879,12.888750000001306,3985.55,52,34,2,86
1880,-3.5647499999984094,2701.764705882353,42,24,5,66
1881,10.834750000001351,4910.8,59,34,0,93
1882,-23.55249999999912,2124.6470588235293,22,24,4,46
1883,-13.430749999999723,2759.2,34,20,6,54
1884,2.1582499999999465,2609.176470588235,40,21,9,61
1885,-41.901999999999944,2016.4117647058824,18,35,6,53
1886,-24.253249999999507,2332.8823529411766,26,32,9,58
1887,-19.451749999999677,2251.8947368421054,18,24,7,42
1888,-4.091999999999759,3124.8947368421054,45,23,7,68
1889,-29.697999999999706,1970.3157894736842,16,31,6,47
1890,-8.421749999999207,2495.470588235294,33,28,3,61
1891,0.4995000000013313,2839.8125,57,27,2,84
1892,-8.466749999999191,2571.1,31,16,8,47
1893,-10.337999999999472,2491.5625,37,17,3,54
1894,-6.935749999999272,2540.1666666666665,34,25,5,59
1895,-23.483500000000028,2503.764705882353,38,28,20,66
1896,-24.390249999999686,1905.2777777777778,23,26,7,49
1897,-0.3287499999990165,2639.8333333333335,38,22,6,60
1898,6.241000000000876,3566.842105263158,46,30,5,76
1899,15.256250000000398,3492.684210526316,56,20,8,76
1900,-4.000249999999735,3614.6315789473683,49,30,6,79
1901,-14.942999999999689,2564.0,27,23,4,50
1902,-20.531249999998938,2090.4444444444443,30,25,4,55
1903,-11.7472499999987,3141.7368421052633,61,19,3,80
1904,-11.947749999999559,2305.6666666666665,29,30,7,59
1905,-13.082499999999456,2624.294117647059,30,16,7,46
1906,-4.20549999999967,2336.705882352941,31,31,7,62
1907,-1.2419999999988562,4143.35,56,16,5,72
1908,10.146500000000737,3655.3,36,38,1,74
1909,10.82100000000142,4483.95,58,30,4,88
1910,-7.932999999998557,2825.8947368421054,44,18,7,62
1911,-12.541999999998378,4517.95,45,32,4,77
1912,0.890250000000855,1835.8125,40,26,3,66
1913,12.360000000001563,4671.85,69,29,2,98
1914,-20.914999999999132,2532.3,28,20,6,48
1915,6.8857500000009555,3756.5263157894738,45,36,4,81
1916,-4.178249999999106,2467.266666666667,45,36,4,81
1917,-8.801749999999156,2168.125,31,18,6,49
1918,-12.140749999999452,2390.9,27,16,6,43
1919,-4.8987499999982935,2421.0625,50,19,3,69
1920,-22.37299999999949,2138.315789473684,22,21,9,43
1921,-4.209999999999015,3044.2,40,20,5,60
1922,-15.726749999999097,2594.2,38,19,9,57
1923,-0.9159999999990213,2198.470588235294,36,26,3,62
1924,-20.187499999999876,1853.8823529411766,15,38,9,53
1925,-2.9262499999990963,3056.9444444444443,38,36,1,74
1926,-17.0124999999992,2961.2105263157896,35,30,5,65
1927,-2.467499999999906,2104.625,36,34,4,70
1928,-6.064749999999728,2302.222222222222,27,29,4,56
1929,-13.592999999999794,2560.5,39,17,20,56
1930,16.32675000000078,3754.3888888888887,63,24,4,87
1931,1.6535000000001354,3570.2105263157896,48,29,11,77
1932,-9.725749999998452,3720.3,46,25,3,71
1933,-16.209999999999052,2344.8125,44,21,14,65
1934,-18.988499999998837,2131.176470588235,41,25,4,66
1935,-8.122749999999249,2516.0,28,28,12,56
1936,-14.906499999999928,1996.3157894736842,23,24,1,47
1937,-1.4112499999990757,3249.1666666666665,44,33,4,77
1938,7.5025000000008095,2703.0,50,21,2,71
1939,7.55975000000092,2184.0625,59,24,6,83
1940,1.9572500000004187,1939.875,49,22,17,71
1941,-23.8277499999997,2005.1176470588234,34,23,8,57
1942,1.9755000000015088,2303.0,43,39,3,82
1943,2.409000000000731,3099.7,44,22,1,66
1944,-7.009249999999206,2451.4166666666665,32,24,4,56
1945,2.2602500000009065,4001.3684210526317,49,39,5,88
1946,-20.60649999999962,2056.05,23,28,0,51
1947,-3.313499999999898,2979.6315789473683,32,24,5,56
1948,-9.806249999999078,3779.1,46,30,7,76
1949,2.1797500000012637,3730.65,47,29,2,76
1950,-0.21874999999888628,2918.5,50,17,2,67
1951,-10.041749999999634,2540.222222222222,34,23,2,57
1952,-19.408499999998966,2573.6315789473683,20,34,4,54
1953,0.015500000001326697,3165.6,51,14,7,65
1954,22.437750000002403,2736.133333333333,69,23,3,92
1955,20.63025000000065,3771.5263157894738,54,22,0,76
1956,-28.87999999999938,2169.55,25,28,1,53
1957,14.38050000000178,4091.8,70,14,3,84
1958,-6.513249999999246,2713.9375,38,24,7,62
1959,13.18025000000174,4481.5,54,38,1,92
1960,-8.611499999999513,2439.8947368421054,26,26,5,52
1961,4.366750000001058,3571.9,36,37,1,73
1962,2.347750000000725,2944.8888888888887,44,33,3,77
1963,-19.675499999999747,2446.875,39,22,18,61
1964,11.66475000000045,1835.8125,39,26,5,65
1965,-16.78674999999939,2773.55,38,18,0,56
1966,17.809750000002474,4391.7,71,16,3,87
1967,-6.57999999999964,2506.85,28,22,5,50
1968,-23.218249999999106,2020.3,25,29,1,54
1969,-21.694250000000103,1999.6666666666667,19,35,8,54
1970,2.9630000000005907,3103.2105263157896,44,30,2,74
1971,-14.448749999999837,2018.1052631578948,22,28,5,50
1972,-4.7557499999988515,3497.45,45,24,3,69
1973,-1.5689999999996362,2280.0555555555557,28,28,3,56
1974,7.438750000001694,3187.6111111111113,61,21,3,82
1975,-10.822999999998439,2049.0555555555557,34,27,7,61
1976,22.113500000001856,5206.9,68,23,6,91
1977,16.196500000001734,4288.6,54,28,4,82
1978,-10.036249999998756,2441.3888888888887,35,20,9,55
1979,-4.445749999999623,2162.25,38,24,4,62
1980,-3.193499999999192,4864.1,57,34,3,91
1981,14.588000000001406,4930.75,68,34,2,102
1982,-4.174249999998632,4378.105263157895,63,26,4,89
1983,-3.520249999998817,3396.5263157894738,41,35,2,76
1984,12.728250000001449,2874.3529411764707,49,26,7,75
1985,-5.394249999998818,3771.95,43,30,6,73
1986,20.26725000000173,4177.578947368421,62,28,1,90
1987,13.936750000001599,3587.8,59,17,0,76
1988,-3.236499999999507,2914.1666666666665,48,15,6,63
1989,-10.238749999999742,2534.529411764706,36,29,6,65
1990,5.070500000001855,3274.0,49,29,1,78
1991,-10.406499999999756,1996.764705882353,36,22,12,58
1992,-15.60324999999889,3327.5555555555557,48,41,5,89
1993,7.596500000000868,2843.6875,69,29,13,98
1994,-7.103249999999081,2714.6666666666665,41,18,2,59
1995,-2.536749999998846,2893.777777777778,46,19,2,65
1996,-7.835999999999262,2330.3333333333335,32,22,5,54
1997,14.584750000001886,3154.6470588235293,67,19,1,86
1998,14.336500000000843,3533.222222222222,71,28,7,99
1999,4.399500000002139,2443.0588235294117,52,23,4,75
2000,3.1320000000013404,3028.5882352941176,45,30,2,75
2001,-17.269999999999335,2490.8947368421054,30,14,7,44
2002,17.25550000000151,5201.3,67,26,0,93
2003,18.254750000001845,2764.3125,62,20,2,82
2004,-14.043749999999198,3056.0,28,34,2,62
2005,1.1277500000004035,2353.1666666666665,26,32,4,58
2006,-9.456999999998606,2655.6666666666665,39,24,7,63
2007,-12.251999999999219,2924.923076923077,31,24,4,55
2008,3.4222500000023084,1976.1764705882354,50,28,2,78
2009,-0.8674999999992729,2433.705882352941,45,21,5,66
2010,-3.323000000000036,1429.0,24,35,2,59
2011,2.271250000001475,3213.4117647058824,62,27,2,89
2012,21.079000000001546,3090.6875,78,22,4,100
2013,-6.53124999999836,2136.3888888888887,36,23,7,59
2014,9.510500000001468,3327.6111111111113,59,24,4,83
2015,21.098750000001854,4356.1,77,15,0,92
2016,5.782500000001024,2952.1052631578946,46,28,7,74
2017,15.387250000001169,3758.4,59,17,2,76
2018,-5.647249999999209,2572.0,46,28,4,74
2019,-8.668999999999414,2422.470588235294,38,25,5,63
2020,-26.866749999999506,1556.0588235294117,13,31,4,44
2021,5.911750000000858,3672.8823529411766,50,35,5,85
2022,-7.916500000000281,2378.6470588235293,35,44,5,79
2023,-2.127999999999404,2548.05,32,21,3,53
2024,-28.728500000000146,1967.1052631578948,20,26,18,46
2025,-18.81024999999948,1937.888888888889,24,23,2,47
2026,-24.26525000000003,2011.0,25,22,24,47
2027,-11.437500000000037,1921.0588235294117,32,29,11,61
2028,-8.827749999999309,2733.0,26,29,1,55
2029,-9.918249999999517,2669.9411764705883,33,22,0,55
2030,5.827750000001389,2609.0666666666666,47,19,4,66
2031,-7.299999999999121,2973.1666666666665,42,30,5,72
2032,-36.92275000000009,1429.0,5,40,2,45
2033,-12.186000000000421,1943.2222222222222,32,27,20,59
2034,1.125000000000774,3508.5789473684213,48,19,8,67
2035,-2.4879999999985474,2353.625,59,19,3,78
2036,12.150000000001441,3818.0,58,25,1,83
2037,-17.752999999999204,2737.0,31,30,0,61
2038,-21.30799999999976,1952.1052631578948,19,25,1,44
2039,-16.938249999999545,2149.9473684210525,22,25,6,47
2040,27.123750000002627,2253.625,63,26,3,89
2041,-6.683500000000156,2155.8947368421054,23,27,10,50
2042,11.959750000000655,3792.5,39,33,0,72
2043,12.049750000001625,2083.529411764706,53,20,2,73
2044,-10.587249999999072,2635.5333333333333,39,19,2,58
2045,-16.57374999999956,3085.684210526316,33,31,2,64
2046,-32.922250000000055,1429.0,12,31,11,43
2047,15.386500000001424,4005.0555555555557,64,23,3,87
2048,17.145250000001244,4992.6,59,26,0,85
2049,-13.461999999999074,4171.85,43,30,2,73
2050,-12.678499999998104,3823.222222222222,58,39,4,97
2051,9.382000000001083,3191.0,44,26,3,70
2052,20.059250000001363,3974.6315789473683,76,23,10,99
2053,-2.09824999999931,2103.6875,37,28,2,65
2054,4.535500000001297,2870.9473684210525,45,24,1,69
2055,-22.168249999999613,2232.7894736842104,21,33,7,54
2056,-8.926499999999688,3736.4736842105262,50,33,14,83
2057,-15.06074999999969,1874.4117647058824,25,31,6,56
2058,-15.625749999999542,2047.235294117647,29,31,8,60
2059,4.085000000000596,2420.705882352941,41,18,3,59
2060,17.30350000000124,4484.263157894737,67,27,9,94
2061,-16.642249999999187,2748.0,36,26,1,62
2062,-23.08924999999957,2028.35,23,22,3,45
2063,-10.364999999999142,2619.6666666666665,33,23,3,56
2064,-21.624249999999872,1957.2777777777778,29,23,5,52
2065,-9.784749999999082,2552.9333333333334,40,25,1,65
2066,-0.9844999999990461,2728.9444444444443,38,24,4,62
2067,-36.609999999999275,1705.75,26,42,4,68
2068,-24.797999999999128,2864.8,35,26,2,61
2069,-32.80224999999969,2097.3888888888887,19,34,3,53
2070,-6.826499999999304,2877.1111111111113,38,30,2,68
2071,10.422000000001258,2854.764705882353,50,27,7,77
2072,-4.996749999999482,2540.222222222222,31,33,2,64
2073,-13.342999999998685,2035.7222222222222,33,24,8,57
2074,-20.28499999999959,2158.4,27,23,0,50
2075,-38.50699999999935,2054.0,29,38,5,67
2076,-7.357249999999285,2558.722222222222,29,27,6,56
2077,20.016500000001543,3969.55,65,18,0,83
2078,-4.703249999999283,3009.2,35,20,4,55
2079,8.000500000001836,4541.05,57,27,4,84
2080,19.725750000002357,2182.0625,69,19,3,88
2081,12.22025000000083,3434.8947368421054,55,17,5,72
2082,-1.7632499999990223,3156.684210526316,45,20,5,65
2083,13.348000000000704,2772.705882352941,52,23,4,75
2084,0.9452500000011395,2596.5333333333333,46,26,4,72
2085,4.503500000000486,2706.3529411764707,36,40,3,76
2086,-17.415749999998788,2681.3529411764707,38,28,5,66
2087,17.284000000001416,3090.1176470588234,57,15,5,72
2088,-12.175249999998682,2992.1052631578946,40,23,11,63
2089,-2.115249999999345,3083.315789473684,43,23,5,66
2090,7.566750000001906,4421.15,77,17,3,94
2091,24.406500000000847,3164.764705882353,73,21,8,94
2092,-0.7069999999988118,3155.0,46,29,2,75
2093,1.2710000000009167,3215.6666666666665,52,29,1,81
2094,-20.78099999999975,2001.3529411764705,37,26,9,63
2095,7.807750000001235,4620.45,56,36,4,92
2096,-13.50249999999943,1853.625,33,21,6,54
2097,5.794250000000479,3387.777777777778,49,21,2,70
2098,1.4077500000009684,2807.235294117647,56,22,3,78
2099,-4.234249999999498,2653.7894736842104,40,24,2,64
2100,12.796250000001272,4114.0,61,29,2,90
2101,-23.88799999999954,2194.1,26,19,2,45
2102,10.691500000001657,4071.9,49,22,6,71
2103,12.397000000000759,2318.0,48,24,7,72
2104,9.30675000000099,3651.25,47,25,1,72
2105,-1.50199999999843,2046.235294117647,36,28,10,64
2106,3.4400000000007744,3948.85,43,35,3,78
2107,-7.261749999998864,3135.45,50,14,2,64
2108,-7.340249999999079,2671.0,38,26,5,64
2109,-6.471749999999517,2171.3529411764707,42,25,1,67
2110,3.192000000000573,2614.0,44,26,1,70
2111,6.28900000000108,3079.8,40,24,3,64
2112,-3.2929999999994544,3606.05,43,23,1,66
2113,4.852000000001408,3208.6315789473683,48,36,4,84
2114,-4.255749999999564,3188.235294117647,49,29,2,78
2115,-6.824499999998811,3044.2,38,26,2,64
2116,-7.807749999998519,2843.705882352941,44,37,1,81
2117,5.1332500000007215,3299.3888888888887,52,24,5,76
2118,15.723250000002789,2932.5555555555557,67,25,5,92
2119,-33.45349999999948,2175.1666666666665,25,38,0,63
2120,-1.7159999999989897,2072.8333333333335,37,24,4,61
2121,13.375500000001713,3232.0,77,21,4,98
2122,-2.1984999999991457,3892.65,53,23,2,76
2123,-2.269749999999169,3108.45,37,18,8,55
2124,5.620500000000345,2583.9375,40,18,5,58
2125,-10.664749999998453,2353.5625,47,25,4,72
2126,2.4207500000006568,2861.8947368421054,38,30,3,68
2127,5.671750000000563,2517.823529411765,46,32,6,78
2128,6.287250000001107,3519.1111111111113,60,32,10,92
2129,-12.900750000000148,1957.2222222222222,28,25,12,53
2130,-3.0857499999988454,3477.4736842105262,59,18,4,77
2131,14.26550000000133,3956.9,56,30,1,86
2132,-34.03299999999983,2912.8,31,27,16,58
2133,-29.312999999999477,2046.421052631579,14,34,3,48
2134,20.400500000001507,4583.736842105263,73,21,4,94
2135,2.768500000001847,2528.3125,52,19,9,71
2136,-1.764999999998579,3705.2,46,33,1,79
2137,-10.353749999999392,2471.4444444444443,30,26,1,56
2138,-27.637999999999288,2039.0,22,23,5,45
2139,-18.86924999999919,2156.6111111111113,19,33,4,52
2140,18.441000000001036,3982.35,61,16,2,77
2141,-22.521249999999423,1986.2105263157894,28,19,4,47
2142,17.052250000001607,2798.0588235294117,55,23,4,78
2143,-7.983999999999116,2826.7894736842104,38,26,5,64
2144,-36.95450000000016,1429.0,7,32,8,39
2145,-15.61224999999879,2998.8947368421054,47,26,5,73
2146,6.3265000000019915,3665.6,59,24,5,83
2147,2.415000000001015,2614.6875,45,27,3,72
2148,-37.28225000000036,1429.0,1,37,10,38
2149,-0.08274999999956689,3682.35,38,26,3,64
2150,-12.701749999999098,2987.9473684210525,40,31,7,71
2151,18.697250000000555,2600.75,63,22,7,85
2152,-17.896499999999484,2460.8333333333335,26,34,3,60
2153,8.998000000000685,3486.5,55,16,2,71
2154,11.629000000001051,3215.777777777778,57,24,6,81
2155,-15.013249999999891,1666.125,24,37,12,61
2156,-5.478999999998916,2769.9473684210525,38,31,3,69
2157,-7.62174999999898,3049.7894736842104,43,25,0,68
2158,20.60325000000191,5483.9,64,31,0,95
2159,-4.148749999999006,2523.5625,53,28,8,81
2160,-2.2072499999982353,4216.9473684210525,51,43,2,94
2161,2.3860000000018795,2680.294117647059,44,21,14,65
2162,-17.381750000000064,1933.4444444444443,25,25,12,50
2163,6.756250000000638,2366.5882352941176,33,24,2,57
2164,7.507000000000315,3887.8,43,23,1,66
2165,-12.01124999999929,2693.4285714285716,30,28,5,58
2166,-19.485999999999045,2591.157894736842,28,32,8,60
2167,-5.537999999998286,2471.6875,57,30,6,87
2168,-12.140999999999424,3194.3684210526317,39,30,10,69
2169,22.83825000000102,4552.15,63,23,1,86
2170,-0.8719999999985539,3639.55,61,17,4,78
2171,-1.817749999999536,2599.8823529411766,43,30,3,73
2172,-2.0044999999984716,3046.5789473684213,47,25,0,72
2173,3.1897500000009957,3823.5,48,28,1,76
2174,5.634000000001136,3735.7894736842104,53,22,2,75
2175,-6.775249999999502,3822.75,38,38,2,76
2176,-24.373999999999235,2688.0,35,48,3,83
2177,-20.996249999999687,2087.1,21,25,0,46
2178,-6.299749999999241,2357.6875,39,32,0,71
2179,-5.032249999999522,3278.7368421052633,38,29,3,67
2180,-5.077499999998315,2517.4375,47,30,8,77
2181,22.55475000000246,2474.8125,71,16,2,87
2182,-29.249749999999334,2046.2777777777778,22,24,15,46
2183,-0.12949999999900044,3272.7,45,20,5,65
2184,-11.36449999999917,4097.25,39,34,1,73
2185,9.617000000001077,3078.0588235294117,54,24,3,78
2186,-25.546749999999456,2045.2941176470588,30,30,6,60
2187,-14.575999999999421,2312.9473684210525,21,29,6,50
2188,0.7787500000009205,3796.6,52,26,1,78
2189,17.679750000002535,2456.1176470588234,59,25,6,84
2190,-18.71125,2572.125,38,28,10,66
2191,3.0002500000006873,3155.157894736842,46,18,0,64
2192,-20.879499999999645,2120.0,20,25,6,45
2193,2.459250000001622,3600.35,54,17,4,71
2194,-11.586999999999003,2591.75,32,24,1,56
2195,-4.110749999999194,3006.2631578947367,43,23,3,66
2196,-2.101249999999581,1971.6470588235295,27,26,4,53
2197,-7.099999999999254,2259.3076923076924,35,19,2,54
2198,-0.2739999999991086,3130.7,41,22,1,63
2199,-8.634499999999308,2544.6666666666665,37,16,8,53
2200,11.976750000001873,1992.5,60,18,4,78
2201,-1.3489999999993603,2370.3529411764707,40,24,6,64
2202,13.253000000001345,3265.1666666666665,63,29,4,92
2203,8.267750000001122,3860.8,58,26,0,84
2204,15.818000000001266,4532.3,60,24,1,84
2205,-13.313499999998857,3132.4736842105262,34,30,12,64
2206,9.689250000000532,3637.8947368421054,51,34,8,85
2207,-8.277749999999191,2662.25,32,24,2,56
2208,-6.382499999999196,3238.6,34,25,4,59
2209,24.569000000001168,4254.6,61,20,3,81
2210,6.065250000000502,2063.9411764705883,36,27,8,63
2211,-10.820749999999334,2528.3,34,18,3,52
2212,3.0340000000005554,2607.625,42,45,2,87
2213,0.9670000000019048,3416.722222222222,49,33,3,82
2214,-54.450749999999445,1438.5333333333333,10,52,1,62
2215,-6.062999999998415,3854.315789473684,61,25,2,86
2216,-3.3549999999992375,3772.0,45,21,1,66
2217,23.72975000000095,3786.277777777778,64,15,1,79
2218,6.557750000001462,4970.3,63,25,1,88
2219,13.404000000000831,3159.25,51,23,0,74
2220,-14.021249999999839,2021.8823529411766,26,20,3,46
2221,22.042750000001632,3993.0526315789475,57,30,2,87
2222,-9.076249999999353,2277.764705882353,31,29,5,60
2223,-15.687499999999151,2523.4210526315787,37,23,1,60
2224,-8.469999999999406,2631.2,35,25,3,60
2225,16.708000000001203,4758.55,62,38,2,100
2226,-2.1537499999988974,3316.4,53,22,0,75
2227,11.204250000001291,3727.1111111111113,58,28,4,86
2228,-18.504749999998968,2385.8333333333335,39,29,4,68
2229,-3.8139999999990666,2086.8888888888887,34,27,2,61
2230,-9.457499999999769,2695.3333333333335,37,24,3,61
2231,-3.9964999999996054,2021.9411764705883,31,21,2,52
2232,9.183750000002213,4947.35,68,18,0,86
2233,-2.8667499999987185,3297.4,49,17,0,66
2234,-25.24324999999954,2024.25,20,23,1,43
2235,1.693750000000899,3246.6111111111113,48,17,2,65
2236,-5.167249999999312,3167.95,40,17,2,57
2237,-17.032749999999304,2411.125,38,22,6,60
2238,-7.5999999999990475,2638.1111111111113,33,26,3,59
2239,-23.746499999999298,2457.4736842105262,36,19,9,55
2240,-13.420249999999754,2179.0,41,21,2,62
2241,16.673500000002058,4379.05,67,25,8,92
2242,-9.493749999999215,2548.2,31,24,1,55
2243,-1.557999999999738,2472.6666666666665,37,23,10,60
2244,-17.88349999999987,2047.1764705882354,29,28,15,57
2245,-16.891749999998687,2078.9411764705883,34,22,4,56
2246,-0.08174999999921777,3291.7,44,27,1,71
2247,-16.321999999999626,2531.4444444444443,35,27,4,62
2248,5.5037500000011415,2545.25,54,31,2,85
2249,10.368500000001033,3599.75,55,22,1,77
2250,-1.2357499999990438,2703.0833333333335,56,24,9,80
2251,-9.96574999999894,3070.7894736842104,47,22,3,69
2252,-32.507249999999864,1429.0,3,26,7,29
2253,5.428750000000915,3884.3684210526317,61,26,6,87
2254,-1.5784999999987164,3028.35,47,20,1,67
2255,9.53025000000068,2518.3125,49,27,1,76
2256,0.06350000000048768,2773.5882352941176,52,24,4,76
2257,-18.010999999999832,2797.35,21,28,6,49
2258,-14.443749999999621,2143.35,25,27,0,52
2259,13.06250000000102,4033.1,54,30,2,84
2260,0.9737500000007573,2703.0526315789475,36,26,1,62
2261,-4.0047499999992375,2715.0,42,16,7,58
2262,5.940750000000191,2473.8125,48,34,8,82
2263,-34.732749999999456,1986.2105263157894,17,24,3,41
2264,13.438250000000604,2194.823529411765,39,19,5,58
2265,-12.51324999999908,2891.4117647058824,47,25,1,72
2266,-36.05700000000015,1429.0,9,36,5,45
2267,-3.2697499999991693,2639.6315789473683,41,20,4,61
2268,2.577250000001455,2904.4117647058824,54,22,3,76
2269,-15.005999999999583,2535.8947368421054,30,19,9,49
2270,-26.12024999999955,2081.4,22,21,0,43
2271,12.394500000001134,2643.8823529411766,51,18,9,69
2272,20.923500000003035,2906.3333333333335,84,13,0,97
2273,-14.544999999998609,1960.8125,38,23,7,61
2274,-3.8377499999988194,3507.5263157894738,39,34,3,73
2275,4.207000000000693,3233.2,46,19,1,65
2276,4.0780000000003795,3689.4,47,21,1,68
2277,17.318250000001253,3951.25,63,19,0,82
2278,10.315750000001575,4668.75,69,13,1,82
2279,6.385500000002102,2620.6666666666665,61,24,3,85
2280,5.250500000000725,3777.45,51,32,0,83
2281,17.805250000001514,2215.3333333333335,51,24,2,75
2282,0.32850000000126656,3177.0,43,30,1,73
2283,12.88800000000156,4652.2,65,28,1,93
2284,10.983750000001068,4223.578947368421,66,40,0,106
2285,4.179500000001171,3280.65,33,33,3,66
2286,-16.764749999999133,3179.315789473684,44,38,4,82
2287,-1.5534999999994628,2684.266666666667,36,23,2,59
2288,-11.250999999999575,2353.4117647058824,36,24,1,60
2289,-26.904499999999548,2106.277777777778,22,27,3,49
2290,-5.304749999999127,2818.1111111111113,39,34,1,73
2291,-5.571999999999636,2619.5555555555557,34,26,2,60
2292,-9.043999999999215,2769.823529411765,59,18,9,77
2293,-4.943749999999096,2536.3529411764707,45,23,3,68
2294,-5.675999999999136,3237.8,34,32,3,66
2295,32.90050000000147,5100.0,70,25,0,95
2296,-14.174499999999673,3053.1052631578946,24,33,6,57
2297,-10.589999999998783,2692.6666666666665,47,32,3,79
2298,16.92325000000123,2984.5555555555557,48,21,4,69
2299,-4.744749999998911,2441.3888888888887,39,19,4,58
2300,16.38325000000143,3908.55,59,23,2,82
2301,-23.083499999999443,2040.05,25,13,8,38
2302,0.49175000000024427,2400.0588235294117,45,24,8,69
2303,-13.767749999999205,2524.35,29,20,3,49
2304,-10.207749999999352,2715.0,39,21,3,60
2305,2.8392500000009546,2536.1875,45,33,1,78
2306,-10.597999999998743,3818.05,35,33,5,68
2307,-14.43249999999964,2571.95,31,21,3,52
2308,15.836500000001513,2988.4117647058824,61,33,2,94
2309,5.121000000001335,3224.6111111111113,44,35,2,79
2310,3.955750000000875,3602.15,44,27,2,71
2311,8.222500000001583,3669.6315789473683,56,27,4,83
2312,6.784750000000514,2960.8888888888887,51,21,1,72
2313,-6.468999999999651,2411.3888888888887,32,19,7,51
2314,-7.301249999998919,2475.8888888888887,40,20,3,60
2315,-11.256249999999081,2473.315789473684,31,21,7,52
2316,-7.861999999999185,3996.55,40,40,2,80
2317,-8.792749999999204,2494.2105263157896,41,22,1,63
2318,-3.3982499999987086,3461.0,51,21,2,72
2319,-3.8397499999990807,2995.3333333333335,38,24,2,62
2320,-9.085749999999736,2152.1875,34,23,6,57
2321,-19.200499999999412,2486.7894736842104,31,23,2,54
2322,10.175000000000587,4053.1052631578946,49,40,2,89
2323,-1.4379999999990454,2569.3684210526317,37,23,2,60
2324,-17.170249999998852,3656.05,32,33,2,65
2325,12.130500000000914,3627.8947368421054,55,20,4,75
2326,4.245000000001274,3594.15,52,28,1,80
2327,-4.225749999999659,2652.4375,33,31,1,64
2328,-17.81199999999939,2580.9375,33,22,6,55
2329,4.725750000000633,3143.3888888888887,47,30,1,77
2330,-10.462999999998967,3067.4444444444443,40,27,4,67
2331,0.8137500000017184,4342.6,67,20,5,87
2332,11.830500000001084,3556.0555555555557,68,21,1,89
2333,4.896750000001882,4113.2,60,23,3,83
2334,-12.642249999999008,2617.9473684210525,31,19,6,50
2335,21.6105000000002,4525.1,56,21,2,77
2336,-20.598249999999346,2008.4,22,24,4,46
2337,-17.25900000000002,2143.3333333333335,31,43,4,74
2338,-19.186749999998785,2882.684210526316,40,22,6,62
2339,-6.397999999999791,2114.733333333333,45,24,4,69
2340,-11.183249999999031,2617.0,31,26,0,57
2341,2.028750000001147,3548.1666666666665,53,31,4,84
2342,8.357750000003042,4544.421052631579,77,28,2,105
2343,-15.398749999999485,2480.6875,38,24,4,62
2344,-8.632249999999427,1981.7058823529412,36,23,8,59
2345,-1.2102499999989955,3251.25,53,17,0,70
2346,24.05400000000173,4264.8,65,24,0,89
2347,15.684000000001808,3274.5263157894738,59,21,0,80
2348,18.157750000001563,2881.0,47,29,6,76
2349,-2.5624999999992517,2669.8333333333335,38,18,3,56
2350,-5.988999999999432,2648.266666666667,43,30,0,73
2351,5.578750000002088,4308.55,60,34,3,94
2352,-4.510999999999569,2505.3333333333335,43,28,2,71
2353,-2.949499999998685,2443.0,51,25,2,76
2354,-2.2694999999994474,1933.9375,42,29,6,71
2355,-22.661999999999924,2240.5882352941176,25,28,7,53
2356,1.5697500000007927,2855.6428571428573,31,26,8,57
2357,26.243000000001,4262.5,81,31,4,112
2358,8.984750000001197,3906.9473684210525,69,20,2,89
2359,-8.923749999999185,2448.315789473684,29,28,5,57
2360,1.0122500000013464,3331.0588235294117,58,31,4,89
2361,11.244000000001396,3810.1,50,25,4,75
2362,-3.8064999999986524,3249.8,47,30,1,77
2363,-26.643499999999573,2706.4210526315787,29,27,8,56
2364,-6.497499999998679,2679.25,38,24,1,62
2365,34.9542500000013,5228.35,78,13,1,91
2366,-11.119499999999721,2024.25,23,23,1,46
2367,11.091000000000971,3087.0,53,22,5,75
2368,3.095500000001566,4306.15,51,37,2,88
2369,19.10125000000145,3671.5,55,29,2,84
2370,-5.734999999999372,3007.2105263157896,40,23,2,63
2371,-29.473499999999568,2082.5,28,29,9,57
2372,-1.361999999999945,2420.1875,37,26,2,63
2373,-21.0937499999998,2229.85,24,20,2,44
2374,-29.776249999999443,1865.5625,24,42,5,66
2375,11.360250000001296,5522.8,69,38,0,107
2376,-8.763249999999827,2611.6111111111113,38,26,1,64
2377,4.887000000000708,3515.6,34,36,2,70
2378,-11.670249999999502,2437.4117647058824,27,25,4,52
2379,5.6330000000022675,4959.526315789473,60,28,1,88
2380,16.446750000001362,3998.1,58,32,1,90
2381,9.823250000001813,3604.5555555555557,66,29,2,95
2382,3.6397500000010092,2416.9411764705883,51,33,2,84
2383,-6.183999999999253,2476.6315789473683,35,25,1,60
2384,-5.408749999999235,2682.9411764705883,46,24,2,70
2385,-22.054000000000208,1965.2222222222222,27,27,12,54
2386,12.48350000000167,3625.3684210526317,64,15,0,79
2387,-43.86624999999977,1429.0,0,32,5,32
2388,4.671500000000579,2424.6111111111113,38,20,3,58
2389,-13.915000000000038,2646.315789473684,33,30,2,63
2390,3.120750000001082,3274.6666666666665,54,22,3,76
2391,-11.054749999999396,2571.95,40,17,1,57
2392,13.877250000000677,3516.55,46,24,2,70
2393,-3.4997499999997643,2624.25,30,20,0,50
2394,-7.543749999999783,2715.0,35,27,3,62
2395,13.295500000000938,4203.05,54,16,0,70
2396,5.85600000000082,2382.75,40,24,0,64
2397,17.407750000002217,2360.8823529411766,52,26,4,78
2398,-13.072249999998826,4206.8,44,30,0,74
2399,17.475000000001348,3970.3,59,21,0,80
2400,9.18275000000125,3205.0588235294117,60,33,1,93
2401,-10.361499999999277,2482.625,46,30,3,76
2402,-46.8177500000004,1429.0,0,37,16,37
2403,-21.932499999999333,2589.875,33,30,3,63
2404,8.006000000000686,2491.4375,49,25,2,74
2405,0.3015000000008886,3345.0,45,28,0,73
2406,6.498000000000734,2492.6470588235293,44,31,10,75
2407,-5.917499999999196,2479.470588235294,37,31,1,68
2408,22.58725000000232,4237.05,81,18,0,99
2409,8.182250000000982,3292.8947368421054,45,23,0,68
2410,12.282500000000343,4083.157894736842,58,34,1,92
2411,-6.691249999999085,2612.5,31,29,7,60
2412,30.8222500000021,4278.388888888889,74,20,0,94
2413,-29.743249999999914,1429.0,11,32,2,43
2414,-8.850749999998417,2933.4444444444443,51,19,1,70
2415,9.171250000001232,3828.3,42,33,1,75
2416,17.357250000001137,2869.764705882353,50,29,4,79
2417,-7.982749999999372,2780.923076923077,37,32,4,69
2418,-16.203499999999625,1862.2941176470588,26,29,4,55
2419,-4.012999999999041,2643.3333333333335,32,39,0,71
2420,-3.7592499999996205,3366.35,34,30,2,64
2421,17.40975000000213,4684.7,75,15,1,90
2422,-4.028249999997727,1934.1764705882354,52,20,1,72
2423,-2.0002499999992116,2482.625,46,21,1,67
2424,-18.29024999999957,2682.25,32,23,0,55
2425,-22.859249999998713,2988.8888888888887,40,27,5,67
2426,1.8270000000010682,3171.9,48,24,1,72
2427,7.152250000000832,3507.684210526316,56,23,1,79
2428,3.252000000000698,2929.4210526315787,52,18,12,70
2429,-21.32900000000002,1429.0,13,27,4,40
2430,-2.91899999999922,1985.611111111111,35,20,6,55
2431,8.790000000001294,4206.894736842105,65,26,1,91
2432,-12.049499999999142,2572.0,28,28,2,56
2433,-13.008249999999137,2608.4,33,21,3,54
2434,-14.626749999999925,2048.1,19,23,1,42
2435,-0.813249999999295,2375.222222222222,40,18,4,58
2436,-2.3577499999988083,2500.6875,49,37,0,86
2437,-20.8004999999992,1998.7894736842106,22,22,8,44
2438,-7.1377499999989125,2877.3846153846152,38,34,1,72
2439,-8.106499999999341,3197.5789473684213,41,26,4,67
2440,5.791500000001288,3611.85,61,19,1,80
2441,-24.37599999999953,2008.35,22,21,1,43
2442,10.908250000001372,3672.2631578947367,64,25,1,89
2443,-10.938999999999302,3184.315789473684,43,32,1,75
2444,3.0482500000007287,3977.157894736842,53,23,1,76
2445,23.84950000000218,3594.470588235294,69,22,2,91
2446,2.485250000002005,3063.2105263157896,50,20,4,70
2447,4.485500000001457,2695.0,51,20,2,71
2448,6.292000000000878,2972.222222222222,55,14,5,69
2449,-13.750249999998905,2708.777777777778,33,28,2,61
2450,-1.6649999999989813,3449.2105263157896,45,28,3,73
2451,14.712500000001532,4215.1578947368425,63,23,2,86
2452,-11.954249999999146,2561.8947368421054,41,23,1,64
2453,-6.657249999999725,2543.4,32,20,4,52
2454,2.489000000000583,3289.684210526316,46,23,1,69
2455,2.788750000001494,3003.6875,75,22,1,97
2456,0.9397500000006567,3814.2105263157896,58,44,3,102
2457,15.965500000002734,4644.2,67,25,1,92
2458,-8.887249999999637,2067.9375,46,20,11,66
2459,-11.206999999999088,3065.842105263158,46,24,4,70
2460,2.520500000000765,2372.0,47,32,3,79
2461,6.456750000001117,2853.9411764705883,59,19,8,78
2462,-5.262999999999254,2030.3529411764705,38,24,9,62
2463,-9.508249999998501,2714.0,40,30,3,70
2464,-18.274250000000272,1429.0,10,36,13,46
2465,-10.138749999998417,2458.9411764705883,48,31,12,79
2466,12.469000000001097,3398.25,45,31,1,76
2467,-19.76450000000002,1933.4444444444443,17,30,11,47
2468,34.69575000000096,4367.263157894737,64,22,3,86
2469,-7.177999999998522,3195.3888888888887,45,21,4,66
2470,-21.24424999999981,2132.5789473684213,20,25,6,45
2471,8.426000000000611,3200.2631578947367,67,25,16,92
2472,-13.731249999999283,2339.3529411764707,31,32,3,63
2473,-10.210999999999421,2123.4375,32,29,12,61
2474,28.526250000001784,3893.8333333333335,83,12,2,95
2475,-22.758499999999444,1991.5,31,35,5,66
2476,10.465750000001574,3945.0,59,20,1,79
2477,-14.723749999999418,2543.4736842105262,34,31,3,65
2478,-3.8272499999994194,2605.529411764706,37,29,4,66
2479,-26.00724999999927,2007.157894736842,17,28,9,45
2480,-9.515749999999223,2234.5625,32,29,3,61
2481,27.577750000000957,2593.75,54,25,3,79
2482,-1.5187499999986342,3653.7894736842104,58,24,5,82
2483,15.719750000001008,3672.75,71,8,1,79
2484,-9.556499999999229,2720.6428571428573,36,20,5,56
2485,-14.072249999999155,3505.8947368421054,43,43,6,86
2486,5.985750000000823,2442.9375,49,11,4,60
2487,-6.077749999999935,2655.9411764705883,51,44,3,95
2488,7.747000000000699,3510.157894736842,50,32,7,82
2489,-14.337249999999162,2348.75,35,33,4,68
2490,-14.943749999999165,3204.4736842105262,32,32,4,64
2491,8.688250000001567,2418.125,61,27,6,88
2492,-2.3439999999987458,2826.8125,62,19,3,81
2493,12.296750000000293,3186.8947368421054,55,16,6,71
2494,-11.657499999999606,2403.8823529411766,39,35,0,74
2495,6.381750000001218,3932.3,53,22,4,75
2496,-12.910999999999252,2536.15,35,15,5,50
2497,-1.8857499999984797,3330.75,51,24,2,75
2498,5.136000000000554,3844.315789473684,57,36,3,93
2499,6.926750000001171,4529.578947368421,64,27,7,91
2500,2.342750000001824,3674.7894736842104,53,26,2,79
2501,-9.847249999999557,2397.3333333333335,36,19,6,55
2502,10.357250000001667,3124.0,61,23,2,84
2503,-0.09799999999923656,2495.625,49,29,3,78
2504,7.911500000001006,2377.2,69,27,6,96
2505,-11.48074999999948,2425.5,36,18,4,54
2506,1.7087500000009619,2941.4444444444443,52,22,5,74
2507,-8.170499999999432,1963.1176470588234,43,23,6,66
2508,-4.7967499999994,3164.2105263157896,53,18,0,71
2509,-0.7802499999989851,3022.3684210526317,48,20,0,68
2510,1.7010000000013121,1909.0588235294117,41,17,6,58
2511,-1.4182499999989193,3024.3333333333335,53,33,3,86
2512,-6.077999999999539,2691.1875,38,20,4,58
2513,-4.1267499999991495,3910.05,51,22,2,73
2514,-1.6854999999995712,2893.722222222222,41,21,8,62
2515,-6.420749999999448,2311.4117647058824,44,25,2,69
2516,-7.087999999999312,3057.2631578947367,40,18,2,58
2517,32.381250000002524,4953.6,81,25,1,106
2518,-11.374499999999486,2674.1428571428573,35,23,8,58
2519,-23.463999999998407,2999.7894736842104,33,34,7,67
2520,1.5225000000006816,3934.4210526315787,55,35,3,90
2521,-13.617249999999306,3012.8333333333335,45,24,8,69
2522,4.0152500000007505,2648.470588235294,58,26,7,84
2523,-19.98675000000002,2007.0,27,21,11,48
2524,-14.99724999999962,2854.5,37,23,1,60
2525,-4.6402499999994,2322.0,41,21,3,62
2526,-0.020749999999010883,2646.3125,49,25,1,74
2527,-8.939499999998699,2489.8888888888887,41,14,7,55
2528,22.767500000002478,2731.9285714285716,62,21,0,83
2529,12.259500000001324,2543.1875,47,23,1,70
2530,-28.023249999999273,2461.0,29,38,3,67
2531,2.574500000001036,3668.1,53,20,1,73
2532,3.8130000000019755,3743.0,79,22,3,101
2533,12.912000000002294,5103.7,97,10,0,107
2534,-14.03574999999891,3619.5,49,28,1,77
2535,-20.33574999999927,2500.157894736842,34,21,3,55
2536,-8.43249999999863,2011.0555555555557,34,27,10,61
2537,-8.39149999999933,2444.3,23,32,0,55
2538,13.803500000001495,2761.470588235294,51,25,1,76
2539,-6.670999999999465,2658.55,36,16,3,52
2540,-34.81349999999976,2256.05,15,28,2,43
2541,4.281250000000896,2938.125,57,33,2,90
2542,0.27775000000125705,3075.9,49,20,1,69
2543,11.04250000000078,3946.65,45,30,1,75
2544,-14.0537499999995,2645.0,23,32,0,55
2545,24.6595000000017,3530.5,74,19,4,93
2546,4.9032500000004635,3025.705882352941,53,14,4,67
2547,-1.9327499999992201,3516.35,42,26,2,68
2548,-2.571749999999816,2328.176470588235,34,27,2,61
2549,-21.973999999999307,2176.7894736842104,23,27,8,50
2550,-24.38149999999968,2051.25,12,23,8,35
2551,4.767000000001136,2980.0588235294117,65,20,9,85
2552,-10.660999999999017,2778.3333333333335,39,28,2,67
2553,-9.910249999999358,2629.95,34,20,3,54
2554,-2.81024999999941,2667.1666666666665,43,25,4,68
2555,-9.09249999999996,2272.294117647059,38,24,8,62
2556,-11.102249999999101,2898.6315789473683,43,17,2,60
2557,9.308000000000234,2795.7894736842104,45,25,5,70
2558,17.975500000001958,2499.9333333333334,82,19,2,101
2559,-12.233249999998872,2567.95,35,22,1,57
2560,-3.6169999999986544,3336.315789473684,50,24,6,74
2561,28.710500000001627,2439.0,55,22,2,77
2562,-9.78574999999946,2594.95,35,16,2,51
2563,-9.962999999999223,2552.2,32,22,2,54
2564,-5.5967499999989085,3069.0,49,25,2,74
2565,4.069250000000832,2717.823529411765,32,25,1,57
2566,-27.155999999999864,2013.842105263158,25,23,15,48
2567,-3.387499999998865,2543.6315789473683,25,31,13,56
2568,-1.5144999999990003,3497.35,53,15,2,68
2569,-26.494999999999465,2028.25,21,22,2,43
2570,-19.776749999999083,2556.05,36,17,5,53
2571,-3.6317499999993537,2532.3,27,26,0,53
2572,-13.811499999999345,2223.8125,41,35,2,76
2573,17.50800000000047,3881.842105263158,69,25,3,94
2574,-3.874749999999331,2661.55,38,23,1,61
2575,3.472500000000975,4173.473684210527,56,23,6,79
2576,17.19050000000109,3864.9,69,13,0,82
2577,-1.9927499999994183,3463.2,41,28,3,69
2578,16.445750000001862,4826.8421052631575,83,29,3,112
2579,-8.897499999998088,2409.722222222222,41,22,9,63
2580,-11.201249999999009,2567.95,32,25,1,57
2581,-10.547499999999483,2532.684210526316,34,24,0,58
2582,7.446250000001745,4281.5,57,32,0,89
2583,0.913250000001575,2651.277777777778,49,20,1,69
2584,-14.252999999999414,2680.6315789473683,34,28,11,62
2585,0.6065000000001367,2465.222222222222,35,26,4,61
2586,-12.660499999999109,2577.0526315789475,34,24,4,58
2587,9.872500000001349,1831.875,44,24,4,68
2588,7.886250000000994,3814.0,61,20,3,81
2589,-15.171749999999895,1429.0,24,35,2,59
2590,-22.204749999999827,1889.388888888889,24,25,2,49
2591,12.699000000000208,2733.277777777778,64,29,9,93
2592,-12.428499999999634,2035.8823529411766,33,20,6,53
2593,-22.517499999999803,2034.888888888889,25,25,4,50
2594,-3.400249999999866,2720.4,32,23,1,55
2595,-1.7967499999991368,3706.8,49,19,4,68
2596,2.687500000000734,3079.95,48,15,1,63
2597,-6.7534999999994465,2554.3888888888887,35,18,4,53
2598,-7.368749999999309,2371.5,37,25,0,62
2599,-19.474999999999802,2080.684210526316,20,27,2,47
2600,-16.56399999999953,1973.4117647058824,24,25,11,49
2601,-2.3094999999988994,3072.0,42,23,0,65
2602,-30.4289999999997,1968.6666666666667,23,24,3,47
2603,-17.666499999998866,2782.95,39,25,0,64
2604,11.00650000000166,2168.125,55,21,1,76
2605,-21.992249999999995,2151.823529411765,34,36,5,70
2606,-2.4379999999991124,2625.375,50,38,2,88
2607,-5.664749999999328,2164.764705882353,30,30,1,60
2608,4.2085000000009485,3160.1176470588234,58,24,3,82
2609,13.265750000000759,4829.1,53,28,1,81
2610,-5.5592499999987055,2934.3333333333335,46,30,3,76
2611,-24.75775000000001,2055.6315789473683,21,24,6,45
2612,-16.583999999999104,3055.6315789473683,38,30,5,68
2613,14.558750000002828,2760.4375,78,18,1,96
2614,-31.272750000000077,1967.0,23,24,27,47
2615,5.5097500000013735,2596.75,61,12,4,73
2616,-5.126499999999318,2435.6470588235293,42,27,3,69
2617,-17.037249999999528,2067.9375,25,24,6,49
2618,7.828000000000619,2125.5,45,29,1,74
2619,20.972500000002047,4799.7,62,28,0,90
2620,-2.284249999998461,2934.3333333333335,56,26,4,82
2621,14.06425000000109,3441.5555555555557,60,27,11,87
2622,-12.740249999998984,2516.4,35,23,0,58
2623,-14.110749999999507,3921.1666666666665,51,54,0,105
2624,-16.30349999999969,2036.611111111111,34,32,7,66
2625,5.067000000001412,4837.9,60,22,0,82
2626,23.486250000001874,4909.25,75,19,0,94
2627,3.1720000000002337,2275.3125,45,24,8,69
2628,-3.837749999999107,3191.0666666666666,36,38,2,74
2629,-25.59999999999958,2153.7,19,26,2,45
2630,-17.57399999999935,2357.315789473684,21,39,3,60
2631,-19.211499999999432,1936.111111111111,24,25,4,49
2632,22.17850000000166,4513.15,64,23,2,87
2633,-14.200249999998727,3084.8,44,18,4,62
2634,-3.1432499999999957,2164.8823529411766,51,27,10,78
2635,23.38575000000201,4655.3,75,19,0,94
2636,-13.502999999999378,2231.8947368421054,26,24,3,50
2637,-26.663999999999497,2008.4,17,24,0,41
2638,24.958000000002254,3049.0,66,18,1,84
2639,1.6510000000005498,3865.6,41,39,4,80
2640,-21.015749999999418,2437.8888888888887,27,25,8,52
2641,3.0860000000010976,2623.9444444444443,57,21,3,78
2642,-3.1812499999987742,4198.85,50,29,4,79
2643,7.289750000001332,2972.529411764706,57,24,0,81
2644,-26.603749999999508,2101.235294117647,21,24,7,45
2645,-20.897249999999495,2008.5,23,24,1,47
2646,14.386000000001186,2885.9444444444443,50,26,3,76
2647,14.446250000001267,4161.7,62,26,0,88
2648,1.6107500000009178,2432.0625,50,24,1,74
2649,0.5490000000012976,3112.35,49,21,1,70
2650,2.4752500000009277,3133.315789473684,46,22,2,68
2651,-2.7737499999997284,2548.2,31,21,2,52
2652,2.2062500000015466,2830.875,53,19,4,72
2653,-5.31249999999904,4245.9,54,22,3,76
2654,-16.523249999999592,2126.5882352941176,26,30,4,56
2655,-18.36174999999951,2348.9473684210525,24,24,4,48
2656,-20.568999999998983,3073.2631578947367,32,39,1,71
2657,-10.312999999999906,2303.153846153846,45,22,7,67
2658,-7.855749999999702,1830.8125,36,26,2,62
2659,0.6075000000014688,3205.3,56,15,0,71
2660,10.47200000000139,3420.5384615384614,60,12,0,72
2661,-25.32599999999977,5268.7,33,46,3,79
2662,11.507750000001177,4715.55,57,22,1,79
2663,27.347000000001394,4997.3,71,26,1,97
2664,0.35375000000115603,2087.294117647059,52,25,8,77
2665,-10.473999999999752,2980.277777777778,48,34,9,82
2666,-11.222499999999398,2783.176470588235,33,22,1,55
2667,-2.4367499999990967,2286.125,62,23,2,85
2668,-11.233499999998932,2772.8,28,30,5,58
2669,-5.576999999999076,2582.214285714286,43,19,5,62
2670,-8.630499999999397,2672.0,37,25,2,62
2671,24.798000000001046,5020.4,77,21,0,98
2672,-9.60724999999965,2114.4117647058824,35,28,3,63
2673,-22.446499999999617,2040.6315789473683,14,31,2,45
2674,5.189250000001353,4683.0,63,19,1,82
2675,-11.47499999999962,2629.2,29,27,0,56
2676,-20.94974999999997,1438.5333333333333,8,35,4,43
2677,22.349750000001873,4402.95,63,23,2,86
2678,21.050500000000767,4108.263157894737,63,29,3,92
2679,-3.7867499999991288,2675.3125,34,26,2,60
2680,15.531750000000201,2607.75,61,21,1,82
2681,-20.034499999999518,2036.15,23,25,1,48
2682,-16.717499999998886,2344.75,36,37,6,73
2683,-18.74599999999989,2375.6875,46,41,1,87
2684,11.022500000001582,3774.8947368421054,69,25,0,94
2685,23.33075000000145,4325.05,65,16,1,81
2686,-3.5942499999992434,2675.705882352941,34,26,2,60
2687,-32.52924999999988,2110.0526315789475,18,26,5,44
2688,20.181250000001356,4132.35,57,21,0,78
2689,-5.410999999999383,4092.5,45,31,3,76
2690,-13.950499999999337,2550.076923076923,33,42,2,75
2691,-1.754249999998909,4102.15,49,27,1,76
2692,-0.3307499999997964,1835.8125,49,29,2,78
2693,-1.2724999999992712,3064.0,45,40,0,85
2694,3.071000000002687,1976.3529411764705,59,30,0,89
2695,-2.4037499999990977,2417.5555555555557,40,21,8,61
2696,-19.913249999999543,2143.4117647058824,25,45,0,70
2697,-21.120749999999486,2028.7222222222222,24,31,8,55
2698,-17.303249999999384,1996.888888888889,24,28,2,52
2699,-22.3917499999997,2099.842105263158,24,24,3,48
2700,5.585750000000521,2362.5333333333333,48,36,0,84
2701,-14.824749999999256,4344.85,42,35,4,77
2702,4.020000000000661,3191.85,49,18,0,67
2703,6.858250000000858,3777.55,53,23,1,76
2704,2.5182500000008643,3362.5,48,20,2,68
2705,-3.1117499999989344,2425.6111111111113,39,27,2,66
2706,19.432500000001514,4244.526315789473,87,22,2,109
2707,-3.713249999999069,2554.3684210526317,39,20,0,59
2708,-12.098999999999105,3417.9,37,30,2,67
2709,-0.5924999999993382,2568.277777777778,49,21,4,70
2710,17.57400000000181,2932.3529411764707,65,30,1,95
2711,7.794250000001062,2396.375,48,27,3,75
2712,-2.929999999999548,2857.6111111111113,46,20,4,66
2713,3.905750000000252,3331.0588235294117,63,30,9,93
2714,0.8432500000006702,2316.5,35,21,5,56
2715,14.554250000001252,4495.5,55,23,0,78
2716,14.192250000001625,4650.4,74,19,2,93
2717,-14.814999999998502,2001.5,37,24,2,61
2718,-7.05274999999921,2571.9375,41,34,3,75
2719,-7.646749999998976,2572.0,40,36,2,76
2720,-7.271749999999033,4272.85,59,29,1,88
2721,-6.218249999999587,3003.842105263158,38,29,4,67
2722,14.736250000000407,3170.0526315789475,46,21,1,67
2723,-1.761499999999355,2551.3529411764707,51,27,8,78
2724,-28.50274999999983,1991.5,34,27,12,61
2725,-0.7097499999994165,2596.8125,51,19,1,70
2726,4.021500000000261,2440.9375,36,22,2,58
2727,-19.411249999999363,2441.3888888888887,39,27,10,66
2728,12.508750000001292,3298.6111111111113,61,27,5,88
2729,7.886500000001769,3138.8333333333335,56,27,1,83
2730,-6.520249999999483,3183.0,45,36,2,81
2731,-17.642749999998824,1945.8333333333333,32,27,4,59
2732,8.325750000001378,2134.0588235294117,46,19,4,65
2733,3.289500000000934,3087.75,43,24,2,67
2734,-12.826499999999527,2032.2,22,25,2,47
2735,-10.296499999998776,1993.0,39,20,3,59
2736,-5.163749999999198,2373.0588235294117,38,33,2,71
2737,-21.185499999999557,1959.5263157894738,23,24,1,47
2738,-22.028749999999217,2008.45,23,28,0,51
2739,-30.134499999999527,2008.45,21,20,3,41
2740,18.949750000001394,4018.8947368421054,66,23,0,89
2741,-3.9757500000001387,2715.0,53,44,4,97
2742,-15.222499999999542,2079.0555555555557,27,28,1,55
2743,-13.039249999999218,2675.0555555555557,38,19,2,57
2744,-7.4952499999992295,2593.529411764706,31,28,0,59
2745,-14.795249999999806,2514.6111111111113,47,24,14,71
2746,15.136750000001891,4685.5,83,10,1,93
2747,-8.336999999999176,2897.4,29,31,2,60
2748,-0.08274999999945898,2505.266666666667,55,17,5,72
2749,6.781500000000756,3071.85,46,20,0,66
2750,9.72650000000135,2734.470588235294,61,27,1,88
2751,15.987000000001567,4981.45,70,23,6,93
2752,-8.828499999999595,1998.5294117647059,36,26,5,62
2753,12.518750000001598,3831.6315789473683,62,19,1,81
2754,2.799000000001615,3048.15,47,25,1,72
2755,-16.40549999999994,2028.3,21,21,3,42
2756,3.3182500000014405,3117.777777777778,52,24,3,76
2757,20.06750000000127,3749.1052631578946,54,25,0,79
2758,-10.863499999999897,2381.3529411764707,38,23,12,61
2759,-14.918999999999158,2544.1,36,22,0,58
2760,22.529250000001632,2951.1111111111113,57,28,3,85
2761,-1.8634999999990705,2488.823529411765,54,27,5,81
2762,-12.835999999998752,2465.529411764706,43,25,4,68
2763,5.269999999999941,2128.5,54,26,9,80
2764,28.915000000000976,3179.9411764705883,61,11,1,72
2765,6.582750000000317,2250.5,55,39,0,94
2766,9.216500000000535,2549.25,63,30,4,93
2767,9.620750000001664,5139.55,73,25,1,98
2768,-0.9597499999992112,2514.8,50,18,0,68
2769,-15.665249999999165,2842.823529411765,37,22,0,59
2770,-2.4484999999994868,2148.6666666666665,43,28,3,71
2771,-14.077499999999123,2583.8,29,26,3,55
2772,-23.039749999999664,2048.15,24,22,2,46
2773,-2.1534999999981004,3683.85,68,11,0,79
2774,-24.699249999998894,2130.294117647059,37,32,5,69
2775,-7.165999999999052,2043.4705882352941,26,25,4,51
2776,-11.44174999999911,1942.9375,43,27,5,70
2777,-17.73074999999944,2073.3529411764707,29,26,3,55
2778,-2.8052499999985923,2201.875,42,31,0,73
2779,-4.621749999999421,2847.4,44,20,0,64
2780,-6.229249999999366,2813.1875,35,21,2,56
2781,-12.670999999999717,1893.8333333333333,25,26,5,51
2782,9.136750000000855,2753.1176470588234,59,21,4,80
2783,12.55500000000065,3478.3684210526317,56,18,8,74
2784,-4.715749999998777,4249.7,49,25,1,74
2785,7.200500000001125,3371.294117647059,45,22,1,67
2786,-12.261999999999189,2543.5263157894738,34,19,3,53
2787,-10.399499999999652,2398.9444444444443,30,27,1,57
2788,-11.436249999999367,2487.8823529411766,36,29,2,65
2789,-23.061749999999616,2032.25,17,27,2,44
2790,1.5917500000006317,3306.05,46,20,5,66
2791,23.58525000000092,3422.6470588235293,64,18,1,82
2792,15.51250000000184,2474.6666666666665,66,29,1,95
2793,-1.7222499999996832,2063.9411764705883,46,23,1,69
2794,4.282750000001916,4416.4,73,16,1,89
2795,-7.461999999999001,2118.5,47,28,3,75
2796,-2.564999999999061,3061.5789473684213,48,20,0,68
2797,-7.346999999999348,2983.6153846153848,37,25,5,62
2798,3.879500000000621,2619.6428571428573,49,19,2,68
2799,12.686000000002254,2953.9411764705883,65,25,1,90
2800,-8.863499999999272,2514.2105263157896,33,24,4,57
2801,10.144500000001477,3666.2631578947367,69,23,2,92
2802,21.435750000000766,3328.6111111111113,58,24,2,82
2803,21.496750000001363,3857.65,70,13,1,83
2804,-16.757499999998853,2518.375,34,25,2,59
2805,-23.844749999999458,1821.1764705882354,18,40,3,58
2806,-3.8637499999991243,2082.6470588235293,39,21,2,60
2807,-22.943249999999566,2032.25,23,24,1,47
2808,18.789250000001836,4702.9,73,20,1,93
2809,22.211500000000715,3289.0555555555557,59,25,1,84
2810,3.369750000000957,3538.65,46,25,0,71
2811,-10.357249999999073,3115.55,45,19,1,64
2812,-9.653249999998085,3755.15,57,30,1,87
2813,-25.518999999999778,2080.5789473684213,19,26,3,45
2814,-13.47099999999987,1908.0,23,36,4,59
2815,26.263750000002112,4807.6,84,15,0,99
2816,9.99650000000118,2795.0588235294117,56,20,3,76
2817,-24.534249999999297,2008.45,17,28,1,45
2818,-13.348249999999553,2961.2105263157896,39,32,1,71
2819,-28.947249999999123,2008.45,21,23,6,44
2820,21.474500000002113,3371.176470588235,75,24,2,99
2821,9.516250000001223,3801.7368421052633,50,24,1,74
2822,-7.893249999999041,2475.7894736842104,35,21,3,56
2823,-9.555749999999438,2000.5,32,31,0,63
2824,8.869250000000893,2979.4444444444443,57,18,4,75
2825,-13.409750000000198,2512.8333333333335,40,33,14,73
2826,2.0112500000002997,2563.5882352941176,46,36,2,82
2827,0.28300000000061054,2478.733333333333,48,23,2,71
2828,-23.061249999999387,2060.0,25,16,6,41
2829,-16.367249999999405,2707.7,32,23,1,55
2830,7.255750000001457,3607.9473684210525,50,24,0,74
2831,7.394750000000367,2529.9411764705883,38,21,2,59
2832,-17.476499999999234,2421.0833333333335,31,19,3,50
2833,-41.08949999999978,1979.2777777777778,23,22,4,45
2834,-5.237749999998603,2803.777777777778,45,28,2,73
2835,-13.838749999999314,2658.4,30,22,2,52
2836,15.739250000002134,3663.25,73,12,1,85
2837,-6.3579999999985075,3036.2,54,15,0,69
2838,26.623750000002275,2800.1875,83,18,1,101
2839,-2.275249999999411,2857.6666666666665,52,33,3,85
2840,-21.948999999999426,2008.5,21,28,1,49
2841,-1.1687499999993953,2750.3529411764707,32,20,2,52
2842,18.391000000000158,2652.3125,66,9,1,75
2843,10.773000000001243,3810.1,63,18,2,81
2844,9.398750000000632,2572.0,42,29,1,71
2845,25.09175000000119,5129.95,78,14,1,92
2846,-19.430749999999804,1635.4117647058824,28,35,8,63
2847,-2.995999999998672,3134.315789473684,49,18,2,67
2848,-14.182749999999192,1887.5294117647059,32,23,3,55
2849,16.461750000001224,4721.15,70,27,0,97
2850,-19.51199999999963,2032.25,22,27,0,49
2851,-2.728999999999343,2693.0,41,28,2,69
2852,7.830750000002989,3525.222222222222,75,19,0,94
2853,0.98450000000068,3123.55,38,24,2,62
2854,4.052000000001376,2169.529411764706,44,22,0,66
2855,2.1312500000005317,3641.2105263157896,59,31,2,90
2856,-14.10824999999923,2524.25,26,26,3,52
2857,17.889750000001474,3580.3529411764707,69,43,0,112
2858,4.381250000001517,4141.1,57,29,0,86
2859,-13.215999999999642,3068.0,29,29,3,58
2860,6.469000000001486,3655.2,64,16,1,80
2861,-8.174499999999464,3083.05,34,27,3,61
2862,-2.1369999999996168,2610.0,53,34,0,87
2863,-14.57824999999906,2595.75,40,17,1,57
2864,-17.81824999999964,2048.1,21,22,3,43
2865,22.534500000001565,4594.15,83,5,1,88
2866,2.51950000000118,4111.631578947368,67,32,11,99
2867,18.24475000000106,3023.4444444444443,58,16,1,74
2868,18.410750000000498,2862.0555555555557,64,17,5,81
2869,-9.344249999999585,2843.8125,34,21,2,55
2870,18.147750000001643,3831.7368421052633,63,19,0,82
2871,-17.169999999999106,2129.3529411764707,28,22,1,50
2872,-5.142249999999103,3821.05,53,26,1,79
2873,-2.896249999999414,2923.722222222222,41,25,4,66
2874,-7.500249999999245,2553.294117647059,33,24,2,57
2875,-1.9797499999995984,2627.0,52,24,7,76
2876,4.2415000000008805,3683.9473684210525,51,31,2,82
2877,-1.352499999999471,2584.4736842105262,40,11,3,51
2878,-30.943999999999612,2063.9444444444443,16,32,5,48
2879,-19.20274999999892,2660.0,39,32,2,71
2880,-8.466749999999568,3065.5789473684213,35,26,1,61
2881,6.47725000000104,2965.222222222222,50,22,1,72
2882,3.234000000000883,2830.0526315789475,48,20,1,68
2883,-4.826999999999387,3847.6315789473683,49,29,0,78
2884,12.12750000000123,2528.4375,58,17,2,75
2885,-10.3962499999991,3099.7,46,18,0,64
2886,-15.902249999998727,2059.0,40,30,2,70
2887,2.7250000000006405,2810.0,43,26,2,69
2888,1.184750000001469,4016.3333333333335,58,38,1,96
2889,10.10500000000134,3769.55,57,21,0,78
2890,1.6825000000014327,3621.157894736842,60,17,2,77
2891,-7.253499999999093,3068.0,44,18,0,62
2892,3.0312500000008917,3062.2631578947367,52,21,1,73
2893,7.937000000001705,4373.45,61,27,0,88
2894,1.859250000000823,2420.125,46,20,1,66
2895,6.555750000000981,2357.6875,50,18,2,68
2896,5.3902500000001625,2434.875,55,28,4,83
2897,-0.36349999999906046,2693.4285714285716,43,28,0,71
2898,-24.762749999999304,2695.0,34,22,0,56
2899,-0.8142499999990875,2527.375,60,34,0,94
2900,40.75900000000148,5253.75,96,15,0,111
2901,-10.685999999998929,2631.0555555555557,39,31,7,70
2902,21.272250000001353,4395.75,75,15,1,90
2903,12.434250000000613,3187.684210526316,51,22,1,73
2904,-7.62974999999914,2536.05,31,23,1,54
2905,16.933750000000902,4287.0,60,20,5,80
2906,-10.739249999999823,4695.75,47,41,1,88
2907,-16.985249999998906,1689.0,28,26,6,54
2908,-29.742000000000008,2015.4444444444443,28,22,14,50
2909,-3.850749999999487,3148.1,35,28,4,63
2910,-14.905249999998711,2595.3684210526317,39,25,2,64
2911,-13.3204999999992,2631.5,37,18,0,55
2912,23.219000000001202,4059.842105263158,85,18,0,103
2913,12.854750000001378,3513.1176470588234,76,29,2,105
2914,-2.8297499999988696,2087.133333333333,43,14,5,57
2915,-1.745249999999936,2370.294117647059,43,29,0,72
2916,17.525500000001152,4228.631578947368,75,27,0,102
2917,22.93225000000162,3312.722222222222,66,17,0,83
2918,28.442250000001515,3502.1666666666665,64,22,1,86
2919,12.67250000000149,2500.5,59,23,0,82
2920,6.26150000000105,2972.8947368421054,58,14,1,72
2921,9.169500000000651,2721.75,56,16,5,72
2922,15.753500000001532,3485.5555555555557,67,17,1,84
2923,9.842000000000796,3627.45,47,21,0,68
2924,-17.746749999998897,3384.65,50,27,0,77
2925,-6.570999999999446,2354.222222222222,38,26,5,64
2926,3.3952500000005683,2114.470588235294,43,29,5,72
2927,-7.186499999999308,2582.214285714286,42,36,1,78
2928,-10.749499999999374,2266.157894736842,37,23,4,60
2929,21.358250000001142,3636.315789473684,65,19,6,84
2930,8.695500000002701,2060.176470588235,55,23,5,78
2931,2.3315000000007333,2504.705882352941,40,21,0,61
2932,28.378250000001845,2698.8125,73,23,0,96
2933,-18.134999999999867,1862.5625,44,29,14,73
2934,13.553000000001674,4950.421052631579,81,21,3,102
2935,21.63375000000112,5058.4,69,19,0,88
2936,-5.280499999999122,3141.85,40,25,2,65
2937,-1.5577499999989857,3368.842105263158,47,27,6,74
2938,7.651000000000835,2914.5882352941176,60,27,5,87
2939,14.72675000000066,4131.631578947368,79,20,2,99
2940,17.110250000001628,4322.05,70,18,1,88
2941,-7.991499999999277,2548.0,31,25,1,56
2942,-12.769749999999018,2406.6470588235293,53,30,7,83
2943,-21.107249999999596,1939.6666666666667,25,28,5,53
2944,-9.58924999999957,2840.2,32,27,1,59
2945,3.739750000000975,2561.785714285714,51,23,1,74
2946,11.467500000001378,4617.2,62,28,2,90
2947,0.6087500000003498,2424.6666666666665,41,22,2,63
2948,5.2272500000006605,2913.0555555555557,50,21,2,71
2949,-14.425749999999747,2727.1666666666665,35,23,9,58
2950,-5.851749999998974,2807.294117647059,50,27,1,77
2951,6.416250000001407,2559.0625,68,22,2,90
2952,-18.692249999999174,2076.4736842105262,27,21,4,48
2953,2.3155000000012835,2922.0555555555557,52,21,1,73
2954,-3.4709999999984547,3220.3,50,25,1,75
2955,-0.7224999999983476,1867.0,50,21,5,71
2956,11.308750000000765,3816.35,61,19,1,80
2957,17.973250000000796,3066.0,75,24,4,99
2958,-21.65474999999975,2032.25,22,22,3,44
2959,-7.158249999999124,2268.25,46,25,3,71
2960,-8.289249999999356,2029.0,41,21,1,62
2961,-15.737749999999622,2806.9333333333334,34,17,0,51
2962,-2.7234999999985723,4421.95,64,34,3,98
2963,0.5250000000009953,2286.266666666667,53,29,2,82
2964,-3.800499999999593,2500.5,38,29,3,67
2965,-6.022249999999007,2911.9473684210525,22,42,5,64
2966,-10.970249999999428,1429.0,16,36,3,52
2967,-12.968999999999914,2057.65,20,23,4,43
2968,5.048500000000496,3115.6,42,22,1,64
2969,-0.14724999999896812,3167.4736842105262,46,20,3,66
2970,12.49000000000164,3774.4,73,18,0,91
2971,-7.402749999999044,2558.6666666666665,39,24,2,63
2972,16.580750000001036,3562.3333333333335,64,20,0,84
2973,-12.133249999999624,2583.3333333333335,35,23,3,58
2974,-18.190749999999717,1908.0,34,45,4,79
2975,4.85375000000158,3167.1666666666665,65,23,3,88
2976,-32.03049999999939,1862.0,21,33,9,54
2977,0.1932500000009644,3010.6315789473683,51,17,2,68
2978,13.870750000001058,2329.733333333333,59,30,6,89
2979,-23.247249999999006,3466.35,29,41,4,70
2980,-16.0899999999987,2299.294117647059,37,19,2,56
2981,-5.535749999999055,3415.6315789473683,52,25,4,77
2982,-10.014499999998725,2489.5625,54,23,2,77
2983,3.6445000000003014,2572.0,48,23,4,71
2984,-21.04300000000009,2110.5882352941176,22,23,21,45
2985,-1.5202499999982937,3198.4117647058824,59,20,5,79
2986,20.30575000000182,4637.75,78,18,2,96
2987,22.75150000000108,4559.473684210527,71,26,1,97
2988,27.039250000001136,4306.1,71,17,1,88
2989,13.048250000001843,4372.1,62,23,2,85
2990,6.4200000000011,2580.5384615384614,54,23,3,77
2991,-23.96424999999922,2607.6,37,19,0,56
2992,-27.356249999999612,2008.55,19,26,1,45
2993,-25.076249999999632,2044.5555555555557,20,25,5,45
2994,51.82500000000152,2703.705882352941,67,27,0,94
2995,-1.8354999999995,2630.8823529411766,43,29,5,72
2996,-14.10324999999988,3539.3684210526317,46,28,3,74
2997,-5.416499999999013,2682.0,39,30,1,69
2998,-30.33024999999943,2094.9,18,24,2,42
2999,-0.8007499999989232,2377.764705882353,51,31,4,82
3000,13.679000000001817,4160.1,71,18,1,89
3001,-10.57699999999883,2222.75,39,18,2,57
3002,-3.755499999999384,3814.75,52,28,4,80
3003,-4.048499999999159,2672.705882352941,49,34,1,83
3004,1.1075000000009236,2620.529411764706,43,30,3,73
3005,-5.589999999999277,2564.0,35,23,1,58
3006,-5.397249999999596,2583.0,39,20,3,59
3007,-8.262249999999238,1929.5294117647059,31,23,2,54
3008,3.99525000000082,2952.9411764705883,53,15,1,68
3009,-12.358749999999741,2070.7368421052633,38,26,4,64
3010,-25.175749999999475,2048.1,18,26,1,44
3011,4.364750000001509,3050.722222222222,62,16,1,78
3012,7.875250000001155,4101.35,45,42,0,87
3013,3.490000000001151,3210.5882352941176,62,34,1,96
3014,2.6295000000017508,2583.176470588235,59,12,4,71
3015,0.9230000000006452,3115.75,43,20,0,63
3016,-14.407249999999674,2579.8888888888887,41,37,2,78
3017,-2.5202499999984096,2649.375,43,24,7,67
3018,-6.1037499999991125,2149.25,50,30,5,80
3019,-13.119499999998794,2123.5,41,22,3,63
3020,-2.7999999999990886,2755.785714285714,40,26,1,66
3021,10.53675000000154,3859.35,62,17,3,79
3022,21.81375000000093,3846.8947368421054,79,12,2,91
3023,15.845500000000694,3643.4444444444443,53,26,3,79
3024,-11.595249999999435,2590.15,36,20,0,56
3025,2.658000000000894,2500.5,46,39,2,85
3026,19.813750000001072,3599.65,56,23,1,79
3027,-10.15024999999925,2043.4117647058824,38,18,7,56
3028,10.764250000001404,3229.777777777778,56,16,2,72
3029,20.66225000000171,4987.0,73,25,0,98
3030,-11.572249999999325,2062.9375,39,24,3,63
3031,-9.630999999999515,1728.6875,31,31,6,62
3032,-34.30099999999964,1429.0,24,34,8,58
3033,-4.72124999999951,2643.5,36,29,1,65
3034,-0.347249999998479,3437.5789473684213,54,22,1,76
3035,-3.661749999999336,2840.2,32,26,3,58
3036,-10.435999999999597,2787.4736842105262,37,25,4,62
3037,3.686000000001081,2526.3125,47,20,1,67
3038,-3.4217499999989633,2793.315789473684,33,29,3,62
3039,-9.654749999999435,2504.705882352941,32,25,1,57
3040,-33.694750000000134,1946.611111111111,14,34,9,48
3041,9.24725000000096,4589.35,72,23,3,95
3042,-5.247499999999221,2652.4375,35,26,0,61
3043,43.489750000001514,4929.05,83,18,0,101
3044,15.336750000001777,4601.4,63,22,0,85
3045,-20.753999999999444,2522.5789473684213,33,27,4,60
3046,-5.342249999999472,3251.722222222222,45,29,0,74
3047,4.4245000000006085,2600.222222222222,40,23,0,63
3048,5.648250000001264,3777.4736842105262,59,21,1,80
3049,-8.008500000000016,2817.9444444444443,37,38,1,75
3050,7.198750000000781,2976.722222222222,54,21,1,75
3051,-28.69874999999944,2012.8333333333333,20,25,11,45
3052,-21.80724999999899,2392.0555555555557,39,26,4,65
3053,-14.510249999999752,2223.5,22,25,1,47
3054,14.13200000000081,2498.1176470588234,72,20,2,92
3055,-11.113749999999266,2612.785714285714,41,26,1,67
3056,5.6197500000008365,3574.6111111111113,56,32,1,88
3057,17.084250000001386,3918.85,67,19,1,86
3058,6.1755000000005085,3899.4736842105262,57,18,14,75
3059,16.050500000001172,3957.0,55,20,3,75
3060,-14.813249999999599,2448.3684210526317,28,22,2,50
3061,14.330750000001197,3430.0526315789475,50,25,0,75
3062,5.983500000000484,2369.3529411764707,47,31,3,78
3063,21.881500000001083,3612.0,74,26,3,100
3064,23.585500000001115,2893.4375,83,17,2,100
3065,14.968000000001402,3222.777777777778,61,21,0,82
3066,6.332250000000536,2471.1176470588234,45,21,1,66
3067,-10.43924999999955,2013.5294117647059,33,25,5,58
3068,-5.735999999999177,2931.3684210526317,44,26,5,70
3069,-12.25024999999901,3174.35,39,32,4,71
3070,-19.776749999999375,2365.5555555555557,33,28,4,61
3071,-23.791749999999997,1944.888888888889,17,26,4,43
3072,-4.397499999998692,3023.2105263157896,45,26,3,71
3073,-22.945999999999927,2099.0526315789475,17,31,9,48
3074,6.955000000000796,3286.1666666666665,45,32,3,77
3075,-10.84974999999938,3021.85,26,28,2,54
3076,9.727500000001571,4593.3,64,26,0,90
3077,-10.10399999999916,1837.1176470588234,35,26,3,61
3078,-6.0784999999990585,4441.0,48,25,0,73
3079,-10.611749999999546,2586.866666666667,42,27,5,69
3080,-5.3054999999990144,2924.3,39,24,0,63
3081,-10.06799999999957,2128.375,35,21,2,56
3082,-7.815749999998921,3821.1,53,29,2,82
3083,-15.901999999999623,2381.5555555555557,25,33,3,58
3084,-8.312249999999043,3473.3684210526317,46,27,5,73
3085,-24.724999999999618,1967.0,15,33,4,48
3086,-13.228249999999235,2568.0,37,18,1,55
3087,-3.120749999998067,3251.0,57,32,2,89
3088,-28.413999999999838,1997.0,23,27,6,50
3089,15.226750000000857,4872.0,58,26,0,84
3090,0.15550000000113942,2958.0,42,29,1,71
3091,-6.06949999999938,2659.3333333333335,38,35,3,73
3092,-18.566249999999574,2028.35,21,20,2,41
3093,1.654250000000832,3421.5789473684213,54,29,1,83
3094,-9.311749999999057,2358.9166666666665,29,24,2,53
3095,-6.499999999998478,3075.95,54,17,1,71
3096,-8.999749999999281,2118.4375,34,23,3,57
3097,-6.319749999999473,2529.9411764705883,30,24,1,54
3098,11.00525000000146,3274.0588235294117,68,25,1,93
3099,-8.571749999999309,2599.7,37,25,0,62
3100,2.370250000001019,3502.684210526316,49,24,2,73
3101,17.502000000001367,4875.85,69,20,0,89
3102,19.643750000002022,2781.25,67,13,5,80
3103,-16.197499999999867,2032.25,15,31,0,46
3104,8.436750000000611,3194.315789473684,39,28,0,67
3105,11.779750000001876,3866.842105263158,70,25,6,95
3106,-4.784499999998937,2638.0,45,27,3,72
3107,-6.457249999999178,3198.85,41,23,4,64
3108,-3.4419999999993762,2400.777777777778,41,30,6,71
3109,-4.359499999999417,2621.157894736842,37,30,3,67
3110,-8.229999999999729,2459.9444444444443,42,26,7,68
3111,-5.763499999999176,3589.5263157894738,58,20,7,78
3112,10.093000000000774,2839.9375,49,19,1,68
3113,4.387750000000833,3155.25,54,16,3,70
3114,1.2457500000002455,2763.4117647058824,39,22,6,61
3115,11.211000000000773,3047.0,87,26,7,113
3116,-17.837749999999566,2185.6666666666665,20,28,3,48
3117,2.7932500000004077,3671.9,51,17,5,68
3118,16.540250000001112,4044.0,62,19,1,81
3119,-12.075749999999912,1866.5625,39,40,1,79
3120,-10.051999999999238,3083.1,32,28,2,60
3121,-20.762249999999927,1429.0,20,35,8,55
3122,-6.168249999999148,2503.1111111111113,36,23,3,59
3123,-23.51099999999935,2089.0,21,22,5,43
3124,16.79625000000033,3563.222222222222,68,27,5,95
3125,9.517000000001621,4084.8,63,27,0,90
3126,17.707000000001226,3761.5263157894738,64,23,6,87
3127,8.398750000002181,2656.823529411765,62,20,4,82
3128,-16.672499999999648,3006.722222222222,40,39,2,79
3129,-9.723249999998309,2328.875,47,31,2,78
3130,3.705750000000742,3910.85,45,27,2,72
3131,-7.837749999999173,2613.684210526316,37,22,5,59
3132,-9.397499999998843,2768.6923076923076,37,26,1,63
3133,-5.576249999999115,2646.133333333333,40,27,1,67
3134,-20.092249999998764,2547.7368421052633,37,26,2,63
3135,3.162750000001801,1930.0625,49,19,4,68
3136,7.928750000000685,4694.95,63,23,1,86
3137,-2.1284999999990886,2558.6666666666665,42,29,1,71
3138,-16.14274999999976,2108.8888888888887,33,22,5,55
3139,22.641250000001367,4356.85,65,26,2,91
3140,-2.333749999999484,2530.3125,38,17,6,55
3141,-2.666999999999336,2500.9411764705883,35,24,10,59
3142,10.766500000000509,3130.842105263158,38,36,3,74
3143,-2.925499999999312,2340.8333333333335,39,27,7,66
3144,-5.313749999999264,2489.0,33,28,4,61
3145,3.9222500000007074,2380.625,67,31,7,98
3146,14.122250000000818,3734.65,57,21,0,78
3147,-20.858749999999386,2125.85,20,25,3,45
3148,-35.357249999999816,1429.0,0,33,6,33
3149,17.81950000000128,2965.3333333333335,52,27,0,79
3150,15.485000000002241,3366.4444444444443,69,29,1,98
3151,-23.116749999999385,2942.6,22,33,2,55
3152,-22.49699999999921,3325.9,36,25,5,61
3153,24.49725000000101,4048.1666666666665,65,26,4,91
3154,3.017000000000658,2133.5,35,25,1,60
3155,-19.201000000000054,2251.1052631578946,23,29,5,52
3156,-9.428749999999074,3019.6315789473683,49,19,6,68
3157,6.437500000001515,4010.7,72,19,5,91
3158,-23.30549999999931,2008.4,21,22,3,43
3159,19.885500000001876,4806.1,83,14,0,97
3160,-4.852249999998692,2582.214285714286,43,29,4,72
3161,-24.114499999999346,1997.157894736842,21,22,7,43
3162,23.859500000002175,4805.25,80,19,1,99
3163,-26.029249999999895,1429.0,23,34,5,57
3164,7.940750000001391,2837.0,49,28,2,77
3165,7.462000000000872,3447.722222222222,51,36,7,87
3166,-24.36374999999945,1925.5,24,26,8,50
3167,-9.18949999999959,1481.9333333333334,32,29,1,61
3168,20.07800000000116,4577.55,62,25,1,87
3169,-2.58624999999861,3877.45,42,35,0,77
3170,3.7735000000013117,2839.9411764705883,54,25,3,79
3171,-11.420499999998986,3760.8,40,36,3,76
3172,-9.726249999998599,2049.0555555555557,31,33,3,64
3173,-12.683499999999032,2477.5882352941176,42,36,4,78
3174,3.393500000000329,2475.705882352941,37,28,2,65
3175,-19.392999999999073,2720.1111111111113,34,29,1,63
3176,-9.125499999999564,2437.0,32,30,3,62
3177,9.326500000000944,2259.3076923076924,42,28,3,70
3178,-37.847999999999864,1429.0,3,33,1,36
3179,-5.680499999998404,5589.4,63,40,0,103
3180,-39.10149999999991,1429.0,0,29,5,29
3181,2.807000000000811,3295.7,54,15,2,69
3182,-1.1772499999981871,4565.6,59,27,2,86
3183,-14.36224999999931,2036.1875,38,46,1,84
3184,-20.38999999999983,1977.0526315789473,17,30,3,47
3185,17.629500000000675,4087.4210526315787,60,28,1,88
3186,-8.861249999998968,2549.5882352941176,41,24,2,65
3187,-7.609249999998596,3174.2105263157896,40,36,0,76
3188,-10.224749999999217,3859.05,56,25,0,81
3189,8.093500000001256,4023.842105263158,56,29,5,85
3190,-12.496999999999312,2636.3,26,28,5,54
3191,-5.413499999998505,3187.684210526316,46,25,0,71
3192,9.170000000000845,4148.8,54,26,4,80
3193,4.920500000001407,4296.6,50,24,0,74
3194,-24.217499999999735,2446.5789473684213,26,29,8,55
3195,-9.238749999999301,2645.85,34,25,1,59
3196,-40.29374999999931,2008.45,15,27,4,42
3197,-23.84024999999975,2378.9473684210525,18,35,1,53
3198,-1.1532499999993546,3267.842105263158,44,25,2,69
3199,10.59500000000059,3111.65,52,13,4,65
3200,-6.137999999998681,4638.55,52,35,2,87
3201,-22.706749999999463,2165.55,24,25,1,49
3202,23.142000000001133,3840.1,63,19,1,82
3203,17.51775000000156,4336.25,60,26,0,86
3204,15.965000000001087,3353.4117647058824,68,16,3,84
3205,4.853000000000694,3198.95,40,23,1,63
3206,4.297500000000939,2765.8888888888887,44,24,2,68
3207,25.92775000000237,3594.4117647058824,75,21,0,96
3208,12.880250000001055,3386.4736842105262,53,25,3,78
3209,15.24675000000147,3836.7894736842104,74,22,1,96
3210,-39.08924999999994,1429.0,0,30,5,30
3211,12.281750000001121,3050.777777777778,56,32,9,88
3212,-4.26674999999917,2552.15,27,29,2,56
3213,-9.854749999999516,2968.8888888888887,47,46,1,93
3214,14.733000000000754,4004.842105263158,58,21,3,79
3215,-10.239249999999156,2670.3125,36,28,1,64
3216,-11.295499999999056,1983.5882352941176,26,32,1,58
3217,4.353250000001699,2485.5625,65,39,4,104
3218,3.3737500000017926,3341.315789473684,54,27,1,81
3219,23.93525000000151,3602.8823529411766,62,27,0,89
3220,-30.895249999999294,1988.3529411764705,21,28,7,49
3221,4.028000000000881,2964.3333333333335,47,25,0,72
3222,11.590250000000845,2391.0,51,28,1,79
3223,-12.950749999999482,2420.705882352941,39,29,3,68
3224,6.492250000001475,2757.3333333333335,52,19,4,71
3225,24.474500000000617,3704.0,63,24,6,87
3226,6.261250000001306,3173.4444444444443,52,29,2,81
3227,-12.706499999999076,2756.266666666667,31,25,2,56
3228,-13.08124999999986,2596.4,42,26,22,68
3229,-0.7742499999991013,3072.2,51,19,1,70
3230,13.239000000001386,4245.7,58,28,0,86
3231,7.65000000000101,2969.764705882353,61,25,1,86
3232,19.319250000001254,3643.45,62,18,0,80
3233,32.39200000000147,4242.55,70,14,1,84
3234,6.805750000000946,3037.777777777778,49,21,2,70
3235,-3.1724999999986325,3087.85,42,25,2,67
3236,-3.2744999999987305,3060.2,49,18,1,67
3237,4.038000000000484,2442.1176470588234,57,18,14,75
3238,11.124250000001812,4583.0,76,9,1,85
3239,-7.143249999998306,3453.777777777778,65,30,3,95
3240,12.52700000000115,2618.5882352941176,59,33,4,92
3241,-9.259249999999389,2575.95,27,25,3,52
3242,23.64175000000075,3571.1052631578946,49,30,0,79
3243,-9.742999999999856,2218.4736842105262,19,34,10,53
3244,-32.79149999999946,2338.55,18,31,4,49
3245,21.51500000000232,2356.235294117647,54,29,2,83
3246,3.4630000000006205,2996.315789473684,44,31,1,75
3247,24.480500000001683,3550.8333333333335,71,22,6,93
3248,4.070500000000803,3025.6470588235293,64,39,2,103
3249,11.189500000001468,4122.7,71,21,0,92
3250,-19.127749999999505,2028.25,16,26,4,42
3251,18.94900000000072,3112.5,54,25,2,79
3252,-25.126749999999866,1927.3333333333333,29,29,10,58
3253,-11.675249999999485,3507.7368421052633,49,39,5,88
3254,-14.625249999999582,2080.875,24,35,3,59
3255,19.59900000000129,3555.8888888888887,71,19,2,90
3256,0.682000000000661,2397.277777777778,36,20,0,56
3257,-0.22624999999906592,2250.4375,46,35,1,81
3258,-1.4742499999992575,3001.4444444444443,41,21,2,62
3259,2.028000000000828,3022.722222222222,44,27,1,71
3260,-5.638499999999574,2438.2631578947367,29,24,1,53
3261,-7.914249999999058,2362.4666666666667,43,30,3,73
3262,-8.042249999998878,2576.277777777778,34,23,3,57
3263,-25.202749999999675,1959.5263157894738,20,26,5,46
3264,-5.880249999999549,2496.5789473684213,43,15,1,58
3265,-1.3522499999992568,2957.9473684210525,46,27,4,73
3266,21.41225000000167,3627.176470588235,75,22,5,97
3267,14.941000000001575,3387.5,65,23,3,88
3268,11.309250000000821,2373.5625,58,19,2,77
3269,1.2505000000006257,2967.0,49,18,2,67
3270,9.671500000000911,2224.8,45,22,1,67
3271,4.6320000000006285,2793.0833333333335,46,24,3,70
3272,-3.7622499999995265,2400.5333333333333,46,34,3,80
3273,2.3970000000015235,4514.05,54,23,2,77
3274,-12.030749999999363,2508.6,30,21,3,51
3275,-3.9169999999989935,2536.777777777778,38,23,4,61
3276,-10.145999999998967,2629.9411764705883,37,18,7,55
3277,-20.004499999999858,2012.5,20,25,0,45
3278,-16.114499999999023,2455.7894736842104,41,19,5,60
3279,-1.7232499999991138,2941.85,42,20,1,62
3280,5.661750000001868,3465.222222222222,64,23,3,87
3281,0.4160000000007008,2900.1111111111113,47,20,2,67
3282,42.80100000000122,4881.105263157895,91,13,1,104
3283,-3.196249999998387,3846.65,46,28,4,74
3284,28.289750000001806,4816.35,77,16,0,93
3285,24.320750000000828,3968.8333333333335,72,21,2,93
3286,-5.8499999999984995,3184.75,52,18,0,70
3287,-3.022999999999191,3699.95,51,19,2,70
3288,17.40325000000101,3808.4,70,14,1,84
3289,-2.336249999998851,2604.625,40,19,3,59
3290,-1.6717499999986827,3435.4,46,30,2,76
3291,-3.1937499999993855,4058.5,49,28,0,77
3292,-30.686249999999507,2000.4117647058824,37,34,11,71
3293,17.900750000000638,2633.5882352941176,52,27,2,79
3294,8.850500000001224,3238.5789473684213,61,18,0,79
3295,-3.7687499999993137,3233.9,40,30,1,70
3296,-13.827749999999366,2836.25,37,25,1,62
3297,23.39950000000267,2738.1176470588234,75,16,5,91
3298,19.816000000001416,3666.277777777778,58,35,1,93
3299,-1.6574999999980384,2539.235294117647,54,28,1,82
3300,-4.308499999998448,2454.176470588235,48,28,2,76
3301,-0.6749999999995022,2433.4444444444443,44,25,2,69
3302,8.756750000001452,2491.625,47,33,1,80
3303,15.280500000000544,2568.176470588235,48,37,1,85
3304,4.6870000000003715,2392.0555555555557,46,26,5,72
3305,6.246500000001086,4367.2,73,16,0,89
3306,-11.634749999997998,2650.529411764706,39,28,11,67
3307,-12.722749999999687,2571.9,32,20,1,52
3308,10.550000000000828,3040.277777777778,55,25,1,80
3309,-7.2709999999987875,2704.0625,44,25,6,69
3310,-5.108999999999433,2056.0,30,28,0,58
3311,7.229750000001511,3895.6111111111113,59,24,2,83
3312,9.425000000001372,2963.0588235294117,55,26,0,81
3313,22.277500000002185,4745.0,75,23,0,98
3314,18.235000000000344,3624.777777777778,59,21,1,80
3315,21.06400000000218,4433.0,73,24,2,97
3316,-30.459749999999538,2089.8947368421054,17,32,0,49
3317,31.707250000002016,5326.7,86,21,2,107
3318,33.294000000002,4863.526315789473,88,18,1,106
3319,-21.515499999999257,1933.4444444444443,31,26,5,57
3320,-22.546499999999526,2004.6315789473683,18,31,7,49
3321,3.7315000000007443,2927.764705882353,34,27,0,61
3322,23.488750000002618,3826.7368421052633,66,24,3,90
3323,-1.301499999998238,2389.764705882353,47,30,2,77
3324,-3.9014999999993676,3325.8888888888887,41,32,1,73
3325,6.793000000001586,3944.5789473684213,66,19,3,85
3326,6.788000000000137,2682.1111111111113,36,37,3,73
3327,-11.799999999998725,2992.1176470588234,53,29,0,82
3328,20.86750000000098,4153.944444444444,71,30,0,101
3329,-15.116499999999377,2126.5555555555557,24,26,2,50
3330,-17.843249999999536,2267.0,27,25,1,52
3331,-14.92249999999944,2682.2,32,24,0,56
3332,14.099250000001234,3768.75,64,16,1,80
3333,-28.969499999999726,2378.0526315789475,22,35,5,57
3334,-2.353999999999398,2634.5,30,25,3,55
3335,15.670000000001384,4577.8421052631575,72,29,0,101
3336,10.226500000001652,3690.2,54,21,2,75
3337,-30.195500000000038,1841.6666666666667,17,37,1,54
3338,-8.436999999999847,2662.3,29,24,0,53
3339,-13.15050000000026,2397.277777777778,44,44,1,88
3340,-3.4652499999995614,2215.75,32,21,3,53
3341,16.54750000000187,4985.4,64,27,2,91
3342,-27.02599999999962,1980.3684210526317,19,29,1,48
3343,4.245500000000773,2509.375,45,32,0,77
3344,14.768000000001752,3811.9411764705883,77,25,3,102
3345,19.81775000000119,4231.45,64,31,0,95
3346,-9.770999999999352,3275.1,31,26,4,57
3347,-2.70374999999916,3223.6666666666665,61,33,5,94
3348,27.047250000001902,4569.65,71,22,0,93
3349,-19.51924999999951,2222.7368421052633,23,28,4,51
3350,-3.3317499999988627,3077.3684210526317,40,30,0,70
3351,-15.700749999998951,2513.235294117647,36,20,1,56
3352,-3.99974999999895,1967.8333333333333,28,28,7,56
3353,-1.5712499999987624,2212.133333333333,37,25,3,62
3354,-16.541249999999124,2684.7368421052633,37,27,2,64
3355,8.21375000000044,2460.9411764705883,47,31,4,78
3356,-22.70949999999973,1821.9375,32,38,2,70
3357,3.8530000000005757,3222.7368421052633,56,30,4,86
3358,25.57725000000236,5335.45,90,23,1,113
3359,14.915000000000962,3971.3684210526317,63,21,0,84
3360,16.115000000001256,3948.25,61,18,0,79
3361,16.502750000001164,4179.0,67,15,0,82
3362,15.66350000000026,2223.8125,45,37,0,82
3363,-24.713000000000086,1897.3333333333333,18,31,0,49
3364,-23.326499999999132,2512.6315789473683,36,26,2,62
3365,-9.485749999999943,2241.5,43,37,2,80
3366,-8.059499999999414,2234.8823529411766,63,33,2,96
3367,-6.549499999999476,2532.3,28,24,2,52
3368,9.9100000000011,2339.8125,57,25,0,82
3369,16.550000000001752,3633.722222222222,58,22,0,80
3370,0.7370000000017245,2975.75,60,15,0,75
3371,-21.67574999999971,1971.5294117647059,23,27,8,50
3372,-16.519999999998838,2512.7368421052633,31,30,2,61
3373,-16.079499999999452,2418.315789473684,22,28,6,50
3374,19.11175000000122,3036.1875,61,33,2,94
3375,14.176750000001977,4371.2,66,18,0,84
3376,-2.2599999999991907,3103.8,33,33,0,66
3377,-7.901999999999385,2638.733333333333,31,28,0,59
3378,5.7822500000009,3099.8,46,19,1,65
3379,0.5127500000006012,2465.277777777778,28,25,0,53
3380,3.603000000001279,3566.6111111111113,56,28,0,84
3381,25.683000000001595,3150.8823529411766,76,24,0,100
3382,7.287250000001388,4171.95,57,30,0,87
3383,2.2570000000006742,3412.3888888888887,38,36,1,74
3384,-3.484499999998602,2992.1176470588234,56,22,2,78
3385,1.5807500000009758,2391.4375,41,23,2,64
3386,-28.329999999999707,2024.3,15,26,0,41
3387,-26.20974999999988,2036.25,10,30,0,40
3388,-3.982749999999318,3414.8,51,30,1,81
3389,15.508250000001246,3743.0,60,28,0,88
3390,-10.804499999999747,1942.875,34,27,4,61
3391,19.996750000001136,4742.65,71,22,0,93
3392,-5.131749999999128,2536.25,31,27,1,58
3393,32.638500000002225,4868.631578947368,81,24,3,105
3394,5.599250000000721,3328.0,45,38,6,83
3395,-27.63424999999966,2173.45,13,37,1,50
3396,6.458250000000168,2711.3888888888887,44,31,5,75
3397,5.871000000000622,2638.0,37,37,0,74
3398,-16.613249999999443,2053.8947368421054,22,30,0,52
3399,-13.785999999999152,2568.5789473684213,34,25,2,59
3400,0.6977500000008325,3099.9473684210525,50,21,0,71
3401,-14.342249999999211,2086.8888888888887,33,38,4,71
3402,5.7695000000005505,2764.8571428571427,44,18,0,62
3403,-7.397249999999251,2530.0,38,31,1,69
3404,9.824500000000596,5362.35,76,35,5,111
3405,-8.219749999998879,3274.35,53,20,0,73
3406,-23.818999999999413,1986.2631578947369,17,26,2,43
3407,-19.06474999999974,2258.8888888888887,36,32,20,68
3408,-40.31349999999996,1429.0,0,24,5,24
3409,-7.961249999998834,3284.3888888888887,54,27,4,81
3410,3.073000000001522,2882.0,63,18,3,81
3411,33.25950000000135,4843.25,79,25,0,104
3412,-5.082999999998581,2680.294117647059,45,22,2,67
3413,44.767750000001456,5231.5,75,28,0,103
3414,12.046500000001203,2144.3125,47,18,6,65
3415,15.660000000000746,3405.277777777778,55,34,0,89
3416,21.6170000000018,4607.0,84,16,0,100
3417,-7.670249999999228,2540.2,33,26,0,59
3418,-5.74000000000007,2325.8888888888887,32,30,0,62
3419,19.397750000000997,4750.5,55,27,1,82
3420,1.1262500000012632,4548.2,69,29,0,98
3421,30.278000000001935,5152.15,79,27,2,106
3422,42.99650000000121,2793.375,84,23,1,107
3423,-16.947249999999094,2403.4444444444443,32,27,1,59
3424,-13.13399999999957,2370.8333333333335,25,36,3,61
3425,-20.18124999999933,2599.7,31,25,0,56
3426,-21.239999999999178,2051.6666666666665,27,25,3,52
3427,-27.224499999999672,1987.5,29,31,14,60
3428,-19.170999999999616,2035.0,27,37,11,64
3429,10.010250000000813,2866.176470588235,56,23,1,79
3430,23.45425000000162,2924.125,70,26,2,96
3431,4.89875000000099,3685.45,51,26,1,77
3432,-13.014499999999057,2407.5882352941176,31,31,1,62
3433,30.776500000000944,5024.4,73,20,1,93
3434,27.22525000000155,4990.15,69,31,0,100
3435,-11.796999999999013,2668.1666666666665,34,23,0,57
3436,-13.662499999999966,2092.222222222222,34,27,10,61
3437,37.28550000000159,2364.5333333333333,83,23,0,106
3438,4.196000000001162,2798.25,60,17,1,77
3439,25.618250000000824,4407.75,63,15,0,78
3440,-5.9699999999990485,2876.842105263158,42,24,1,66
3441,11.146750000000797,3953.85,52,28,0,80
3442,-7.843749999998354,3042.6470588235293,53,40,0,93
3443,-1.151499999998817,4206.75,50,30,0,80
3444,8.852500000000832,1833.8125,61,28,6,89
3445,13.36050000000144,3120.9285714285716,58,27,5,85
3446,-18.232999999999706,2008.4,20,19,5,39
3447,24.03625000000179,5346.55,88,19,0,107
3448,-4.0959999999996795,2181.705882352941,33,26,11,59
3449,5.7067500000021845,4870.35,84,16,3,100
3450,-42.667249999999655,1429.0,4,32,5,36
3451,-12.826499999999324,2531.7368421052633,40,24,4,64
3452,-10.629749999999332,2175.125,29,27,2,56
3453,-18.935749999999487,2138.315789473684,23,27,1,50
3454,2.7315000000011502,3131.5,43,32,1,75
3455,21.063750000000717,4031.5263157894738,72,41,0,113
3456,-28.86899999999941,2024.25,17,29,0,46
3457,3.109500000001023,3311.65,43,26,1,69
3458,37.44650000000169,4655.25,83,14,0,97
3459,0.7665000000013594,3037.8,48,19,0,67
3460,-3.0219999999987803,3237.15,49,22,0,71
3461,-0.9719999999990643,3131.4,31,36,1,67
3462,-12.661249999999026,2500.5555555555557,39,20,4,59
3463,-27.65924999999927,2028.2,16,28,2,44
3464,21.524750000001,3909.5789473684213,73,27,0,100
3465,-10.4627499999989,2712.8125,31,24,0,55
3466,-13.095749999999622,2576.157894736842,32,29,6,61
3467,8.510250000000287,2339.8125,44,31,2,75
3468,10.254500000000883,3676.1,58,20,0,78
3469,0.8307500000008117,3470.8947368421054,56,23,0,79
3470,-2.4517499999987296,3865.65,47,36,0,83
3471,-21.956749999999534,2273.0,24,26,1,50
3472,7.527250000000812,2803.470588235294,52,27,10,79
3473,21.065250000001917,3735.8888888888887,77,17,3,94
3474,-24.44949999999964,2032.25,19,26,1,45
3475,2.3020000000007084,3460.1,44,26,2,70
3476,-0.8212499999989923,2921.1666666666665,48,36,1,84
3477,-12.550749999999493,2575.3888888888887,35,34,2,69
3478,4.729750000001973,4079.15,67,16,0,83
3479,9.323750000000592,3450.842105263158,60,24,2,84
3480,15.09875000000173,3177.777777777778,63,21,1,84
3481,-5.592499999998298,2666.133333333333,38,31,6,69
3482,-22.537249999999705,2074.3,20,25,1,45
3483,5.109750000001082,3905.315789473684,68,26,1,94
3484,-16.239999999999398,2055.6315789473683,26,28,2,54
3485,-23.54749999999948,2464.7,17,33,0,50
3486,16.43900000000101,4218.8,67,19,1,86
3487,31.050000000002502,4992.6,91,14,0,105
3488,-3.6602499999990967,2551.9,37,20,0,57
3489,37.08300000000167,2837.1176470588234,76,28,0,104
3490,5.198000000001245,4412.45,71,13,1,84
3491,-24.736749999999564,1992.1052631578948,17,32,1,49
3492,-6.503499999998352,2768.3125,47,29,1,76
3493,1.2980000000005891,3280.6470588235293,53,23,2,76
3494,7.875500000000864,3032.3,44,22,3,66
3495,-29.503249999999742,2024.3,17,17,5,34
3496,3.0925000000013703,3771.2,66,12,0,78
3497,8.387500000001406,4916.45,59,39,0,98
3498,-6.341999999999449,3957.842105263158,48,29,3,77
3499,-1.6602499999997584,3328.25,47,17,5,64
3500,6.572000000001213,3834.65,55,26,0,81
3501,-12.461999999999351,2610.6875,28,27,1,55
3502,-36.52474999999944,2625.1,26,25,3,51
3503,-1.6575000000000226,2393.375,53,41,5,94
3504,-12.934749999999465,2694.3571428571427,27,27,3,54
3505,18.2982500000014,3306.5555555555557,58,18,0,76
3506,-16.91824999999927,2774.777777777778,46,27,7,73
3507,5.615000000001237,3146.45,47,26,0,73
3508,-17.127500000000065,2009.375,47,30,7,77
3509,1.7072500000008861,3285.3888888888887,56,27,3,83
3510,-11.331249999998738,2409.1666666666665,31,26,2,57
3511,-7.482749999999885,2429.0,34,26,2,60
3512,-10.877999999999254,2741.0588235294117,34,21,3,55
3513,-4.876999999998667,3078.2631578947367,48,21,2,69
3514,0.5715000000005575,2429.0625,45,34,3,79
3515,-12.419499999999234,2580.9375,34,21,1,55
3516,-9.931749999999747,1920.0625,36,37,1,73
3517,22.058750000001748,5004.684210526316,73,26,2,99
3518,24.898500000001043,3898.6315789473683,57,24,2,81
3519,6.402500000001005,2542.1875,49,12,1,61
3520,13.728250000001585,3564.15,65,16,0,81
3521,-2.1737499999985026,4093.4,57,25,1,82
3522,1.3510000000008833,2561.8571428571427,51,21,2,72
3523,-31.534500000000055,1429.0,21,38,2,59
3524,3.996250000000555,3057.315789473684,40,25,3,65
3525,-4.018999999999009,2302.0588235294117,30,25,10,55
3526,-16.732999999999397,2016.3529411764705,25,25,4,50
3527,-4.0712499999992104,2639.176470588235,44,24,1,68
3528,13.836000000001608,4564.05,69,20,1,89
3529,-5.877749999998882,3091.8,51,20,0,71
3530,-2.5674999999991104,3056.25,48,16,5,64
3531,-5.253249999999065,2053.4,48,26,4,74
3532,-21.82174999999927,2880.65,36,24,0,60
3533,12.734250000001202,3916.4,68,21,0,89
3534,1.5435000000008645,3091.8,38,28,1,66
3535,-20.775499999999322,3562.7894736842104,41,32,2,73
3536,-19.85949999999955,2032.25,20,23,3,43
3537,-22.424999999999592,2157.6,18,26,3,44
3538,-16.542249999999555,2011.0,24,26,8,50
3539,2.672250000001229,3312.4,42,25,2,67
3540,-27.934250000000162,1429.0,0,28,11,28
3541,16.614000000001127,2731.625,55,28,1,83
3542,1.4382500000003335,2441.3333333333335,50,24,3,74
3543,15.90500000000126,4239.526315789473,78,23,2,101
3544,-22.951999999999856,2675.5263157894738,34,32,5,66
3545,2.5352500000007248,2186.733333333333,33,29,5,62
3546,-43.89425000000002,1429.0,0,23,10,23
3547,-28.979249999999656,2048.15,15,30,1,45
3548,27.70025000000242,2546.6,74,16,2,90
3549,-19.2232499999991,2824.3,32,24,2,56
3550,2.8717500000005405,3049.8947368421054,52,27,19,79
3551,-6.940749999999873,2196.8125,43,33,2,76
3552,-1.6772499999990202,3245.3684210526317,48,21,0,69
3553,5.95925000000125,2820.0,50,25,6,75
3554,-3.8997499999996967,2429.0,40,32,3,72
3555,-2.327249999998851,3033.2105263157896,46,23,7,69
3556,20.76600000000159,2575.8125,57,31,2,88
3557,-28.366249999999855,2711.4736842105262,30,24,18,54
3558,-9.448499999999619,2469.0588235294117,37,32,2,69
3559,3.990250000001249,2433.705882352941,43,34,4,77
3560,-12.692999999999339,3961.2105263157896,37,51,8,88
3561,-26.12550000000012,1992.611111111111,27,35,4,62
3562,-0.6709999999997328,2503.6315789473683,31,35,9,66
3563,-1.6107499999999333,2630.6153846153848,55,23,17,78
3564,-19.692749999999606,2116.8888888888887,24,25,2,49
3565,12.96125000000105,3527.6315789473683,53,17,3,70
3566,3.5780000000005985,2671.0,65,26,4,91
3567,23.77500000000122,4241.7,71,24,2,95
3568,32.715250000001575,4756.9,69,21,2,90
3569,-12.563749999999228,2425.684210526316,33,24,4,57
3570,10.371250000001336,3631.5,58,21,1,79
3571,-2.4502499999989675,3278.3333333333335,57,30,5,87
3572,22.027750000001873,4141.0,71,16,1,87
3573,-10.396749999999614,2580.9375,25,26,2,51
3574,-5.311999999999151,2638.733333333333,36,23,0,59
3575,29.333500000002413,3585.1176470588234,87,18,2,105
3576,20.890000000002132,3347.0555555555557,73,21,1,94
3577,8.73975000000161,2634.375,54,22,4,76
3578,14.588750000001522,2424.9333333333334,67,24,4,91
3579,-13.448749999999688,1982.157894736842,15,32,10,47
3580,-1.21424999999936,2465.3333333333335,38,27,5,65
3581,17.974500000001076,3999.8,56,26,0,82
3582,7.58875000000035,2205.8125,51,35,2,86
3583,10.978500000001647,4094.95,60,23,0,83
3584,11.442250000001325,3857.65,62,24,2,86
3585,6.188000000001454,3319.0,69,28,2,97
3586,1.3647500000010022,1909.0588235294117,39,24,3,63
3587,-14.353999999999491,2574.4210526315787,35,25,7,60
3588,-8.231999999999406,2033.888888888889,32,29,1,61
3589,15.866000000001012,2790.6666666666665,62,25,2,87
3590,-11.118499999998894,2090.8125,31,25,4,56
3591,15.006250000000628,4022.157894736842,72,19,2,91
3592,6.268500000001271,3876.9473684210525,64,21,3,85
3593,24.550750000000686,4454.45,69,17,1,86
3594,-19.68124999999917,2725.05,32,27,4,59
3595,2.0962500000007767,2779.714285714286,35,21,4,56
3596,21.660250000001373,4145.1,61,24,1,85
3597,-27.865999999998877,1960.75,29,23,4,52
3598,-8.890249999999114,2521.722222222222,29,27,4,56
3599,23.236250000001185,4262.105263157895,66,31,1,97
3600,20.06325000000175,3368.529411764706,68,16,4,84
3601,-24.51699999999926,3286.2,39,28,4,67
3602,-5.65799999999921,3029.7368421052633,44,24,5,68
3603,-12.82724999999931,2679.2,31,23,1,54
3604,-22.730499999999516,2036.1,24,24,1,48
3605,1.9067500000004387,3588.6,47,19,0,66
3606,30.14250000000116,5327.5,79,17,1,96
3607,5.580500000000582,2406.25,43,20,1,63
3608,-3.9969999999992205,2581.0,33,19,1,52
3609,2.1422500000005913,3339.7894736842104,57,24,11,81
3610,-20.184999999999903,2048.15,17,29,2,46
3611,3.426750000000953,2505.5,45,22,1,67
3612,22.131250000001096,4868.05,59,28,1,87
3613,-24.17024999999931,2008.4,20,25,3,45
3614,20.92125000000099,4804.0526315789475,68,31,3,99
3615,-1.6369999999988338,2853.4736842105262,34,31,3,65
3616,6.003000000001711,4518.0,76,24,0,100
3617,6.07175000000082,3655.4,48,26,2,74
3618,4.798250000000797,2776.3888888888887,47,18,0,65
3619,-19.21249999999889,2387.0588235294117,30,50,6,80
3620,-13.015249999999458,1977.2,41,23,6,64
3621,4.540250000001086,2476.625,44,23,4,67
3622,-22.826249999999852,2145.9473684210525,14,28,2,42
3623,18.888000000001064,4647.9473684210525,75,28,1,103
3624,4.154250000000977,3290.95,45,26,0,71
3625,14.034000000000805,4198.15,54,27,1,81
3626,-3.2049999999993304,2306.4444444444443,33,29,8,62
3627,-7.455999999999061,2998.8947368421054,39,27,1,66
3628,-7.132749999999248,2388.764705882353,41,19,4,60
3629,12.823500000000589,4302.105263157895,59,30,3,89
3630,-15.03124999999884,2489.0555555555557,36,30,8,66
3631,-7.489249999999439,2491.6,34,31,13,65
3632,-4.47249999999942,1996.5625,39,25,2,64
3633,-12.60349999999947,2412.294117647059,32,29,5,61
3634,-10.19624999999925,2693.866666666667,35,28,6,63
3635,-2.9489999999991214,3014.0,45,22,0,67
3636,-16.59374999999917,2413.277777777778,29,33,6,62
3637,-9.111499999999308,2544.15,34,19,1,53
3638,27.01525000000159,4640.1,63,21,2,84
3639,2.9382500000016214,4344.15,64,28,2,92
3640,-6.7034999999996385,2621.2631578947367,35,28,8,63
3641,3.073000000000275,2532.705882352941,60,28,5,88
3642,-27.46900000000008,2049.842105263158,20,23,10,43
3643,4.473250000001235,2730.75,56,20,8,76
3644,29.2265000000008,3900.0,73,25,4,98
3645,20.37450000000132,4134.65,56,28,1,84
3646,-8.546249999999324,2492.5789473684213,33,27,1,60
3647,-11.246499999999255,2670.1176470588234,35,21,0,56
3648,14.625750000001634,4268.75,52,27,2,79
3649,-18.25299999999961,2465.0,33,24,8,57
3650,-1.451499999998612,3043.777777777778,48,34,2,82
3651,-7.827499999999612,2917.7894736842104,30,26,4,56
3652,-22.484499999999763,2028.35,13,26,2,39
3653,-4.186499999999625,2095.764705882353,35,29,4,64
3654,25.130750000001978,4176.736842105263,101,28,1,129
3655,-6.819999999999463,2683.8947368421054,29,25,1,54
3656,8.294000000001622,3583.9,61,14,2,75
3657,-19.09149999999969,2008.5,16,29,2,45
3658,-33.222749999999806,2027.2105263157894,24,19,11,43
3659,18.700000000000955,3068.4444444444443,56,35,2,91
3660,-17.043499999999415,2431.5789473684213,34,22,5,56
3661,27.56050000000148,2851.4666666666667,70,23,0,93
3662,-8.374499999998609,3718.0,52,28,3,80
3663,14.607750000002019,1889.375,71,35,1,106
3664,-15.446999999999795,2873.5,37,48,1,85
3665,-15.580499999999052,2294.6470588235293,25,36,0,61
3666,16.953000000002152,2635.5625,61,25,2,86
3667,-4.404999999999517,3569.222222222222,45,39,1,84
3668,14.276000000001295,4101.631578947368,54,28,2,82
3669,-14.305249999999342,2125.5625,24,30,1,54
3670,10.400750000001256,3702.5555555555557,55,35,0,90
3671,31.822250000001315,2787.705882352941,68,14,1,82
3672,-9.575999999999373,2598.75,43,23,2,66
3673,22.648000000002554,5387.8,84,22,0,106
3674,-16.867249999999146,2417.6111111111113,31,29,3,60
3675,4.57675000000087,3033.222222222222,50,28,2,78
3676,5.465000000001807,2986.3888888888887,59,23,2,82
3677,3.3482500000010176,3277.8947368421054,47,25,2,72
3678,-19.227249999999135,2544.15,27,24,2,51
3679,-20.85099999999924,2638.733333333333,28,26,2,54
3680,6.878750000001697,4680.7,54,38,0,92
3681,-52.07200000000002,1429.0,0,28,14,28
3682,-9.600749999999561,2944.5789473684213,39,24,3,63
3683,19.87475000000147,3895.9473684210525,70,26,1,96
3684,22.431000000001617,4391.75,72,17,0,89
3685,23.832000000001063,4528.473684210527,85,20,7,105
3686,-4.651499999999269,3087.4210526315787,39,28,0,67
3687,-14.88049999999983,2387.1176470588234,40,26,0,66
3688,-18.898500000000087,1429.0,32,34,2,66
3689,11.133000000000933,3929.15,62,21,1,83
3690,-15.384999999999271,2233.277777777778,27,25,2,52
3691,16.83400000000174,2517.823529411765,64,17,1,81
3692,-14.359749999999337,2560.0,23,35,1,58
3693,5.18075000000036,4091.5789473684213,59,24,0,83
3694,11.816500000001446,4520.35,61,27,3,88
3695,-2.7397499999992108,3100.684210526316,43,28,2,71
3696,-0.8559999999991239,3480.75,45,27,0,72
3697,4.771000000000802,3659.25,47,20,0,67
3698,-12.001250000000118,1481.9333333333334,31,32,15,63
3699,-41.7022500000001,1429.0,3,39,2,42
3700,20.622000000001893,5429.15,73,25,1,98
3701,-10.324499999998949,3687.05,41,28,1,69
3702,5.589750000001432,2342.6666666666665,39,28,4,67
3703,16.585750000001532,4173.55,60,29,0,89
3704,-2.076249999999219,2426.3333333333335,33,26,8,59
3705,-3.931249999999359,2491.5625,35,24,2,59
3706,-25.7432499999994,2028.3,21,24,2,45
3707,-3.5369999999989132,2953.9444444444443,48,23,0,71
3708,10.469750000001211,3233.05,54,19,2,73
3709,-3.2247499999991076,3104.266666666667,43,25,0,68
3710,17.79200000000142,4459.2,60,25,1,85
3711,-2.867999999998376,4380.6,56,28,3,84
3712,9.32900000000075,2465.277777777778,53,34,4,87
3713,-1.5872499999990362,4025.85,47,31,2,78
3714,7.173250000000685,2682.0,43,23,3,66
3715,1.367000000000528,2487.7894736842104,30,28,0,58
3716,-2.147749999999694,3501.3,44,28,6,72
3717,-5.31224999999927,2576.8947368421054,31,33,5,64
3718,-1.5454999999990506,2384.5,42,32,0,74
3719,-2.436999999998444,2100.9333333333334,46,19,4,65
3720,-4.710749999999623,2054.0,41,18,1,59
3721,24.901500000001924,4068.4444444444443,84,17,1,101
3722,-16.938999999999403,2529.9411764705883,33,27,9,60
3723,41.98575000000169,4434.65,77,23,1,100
3724,-35.271249999999725,2008.4444444444443,17,29,4,46
3725,18.20600000000272,4365.6,73,19,1,92
3726,-12.645249999999317,2373.5555555555557,36,29,2,65
3727,17.82000000000305,2928.705882352941,71,29,4,100
3728,-34.26125000000009,1429.0,4,32,3,36
3729,-12.901000000000128,2032.2222222222222,23,33,0,56
3730,4.908750000000582,3433.315789473684,56,23,4,79
3731,17.111750000001663,3093.0588235294117,64,30,1,94
3732,11.20050000000148,4340.2,70,19,0,89
3733,-0.5904999999987781,2372.0666666666666,58,27,2,85
3734,-4.010499999999072,2743.75,32,36,2,68
3735,21.339750000002148,4609.578947368421,74,31,0,105
3736,-24.54599999999888,1900.5882352941176,27,28,5,55
3737,11.406000000001578,4162.4,58,24,2,82
3738,0.37125000000135805,3048.25,47,26,1,73
3739,12.72250000000186,3811.65,66,27,1,93
3740,-0.4224999999990948,3111.6666666666665,48,35,1,83
3741,14.283000000001408,3328.6111111111113,62,18,0,80
3742,28.956500000000865,4521.9,72,29,1,101
3743,0.8602500000004237,2019.375,52,30,3,82
3744,-9.57849999999976,2643.277777777778,29,32,0,61
3745,-15.052249999999214,2722.294117647059,29,27,0,56
3746,-9.316249999999012,2178.0625,29,28,0,57
3747,-26.78099999999959,2024.3,16,30,0,46
3748,26.904000000000746,3669.684210526316,59,36,1,95
3749,-31.627749999999935,1429.0,14,36,4,50
3750,-33.600249999999846,1429.0,0,36,3,36
3751,31.349250000002066,4110.666666666667,79,28,5,107
3752,6.635250000000989,3335.45,51,18,1,69
3753,8.002750000001145,4173.421052631579,62,27,1,89
3754,-12.734499999998985,2999.6315789473683,42,26,1,68
3755,0.914250000000893,3539.45,48,22,1,70
3756,12.216250000000304,4129.1578947368425,59,27,2,86
3757,0.13400000000076737,4287.1,43,32,1,75
3758,-30.15575000000021,1807.235294117647,23,33,3,56
3759,24.103750000000662,3223.705882352941,65,26,3,91
3760,-8.089249999999817,2004.9444444444443,35,27,0,62
3761,6.7672500000009395,2613.823529411765,51,15,1,66
3762,-1.1037499999989864,2301.0625,37,27,2,64
3763,-2.962999999999363,2543.1875,49,23,3,72
3764,-7.596249999999797,2330.222222222222,44,23,6,67
3765,11.817000000000869,2819.875,65,18,0,83
3766,-24.796749999999953,1429.0,18,38,3,56
3767,10.84425000000071,3434.55,43,24,0,67
3768,16.138750000001686,4870.3,76,19,0,95
3769,29.49950000000201,4991.0,77,21,0,98
3770,-25.882999999999775,1875.5,23,45,0,68
3771,-4.770249999998792,3068.4444444444443,52,20,3,72
3772,16.876000000002087,2957.222222222222,58,31,0,89
3773,-4.614749999999078,2770.3888888888887,49,21,2,70
3774,7.8952500000010275,3599.277777777778,59,35,2,94
3775,-10.717249999999279,2328.5,31,29,2,60
3776,-28.0922499999997,2092.3684210526317,24,25,13,49
3777,4.645750000001572,3403.157894736842,53,26,0,79
3778,1.0897500000006093,2518.3125,56,32,1,88
3779,-23.117499999999556,2032.25,19,34,2,53
3780,14.649500000001106,3468.6666666666665,62,26,0,88
3781,7.788500000001262,3293.7368421052633,54,23,1,77
3782,9.199000000001337,3716.4,55,25,2,80
3783,20.885250000003843,2621.470588235294,89,23,2,112
3784,2.2252500000014814,2999.722222222222,46,35,1,81
3785,-8.06649999999873,3225.1,42,34,0,76
3786,8.612750000002023,2439.0625,59,27,0,86
3787,-4.982749999999177,2492.5,46,21,0,67
3788,20.096000000001872,4722.75,79,18,0,97
3789,15.489250000001238,3147.777777777778,69,31,7,100
3790,0.577250000000494,2420.1875,53,38,5,91
3791,-13.892749999999182,2532.45,28,27,0,55
3792,8.72125000000106,4193.526315789473,64,31,5,95
3793,-3.0117499999989628,2279.5882352941176,50,18,2,68
3794,-2.8672499999993057,3255.785714285714,46,36,1,82
3795,-7.399749999998958,2908.6315789473683,46,18,2,64
3796,2.518000000001043,3683.05,56,26,0,82
3797,11.321250000001942,4446.578947368421,83,24,3,107
3798,-7.13574999999957,2429.0555555555557,35,28,1,63
3799,-33.113749999999925,1933.235294117647,21,38,3,59
3800,-22.085249999999455,2008.45,12,35,0,47
3801,-32.1267499999999,1980.3684210526317,21,28,13,49
3802,7.1012500000015795,4531.0,70,44,1,114
3803,26.47475000000149,4249.0,68,23,3,91
3804,0.4767500000005615,2462.5882352941176,43,21,2,64
3805,-17.24424999999972,2214.4210526315787,23,23,6,46
3806,-1.8154999999984291,3290.4210526315787,55,25,0,80
3807,-6.152999999999449,2580.9375,34,26,0,60
3808,-6.5719999999992975,2584.65,34,25,2,59
3809,-11.470499999999634,2833.8888888888887,40,35,9,75
3810,3.727500000000397,1949.9375,50,28,2,78
3811,12.957000000001894,4221.9,74,20,2,94
3812,8.410250000000833,3110.75,47,17,1,64
3813,-1.6319999999993051,2339.470588235294,51,34,5,85
3814,-25.4417499999994,2028.25,22,21,2,43
3815,-26.280749999999365,2020.25,16,28,0,44
3816,-8.4357499999996,1946.2941176470588,38,30,0,68
3817,26.47575000000172,4160.85,78,15,0,93
3818,-25.612749999999828,2147.6315789473683,17,28,2,45
3819,-17.50774999999934,2713.2,38,21,1,59
3820,-8.753749999999384,2531.3888888888887,41,26,6,67
3821,4.714750000000814,2170.125,49,42,0,91
3822,6.067000000001138,3101.4117647058824,48,30,2,78
3823,24.453250000002267,3369.1666666666665,76,17,0,93
3824,1.5310000000009978,3828.2,48,32,0,80
3825,12.41325000000029,1818.0,48,25,1,73
3826,32.27425000000182,4821.2,81,20,0,101
3827,6.930250000001135,4159.2,63,13,0,76
3828,23.20775000000094,5260.05,79,24,0,103
3829,4.446000000000906,3072.3684210526317,61,24,2,85
3830,7.035500000001726,2517.764705882353,52,28,3,80
3831,1.597250000001461,2612.625,56,18,3,74
3832,-5.841499999999176,2559.3684210526317,37,27,4,64
3833,37.16050000000091,3552.6666666666665,72,15,4,87
3834,20.591000000002573,4049.842105263158,94,16,4,110
3835,-14.570999999999938,2019.7894736842106,26,24,10,50
3836,-28.102249999999117,2008.35,23,25,0,48
3837,-6.633999999999354,1996.5,52,32,5,84
3838,2.8730000000006215,2706.3529411764707,58,37,0,95
3839,17.259000000001105,3556.1111111111113,60,20,0,80
3840,1.772000000001055,3743.3,51,26,0,77
3841,-23.80249999999961,1896.0,22,32,2,54
3842,-5.397499999998992,3083.85,41,26,2,67
3843,4.85375000000135,3633.7894736842104,60,28,2,88
3844,-23.622249999999365,2571.8888888888887,39,28,0,67
3845,5.442750000000632,2334.8333333333335,37,25,2,62
3846,8.136000000001001,3187.9,49,23,1,72
3847,10.099250000001202,3548.1,61,15,0,76
3848,2.742750000001737,2719.470588235294,60,31,1,91
3849,-2.893249999999843,2575.4444444444443,46,41,2,87
3850,-36.25600000000015,1429.0,4,43,4,47
3851,-15.015499999999502,2713.0,31,27,7,58
3852,-29.685499999999642,2020.25,20,23,2,43
3853,-7.000999999999077,3129.3333333333335,48,23,0,71
3854,-13.847249999999624,1862.3529411764705,30,32,4,62
3855,0.7152500000005665,2341.294117647059,50,25,1,75
3856,-1.5322499999997095,2544.8823529411766,39,25,3,64
3857,-7.119749999999117,2580.9375,32,23,0,55
3858,-5.4504999999989225,2577.7368421052633,37,24,0,61
3859,-7.31674999999903,2566.0,43,18,1,61
3860,-17.494499999999263,2737.75,29,25,2,54
3861,-8.992999999999103,2613.15,40,21,0,61
3862,-20.725249999999455,2815.0,33,33,12,66
3863,-10.578249999999553,2423.777777777778,28,35,6,63
3864,0.7057500000018286,2927.4444444444443,53,28,0,81
3865,24.44650000000171,4341.05,75,19,0,94
3866,16.885500000002317,2833.294117647059,66,19,1,85
3867,-2.641999999999107,3443.2631578947367,57,29,2,86
3868,11.498750000001237,4827.578947368421,74,23,5,97
3869,-6.604249999999331,2370.176470588235,38,29,0,67
3870,13.203000000000904,3655.3,46,27,0,73
3871,-7.151999999999586,2568.0,31,24,1,55
3872,-5.053749999998724,2537.470588235294,43,26,1,69
3873,12.170750000001595,3607.65,61,15,1,76
3874,21.698750000001656,5064.05,78,17,1,95
3875,16.38900000000075,3429.222222222222,63,24,2,87
3876,37.5087500000021,5043.35,77,22,0,99
3877,-4.656249999999684,2223.8125,38,32,1,70
3878,-9.928749999999706,2021.9411764705883,31,37,3,68
3879,13.540000000000536,2246.5625,62,22,1,84
3880,33.201750000001454,4127.45,66,27,1,93
3881,-10.674999999999484,2536.1052631578946,25,35,1,60
3882,-24.24699999999975,2008.5,13,28,1,41
3883,-20.254000000000225,1429.0,29,54,2,83
3884,-7.258249999998386,4176.7,54,31,0,85
3885,2.9137500000011785,3042.6470588235293,63,34,0,97
3886,2.2297500000011516,4286.15,63,27,0,90
3887,-4.846749999998666,2623.9444444444443,43,35,2,78
3888,19.451000000001738,3576.157894736842,72,26,6,98
3889,-11.081750000000078,2294.1666666666665,31,34,2,65
3890,11.042500000000858,3661.9444444444443,56,24,0,80
3891,1.1770000000008816,3575.1,39,32,1,71
3892,-3.9257499999980694,3762.55,61,21,0,82
3893,14.379999999999777,2429.0625,59,29,2,88
3894,-8.509499999999742,2607.7894736842104,39,32,1,71
3895,16.13725000000089,3631.2105263157896,60,20,0,80
3896,-10.64274999999946,2875.2,29,28,3,57
3897,-2.2639999999989393,3143.25,49,20,3,69
3898,6.640250000001177,3079.9,53,14,1,67
3899,4.742500000002179,4077.1176470588234,56,29,0,85
3900,-4.050499999999494,2514.866666666667,51,35,4,86
3901,-19.894749999998844,3941.7,48,37,0,85
3902,38.28775000000193,5915.55,96,15,0,111
3903,-11.364499999999369,2668.222222222222,31,22,2,53
3904,-13.495249999999649,2530.9473684210525,40,20,1,60
3905,5.398250000000777,3282.4,42,25,1,67
3906,3.466500000000509,2528.3,28,29,0,57
3907,15.625750000000831,3905.3333333333335,67,38,0,105
3908,-22.561999999999706,2044.15,16,27,0,43
3909,-13.139249999998956,2536.722222222222,32,25,5,57
3910,4.022250000000673,3261.5,50,28,0,78
3911,16.751250000001242,4310.1,66,19,1,85
3912,2.265000000001093,2588.6470588235293,42,35,0,77
3913,-1.2422499999984438,3591.2631578947367,61,17,2,78
3914,-31.716999999999736,1980.3157894736842,22,29,6,51
3915,4.188000000002542,2628.6875,57,29,0,86
3916,13.484750000000847,3720.7368421052633,54,20,2,74
3917,-14.809749999999692,1984.6842105263158,18,28,0,46
3918,-10.591749999999566,2526.9444444444443,36,26,1,62
3919,-29.62074999999961,2012.7777777777778,33,20,9,53
3920,5.6260000000011505,2915.5882352941176,54,32,2,86
3921,-33.17674999999943,2462.5263157894738,27,28,3,55
3922,18.09700000000111,2561.785714285714,61,33,0,94
3923,-18.070999999999128,2556.0,34,21,0,55
3924,-32.2467499999991,2003.0,18,31,0,49
3925,-17.451249999999206,3498.15,35,33,0,68
3926,9.044000000001114,3002.3333333333335,50,20,3,70
3927,-21.314999999999245,2202.8,25,28,0,53
3928,4.9725000000007915,3524.4444444444443,49,32,0,81
3929,-0.4504999999986074,2072.9444444444443,39,29,0,68
3930,18.307500000001426,5245.75,65,28,0,93
3931,-26.549749999999012,2508.45,32,22,0,54
3932,16.249500000002055,3971.2631578947367,76,19,1,95
3933,5.707250000001385,3879.0,56,24,0,80
3934,-7.83249999999922,3505.3,46,32,0,78
3935,-13.362999999999479,1930.0,26,25,1,51
3936,4.08825000000109,3095.7,48,22,0,70
3937,5.154000000001082,2989.0,42,23,1,65
3938,-13.801749999999021,2815.157894736842,39,28,2,67
3939,-18.203249999999166,2068.5882352941176,25,23,1,48
3940,-14.96974999999784,2677.5,44,29,3,73
3941,5.539500000001084,2988.7368421052633,57,22,1,79
3942,7.583250000000983,3012.157894736842,52,15,7,67
3943,10.142500000000776,3855.8888888888887,63,32,2,95
3944,-14.71449999999957,2028.2,20,29,0,49
3945,15.982000000000625,3284.4444444444443,54,18,0,72
3946,13.316500000001028,3816.4,58,18,1,76
3947,-24.32299999999957,2024.3,21,28,0,49
3948,4.6227500000012505,3611.5555555555557,67,31,1,98
3949,-19.02374999999926,3410.0,31,34,0,65
3950,23.772250000000877,4798.05,77,29,0,106
3951,32.1077500000009,3484.3684210526317,79,14,2,93
3952,-39.756250000000676,1429.0,7,29,22,36
3953,-10.037749999999168,2488.3333333333335,31,33,0,64
3954,-9.282249999999621,2595.722222222222,31,40,0,71
3955,6.143250000001196,3502.7368421052633,50,30,1,80
3956,-18.00924999999969,2053.3888888888887,19,33,0,52
3957,13.094500000000599,2714.705882352941,56,16,0,72
3958,-12.475999999999587,2727.45,30,28,0,58
3959,3.1955000000005382,3042.2631578947367,44,23,4,67
3960,-13.62574999999947,2696.4210526315787,42,21,1,63
3961,9.925250000000945,3263.9,53,17,0,70
3962,-1.969999999999827,2047.0588235294117,47,29,0,76
3963,-5.415749999998826,3444.9444444444443,52,39,2,91
3964,4.921750000001375,3801.3,60,13,0,73
3965,14.022500000001012,3553.6315789473683,66,28,6,94
3966,22.462000000001154,4684.7,64,29,1,93
3967,5.118750000000583,3127.5,54,23,1,77
3968,-0.7097499999985786,2537.0666666666666,45,27,0,72
3969,-29.214749999999704,1952.0,15,28,4,43
3970,-0.22474999999936793,2533.866666666667,46,25,1,71
3971,23.11600000000014,2089.8125,75,22,1,97
3972,12.54650000000112,4729.05,74,20,1,94
3973,26.84050000000252,2963.9375,78,19,2,97
3974,-24.577999999999328,2136.2,19,32,1,51
3975,3.9762500000008614,3285.3333333333335,50,22,1,72
3976,-6.9824999999992725,2351.529411764706,48,26,4,74
3977,5.51350000000039,2152.6470588235293,34,27,0,61
3978,-16.03399999999896,2504.8888888888887,37,28,3,65
3979,-7.4424999999992085,2744.75,29,31,0,60
3980,1.484250000000527,3179.15,49,23,1,72
3981,15.121750000001592,4243.4,67,24,1,91
3982,-24.772749999999895,2272.6,18,26,2,44
3983,14.371000000000773,3775.25,53,21,0,74
3984,-16.007499999999776,2756.266666666667,50,22,18,72
3985,4.758750000000925,2671.5555555555557,41,24,1,65
3986,18.09950000000171,3099.529411764706,60,33,0,93
3987,-5.259249999999274,3127.6,49,21,0,70
3988,-3.4589999999995884,2502.5789473684213,34,32,2,66
3989,-5.048249999998825,3040.5789473684213,47,28,2,75
3990,-12.49049999999919,2181.222222222222,28,31,2,59
3991,-1.2937499999991773,3233.05,44,32,0,76
3992,11.88850000000036,3190.1666666666665,59,27,0,86
3993,-14.58799999999997,1429.0,27,37,2,64
3994,3.5515000000004013,3049.0526315789475,43,25,1,68
3995,19.319250000001162,4050.6315789473683,69,26,3,95
3996,12.471750000000839,3516.4444444444443,71,21,0,92
3997,-17.013999999999303,2672.2105263157896,29,24,3,53
3998,7.359500000000911,2990.294117647059,59,25,1,84
3999,9.828250000001011,3693.5555555555557,83,27,4,110
4000,-0.9772499999990985,2538.4444444444443,39,19,2,58
4001,-5.625499999998686,2632.3333333333335,44,28,2,72
4002,3.213250000001048,2541.3571428571427,48,27,5,75
4003,-1.265499999998506,3810.05,67,15,0,82
4004,17.87725000000092,4072.3684210526317,65,22,1,87
4005,26.761750000000706,3579.875,79,17,0,96
4006,4.888750000000089,2648.266666666667,41,30,1,71
4007,-23.776000000000344,1952.8333333333333,36,38,4,74
4008,24.526750000001403,4733.8,69,24,2,93
4009,-18.968999999998918,2779.15,33,30,1,63
4010,0.3467500000008199,3140.0526315789475,45,28,3,73
4011,10.956500000001048,2992.1176470588234,50,24,1,74
4012,-6.584249999999083,2364.5625,41,17,4,58
4013,-4.400999999999273,2780.75,36,24,0,60
4014,-17.621999999999122,2303.0,31,35,1,66
4015,6.969000000001095,2795.125,54,23,2,77
4016,-21.257999999999015,1719.6875,33,34,8,67
4017,-16.819999999999123,2680.4210526315787,34,27,1,61
4018,28.207500000000522,2201.9375,62,21,1,83
4019,-2.5157499999989392,2167.5882352941176,46,17,3,63
4020,19.14475000000117,3630.1666666666665,69,19,0,88
4021,-13.984749999999346,2500.157894736842,33,26,0,59
4022,6.256250000001322,3376.277777777778,55,24,4,79
4023,10.20625000000093,2496.235294117647,50,43,0,93
4024,16.89025000000072,3325.9444444444443,56,16,0,72
4025,43.54800000000277,3817.4117647058824,95,11,0,106
4026,3.576500000001574,4342.55,58,25,0,83
4027,12.036250000001626,3404.8947368421054,60,21,0,81
4028,-10.000499999998851,2584.1176470588234,37,32,3,69
4029,-7.2099999999985185,2432.0625,46,19,2,65
4030,14.421750000001216,2561.8571428571427,63,30,2,93
4031,10.99375000000086,4168.8,53,26,0,79
4032,33.385250000001186,2585.875,65,29,2,94
4033,16.988750000001932,4376.7,77,17,0,94
4034,-5.286249999998923,3176.0,45,24,0,69
4035,-18.99749999999957,2198.4210526315787,21,31,3,52
4036,-3.228249999999162,2523.3125,33,32,0,65
4037,2.1190000000010887,2518.3125,46,40,1,86
4038,22.994750000001986,4028.25,76,10,0,86
4039,-0.3602499999993585,3416.4,41,31,1,72
4040,-0.8127499999992931,2438.125,40,31,1,71
4041,-12.561499999999384,2576.5882352941176,28,26,4,54
4042,20.035000000001375,3572.0,58,23,1,81
4043,15.064250000002161,3737.8,61,20,3,81
4044,8.671750000000305,2521.3125,59,24,2,83
4045,1.2175000000008274,2691.125,35,25,0,60
4046,15.787500000000488,2463.0666666666666,57,22,2,79
4047,-5.849249999999498,2714.8333333333335,30,35,0,65
4048,-15.212249999999596,2538.4210526315787,36,27,13,63
4049,11.618500000001521,5145.0,80,20,1,100
4050,27.001250000001242,3490.823529411765,74,11,2,85
4051,-10.961999999999488,2629.2,33,25,3,58
4052,-16.678749999999262,2618.75,34,23,3,57
4053,3.116750000000966,3633.05,46,32,1,78
4054,3.7757500000013535,2748.294117647059,48,24,4,72
4055,-6.88924999999917,2528.35,32,22,0,54
4056,-10.736499999999161,2479.470588235294,29,29,0,58
4057,-7.3742499999988596,2703.8947368421054,40,27,5,67
4058,4.250500000000406,2795.6153846153848,36,21,1,57
4059,15.647250000001279,3904.4,61,25,0,86
4060,16.947750000002763,4862.4,79,28,0,107
4061,7.188000000001132,3693.35,47,30,0,77
4062,19.484750000000673,2966.823529411765,53,27,0,80
4063,31.73925000000198,3063.1176470588234,69,20,0,89
4064,-24.399749999999575,2028.2,18,25,1,43
4065,21.596249999999966,4185.210526315789,66,22,4,88
4066,-15.86924999999919,3106.85,30,29,2,59
4067,11.362750000000432,3793.35,44,32,0,76
4068,7.768000000001068,3081.777777777778,51,28,1,79
4069,1.5477500000003448,2770.4444444444443,40,32,1,72
4070,-30.886999999999897,1429.0,0,36,5,36
4071,-8.98574999999921,2560.05,34,16,6,50
4072,-10.988499999999362,2652.157894736842,37,30,3,67
4073,-10.945499999998997,2491.842105263158,37,21,3,58
4074,36.532750000001485,2993.5625,83,23,0,106
4075,16.348250000001503,3898.9,55,37,0,92
4076,-23.748749999999248,2495.3333333333335,34,28,2,62
4077,-15.618749999999363,2711.9375,26,23,3,49
4078,19.052000000001964,4440.2,73,22,0,95
4079,8.723500000002312,2515.375,61,27,0,88
4080,3.882500000001527,3652.157894736842,66,18,2,84
4081,5.753500000001138,3508.4736842105262,53,27,0,80
4082,-5.627749999999404,3401.35,39,27,0,66
4083,-7.13699999999916,2656.0588235294117,47,29,2,76
4084,18.970000000001704,4139.35,66,31,0,97
4085,14.649000000001934,4155.2,67,26,0,93
4086,-8.111749999998702,2295.9444444444443,37,31,2,68
4087,-2.886499999999077,2564.0,47,22,2,69
4088,-26.19474999999955,1986.3684210526317,17,29,2,46
4089,7.370000000000836,3611.7,52,22,2,74
4090,-2.604499999998518,4145.75,49,37,0,86
4091,-16.31524999999938,2492.6315789473683,29,28,1,57
4092,-2.3529999999994256,2610.6875,53,27,1,80
4093,-3.639999999999234,3563.5263157894738,44,25,1,69
4094,-5.242749999998514,3171.0,48,22,3,70
4095,-15.264749999999498,2351.529411764706,49,24,2,73
4096,-9.987999999999323,2737.0,40,29,2,69
4097,16.406500000001785,3234.222222222222,59,26,1,85
4098,9.975750000001028,2405.25,50,26,2,76
4099,9.46075000000118,4641.85,61,26,0,87
4100,-13.867249999999169,3862.45,36,30,3,66
4101,-27.54999999999969,1429.0,11,32,2,43
4102,25.6865000000022,4704.45,66,33,3,99
4103,1.1095000000012956,3000.5882352941176,51,41,1,92
4104,-9.873499999998865,2050.777777777778,50,29,4,79
4105,-6.328499999999674,2521.375,35,26,1,61
4106,3.0842500000010715,3378.157894736842,51,28,1,79
4107,-33.13500000000015,1429.0,16,37,2,53
4108,-27.070749999999816,1884.3125,33,33,5,66
4109,13.19600000000203,4139.1578947368425,79,21,0,100
4110,23.414000000000858,2954.9411764705883,57,22,2,79
4111,24.033250000000685,2072.4666666666667,62,27,8,89
4112,-9.159999999999279,2556.05,33,24,0,57
4113,-17.136999999999787,1958.111111111111,27,25,5,52
4114,0.8132500000007079,3197.4,45,23,0,68
4115,-31.433249999999475,2076.4736842105262,15,30,2,45
4116,-32.25649999999955,2028.25,14,28,3,42
4117,5.8340000000012635,4540.2,67,27,2,94
4118,-28.63499999999994,2040.15,13,28,2,41
4119,11.96150000000178,3722.0,67,20,2,87
4120,32.403000000001825,4506.95,74,18,1,92
4121,-0.31274999999934117,2403.4444444444443,46,25,5,71
4122,-10.426999999999307,2461.684210526316,33,24,0,57
4123,-17.080999999999637,2008.45,16,31,1,47
4124,18.671250000002335,2842.777777777778,63,22,0,85
4125,2.9967500000014975,4485.5,59,23,0,82
4126,4.198250000001934,4682.3,63,34,0,97
4127,12.444000000001378,3269.529411764706,64,33,1,97
4128,-13.873249999999643,2515.9473684210525,29,28,1,57
4129,-7.725249999999498,2524.3333333333335,37,38,1,75
4130,-18.18749999999949,2048.15,19,28,3,47
4131,19.043000000000408,2365.6875,50,34,1,84
4132,5.831000000000424,3044.6111111111113,51,28,6,79
4133,23.865750000001064,3479.764705882353,63,27,0,90
4134,35.974750000001976,2967.823529411765,74,12,1,86
4135,19.686750000001616,4694.95,76,22,0,98
4136,-26.64224999999923,2530.9473684210525,35,23,2,58
4137,8.866250000001738,4953.65,59,37,1,96
4138,-3.3262499999998085,2411.4444444444443,45,28,3,73
4139,-31.235499999999746,2129.15,17,25,3,42
4140,25.054750000001558,4626.05,73,20,2,93
4141,23.812250000000837,3050.25,83,19,3,102
4142,-3.6327499999996578,2633.285714285714,34,24,1,58
4143,-5.368999999999018,2539.25,40,24,0,64
4144,0.024000000000598386,3482.2,32,35,1,67
4145,-32.14399999999948,2028.35,18,27,3,45
4146,22.696750000001764,5434.7,88,20,0,108
4147,-2.1527499999991546,3314.7,44,26,0,70
4148,-2.852249999999369,2508.4444444444443,37,29,1,66
4149,0.9697500000011207,3277.842105263158,48,30,0,78
4150,18.53450000000108,3116.5625,65,29,0,94
4151,-3.51074999999909,3968.75,62,19,0,81
4152,1.4755000000001828,2533.866666666667,42,39,0,81
4153,26.015750000001436,4267.9473684210525,78,34,4,112
4154,10.897750000000988,3471.3888888888887,58,19,2,77
4155,-12.084249999998876,2513.176470588235,35,28,1,63
4156,-0.997249999999023,3075.95,46,22,1,68
4157,0.3012500000011425,2173.294117647059,48,29,2,77
4158,-17.02524999999968,2123.2631578947367,22,26,1,48
4159,-6.028249999997433,2396.4444444444443,52,30,3,82
4160,-13.840499999998958,2665.4210526315787,34,30,0,64
4161,-3.3364999999993876,2066.8823529411766,34,26,1,60
4162,1.088500000000844,3071.8333333333335,46,32,0,78
4163,-30.799499999999732,1429.0,11,34,3,45
4164,8.623000000000323,2563.529411764706,46,26,0,72
4165,16.123750000001312,3909.8333333333335,59,26,1,85
4166,-4.042499999999118,2500.5,37,22,0,59
4167,1.3197500000011548,2674.5882352941176,46,28,1,74
4168,11.671750000001223,4222.75,72,20,1,92
4169,-15.969499999999261,2546.4444444444443,32,22,1,54
4170,-8.214249999999058,2509.4117647058824,38,23,2,61
4171,2.940750000000481,2313.1176470588234,51,26,2,77
4172,-5.59374999999943,2633.285714285714,35,31,0,66
4173,5.361250000000741,2492.6111111111113,36,29,0,65
4174,-11.920249999999049,3713.3,38,30,0,68
4175,-4.718999999999335,3125.157894736842,49,20,0,69
4176,7.4265000000014485,3319.777777777778,57,27,0,84
4177,-0.3242499999996175,2064.0,34,21,1,55
4178,14.312000000001015,2548.9444444444443,48,25,2,73
4179,30.981500000001386,5086.2,70,27,0,97
4180,-1.665999999999021,2570.1111111111113,36,29,2,65
4181,7.634250000001414,2800.25,52,28,2,80
4182,-26.647999999999417,2349.7,19,29,2,48
4183,-12.955749999999437,2251.8888888888887,27,23,3,50
4184,-15.119249999999388,3043.8947368421054,39,27,1,66
4185,16.252500000001596,2614.625,74,19,0,93
4186,-28.827749999999686,1929.5294117647059,26,20,8,46
4187,7.421500000001259,3816.5789473684213,54,23,0,77
4188,-0.2117499999991627,3511.684210526316,47,35,2,82
4189,20.83100000000089,4367.95,56,23,2,79
4190,7.463000000001827,4663.3,73,30,0,103
4191,-9.641999999999706,2645.9,28,28,0,56
4192,2.448250000000536,3421.6315789473683,48,26,1,74
4193,3.257000000000699,2955.6111111111113,44,28,0,72
4194,-5.100999999998747,2866.5,56,30,1,86
4195,-9.091999999999732,2578.1666666666665,35,20,1,55
4196,-5.425249999998863,2528.3,30,27,2,57
4197,22.831250000000676,2642.285714285714,71,21,1,92
4198,-12.208999999999266,2496.294117647059,33,26,0,59
4199,3.824000000000212,3170.35,40,17,0,57
4200,9.820000000001292,3619.55,57,24,0,81
4201,5.865000000000759,3785.0,53,41,2,94
4202,5.010750000001442,1901.5294117647059,40,29,0,69
4203,0.45025000000113397,3643.3,50,28,0,78
4204,-32.279999999999724,2179.15,14,33,1,47
4205,32.054250000000906,2444.0,69,24,2,93
4206,15.052000000001252,3875.2631578947367,66,27,1,93
4207,-11.57224999999906,2548.15,31,24,0,55
4208,10.336250000000675,3014.9473684210525,51,19,1,70
4209,9.920750000000968,3718.85,48,25,1,73
4210,-8.673499999999501,2563.125,25,28,1,53
4211,-19.5557499999997,2008.8947368421052,14,31,1,45
4212,17.877000000001278,4448.95,65,23,0,88
4213,19.83900000000182,4853.75,69,26,0,95
4214,12.338250000001027,3333.8888888888887,58,19,0,77
4215,2.0760000000013528,4071.15,43,32,1,75
4216,-33.368249999999,1986.2631578947369,15,27,9,42
4217,-2.922999999998852,2708.8947368421054,37,35,0,72
4218,15.183750000000733,3933.15,57,31,0,88
4219,-3.553749999998563,3154.230769230769,43,42,0,85
4220,27.132750000001174,4127.5,70,14,1,84
4221,-23.289750000000033,2102.722222222222,20,32,9,52
4222,7.199250000000804,2873.5,50,28,1,78
4223,-17.31724999999972,1429.0,16,33,0,49
4224,6.00124999999988,1879.1176470588234,50,25,7,75
4225,-13.429249999999575,3200.6,36,39,0,75
4226,18.06925000000084,2348.75,62,27,0,89
4227,-16.741249999999944,1941.3333333333333,21,25,4,46
4228,-4.971749999998886,2005.1764705882354,44,29,2,73
4229,-16.622499999999157,2280.75,27,28,2,55
4230,-4.658499999999288,3673.7894736842104,51,30,1,81
4231,-5.018499999999262,1848.625,43,32,0,75
4232,19.275250000001435,4352.15,69,28,0,97
4233,6.491500000000559,2541.1875,52,31,0,83
4234,0.1160000000002774,3346.1666666666665,51,23,4,74
4235,0.37550000000074035,2450.705882352941,44,38,9,82
4236,2.1997500000010857,3029.133333333333,49,25,1,74
4237,-0.41899999999889753,2250.5625,50,38,0,88
4238,-20.792749999999586,2028.25,18,29,0,47
4239,28.52075000000152,4852.1,86,14,1,100
4240,13.429500000000463,3532.842105263158,49,25,0,74
4241,10.242000000001621,2691.8333333333335,56,18,1,74
4242,-3.9192499999993045,2491.625,41,29,1,70
4243,-6.554499999999277,2726.0,39,42,2,81
4244,-2.9034999999996742,2982.9473684210525,36,31,0,67
4245,-7.156749999999192,2595.294117647059,36,23,1,59
4246,-11.079999999999192,2348.6875,51,32,2,83
4247,-7.899499999999767,2436.8333333333335,38,33,1,71
4248,-7.406249999999124,2998.7894736842104,41,29,3,70
4249,-12.578749999999134,2511.222222222222,35,26,1,61
4250,-21.3674999999999,2500.4444444444443,23,31,0,54
4251,-2.6577499999990217,3775.15,47,32,0,79
4252,-3.082999999999152,3385.35,41,27,1,68
4253,11.98800000000189,3667.277777777778,75,33,1,108
4254,-14.65574999999878,2139.375,46,38,1,84
4255,-2.6144999999995386,2495.1666666666665,63,25,4,88
4256,5.543750000000678,2684.3571428571427,52,26,0,78
4257,-32.83400000000003,1429.0,1,33,5,34
4258,-6.830249999999635,2952.8888888888887,52,27,0,79
4259,-1.4757499999988333,2433.9411764705883,50,27,4,77
4260,20.366000000000703,2128.3529411764707,63,21,2,84
4261,0.4272500000010592,2491.625,42,25,2,67
4262,-25.441499999999486,1884.375,21,38,1,59
4263,-15.05799999999951,2571.875,38,27,0,65
4264,-42.13424999999985,1429.0,2,33,2,35
4265,5.639000000002083,2838.9411764705883,63,20,1,83
4266,-23.55399999999969,2134.157894736842,18,32,2,50
4267,-7.3457499999993825,1853.625,49,29,3,78
4268,10.145250000000207,2255.4375,60,30,2,90
4269,-17.697999999999535,2056.8888888888887,20,28,3,48
4270,15.701000000001699,3831.5,74,16,0,90
4271,-28.014249999999628,2068.9473684210525,24,26,4,50
4272,-15.559999999999315,2020.1176470588234,25,29,2,54
4273,11.726250000001942,4883.85,83,26,3,109
4274,-4.904999999999323,2521.529411764706,35,20,0,55
4275,22.697500000000794,4111.65,65,10,0,75
4276,1.5992500000011334,2697.176470588235,46,23,0,69
4277,2.553750000000783,1867.0666666666666,61,27,1,88
4278,3.1012500000010266,3114.2105263157896,44,22,0,66
4279,-3.264249999999408,2525.9473684210525,31,23,1,54
4280,7.901500000000455,2351.529411764706,61,28,3,89
4281,19.147750000001587,4525.05,63,24,2,87
4282,27.48575000000187,3866.0,86,25,0,111
4283,-32.635499999999986,2087.722222222222,18,39,6,57
4284,-26.213249999999608,2040.1,19,24,2,43
4285,-25.07799999999962,2028.3,15,26,7,41
4286,-2.929499999999246,2932.0526315789475,45,22,1,67
4287,0.340500000001611,4186.3,55,24,1,79
4288,0.7047499999999781,1960.8125,67,20,1,87
4289,15.496000000002178,3304.6666666666665,83,28,0,111
4290,11.287000000000543,2602.733333333333,45,24,0,69
4291,-6.534999999999218,2573.6666666666665,31,27,5,58
4292,15.688000000001654,4330.65,70,17,0,87
4293,21.46925000000267,4430.7,81,19,1,100
4294,29.442750000001713,4688.8421052631575,98,28,3,126
4295,17.830000000000982,3380.75,58,17,1,75
4296,33.20500000000088,4190.944444444444,85,16,0,101
4297,-3.2969999999995117,3055.842105263158,43,17,1,60
4298,29.253750000001496,2642.375,63,25,1,88
4299,-17.553749999999326,2023.375,28,28,1,56
4300,-10.261249999998883,3024.3888888888887,45,33,1,78
4301,4.243250000000285,2496.8888888888887,53,23,2,76
4302,11.762250000000988,3995.4736842105262,62,16,2,78
4303,-17.25624999999939,2202.1176470588234,33,35,1,68
4304,26.848250000001162,4798.2,82,18,0,100
4305,20.414250000001356,4390.3,69,27,0,96
4306,2.884250000001328,2744.705882352941,61,15,1,76
4307,-21.99700000000016,1857.7058823529412,34,43,2,77
4308,-5.874749999998287,3817.85,62,31,0,93
4309,1.5977500000007696,3218.0,40,20,4,60
4310,-9.19174999999927,2471.0526315789475,29,30,3,59
4311,34.3875000000032,3903.5555555555557,83,22,4,105
4312,-0.7794999999987074,3135.45,46,25,0,71
4313,22.88775000000187,4081.684210526316,80,14,1,94
4314,-8.457999999999437,1916.3529411764705,48,47,1,95
4315,24.906250000001258,4374.4,72,19,0,91
4316,8.933500000001192,3567.95,51,30,0,81
4317,31.62900000000179,4139.35,75,22,0,97
4318,6.643750000000429,2068.0,56,32,15,88
4319,0.31349999999992095,1809.0625,38,25,8,63
4320,26.39675000000269,3051.125,80,22,4,102
4321,4.549750000002051,2247.4444444444443,50,25,1,75
4322,10.134750000001961,3322.6470588235293,64,32,2,96
4323,6.3507500000010975,3325.1111111111113,57,19,1,76
4324,-10.88874999999925,2715.0833333333335,45,30,3,75
4325,-10.177999999998423,4370.25,56,19,5,75
4326,-8.613499999998968,2548.15,38,19,3,57
4327,21.712750000000405,4016.3888888888887,63,27,3,90
4328,-21.5579999999991,2059.0,22,32,2,54
4329,-7.03899999999974,2882.8571428571427,32,36,11,68
4330,5.332750000001463,2805.529411764706,50,18,3,68
4331,-17.219249999999683,2041.111111111111,20,27,3,47
4332,9.007250000000834,3111.6,48,18,0,66
4333,8.674500000001474,3699.0,62,30,2,92
4334,-3.8432499999986502,3056.15,44,30,1,74
4335,-16.84474999999901,2901.722222222222,35,30,1,65
4336,3.2617500000010002,2782.0,43,35,0,78
4337,-0.3642499999992249,2528.25,55,27,17,82
4338,7.849250000001088,4203.7,58,19,0,77
4339,18.57325000000113,4288.55,63,17,0,80
4340,16.84375000000088,3749.1666666666665,62,22,0,84
4341,30.92400000000145,4365.578947368421,77,22,1,99
4342,-2.750499999999628,2402.25,54,37,4,91
4343,0.6947500000008572,2253.4375,42,29,0,71
4344,-17.255999999998604,2610.133333333333,46,40,0,86
4345,12.11750000000146,2687.8125,53,28,2,81
4346,7.6625000000010175,2984.6666666666665,48,32,3,80
4347,-22.70824999999974,2032.25,12,36,0,48
4348,11.158000000002302,4262.0,66,27,1,93
4349,-16.59149999999935,2665.5263157894738,29,29,1,58
4350,-24.83474999999978,1946.9375,23,41,0,64
4351,-11.911499999999595,1884.375,29,35,0,64
4352,2.214000000001165,2980.222222222222,47,27,1,74
4353,-5.449999999999165,3086.2,39,26,2,65
4354,14.047250000001776,3960.4736842105262,64,18,2,82
4355,-7.83049999999893,2830.277777777778,47,19,1,66
4356,11.360500000000716,3844.15,58,19,0,77
4357,-7.451249999999199,2234.1666666666665,33,25,4,58
4358,29.653750000001185,4143.45,59,21,0,80
4359,-8.394249999999353,2723.4,42,26,3,68
4360,9.490250000000994,3770.9333333333334,42,24,1,66
4361,11.700749999999955,2355.75,44,26,1,70
4362,44.40525000000282,5275.95,83,30,0,113
4363,-4.381999999999095,3302.0526315789475,41,28,1,69
4364,-21.858499999999832,2150.55,16,35,3,51
4365,2.99625000000078,2827.6666666666665,42,33,1,75
4366,30.60700000000146,4925.95,78,19,2,97
4367,22.418250000001734,4143.5,78,14,0,92
4368,17.029750000001204,2504.5,53,21,1,74
4369,-0.4137499999988192,2955.6111111111113,48,23,1,71
4370,24.310750000001395,3663.8947368421054,56,32,1,88
4371,-11.645749999999406,2620.5882352941176,31,24,0,55
4372,-15.375249999999273,2458.2631578947367,28,27,6,55
4373,8.405000000001342,2774.5882352941176,49,21,2,70
4374,28.682500000001443,3443.1176470588234,78,23,0,101
4375,-23.095749999999786,1909.6666666666667,16,31,2,47
4376,17.079750000001052,4187.85,56,38,0,94
4377,13.458750000001459,4068.315789473684,61,25,1,86
4378,-5.895749999998712,2610.133333333333,35,29,0,64
4379,-16.668749999999513,2537.6111111111113,30,31,0,61
4380,25.727500000000628,4491.736842105263,94,26,2,120
4381,-1.1597499999990872,3508.4444444444443,51,29,0,80
4382,-2.845749999999295,3314.85,38,31,0,69
4383,2.4745000000013,3214.4210526315787,53,23,0,76
4384,-5.700749999999051,2333.875,44,37,4,81
4385,-12.342749999999157,2210.529411764706,24,29,2,53
4386,2.3342500000007735,3215.7,44,19,0,63
4387,-4.007999999998864,2699.9375,49,27,2,76
4388,30.3800000000014,5673.45,89,22,2,111
4389,4.580000000000687,3774.1052631578946,51,32,1,83
4390,-6.622749999999431,1992.0,33,34,1,67
4391,11.89250000000184,4759.25,67,22,0,89
4392,-19.11149999999909,2039.2777777777778,22,29,3,51
4393,-5.3594999999990645,2256.4117647058824,29,37,0,66
4394,-8.648999999999033,2698.0,36,25,3,61
4395,12.783999999999754,2464.8125,59,38,1,97
4396,-8.876249999999525,2141.5,30,28,5,58
4397,17.378250000001735,5002.9,55,39,0,94
4398,28.807250000002476,2434.4666666666667,86,32,1,118
4399,17.177250000001905,4163.3,62,27,0,89
4400,-20.76999999999951,2008.35,17,29,1,46
4401,15.977000000000416,2017.235294117647,46,34,1,80
4402,26.101500000002726,3876.3529411764707,84,14,2,98
4403,8.231250000001062,4260.05,53,30,0,83
4404,-6.175749999999237,2415.176470588235,50,34,5,84
4405,-23.838999999999473,2769.9473684210525,24,32,6,56
4406,-7.560499999999275,3224.35,28,37,6,65
4407,-24.65824999999925,2579.8,23,33,1,56
4408,-0.493999999999145,3936.157894736842,56,32,2,88
4409,-6.415249999999692,3135.4,32,27,2,59
4410,9.72775000000227,1831.875,60,22,2,82
4411,15.297250000001375,4255.3,56,26,1,82
4412,-7.963999999999325,2059.0,29,24,4,53
4413,-1.5255000000000565,1929.5882352941176,39,32,2,71
4414,-25.80874999999994,1429.0,11,32,3,43
4415,10.38125000000043,2652.375,53,37,1,90
4416,-15.480749999999935,2412.235294117647,37,42,0,79
4417,-3.6994999999994334,2524.35,32,23,2,55
4418,16.382000000000648,2277.25,54,30,0,84
4419,3.0917500000006504,2777.375,44,40,1,84
4420,0.17550000000088453,2563.4117647058824,33,37,0,70
4421,-6.131999999999277,2650.3888888888887,38,24,2,62
4422,5.944000000000766,3411.6,40,28,2,68
4423,-19.785749999999478,2771.684210526316,35,25,4,60
4424,-10.767999999999919,1923.7777777777778,23,29,3,52
4425,-13.151749999999396,2789.133333333333,27,22,3,49
4426,0.8872500000007536,2564.0,37,33,1,70
4427,-5.904749999999231,2839.2631578947367,36,34,0,70
4428,4.524250000000089,1481.9333333333334,45,34,2,79
4429,-2.004749999998829,2531.764705882353,44,28,1,72
4430,25.345500000001245,4377.55,63,21,0,84
4431,-1.1364999999988088,3478.25,47,30,1,77
4432,3.1140000000007317,3205.1052631578946,52,26,3,78
4433,-28.080499999999383,1818.0,24,32,2,56
4434,10.896500000000739,2362.4,47,23,1,70
4435,10.095000000000663,2731.6470588235293,48,24,3,72
4436,10.408250000000885,3026.1666666666665,53,17,0,70
4437,-26.01099999999962,2028.3,17,26,3,43
4438,-9.605749999998595,2398.3125,47,25,4,72
4439,-6.924249999998932,3186.8947368421054,45,26,2,71
4440,-18.03549999999999,2546.705882352941,33,44,0,77
4441,-11.134499999999061,2454.6111111111113,45,20,3,65
4442,-20.97849999999979,1981.3157894736842,16,31,0,47
4443,21.818250000001562,4210.8,74,15,1,89
4444,-19.728749999999053,2540.1,29,29,2,58
4445,-33.49399999999962,1963.842105263158,12,32,2,44
4446,-0.21974999999905132,2564.470588235294,44,21,0,65
4447,-18.08874999999919,2581.5333333333333,31,30,2,61
4448,11.562250000001466,3429.0833333333335,55,28,1,83
4449,23.54675000000126,3534.6470588235293,65,17,1,82
4450,24.92450000000248,4941.8,79,22,0,101
4451,-16.46924999999916,2715.0,33,25,2,58
4452,-5.893499999999916,2374.7894736842104,27,19,2,46
4453,35.88100000000218,4752.1,84,16,0,100
4454,11.19425000000145,4190.25,60,23,1,83
4455,41.45000000000289,5890.2,110,16,0,126
4456,14.169000000001807,4283.9,77,20,0,97
4457,-12.459249999999304,2528.25,28,26,2,54
4458,-3.893750000000099,1933.1764705882354,40,41,5,81
4459,-15.569000000000225,3137.4736842105262,39,40,4,79
4460,26.77125000000212,4597.105263157895,92,22,2,114
4461,-1.5237499999983115,4357.7,61,37,0,98
4462,-2.5527499999993415,2563.0625,37,24,2,61
4463,21.373250000001143,2273.375,61,23,4,84
4464,-24.170749999999686,1842.611111111111,20,26,1,46
4465,34.02650000000152,3095.8125,98,20,1,118
4466,-18.772749999999313,2728.157894736842,30,35,1,65
4467,-1.7929999999989938,2467.0555555555557,35,34,2,69
4468,-16.207499999998937,3116.1111111111113,35,40,2,75
4469,33.95850000000142,3934.5263157894738,68,22,0,90
4470,6.825500000002395,2795.0588235294117,63,27,4,90
4471,-3.7169999999996874,2506.6666666666665,38,26,4,64
4472,32.32400000000278,4636.25,76,23,1,99
4473,-20.318249999999363,1941.3333333333333,26,30,2,56
4474,6.941500000000616,2489.0555555555557,54,21,2,75
4475,14.916750000001619,3061.4444444444443,57,24,1,81
4476,-7.676749999999425,2543.4,35,28,5,63
4477,-9.068249999999257,2500.5,35,18,2,53
4478,0.9979999999999907,1942.875,61,29,2,90
4479,13.857750000001086,3253.4375,58,28,1,86
4480,-25.09674999999975,2008.5,15,32,1,47
4481,1.1107500000004369,2425.5555555555557,31,30,0,61
4482,20.083500000002292,4031.3888888888887,74,22,1,96
4483,1.6155000000014237,3511.277777777778,59,24,1,83
4484,-6.260999999999511,2571.923076923077,41,28,3,69
4485,-10.043249999998675,2664.6315789473683,43,25,2,68
4486,12.283750000002385,2520.5882352941176,59,22,2,81
4487,-3.739749999999185,2992.315789473684,42,25,1,67
4488,-28.096749999999844,1429.0,18,33,5,51
4489,-0.6057499999992386,3837.75,51,29,3,80
4490,22.117250000002336,4298.894736842105,82,21,0,103
4491,20.809250000001274,4451.4,63,25,1,88
4492,15.255250000001386,2768.3125,63,23,0,86
4493,-6.406999999999835,2052.5,40,21,10,61
4494,11.463500000001222,2405.3125,50,27,0,77
4495,2.9292500000016153,3010.4210526315787,47,29,0,76
4496,-18.169999999999398,2651.1666666666665,36,29,0,65
4497,-21.021499999999374,2937.9,32,33,1,65
4498,-27.84549999999996,1429.0,21,42,3,63
4499,12.56825000000154,3418.157894736842,53,29,3,82
4500,-9.113249999999404,2612.75,34,32,4,66
4501,-25.05849999999987,2202.15,17,26,4,43
4502,-5.139499999998966,2484.9473684210525,40,19,1,59
4503,-28.34324999999971,2052.05,14,31,1,45
4504,8.497000000000975,3009.9411764705883,58,31,3,89
4505,-9.391499999999363,1845.5294117647059,26,29,1,55
4506,-17.1997499999992,2540.3,27,25,0,52
4507,-21.866749999999936,2869.75,28,42,2,70
4508,2.576500000001039,3617.0526315789475,55,23,1,78
4509,5.761500000001139,3541.222222222222,64,19,1,83
4510,2.050250000000817,2948.15,39,24,3,63
4511,-18.79324999999948,2452.8333333333335,32,30,0,62
4512,9.872500000000555,2357.5625,42,29,2,71
4513,6.504250000001574,3281.55,54,20,0,74
4514,12.276250000001617,2941.4444444444443,49,25,0,74
4515,-18.367249999999522,2726.4210526315787,39,26,4,65
4516,4.300750000000908,2366.625,48,38,0,86
4517,12.483500000002064,5335.5,72,26,2,98
4518,8.345000000001647,1914.111111111111,46,30,1,76
4519,-1.071749999998471,3841.777777777778,61,37,3,98
4520,-25.447499999999756,1959.578947368421,15,29,5,44
4521,-3.2404999999994097,3117.5789473684213,36,31,2,67
4522,25.807000000001153,2364.5,64,21,4,85
4523,-2.948749999998829,3063.315789473684,45,23,2,68
4524,-16.84524999999957,2567.9,29,28,0,57
4525,15.252500000001447,4730.631578947368,69,24,0,93
4526,-2.8572499999993424,2495.8,46,22,4,68
4527,-7.611499999998894,2460.8333333333335,37,23,1,60
4528,18.797750000001834,5206.95,78,17,0,95
4529,-14.190999999999345,2566.722222222222,35,23,0,58
4530,0.8335000000013203,2616.0,46,25,1,71
4531,16.46050000000121,4051.4736842105262,58,39,3,97
4532,-14.33449999999927,3095.6,31,30,0,61
4533,-18.89874999999906,1986.421052631579,23,30,4,53
4534,5.266000000001301,3895.2105263157896,62,22,1,84
4535,1.5704999999998828,2605.529411764706,47,40,0,87
4536,7.559250000000285,1940.9375,65,33,2,98
4537,12.087500000001402,2576.6470588235293,57,30,5,87
4538,-9.192749999998506,2802.4736842105262,38,33,1,71
4539,24.407750000002316,4375.9,71,24,0,95
4540,1.8420000000005405,3168.75,42,24,0,66
4541,5.846750000000793,3476.8,41,26,0,67
4542,-16.067499999999697,1898.375,25,23,4,48
4543,-21.951499999999093,2408.5882352941176,33,34,0,67
4544,19.835000000002598,3453.722222222222,71,19,4,90
4545,-1.8697499999990306,3056.1,37,24,0,61
4546,7.212250000000978,4183.05,59,25,1,84
4547,23.432500000002257,4864.05,89,17,0,106
4548,8.476250000000972,3119.6,51,16,0,67
4549,17.734500000002022,2688.9375,59,29,0,88
4550,-5.416999999998782,2966.0588235294117,44,26,1,70
4551,-5.997999999997967,4809.2,79,29,1,108
4552,-14.014999999999546,2541.8947368421054,33,17,2,50
4553,6.817500000001367,2371.9333333333334,50,24,0,74
4554,-26.05899999999961,1967.0526315789473,16,29,5,45
4555,15.87250000000211,3968.722222222222,86,21,0,107
4556,-8.978249999999221,3004.6315789473683,42,28,0,70
4557,15.752500000001513,5156.05,72,21,0,93
4558,3.6305000000010303,3050.0,51,28,1,79
4559,3.377750000000259,3222.777777777778,43,26,0,69
4560,-16.957249999999032,2549.5882352941176,33,27,5,60
4561,4.435750000000841,3173.5,51,22,1,73
4562,-9.736499999998893,3866.45,42,39,1,81
4563,36.94750000000255,4091.277777777778,96,24,1,120
4564,-9.554499999999774,2560.3888888888887,32,27,1,59
4565,-23.139499999999295,2051.3684210526317,20,29,2,49
4566,22.69850000000206,3512.777777777778,64,24,1,88
4567,8.543500000001444,3151.6470588235293,62,36,0,98
4568,-9.582499999999794,2497.0555555555557,38,33,3,71
4569,17.73500000000114,4817.95,70,29,0,99
4570,14.163250000000463,3722.722222222222,61,35,0,96
4571,5.764000000002161,4326.05,73,29,0,102
4572,-10.224499999998613,2494.470588235294,41,29,1,70
4573,-1.4897499999994452,3891.9473684210525,66,28,1,94
4574,10.084750000001609,4111.75,67,20,1,87
4575,7.680250000001001,2885.6470588235293,47,33,7,80
4576,2.4352500000016497,3551.4,48,26,1,74
4577,2.1057500000020077,4138.55,65,23,0,88
4578,17.44750000000062,3764.157894736842,74,18,1,92
4579,-10.001999999998489,5914.75,80,32,3,112
4580,33.18175000000191,4643.4,79,17,0,96
4581,-9.006249999999472,2608.7894736842104,31,27,0,58
4582,-36.163749999999936,1944.9444444444443,22,35,3,57
4583,-0.8589999999989011,2647.777777777778,50,25,4,75
4584,19.84375000000083,3930.55,53,31,0,84
4585,11.37600000000118,4229.85,61,30,0,91
4586,-5.77499999999967,2028.4705882352941,44,30,0,74
4587,17.82950000000127,3493.4,56,21,0,77
4588,-9.195250000000057,2209.6111111111113,32,32,4,64
4589,-0.28749999999944953,2321.8125,48,26,0,74
4590,-7.63924999999941,3117.5789473684213,44,28,1,72
4591,18.152250000001565,4558.578947368421,64,34,0,98
4592,21.49650000000118,3611.6111111111113,77,23,0,100
4593,-5.008249999998406,3042.5882352941176,51,21,1,72
4594,-1.0329999999990969,3138.1111111111113,46,19,0,65
4595,-8.558249999998763,2510.157894736842,43,26,1,69
4596,-16.828999999999773,2129.1,14,37,1,51
4597,10.17775000000099,4139.105263157895,59,33,2,92
4598,-7.024999999998213,4131.055555555556,60,44,3,104
4599,-6.070999999999665,2265.705882352941,44,30,0,74
4600,-6.711749999999351,2511.1111111111113,36,30,7,66
4601,-7.464249999998849,2442.3333333333335,35,31,0,66
4602,-7.899499999999025,2668.1176470588234,43,22,1,65
4603,-2.272249999999337,3608.5,49,19,1,68
4604,2.3102500000007438,2741.277777777778,44,22,0,66
4605,11.180250000002223,2590.5882352941176,64,22,1,86
4606,-20.942249999999426,2008.45,20,26,2,46
4607,17.680250000000928,3752.2,58,18,0,76
4608,-15.444250000000213,1933.4444444444443,45,35,3,80
4609,-31.198999999999707,1889.4444444444443,19,33,2,52
4610,42.09750000000075,4825.9,73,19,0,92
4611,-22.866249999999475,2008.4,17,29,1,46
4612,-18.289749999999266,2532.764705882353,31,27,0,58
4613,13.394250000000593,3507.5789473684213,62,20,2,82
4614,3.411000000000616,2966.823529411765,54,33,1,87
4615,-27.5074999999997,1952.0,19,29,7,48
4616,1.9552500000014703,3087.5263157894738,46,28,2,74
4617,14.683499999999778,2352.9333333333334,58,21,0,79
4618,28.383750000001065,4694.2,62,30,0,92
4619,-12.399999999999526,2691.125,30,26,0,56
4620,1.6042500000007867,2375.0,44,27,4,71
4621,14.67950000000101,2444.8823529411766,51,22,0,73
4622,-11.812749999998848,2550.1875,40,26,0,66
4623,-2.5039999999989067,3198.4736842105262,45,28,0,73
4624,7.716000000001662,3672.0,54,25,0,79
4625,-1.9159999999991029,2500.5625,36,30,0,66
4626,-3.0847499999990733,3198.15,43,24,0,67
4627,-22.944499999999543,2099.7,20,27,0,47
4628,-0.1089999999993406,2540.133333333333,38,25,1,63
4629,11.008250000000706,3203.4444444444443,55,39,0,94
4630,2.945500000001178,3154.1111111111113,49,27,1,76
4631,-5.749999999999441,2496.684210526316,31,30,0,61
4632,18.496500000001774,4178.35,65,21,1,86
4633,-25.86599999999968,1963.388888888889,22,30,9,52
4634,22.270000000001637,2950.8125,78,18,0,96
4635,3.3120000000009506,3643.35,56,20,1,76
4636,0.8325000000007297,2471.0588235294117,34,22,1,56
4637,-29.963249999999853,1957.2777777777778,21,32,5,53
4638,-2.8319999999995913,1914.125,42,27,7,69
4639,47.98600000000187,5181.8421052631575,86,26,0,112
4640,-9.148999999999925,1917.611111111111,27,31,5,58
4641,-12.406500000000264,2311.4117647058824,39,32,9,71
4642,-4.4572499999982735,3526.9444444444443,68,29,1,97
4643,-7.35824999999889,3108.45,42,27,0,69
4644,37.35675000000237,5565.6,90,11,0,101
4645,-3.7727499999993896,2569.875,35,22,1,57
4646,13.970000000001226,4260.1,63,34,0,97
4647,11.901000000001332,3420.764705882353,72,26,1,98
4648,-31.859249999999953,1429.0,5,31,2,36
4649,-29.086750000000002,2056.0,10,35,3,45
4650,14.71725000000119,3786.684210526316,65,25,1,90
4651,0.3610000000009811,3089.0,33,36,0,69
4652,-11.220499999998818,2561.0625,39,26,3,65
4653,-16.406999999999176,2601.75,34,25,4,59
4654,-16.59599999999906,2600.1111111111113,39,28,1,67
4655,6.904750000001128,2467.3333333333335,55,25,0,80
4656,18.912000000000734,3530.0588235294117,62,22,0,84
4657,18.79925000000164,5042.55,78,18,0,96
4658,14.048500000001027,4231.45,60,23,1,83
4659,0.9072500000009487,2861.7894736842104,38,26,0,64
4660,11.764500000000856,3179.3888888888887,49,29,0,78
4661,3.4720000000012092,2720.4117647058824,49,25,0,74
4662,-7.096999999999466,2556.9473684210525,34,23,1,57
4663,-0.4909999999991396,3288.6,47,25,0,72
4664,3.081750000000819,2476.6666666666665,59,23,1,82
4665,15.316500000001763,3927.3333333333335,79,15,1,94
4666,14.950500000002,3518.764705882353,75,19,2,94
4667,7.087500000001489,4005.2,57,29,1,86
4668,7.658750000000959,3083.9,48,19,0,67
4669,-1.8947499999994366,2516.7894736842104,30,29,0,59
4670,10.900750000000695,3396.4444444444443,60,20,1,80
4671,12.45900000000107,3153.0555555555557,49,23,1,72
4672,11.010250000000472,3055.222222222222,56,34,3,90
4673,-12.918499999999614,3390.25,29,35,0,64
4674,-11.280749999999198,2590.2,34,21,0,55
4675,28.746750000001537,5174.45,73,19,2,92
4676,19.518250000001494,3901.35,65,16,0,81
4677,10.855500000000607,2874.6470588235293,47,29,0,76
4678,-5.999999999998986,3458.3684210526317,54,29,1,83
4679,-26.879249999999438,2024.3,17,29,1,46
4680,14.334750000001412,3944.5789473684213,66,11,0,77
4681,-8.561499999999368,2368.1666666666665,36,33,0,69
4682,-21.20799999999958,3012.45,30,40,1,70
4683,-0.2897499999995411,2602.722222222222,37,32,0,69
4684,7.923750000001009,3737.1,57,22,0,79
4685,-18.816749999999082,2708.0,27,34,0,61
4686,-4.373499999998933,3103.75,40,25,1,65
4687,5.1942500000017535,2374.4444444444443,44,28,3,72
4688,24.627750000002024,4528.473684210527,78,18,3,96
4689,45.47300000000197,4977.6,83,21,1,104
4690,31.26850000000214,2543.0,57,28,2,85
4691,3.5370000000007287,2695.9375,45,27,3,72
4692,-3.09974999999866,3127.6315789473683,47,24,2,71
4693,11.744000000000412,4288.789473684211,55,28,0,83
4694,10.923000000000815,2005.4375,54,20,0,74
4695,-0.6202499999993971,3222.7894736842104,45,25,0,70
4696,24.926500000000832,3161.176470588235,66,25,1,91
4697,7.230750000001242,3380.75,52,24,0,76
4698,14.76275000000119,2393.375,61,27,0,88
4699,-11.570499999999852,1877.8333333333333,27,33,3,60
4700,-13.717749999999924,2032.3,14,29,1,43
4701,-20.545249999999115,3994.95,44,30,0,74
4702,5.418250000001036,3004.7894736842104,47,23,4,70
4703,3.087750000000932,2330.75,50,29,0,79
4704,3.8845000000007466,2776.4444444444443,62,24,9,86
4705,0.7757500000007416,3702.95,52,26,0,78
4706,-20.434249999999956,2049.842105263158,23,32,9,55
4707,-4.454249999998066,1917.4117647058824,43,31,1,74
4708,-4.188749999999251,3061.4736842105262,40,33,0,73
4709,-0.5862499999989094,3910.1,49,26,0,75
4710,7.363000000001497,2816.0,65,27,0,92
4711,12.716750000001303,3639.25,50,28,0,78
4712,8.101750000000658,3646.5,53,22,0,75
4713,-9.101749999999264,3296.2631578947367,37,36,3,73
4714,31.707750000000726,3997.2105263157896,63,20,1,83
4715,24.71900000000151,4556.789473684211,81,27,2,108
4716,-17.2669999999996,2560.0,25,27,1,52
4717,-33.76499999999993,1429.0,19,36,5,55
4718,14.853750000001659,1888.375,51,20,3,71
4719,-19.634999999999025,2851.4,29,32,0,61
4720,-1.5162499999985648,3594.9,46,29,1,75
4721,7.70700000000118,3904.5789473684213,57,29,2,86
4722,-12.67399999999892,2489.5625,50,25,9,75
4723,10.549500000001698,3215.4117647058824,59,38,2,97
4724,-29.976499999999362,1979.9411764705883,16,32,2,48
4725,-0.8744999999989093,3959.5789473684213,54,31,2,85
4726,4.043000000001362,3264.764705882353,61,27,3,88
4727,3.697750000001091,2850.722222222222,46,24,0,70
4728,-24.52799999999922,2059.294117647059,34,41,1,75
4729,5.728000000001175,3503.8823529411766,52,21,0,73
4730,-3.1979999999987205,3483.315789473684,43,29,0,72
4731,25.07250000000255,4794.1578947368425,83,26,1,109
4732,-24.36824999999883,2650.45,36,24,2,60
4733,5.380750000000985,3033.1666666666665,50,25,3,75
4734,29.759000000001038,2503.5625,69,20,1,89
4735,23.76250000000102,3164.0,78,21,2,99
4736,-13.392999999999645,1857.625,27,42,1,69
4737,10.471750000001213,3131.4375,55,19,0,74
4738,13.094500000001059,3033.1666666666665,51,32,0,83
4739,3.5922500000014663,3013.8947368421054,53,27,0,80
4740,-14.209999999999042,2803.375,26,33,2,59
4741,18.1712500000017,3112.470588235294,61,25,1,86
4742,11.42975000000084,3027.722222222222,48,22,1,70
4743,-16.08049999999951,1927.5882352941176,23,25,5,48
4744,-6.897999999999129,2387.0,45,23,0,68
4745,-7.71824999999956,2562.4666666666667,31,26,1,57
4746,-1.3434999999996944,2671.2,31,24,1,55
4747,15.109750000000867,4348.85,54,26,1,80
4748,-12.397749999999334,2359.0588235294117,33,28,1,61
4749,-13.808249999999692,2055.1666666666665,30,32,4,62
4750,16.584250000001266,3744.25,59,20,0,79
4751,32.93225000000226,4991.0,81,27,0,108
4752,-1.1102499999994073,2723.6875,51,29,0,80
4753,-18.415999999998938,2817.3,30,29,3,59
4754,2.037500000000727,2445.823529411765,45,36,1,81
4755,-1.9099999999986241,3649.65,43,33,0,76
4756,29.617500000001247,5492.45,84,26,0,110
4757,-16.27999999999961,3469.55,29,33,2,62
4758,16.834250000002804,4651.421052631579,77,31,0,108
4759,19.96500000000147,3658.4444444444443,66,21,0,87
4760,-13.925499999999417,2900.2631578947367,31,31,2,62
4761,-8.51474999999948,2514.8,40,33,0,73
4762,-7.081999999999572,2345.0,38,33,1,71
4763,1.0550000000005142,2419.6,45,29,0,74
4764,9.985500000002208,4556.2,77,22,0,99
4765,20.189500000000812,3602.0,60,35,0,95
4766,19.392000000000515,3728.1052631578946,49,31,0,80
4767,-0.8482499999992449,4130.894736842105,67,39,1,106
4768,12.69800000000094,3607.6,58,21,0,79
4769,-1.3327499999987036,3012.157894736842,47,20,0,67
4770,-9.602999999999387,2711.277777777778,30,24,5,54
4771,13.737250000001021,3681.4736842105262,57,24,1,81
4772,-16.242749999999855,2032.2,13,33,0,46
4773,22.262750000001173,2442.875,65,26,0,91
4774,2.7632500000015954,2358.6875,48,27,0,75
4775,6.835750000000745,4029.05,43,33,0,76
4776,-8.00049999999887,3482.3,50,26,0,76
4777,23.541250000001003,3150.823529411765,74,22,0,96
4778,-12.145749999999556,2623.625,47,27,2,74
4779,17.222250000002074,2279.866666666667,76,25,1,101
4780,33.56100000000216,2811.0,71,22,0,93
4781,3.7977500000010602,3914.7,49,29,1,78
4782,25.7255000000018,4594.473684210527,87,32,1,119
4783,-7.45574999999923,2284.1875,47,25,5,72
4784,-5.857499999998948,3051.722222222222,56,31,1,87
4785,20.36250000000139,4707.0,70,20,1,90
4786,-2.963249999999172,2357.75,46,32,0,78
4787,-16.528499999999802,2016.3333333333333,23,28,1,51
4788,33.16750000000175,4631.55,72,25,0,97
4789,20.865750000000492,2953.823529411765,59,20,0,79
4790,16.410500000001964,3622.1666666666665,65,24,2,89
4791,-22.737999999999793,2072.3529411764707,28,31,1,59
4792,35.22125000000255,5153.7,86,18,0,104
4793,-9.346249999999397,2871.15,32,29,0,61
4794,23.290750000001275,4791.05,64,25,0,89
4795,26.891000000001156,5186.4,73,22,0,95
4796,27.315500000000903,4687.1,73,16,0,89
4797,19.909750000002674,4747.35,81,17,0,98
4798,-4.316249999999059,3576.65,42,29,0,71
4799,1.5335000000008026,3413.157894736842,48,37,0,85
4800,3.514500000000381,2067.705882352941,47,36,0,83
4801,11.464500000000717,3227.5,54,17,0,71
4802,-10.066999999999563,2629.2,25,24,1,49
4803,-17.06099999999886,2359.3888888888887,30,30,0,60
4804,-9.955999999999309,2479.470588235294,29,25,0,54
4805,37.56775000000102,3252.722222222222,77,19,1,96
4806,15.73350000000028,2542.9411764705883,58,26,2,84
4807,-20.321999999999598,2008.5,16,31,3,47
4808,0.739750000000471,2759.8947368421054,33,25,4,58
4809,11.826250000001558,4143.5,69,23,0,92
4810,-30.54475000000027,1952.0526315789473,15,27,7,42
4811,9.513750000001655,3450.7894736842104,53,25,0,78
4812,3.5940000000007144,3673.8947368421054,58,30,0,88
4813,8.754500000001308,4367.25,61,27,0,88
4814,-10.30774999999928,2617.8,37,21,0,58
4815,7.302750000000938,4103.75,52,21,0,73
4816,-13.994249999999838,2294.6470588235293,38,29,3,67
4817,15.691250000001741,3776.684210526316,52,33,1,85
4818,19.37625000000066,3100.277777777778,56,25,1,81
4819,-4.4615000000000915,1853.9411764705883,32,33,2,65
4820,16.919250000000567,3509.277777777778,66,33,0,99
4821,-0.40599999999921427,2877.4117647058824,40,25,1,65
4822,25.07775000000154,4705.15,63,22,0,85
4823,10.790750000001685,2653.25,55,29,0,84
4824,17.500000000001457,5444.2,71,27,0,98
4825,-27.359249999999484,1976.3157894736842,17,31,1,48
4826,-10.54174999999933,2839.45,35,27,0,62
4827,0.76125000000149,4092.55,46,28,0,74
4828,2.5902500000009443,2587.9285714285716,40,33,0,73
4829,-17.8062499999993,2444.8888888888887,38,30,0,68
4830,-17.508249999998757,2355.176470588235,37,29,2,66
4831,-22.395500000000492,2013.842105263158,30,22,16,52
4832,-25.806999999999608,2172.8,16,26,1,42
4833,-11.335249999999053,2572.0,36,34,1,70
4834,3.9912500000003126,3774.0526315789475,69,32,0,101
4835,-18.34324999999894,1993.0,31,22,5,53
4836,5.2602500000013865,4074.8947368421054,90,27,1,117
4837,-6.11749999999927,2582.0,35,23,1,58
4838,10.726250000001984,3671.3684210526317,64,19,0,83
4839,12.973500000002115,3317.8888888888887,59,28,0,87
4840,15.695499999999914,3896.842105263158,65,27,1,92
4841,-10.764249999999512,2476.6666666666665,37,37,1,74
4842,24.755000000002294,4870.45,87,19,0,106
4843,21.151000000001726,4710.9,74,28,0,102
4844,-3.105499999999335,3106.5789473684213,49,29,0,78
4845,-9.393249999999256,2513.0,43,36,0,79
4846,21.26625000000073,2917.1875,85,27,2,112
4847,5.751250000002345,4472.0,67,23,0,90
4848,25.760250000001367,4267.3,72,18,1,90
4849,15.1772500000022,2965.9411764705883,61,27,0,88
4850,15.423000000001716,3392.0555555555557,68,18,0,86
4851,-7.739249999999274,2513.1176470588234,31,25,0,56
4852,2.600750000001186,3214.65,56,24,1,80
4853,-1.8034999999987693,3407.55,45,30,1,75
4854,13.657250000000982,4395.789473684211,83,31,3,114
4855,18.299250000001127,3946.157894736842,59,28,0,87
4856,33.16750000000033,3615.1666666666665,80,16,0,96
4857,-25.748999999999988,2145.8947368421054,19,28,5,47
4858,16.243500000000168,2243.5,49,21,0,70
4859,-25.72499999999925,2651.3684210526317,28,31,4,59
4860,-17.17074999999966,2075.8,17,28,0,45
4861,6.916750000000482,3819.55,44,24,2,68
4862,0.4085000000023956,3630.266666666667,52,30,0,82
4863,-7.5099999999994465,1866.5625,34,38,1,72
4864,-1.7412499999997635,2409.722222222222,26,30,1,56
4865,-4.487749999999425,2693.777777777778,31,32,1,63
4866,-17.9737499999992,2596.8947368421054,35,23,1,58
4867,-9.525499999999258,2544.9411764705883,36,26,1,62
4868,-18.564249999998772,2221.090909090909,28,40,3,68
4869,-8.927249999999358,3252.85,36,24,1,60
4870,40.59275000000224,4704.6,91,15,0,106
4871,32.81125000000118,4516.444444444444,88,21,0,109
4872,1.375500000001032,3214.1111111111113,55,32,6,87
4873,-29.21199999999942,2008.4,15,30,1,45
4874,5.0690000000013455,3922.7894736842104,62,24,3,86
4875,-31.793750000000006,2457.5263157894738,19,42,4,61
4876,9.615500000000836,2521.529411764706,52,32,0,84
4877,4.285500000001335,2874.3529411764707,61,38,0,99
4878,8.204750000000285,1898.3125,44,29,1,73
4879,5.118750000001155,2255.4666666666667,59,26,4,85
4880,26.587000000001346,4343.35,68,18,0,86
4881,-25.813499999999102,2121.5,46,29,10,75
4882,23.710750000001433,4232.894736842105,86,20,0,106
4883,-20.78174999999954,2040.15,12,33,3,45
4884,3.149750000000692,3243.25,50,27,0,77
4885,33.66875000000117,5916.4,81,23,1,104
4886,4.402500000001909,3806.85,63,28,1,91
4887,7.968750000001248,3109.8333333333335,56,27,0,83
4888,2.834500000000893,2420.1666666666665,53,34,3,87
4889,22.097500000001737,3492.6470588235293,69,24,0,93
4890,-29.382749999999646,2142.5,17,32,0,49
4891,8.586250000001078,2807.235294117647,50,33,0,83
4892,18.435500000002186,2843.75,68,25,0,93
4893,-0.41324999999848516,3469.3846153846152,54,32,0,86
4894,26.597750000002215,3348.875,96,29,0,125
4895,-7.802999999999154,2548.15,35,19,1,54
4896,-33.45275000000048,1429.0,19,45,0,64
4897,16.230500000001626,3591.7,59,23,0,82
4898,7.454500000001462,4785.45,61,39,0,100
4899,21.898750000000998,3338.1666666666665,70,25,0,95
4900,-13.0614999999992,2662.2631578947367,30,28,1,58
4901,9.085000000001772,4645.85,63,29,0,92
4902,25.043500000000783,2543.4,74,28,2,102
4903,-1.4839999999991085,3339.222222222222,60,15,3,75
4904,13.259000000001887,4490.95,68,21,0,89
4905,-1.4962499999987757,3538.4736842105262,48,26,3,74
4906,16.313000000001065,3612.45,53,18,0,71
4907,-2.6119999999987686,2419.125,48,21,0,69
4908,14.496500000000305,2414.375,57,27,1,84
4909,-23.28124999999961,2024.35,15,33,0,48
4910,-12.212999999998807,3031.4736842105262,43,32,0,75
4911,-1.905749999998775,3033.0588235294117,41,35,0,76
4912,-1.9024999999990975,2610.85,34,24,0,58
4913,17.307750000001132,3619.65,51,27,0,78
4914,-16.842999999998757,2059.7894736842104,29,24,5,53
4915,-5.72499999999845,4513.25,48,34,0,82
4916,-4.333749999999422,2685.6315789473683,36,26,1,62
4917,-47.095750000000145,1429.0,6,30,4,36
4918,8.987250000001257,3691.0555555555557,60,34,1,94
4919,11.8965000000012,4131.5,65,18,1,83
4920,-12.420249999999921,1816.0,31,32,0,63
4921,18.6252500000016,4328.2,58,31,0,89
4922,-21.328249999999464,3460.777777777778,39,31,0,70
4923,-9.608249999999376,2504.705882352941,33,23,0,56
4924,-14.108749999999574,2138.764705882353,28,28,0,56
4925,8.520500000000496,3014.842105263158,39,27,4,66
4926,-14.226499999999708,2020.7777777777778,36,32,11,68
4927,17.513750000002055,5745.65,79,23,1,102
4928,5.665500000000455,2715.0,48,25,1,73
4929,-29.772249999999445,1966.764705882353,20,37,0,57
4930,-8.292499999999634,1759.4375,33,33,2,66
4931,-4.509499999999678,2021.9411764705883,35,31,3,66
4932,-12.125999999999683,2085.8125,21,25,2,46
4933,1.0220000000001825,2134.25,48,43,0,91
4934,14.52500000000129,3980.8,69,25,1,94
4935,-2.083999999999379,2795.8947368421054,32,32,1,64
4936,-1.5254999999992438,2556.0625,44,31,0,75
4937,-14.333499999999194,2657.8,28,27,0,55
4938,-8.1962499999991,2700.0625,36,27,0,63
4939,-10.352249999999511,2395.6315789473683,29,31,6,60
4940,-11.683749999999804,2683.0,38,31,0,69
4941,21.28850000000179,5429.85,77,24,1,101
4942,5.516500000001761,3894.25,60,24,0,84
4943,-3.7739999999998703,2435.222222222222,66,36,0,102
4944,-1.1464999999989378,2496.294117647059,51,26,1,77
4945,-23.37924999999966,2096.6,15,28,2,43
4946,19.124250000000263,1839.75,64,34,0,98
4947,-11.895249999998454,2421.1666666666665,40,28,0,68
4948,-22.837749999999556,1909.6666666666667,25,30,6,55
4949,-11.934499999999566,2619.6,29,21,1,50
4950,-13.336999999999245,2836.3888888888887,37,32,1,69
4951,5.6387500000009,3787.85,53,28,1,81
4952,-11.04174999999952,2485.8947368421054,30,24,4,54
4953,-14.018249999999128,2536.35,31,22,2,53
4954,-14.354999999999794,2302.0,29,27,0,56
4955,-2.8532499999994,2553.4444444444443,32,21,1,53
4956,14.526250000002037,4124.777777777777,77,32,0,109
4957,9.871750000001903,2884.705882352941,62,25,0,87
4958,-6.156249999999412,2443.1111111111113,50,34,5,84
4959,-3.3979999999994157,2364.6470588235293,33,32,2,65
4960,-7.152499999999252,3000.5263157894738,34,34,1,68
4961,-14.666249999999229,3336.25,37,25,2,62
4962,24.82100000000129,4492.65,73,14,0,87
4963,6.037750000001074,2396.375,67,32,2,99
4964,-8.761749999999344,2259.3076923076924,35,23,17,58
4965,9.628000000000618,2291.0,62,28,0,90
4966,-11.552999999999537,2513.176470588235,29,23,1,52
4967,0.5710000000011021,1880.4375,51,27,0,78
4968,30.325500000001348,3200.4117647058824,93,30,3,123
4969,-13.293499999999018,2521.0526315789475,32,25,2,57
4970,6.949000000001684,3942.3333333333335,56,29,4,85
4971,22.88425000000182,5359.2,78,29,0,107
4972,10.198750000000809,3725.6315789473683,53,24,1,77
4973,20.33300000000115,4402.15,66,15,0,81
4974,-18.52099999999904,3614.05,31,28,0,59
4975,-1.406999999999011,3174.35,47,19,1,66
4976,-0.13524999999955592,2471.0,35,21,1,56
4977,-12.79474999999908,2508.55,29,25,4,54
4978,-14.853999999998958,2479.470588235294,35,24,1,59
4979,-19.66499999999975,1954.7058823529412,37,30,3,67
4980,2.5532500000008875,3398.95,54,25,2,79
4981,28.906000000001846,4087.3684210526317,75,20,0,95
4982,17.709500000001192,3845.0,61,15,2,76
4983,20.258000000002696,4360.684210526316,84,11,1,95
4984,-10.720499999999081,2579.85,36,23,1,59
4985,7.441000000000976,2498.0588235294117,53,24,1,77
4986,6.9885000000005615,2481.75,49,20,7,69
4987,-4.415999999998862,2616.0,41,27,2,68
4988,13.874500000000769,2899.764705882353,60,20,1,80
4989,-11.26149999999826,3334.8888888888887,55,28,1,83
4990,22.00650000000128,2827.705882352941,70,30,0,100
4991,-21.628249999999255,2071.8888888888887,27,38,0,65
4992,-24.06349999999952,1429.0,17,26,4,43
4993,-3.097999999999339,2996.5263157894738,44,33,1,77
4994,-7.15449999999853,3258.45,47,26,1,73
4995,21.530000000002648,2549.125,64,27,0,91
4996,19.999000000000315,3561.842105263158,72,23,0,95
4997,-8.291249999999604,2258.176470588235,46,34,1,80
4998,7.464250000001071,3840.95,50,21,1,71
4999,14.47800000000061,3698.0526315789475,66,35,2,101
5000,5.061749999999984,2726.5263157894738,43,26,2,69
